name[Blue Spice], eatType[coffee shop], area[city centre]	The coffee shop Blue Spice is located in the city centre.
name[Blue Spice], eatType[coffee shop], area[riverside]	The coffee shop Blue Spice is located in the riverside area.
name[Blue Spice], eatType[coffee shop], customer rating[5 out of 5], near[Crowne Plaza Hotel]	The coffee shop Blue Spice is near Crowne Plaza Hotel. It has a customer rating of 5 out of 5.
name[Blue Spice], eatType[coffee shop], customer rating[average], near[Burger King]	The coffee shop Blue Spice is by Burger King. It has an average customer rating.
name[Blue Spice], eatType[coffee shop], customer rating[average], near[Crowne Plaza Hotel]	The coffee shop Blue Spice is located near Crowne Plaza Hotel. It has an average customer rating.
name[Blue Spice], eatType[pub], area[city centre]	The pub Blue Spice is in city centre.
name[Blue Spice], eatType[pub], area[riverside]	The pub Blue Spice is in the riverside area.
name[Blue Spice], eatType[pub], customer rating[5 out of 5], near[Crowne Plaza Hotel]	The pub Blue Spice can be found near Crowne Plaza Hotel. Customer rate it 5 out of 5.
name[Blue Spice], eatType[pub], customer rating[average], near[Burger King]	The pub Blue Spice is near Burger King. It has an average customer rating.
name[Blue Spice], eatType[pub], customer rating[average], near[Crowne Plaza Hotel]	The pub Blue Spice is by Crowne Plaza Hotel. It has an average customer rating.
name[Blue Spice], eatType[pub], food[Chinese], area[city centre], familyFriendly[no], near[Rainbow Vegetarian Café]	Blue Spice, which serves Chinese food, is a non-family-friendly pub. It is located in the city centre near Rainbow Vegetarian Café.
name[Blue Spice], eatType[pub], food[Chinese], area[city centre], familyFriendly[yes], near[Rainbow Vegetarian Café]	Blue Spice, which serves Chinese cuisine, is a family-friendly pub. It is located in the city centre area and can be found near Rainbow Vegetarian Café.
name[Blue Spice], eatType[pub], food[Chinese], area[riverside], familyFriendly[no], near[Rainbow Vegetarian Café]	Blue Spice, which offers Chinese food, is a non-child-friendly pub. It is in riverside near Rainbow Vegetarian Café.
name[Blue Spice], eatType[pub], food[Chinese], area[riverside], familyFriendly[yes], near[Rainbow Vegetarian Café]	Blue Spice, which offers Chinese cuisine, is a child-friendly pub. It is in the riverside area by Rainbow Vegetarian Café.
name[Blue Spice], eatType[pub], food[English], area[city centre], familyFriendly[no], near[Rainbow Vegetarian Café]	Blue Spice, which serves English food, is a non-kid-friendly pub. It is located in the city centre near Rainbow Vegetarian Café.
name[Blue Spice], eatType[pub], food[English], area[city centre], familyFriendly[yes], near[Rainbow Vegetarian Café]	Blue Spice, which serves English cuisine, is a kid-friendly pub. It is located in the city centre area and can be found near Rainbow Vegetarian Café.
name[Blue Spice], eatType[pub], food[English], area[riverside], familyFriendly[no], near[Rainbow Vegetarian Café]	The pub Blue Spice is in riverside. It offers English food. Blue Spice, which is near Rainbow Vegetarian Café, does not welcome children.
name[Blue Spice], eatType[pub], food[English], area[riverside], familyFriendly[yes], near[Rainbow Vegetarian Café]	The pub Blue Spice is in the riverside area. It offers English cuisine. Blue Spice, which is by Rainbow Vegetarian Café, welcomes children.
name[Blue Spice], eatType[restaurant], food[Chinese], area[city centre], familyFriendly[no], near[Rainbow Vegetarian Café]	The restaurant Blue Spice is located in the city centre. It serves Chinese food. It does not welcome kids.
name[Blue Spice], eatType[restaurant], food[Chinese], area[city centre], familyFriendly[yes], near[Rainbow Vegetarian Café]	The restaurant Blue Spice is located in the city centre area. It serves Chinese cuisine. Blue Spice which can be found near Rainbow Vegetarian Café welcomes kids.
name[Blue Spice], eatType[restaurant], food[Chinese], area[riverside], familyFriendly[no], near[Rainbow Vegetarian Café]	Blue Spice, which offers Chinese food, is a non-family-friendly restaurant. It is in riverside near Rainbow Vegetarian Café.
name[Blue Spice], eatType[restaurant], food[Chinese], area[riverside], familyFriendly[yes], near[Rainbow Vegetarian Café]	The restaurant Blue Spice is in the riverside area. It offers Chinese cuisine. Blue Spice, which is by Rainbow Vegetarian Café, welcomes families.
name[Blue Spice], eatType[restaurant], food[English], area[city centre], familyFriendly[no], near[Rainbow Vegetarian Café]	Blue Spice, which serves English food, is a non-child-friendly restaurant. It is located in the city centre near Rainbow Vegetarian Café.
name[Blue Spice], eatType[restaurant], food[English], area[city centre], familyFriendly[yes], near[Rainbow Vegetarian Café]	Blue Spice, which serves English cuisine, is a family-friendly restaurant. It is located in the city centre area and can be found near Rainbow Vegetarian Café.
name[Blue Spice], eatType[restaurant], food[English], area[riverside], familyFriendly[no], near[Rainbow Vegetarian Café]	Blue Spice, which offers English food, is a non-kid-friendly restaurant. It is in riverside near Rainbow Vegetarian Café.
name[Blue Spice], eatType[restaurant], food[English], area[riverside], familyFriendly[yes], near[Rainbow Vegetarian Café]	Blue Spice, which offers English cuisine, is a child-friendly restaurant. It is in the riverside area by Rainbow Vegetarian Café.
name[Clowns], eatType[coffee shop], customer rating[3 out of 5], near[All Bar One]	The coffee shop Clowns is located near All Bar One. It has a customer rating of 3 out of 5.
name[Clowns], eatType[coffee shop], customer rating[5 out of 5], near[Crowne Plaza Hotel]	The coffee shop Clowns can be found near Crowne Plaza Hotel. Customer rate it 5 out of 5.
name[Clowns], eatType[coffee shop], near[The Sorrento]	The coffee shop Clowns is near The Sorrento.
name[Clowns], eatType[pub], customer rating[3 out of 5], near[All Bar One]	The pub Clowns is by All Bar One. It has a customer rating of 3 out of 5.
name[Clowns], eatType[pub], customer rating[5 out of 5], near[Crowne Plaza Hotel]	The pub Clowns is located near Crowne Plaza Hotel. Customer rate it 5 out of 5.
name[Clowns], eatType[pub], near[The Sorrento]	The pub Clowns can be found near The Sorrento.
name[Cocum], eatType[coffee shop], customer rating[high], near[Burger King]	The coffee shop Cocum is near Burger King. It has a high customer rating.
name[Cocum], eatType[coffee shop], customer rating[high], near[Café Sicilia]	The coffee shop Cocum is by Café Sicilia. It has a high customer rating.
name[Cocum], eatType[coffee shop], customer rating[low], near[Café Sicilia]	The coffee shop Cocum is located near Café Sicilia. It has a low customer rating.
name[Cocum], eatType[coffee shop], customer rating[low], near[Express by Holiday Inn]	The coffee shop Cocum can be found near Express by Holiday Inn. It has a low customer rating.
name[Cocum], eatType[coffee shop], near[The Rice Boat]	The coffee shop Cocum is near The Rice Boat.
name[Cocum], eatType[coffee shop], near[The Sorrento]	The coffee shop Cocum is by The Sorrento.
name[Cocum], eatType[pub], customer rating[high], near[Burger King]	The pub Cocum is located near Burger King. It has a high customer rating.
name[Cocum], eatType[pub], customer rating[high], near[Café Sicilia]	The pub Cocum can be found near Café Sicilia. It has a high customer rating.
name[Cocum], eatType[pub], customer rating[low], near[Café Sicilia]	The pub Cocum is near Café Sicilia. It has a low customer rating.
name[Cocum], eatType[pub], customer rating[low], near[Express by Holiday Inn]	The pub Cocum is by Express by Holiday Inn. It has a low customer rating.
name[Cocum], eatType[pub], near[The Rice Boat]	The pub Cocum is located near The Rice Boat.
name[Cocum], eatType[pub], near[The Sorrento]	The pub Cocum can be found near The Sorrento.
name[Cotto], eatType[coffee shop], near[The Bakers]	The coffee shop Cotto is near The Bakers.
name[Cotto], eatType[pub], near[The Bakers]	The pub Cotto is by The Bakers.
name[Giraffe], eatType[coffee shop], near[The Bakers]	The coffee shop Giraffe is located near The Bakers.
name[Giraffe], eatType[coffee shop], near[The Rice Boat]	The coffee shop Giraffe can be found near The Rice Boat.
name[Giraffe], eatType[pub], food[English], area[riverside], familyFriendly[yes], near[Rainbow Vegetarian Café]	Giraffe, which serves English food, is a kid-friendly pub. It is located in the riverside near Rainbow Vegetarian Café.
name[Giraffe], eatType[pub], food[Fast food], area[city centre], familyFriendly[no], near[Rainbow Vegetarian Café]	The pub Giraffe is located in the city centre area. It serves fast food. Giraffe, which is by Rainbow Vegetarian Café, does not welcome children.
name[Giraffe], eatType[pub], food[Fast food], area[city centre], familyFriendly[yes], near[Rainbow Vegetarian Café]	The pub Giraffe is in city centre. It offers fast food. Giraffe, which is located near Rainbow Vegetarian Café, welcomes children.
name[Giraffe], eatType[pub], food[Fast food], area[riverside], familyFriendly[no], near[Rainbow Vegetarian Café]	The pub Giraffe is in the riverside area. It offers fast food. Giraffe which can be found near Rainbow Vegetarian Café does not welcome kids.
name[Giraffe], eatType[pub], food[Fast food], area[riverside], familyFriendly[yes], near[Rainbow Vegetarian Café]	The pub Giraffe is located in the riverside. It serves fast food. Giraffe, which is near Rainbow Vegetarian Café, welcomes kids.
name[Giraffe], eatType[pub], food[Fast food], area[riverside], familyFriendly[yes], near[Raja Indian Cuisine]	The pub Giraffe is located in the riverside area. It serves fast food. Giraffe, which is by Raja Indian Cuisine, welcomes families.
name[Giraffe], eatType[pub], food[French], area[city centre], familyFriendly[no], near[Raja Indian Cuisine]	Giraffe, which offers French food, is a non-family-friendly pub. It is in city centre and is located near Raja Indian Cuisine.
name[Giraffe], eatType[pub], food[French], area[city centre], familyFriendly[yes], near[Raja Indian Cuisine]	Giraffe, which offers French cuisine, is a family-friendly pub. It is in the city centre area and can be found near Raja Indian Cuisine.
name[Giraffe], eatType[pub], food[French], area[riverside], familyFriendly[no], near[Raja Indian Cuisine]	Giraffe, which serves French food, is a non-child-friendly pub. It is located in the riverside near Raja Indian Cuisine.
name[Giraffe], eatType[pub], food[French], area[riverside], familyFriendly[yes], near[Raja Indian Cuisine]	Giraffe, which serves French cuisine, is a child-friendly pub. It is located in the riverside area by Raja Indian Cuisine.
name[Giraffe], eatType[pub], near[The Bakers]	The pub Giraffe is located near The Bakers.
name[Giraffe], eatType[pub], near[The Rice Boat]	The pub Giraffe can be found near The Rice Boat.
name[Giraffe], eatType[restaurant], food[English], area[riverside], familyFriendly[yes], near[Rainbow Vegetarian Café]	Giraffe, which offers English food, is a kid-friendly restaurant. It is in riverside near Rainbow Vegetarian Café.
name[Giraffe], eatType[restaurant], food[Fast food], area[city centre], familyFriendly[no], near[Rainbow Vegetarian Café]	Giraffe, which offers fast food, is a non-kid-friendly restaurant. It is in the city centre area by Rainbow Vegetarian Café.
name[Giraffe], eatType[restaurant], food[Fast food], area[city centre], familyFriendly[yes], near[Rainbow Vegetarian Café]	The restaurant Giraffe is located in the city centre. It serves fast food. It welcomes children.
name[Giraffe], eatType[restaurant], food[Fast food], area[riverside], familyFriendly[no], near[Rainbow Vegetarian Café]	The restaurant Giraffe is located in the riverside area. It serves fast food. Giraffe which can be found near Rainbow Vegetarian Café does not welcome children.
name[Giraffe], eatType[restaurant], food[Fast food], area[riverside], familyFriendly[yes], near[Rainbow Vegetarian Café]	The restaurant Giraffe is in riverside. It offers fast food. Giraffe, which is near Rainbow Vegetarian Café, welcomes kids.
name[Giraffe], eatType[restaurant], food[Fast food], area[riverside], familyFriendly[yes], near[Raja Indian Cuisine]	The restaurant Giraffe is in the riverside area. It offers fast food. Giraffe, which is by Raja Indian Cuisine, welcomes families.
name[Giraffe], eatType[restaurant], food[French], area[city centre], familyFriendly[no], near[Raja Indian Cuisine]	The restaurant Giraffe is located in the city centre. It serves French food. It does not welcome kids.
name[Giraffe], eatType[restaurant], food[French], area[city centre], familyFriendly[yes], near[Raja Indian Cuisine]	Giraffe, which serves French cuisine, is a family-friendly restaurant. It is located in the city centre area and can be found near Raja Indian Cuisine.
name[Giraffe], eatType[restaurant], food[French], area[riverside], familyFriendly[no], near[Raja Indian Cuisine]	Giraffe, which offers French food, is a non-family-friendly restaurant. It is in riverside near Raja Indian Cuisine.
name[Giraffe], eatType[restaurant], food[French], area[riverside], familyFriendly[yes], near[Raja Indian Cuisine]	Giraffe, which offers French cuisine, is a child-friendly restaurant. It is in the riverside area by Raja Indian Cuisine.
name[Green Man], eatType[coffee shop], customer rating[1 out of 5], near[All Bar One]	The coffee shop Green Man is located near All Bar One. It has a customer rating of 1 out of 5.
name[Green Man], eatType[coffee shop], customer rating[3 out of 5], near[All Bar One]	The coffee shop Green Man can be found near All Bar One. Customer rate it 3 out of 5.
name[Green Man], eatType[pub], customer rating[1 out of 5], near[All Bar One]	The pub Green Man is near All Bar One. It has a customer rating of 1 out of 5.
name[Green Man], eatType[pub], customer rating[3 out of 5], near[All Bar One]	The pub Green Man is by All Bar One. Customer rate it 3 out of 5.
name[Green Man], eatType[pub], food[Italian], area[riverside], familyFriendly[yes], near[Express by Holiday Inn]	Green Man, which serves Italian food, is a kid-friendly pub. It is located in the riverside near Express by Holiday Inn.
name[Green Man], eatType[pub], food[Italian], area[riverside], familyFriendly[yes], near[Raja Indian Cuisine]	The pub Green Man is located in the riverside area. It serves Italian cuisine. Green Man which can be found near Raja Indian Cuisine welcomes children.
name[Green Man], eatType[pub], food[Japanese], area[city centre], familyFriendly[no], near[Express by Holiday Inn]	Green Man, which offers Japanese food, is a non-child-friendly pub. It is in city centre near Express by Holiday Inn.
name[Green Man], eatType[pub], food[Japanese], area[city centre], familyFriendly[yes], near[Express by Holiday Inn]	The pub Green Man is in the city centre area. It offers Japanese cuisine. Green Man, which is by Express by Holiday Inn, welcomes kids.
name[Green Man], eatType[pub], food[Japanese], area[riverside], familyFriendly[no], near[Express by Holiday Inn]	Green Man, which serves Japanese food, is a non-kid-friendly pub. It is located in the riverside near Express by Holiday Inn.
name[Green Man], eatType[pub], food[Japanese], area[riverside], familyFriendly[yes], near[Express by Holiday Inn]	The pub Green Man is located in the riverside area. It serves Japanese cuisine. Green Man which can be found near Express by Holiday Inn welcomes families.
name[Green Man], eatType[restaurant], food[Italian], area[riverside], familyFriendly[yes], near[Express by Holiday Inn]	Green Man, which offers Italian food, is a family-friendly restaurant. It is in riverside near Express by Holiday Inn.
name[Green Man], eatType[restaurant], food[Italian], area[riverside], familyFriendly[yes], near[Raja Indian Cuisine]	Green Man, which offers Italian cuisine, is a child-friendly restaurant. It is in the riverside area by Raja Indian Cuisine.
name[Green Man], eatType[restaurant], food[Japanese], area[city centre], familyFriendly[no], near[Express by Holiday Inn]	The restaurant Green Man is located in the city centre. It serves Japanese food. It does not welcome children.
name[Green Man], eatType[restaurant], food[Japanese], area[city centre], familyFriendly[yes], near[Express by Holiday Inn]	Green Man, which serves Japanese cuisine, is a kid-friendly restaurant. It is located in the city centre area and can be found near Express by Holiday Inn.
name[Green Man], eatType[restaurant], food[Japanese], area[riverside], familyFriendly[no], near[Express by Holiday Inn]	The restaurant Green Man is in riverside. It offers Japanese food. Green Man, which is near Express by Holiday Inn, does not welcome kids.
name[Green Man], eatType[restaurant], food[Japanese], area[riverside], familyFriendly[yes], near[Express by Holiday Inn]	The restaurant Green Man is in the riverside area. It offers Japanese cuisine. Green Man, which is by Express by Holiday Inn, welcomes children.
name[Loch Fyne], eatType[coffee shop], area[riverside]	The coffee shop Loch Fyne is located in the riverside.
name[Loch Fyne], eatType[pub], area[riverside]	The pub Loch Fyne is located in the riverside area.
name[Strada], eatType[coffee shop], area[city centre]	The coffee shop Strada is in city centre.
name[Strada], eatType[coffee shop], customer rating[1 out of 5], near[All Bar One]	The coffee shop Strada is located near All Bar One. It has a customer rating of 1 out of 5.
name[Strada], eatType[coffee shop], customer rating[1 out of 5], near[Rainbow Vegetarian Café]	The coffee shop Strada can be found near Rainbow Vegetarian Café. Customer rate it 1 out of 5.
name[Strada], eatType[coffee shop], customer rating[low], near[Express by Holiday Inn]	The coffee shop Strada is near Express by Holiday Inn. It has a low customer rating.
name[Strada], eatType[pub], area[city centre]	The pub Strada is in the city centre area.
name[Strada], eatType[pub], customer rating[1 out of 5], near[All Bar One]	The pub Strada is by All Bar One. It has a customer rating of 1 out of 5.
name[Strada], eatType[pub], customer rating[1 out of 5], near[Rainbow Vegetarian Café]	The pub Strada is located near Rainbow Vegetarian Café. Customer rate it 1 out of 5.
name[Strada], eatType[pub], customer rating[low], near[Express by Holiday Inn]	The pub Strada can be found near Express by Holiday Inn. It has a low customer rating.
name[The Cricketers], eatType[coffee shop], customer rating[1 out of 5], familyFriendly[yes], near[Avalon]	The coffee shop The Cricketers is near Avalon. The Cricketers, which welcomes kids, has a customer rating of 1 out of 5.
name[The Cricketers], eatType[coffee shop], customer rating[3 out of 5], familyFriendly[yes], near[Avalon]	The coffee shop The Cricketers is by Avalon. Customer rate The Cricketers, which welcomes families, 3 out of 5.
name[The Cricketers], eatType[coffee shop], customer rating[3 out of 5], familyFriendly[yes], near[Crowne Plaza Hotel]	The Cricketers, which has a customer rating of 3 out of 5, is a family-friendly coffee shop. It is located near Crowne Plaza Hotel.
name[The Cricketers], eatType[coffee shop], customer rating[5 out of 5], familyFriendly[no], near[Crowne Plaza Hotel]	The Cricketers, which customer rate 5 out of 5, is a non-family-friendly coffee shop. It can be found near Crowne Plaza Hotel.
name[The Cricketers], eatType[coffee shop], customer rating[5 out of 5], familyFriendly[yes], near[Crowne Plaza Hotel]	The Cricketers, which has a customer rating of 5 out of 5, is a child-friendly coffee shop. It is near Crowne Plaza Hotel.
name[The Cricketers], eatType[coffee shop], customer rating[average], familyFriendly[no], near[Café Sicilia]	The Cricketers, which has an average customer rating, is a non-child-friendly coffee shop. It is by Café Sicilia.
name[The Cricketers], eatType[coffee shop], customer rating[average], familyFriendly[no], near[Crowne Plaza Hotel]	The Cricketers, which has an average customer rating, is a non-kid-friendly coffee shop. It is located near Crowne Plaza Hotel.
name[The Cricketers], eatType[coffee shop], customer rating[average], familyFriendly[yes], near[Café Sicilia]	The Cricketers, which has an average customer rating, is a kid-friendly coffee shop. It can be found near Café Sicilia.
name[The Cricketers], eatType[coffee shop], customer rating[high], familyFriendly[yes], near[Café Sicilia]	The coffee shop The Cricketers is near Café Sicilia. The Cricketers, which welcomes children, has a high customer rating.
name[The Cricketers], eatType[coffee shop], customer rating[high], familyFriendly[yes], near[Express by Holiday Inn]	The coffee shop The Cricketers is by Express by Holiday Inn. The Cricketers, which welcomes kids, has a high customer rating.
name[The Cricketers], eatType[coffee shop], customer rating[low], familyFriendly[no], near[Express by Holiday Inn]	The coffee shop The Cricketers is located near Express by Holiday Inn. The Cricketers, which does not welcome children, has a low customer rating.
name[The Cricketers], eatType[coffee shop], customer rating[low], familyFriendly[no], near[Ranch]	The coffee shop The Cricketers can be found near Ranch. The Cricketers, which does not welcome kids, has a low customer rating.
name[The Cricketers], eatType[coffee shop], customer rating[low], familyFriendly[yes], near[Ranch]	The coffee shop The Cricketers is near Ranch. The Cricketers, which welcomes families, has a low customer rating.
name[The Cricketers], eatType[restaurant], customer rating[1 out of 5], familyFriendly[yes], near[Avalon]	The Cricketers, which customer rate 1 out of 5, is a family-friendly restaurant. It is by Avalon.
name[The Cricketers], eatType[restaurant], customer rating[3 out of 5], familyFriendly[yes], near[Avalon]	The Cricketers, which has a customer rating of 3 out of 5, is a child-friendly restaurant. It is located near Avalon.
name[The Cricketers], eatType[restaurant], customer rating[3 out of 5], familyFriendly[yes], near[Crowne Plaza Hotel]	The Cricketers, which customer rate 3 out of 5, is a kid-friendly restaurant. It can be found near Crowne Plaza Hotel.
name[The Cricketers], eatType[restaurant], customer rating[5 out of 5], familyFriendly[no], near[Crowne Plaza Hotel]	The Cricketers, which has a customer rating of 5 out of 5, is a non-family-friendly restaurant. It is near Crowne Plaza Hotel.
name[The Cricketers], eatType[restaurant], customer rating[5 out of 5], familyFriendly[yes], near[Crowne Plaza Hotel]	The restaurant The Cricketers is by Crowne Plaza Hotel. Customer rate The Cricketers, which welcomes children, 5 out of 5.
name[The Cricketers], eatType[restaurant], customer rating[average], familyFriendly[no], near[Café Sicilia]	The Cricketers, which has an average customer rating, is a non-child-friendly restaurant. It is located near Café Sicilia.
name[The Cricketers], eatType[restaurant], customer rating[average], familyFriendly[no], near[Crowne Plaza Hotel]	The Cricketers, which has an average customer rating, is a non-kid-friendly restaurant. It can be found near Crowne Plaza Hotel.
name[The Cricketers], eatType[restaurant], customer rating[average], familyFriendly[yes], near[Café Sicilia]	The restaurant The Cricketers is near Café Sicilia. The Cricketers, which welcomes kids, has an average customer rating.
name[The Cricketers], eatType[restaurant], customer rating[high], familyFriendly[yes], near[Café Sicilia]	The restaurant The Cricketers is by Café Sicilia. The Cricketers, which welcomes families, has a high customer rating.
name[The Cricketers], eatType[restaurant], customer rating[high], familyFriendly[yes], near[Express by Holiday Inn]	The Cricketers, which has a high customer rating, is a family-friendly restaurant. It is located near Express by Holiday Inn.
name[The Cricketers], eatType[restaurant], customer rating[low], familyFriendly[no], near[Express by Holiday Inn]	The restaurant The Cricketers can be found near Express by Holiday Inn. The Cricketers, which does not welcome children, has a low customer rating.
name[The Cricketers], eatType[restaurant], customer rating[low], familyFriendly[no], near[Ranch]	The restaurant The Cricketers is near Ranch. The Cricketers, which does not welcome kids, has a low customer rating.
name[The Cricketers], eatType[restaurant], customer rating[low], familyFriendly[yes], near[Ranch]	The Cricketers, which has a low customer rating, is a child-friendly restaurant. It is by Ranch.
name[The Cricketers], eatType[restaurant], food[Chinese], priceRange[£20-25], customer rating[high], area[city centre], familyFriendly[no], near[All Bar One]	The Cricketers, which serves Chinese food, is a mid-priced restaurant. It has a high customer rating. Non-family-friendly The Cricketers is located in the city centre near All Bar One.
name[The Cricketers], eatType[restaurant], food[Chinese], priceRange[£20-25], customer rating[high], area[city centre], familyFriendly[yes], near[All Bar One]	The Cricketers, which serves Chinese cuisine, is an average-priced restaurant. It has a high customer rating. It is located in the city centre area and can be found near All Bar One. It is kid-friendly.
name[The Cricketers], eatType[restaurant], food[Chinese], priceRange[£20-25], customer rating[high], area[riverside], familyFriendly[no], near[All Bar One]	The Cricketers, which offers Chinese food, is a restaurant. It is moderately priced. It has a high customer rating. It is in riverside near All Bar One. It is not child-friendly.
name[The Cricketers], eatType[restaurant], food[Chinese], priceRange[£20-25], customer rating[high], area[riverside], familyFriendly[yes], near[All Bar One]	The Cricketers, which offers Chinese cuisine, is a mid-priced restaurant. It has a high customer rating. It is in the riverside area by All Bar One. It welcomes children.
name[The Cricketers], eatType[restaurant], food[Chinese], priceRange[cheap], customer rating[5 out of 5], area[city centre], familyFriendly[no], near[All Bar One]	The Cricketers, which serves Chinese food, is a cheap restaurant. It has a customer rating of 5 out of 5. Non-kid-friendly The Cricketers is located in the city centre near All Bar One.
name[The Cricketers], eatType[restaurant], food[Chinese], priceRange[cheap], customer rating[5 out of 5], area[city centre], familyFriendly[yes], near[All Bar One]	The Cricketers, which serves Chinese cuisine, is a low-priced restaurant. Customer rate The Cricketers, which welcomes kids, 5 out of 5. It is located in the city centre area and can be found near All Bar One.
name[The Cricketers], eatType[restaurant], food[Chinese], priceRange[cheap], customer rating[5 out of 5], area[riverside], familyFriendly[no], near[All Bar One]	The Cricketers, which offers Chinese food, is a cheap restaurant. It has a customer rating of 5 out of 5. It is in riverside near All Bar One. It does not welcome children.
name[The Cricketers], eatType[restaurant], food[Chinese], priceRange[cheap], customer rating[5 out of 5], area[riverside], familyFriendly[yes], near[All Bar One]	The Cricketers, which offers Chinese cuisine, is a low-priced restaurant. Customer rate The Cricketers, which is in the riverside area by All Bar One, 5 out of 5. It welcomes families.
name[The Cricketers], eatType[restaurant], food[Chinese], priceRange[cheap], customer rating[average], area[city centre], familyFriendly[no], near[All Bar One]	The Cricketers, which serves Chinese food, is a cheap restaurant. It has an average customer rating. The Cricketers, which does not welcome kids, is located in the city centre near All Bar One.
name[The Cricketers], eatType[restaurant], food[Chinese], priceRange[cheap], customer rating[average], area[city centre], familyFriendly[yes], near[All Bar One]	The Cricketers, which serves Chinese cuisine, is a low-priced restaurant. It has an average customer rating. It is located in the city centre area and can be found near All Bar One. It is family-friendly.
name[The Cricketers], eatType[restaurant], food[Chinese], priceRange[cheap], customer rating[average], area[riverside], familyFriendly[no], near[All Bar One]	The Cricketers, which offers Chinese food, is a cheap restaurant. It has an average customer rating. It is in riverside near All Bar One. It is not family-friendly.
name[The Cricketers], eatType[restaurant], food[Chinese], priceRange[cheap], customer rating[average], area[riverside], familyFriendly[yes], near[All Bar One]	The Cricketers, which offers Chinese cuisine, is a low-priced restaurant. It has an average customer rating. It is in the riverside area by All Bar One. It is child-friendly.
name[The Cricketers], eatType[restaurant], food[Chinese], priceRange[high], customer rating[1 out of 5], area[city centre], familyFriendly[no], near[All Bar One]	The Cricketers, which serves Chinese food, is an expensive restaurant. It has a customer rating of 1 out of 5. Non-child-friendly The Cricketers is located in the city centre near All Bar One.
name[The Cricketers], eatType[restaurant], food[Chinese], priceRange[high], customer rating[1 out of 5], area[city centre], familyFriendly[yes], near[All Bar One]	The Cricketers, which serves Chinese cuisine, is a high-priced restaurant. Customer rate kid-friendly The Cricketers 1 out of 5. It is located in the city centre area and can be found near All Bar One.
name[The Cricketers], eatType[restaurant], food[Chinese], priceRange[high], customer rating[1 out of 5], area[riverside], familyFriendly[no], near[All Bar One]	The Cricketers, which offers Chinese food, is an expensive restaurant. It has a customer rating of 1 out of 5. It is in riverside near All Bar One. It is not kid-friendly.
name[The Cricketers], eatType[restaurant], food[Chinese], priceRange[high], customer rating[1 out of 5], area[riverside], familyFriendly[yes], near[All Bar One]	The Cricketers, which offers Chinese cuisine, is a high-priced restaurant. Customer rate The Cricketers, which is in the riverside area by All Bar One, 1 out of 5. It welcomes children.
name[The Cricketers], eatType[restaurant], food[Chinese], priceRange[high], customer rating[average], area[city centre], familyFriendly[no], near[All Bar One]	The Cricketers, which serves Chinese food, is an expensive restaurant. It has an average customer rating. The Cricketers, which does not welcome children, is located in the city centre near All Bar One.
name[The Cricketers], eatType[restaurant], food[Chinese], priceRange[high], customer rating[average], area[city centre], familyFriendly[yes], near[All Bar One]	The Cricketers, which serves Chinese cuisine, is a high-priced restaurant. It has an average customer rating. It is located in the city centre area and can be found near All Bar One. It welcomes kids.
name[The Cricketers], eatType[restaurant], food[Chinese], priceRange[high], customer rating[average], area[riverside], familyFriendly[no], near[All Bar One]	The Cricketers, which offers Chinese food, is an expensive restaurant. It has an average customer rating. It is in riverside near All Bar One. It does not welcome kids.
name[The Cricketers], eatType[restaurant], food[Chinese], priceRange[high], customer rating[average], area[riverside], familyFriendly[yes], near[All Bar One]	The Cricketers, which offers Chinese cuisine, is a high-priced restaurant. It has an average customer rating. It is in the riverside area by All Bar One. It welcomes families.
name[The Cricketers], eatType[restaurant], food[Chinese], priceRange[less than £20], customer rating[low], area[city centre], familyFriendly[no], near[All Bar One]	The Cricketers, which serves Chinese food, is a cheap restaurant. It has a low customer rating. Non-family-friendly The Cricketers is located in the city centre near All Bar One.
name[The Cricketers], eatType[restaurant], food[Chinese], priceRange[less than £20], customer rating[low], area[city centre], familyFriendly[yes], near[All Bar One]	The Cricketers, which serves Chinese cuisine, is a low-priced restaurant. It has a low customer rating. It is located in the city centre area and can be found near All Bar One. It is family-friendly.
name[The Cricketers], eatType[restaurant], food[Chinese], priceRange[less than £20], customer rating[low], area[riverside], familyFriendly[no], near[All Bar One]	The Cricketers, which offers Chinese food, is a cheap restaurant. It has a low customer rating. It is in riverside near All Bar One. It is not child-friendly.
name[The Cricketers], eatType[restaurant], food[Chinese], priceRange[less than £20], customer rating[low], area[riverside], familyFriendly[yes], near[All Bar One]	The Cricketers, which offers Chinese cuisine, is a low-priced restaurant. It has a low customer rating. It is in the riverside area by All Bar One. It is child-friendly.
name[The Cricketers], eatType[restaurant], food[Chinese], priceRange[moderate], customer rating[1 out of 5], area[city centre], familyFriendly[no], near[All Bar One]	The Cricketers, which serves Chinese food, is an average-priced restaurant. It has a customer rating of 1 out of 5. Non-kid-friendly The Cricketers is located in the city centre near All Bar One.
name[The Cricketers], eatType[restaurant], food[Chinese], priceRange[moderate], customer rating[1 out of 5], area[city centre], familyFriendly[yes], near[All Bar One]	The Cricketers, which serves Chinese cuisine, is a restaurant. It is moderately priced. Customer rate kid-friendly The Cricketers 1 out of 5. It is located in the city centre area and can be found near All Bar One.
name[The Cricketers], eatType[restaurant], food[Chinese], priceRange[moderate], customer rating[1 out of 5], area[riverside], familyFriendly[no], near[All Bar One]	The Cricketers, which offers Chinese food, is a mid-priced restaurant. It has a customer rating of 1 out of 5. It is in riverside near All Bar One. It does not welcome children.
name[The Cricketers], eatType[restaurant], food[Chinese], priceRange[moderate], customer rating[1 out of 5], area[riverside], familyFriendly[yes], near[All Bar One]	The Cricketers, which offers Chinese cuisine, is an average-priced restaurant. Customer rate The Cricketers, which is in the riverside area by All Bar One, 1 out of 5. It welcomes children.
name[The Cricketers], eatType[restaurant], food[Chinese], priceRange[moderate], customer rating[3 out of 5], area[city centre], familyFriendly[no], near[All Bar One]	The Cricketers, which serves Chinese food, is a restaurant. It is moderately priced. It has a customer rating of 3 out of 5. The Cricketers, which does not welcome kids, is located in the city centre near All Bar One.
name[The Cricketers], eatType[restaurant], food[Chinese], priceRange[moderate], customer rating[3 out of 5], area[city centre], familyFriendly[yes], near[All Bar One]	The Cricketers, which serves Chinese cuisine, is a mid-priced restaurant. Customer rate The Cricketers, which welcomes kids, 3 out of 5. It is located in the city centre area and can be found near All Bar One.
name[The Cricketers], eatType[restaurant], food[Chinese], priceRange[moderate], customer rating[3 out of 5], area[riverside], familyFriendly[no], near[All Bar One]	The Cricketers, which offers Chinese food, is an average-priced restaurant. It has a customer rating of 3 out of 5. It is in riverside near All Bar One. It is not family-friendly.
name[The Cricketers], eatType[restaurant], food[Chinese], priceRange[moderate], customer rating[3 out of 5], area[riverside], familyFriendly[yes], near[All Bar One]	The Cricketers, which offers Chinese cuisine, is a restaurant. It is moderately priced. Customer rate The Cricketers, which is in the riverside area by All Bar One, 3 out of 5. It welcomes families.
name[The Cricketers], eatType[restaurant], food[Chinese], priceRange[more than £30], customer rating[high], area[city centre], familyFriendly[no], near[All Bar One]	The Cricketers, which serves Chinese food, is an expensive restaurant. It has a high customer rating. Non-child-friendly The Cricketers is located in the city centre near All Bar One.
name[The Cricketers], eatType[restaurant], food[Chinese], priceRange[more than £30], customer rating[high], area[city centre], familyFriendly[yes], near[All Bar One]	The Cricketers, which serves Chinese cuisine, is a high-priced restaurant. It has a high customer rating. It is located in the city centre area and can be found near All Bar One. It is family-friendly.
name[The Cricketers], eatType[restaurant], food[Chinese], priceRange[more than £30], customer rating[high], area[riverside], familyFriendly[no], near[All Bar One]	The Cricketers, which offers Chinese food, is an expensive restaurant. It has a high customer rating. It is in riverside near All Bar One. It is not kid-friendly.
name[The Cricketers], eatType[restaurant], food[Chinese], priceRange[more than £30], customer rating[high], area[riverside], familyFriendly[yes], near[All Bar One]	The Cricketers, which offers Chinese cuisine, is a high-priced restaurant. It has a high customer rating. It is in the riverside area by All Bar One. It is child-friendly.
name[The Cricketers], eatType[restaurant], food[English], priceRange[£20-25], customer rating[high], area[city centre], familyFriendly[no], near[All Bar One]	The Cricketers, which serves English food, is a mid-priced restaurant. It has a high customer rating. The Cricketers, which does not welcome children, is located in the city centre near All Bar One.
name[The Cricketers], eatType[restaurant], food[English], priceRange[£20-25], customer rating[high], area[city centre], familyFriendly[yes], near[All Bar One]	The Cricketers, which serves English cuisine, is an average-priced restaurant. It has a high customer rating. It is located in the, city centre, area and can be found near All Bar One. It is kid-friendly.
name[The Cricketers], eatType[restaurant], food[English], priceRange[£20-25], customer rating[high], area[riverside], familyFriendly[no], near[All Bar One]	The Cricketers, which offers English food, is a restaurant. It is moderately priced. It has a high customer rating. It is in riverside near All Bar One. It does not welcome kids.
name[The Cricketers], eatType[restaurant], food[English], priceRange[£20-25], customer rating[high], area[riverside], familyFriendly[yes], near[All Bar One]	The Cricketers, which offers English cuisine, is a mid-priced restaurant. It has a high customer rating. It is in the riverside area by All Bar One. It welcomes children.
name[The Cricketers], eatType[restaurant], food[English], priceRange[cheap], customer rating[5 out of 5], area[city centre], familyFriendly[no], near[Café Rouge]	The Cricketers, which serves English food, is a cheap restaurant. It has a customer rating of 5 out of 5. Non-family-friendly The Cricketers is located in the city centre near Café Rouge.
name[The Cricketers], eatType[restaurant], food[English], priceRange[cheap], customer rating[5 out of 5], area[city centre], familyFriendly[yes], near[Café Rouge]	The Cricketers, which serves English cuisine, is a low-priced restaurant. Customer rate The Cricketers, which welcomes kids, 5 out of 5. It is located in the city centre area and can be found near Café Rouge.
name[The Cricketers], eatType[restaurant], food[English], priceRange[cheap], customer rating[5 out of 5], area[riverside], familyFriendly[no], near[Café Rouge]	The Cricketers, which offers English food, is a cheap restaurant. It has a customer rating of 5 out of 5. It is in riverside near Café Rouge. It is not child-friendly.
name[The Cricketers], eatType[restaurant], food[English], priceRange[cheap], customer rating[5 out of 5], area[riverside], familyFriendly[yes], near[Café Rouge]	The Cricketers, which offers English cuisine, is a low-priced restaurant. Customer rate The Cricketers, which is in the riverside area by Café Rouge, 5 out of 5. It welcomes families.
name[The Cricketers], eatType[restaurant], food[English], priceRange[cheap], customer rating[average], area[city centre], familyFriendly[no], near[Café Rouge]	The Cricketers, which serves English food, is a cheap restaurant. It has an average customer rating. Non-kid-friendly The Cricketers is located in the city centre near Café Rouge.
name[The Cricketers], eatType[restaurant], food[English], priceRange[cheap], customer rating[average], area[city centre], familyFriendly[yes], near[Café Rouge]	The Cricketers, which serves English cuisine, is a low-priced restaurant. It has an average customer rating. It is located in the city centre area and can be found near Café Rouge. It is family-friendly.
name[The Cricketers], eatType[restaurant], food[English], priceRange[cheap], customer rating[average], area[riverside], familyFriendly[no], near[Café Rouge]	The Cricketers, which offers English food, is a cheap restaurant. It has an average customer rating. It is in riverside near Café Rouge. It does not welcome children.
name[The Cricketers], eatType[restaurant], food[English], priceRange[cheap], customer rating[average], area[riverside], familyFriendly[yes], near[Café Rouge]	The Cricketers, which offers English cuisine, is a low-priced restaurant. It has an average customer rating. It is in the riverside area by Café Rouge. It is child-friendly.
name[The Cricketers], eatType[restaurant], food[English], priceRange[high], customer rating[1 out of 5], area[city centre], familyFriendly[no], near[Café Rouge]	The Cricketers, which serves English food, is an expensive restaurant. It has a customer rating of 1 out of 5. The Cricketers, which does not welcome kids, is located in the city centre near Café Rouge.
name[The Cricketers], eatType[restaurant], food[English], priceRange[high], customer rating[1 out of 5], area[city centre], familyFriendly[yes], near[Café Rouge]	The Cricketers, which serves English cuisine, is a high-priced restaurant. Customer rate kid-friendly The Cricketers 1 out of 5. It is located in the city centre area and can be found near Café Rouge.
name[The Cricketers], eatType[restaurant], food[English], priceRange[high], customer rating[1 out of 5], area[riverside], familyFriendly[no], near[Café Rouge]	The Cricketers, which offers English food, is an expensive restaurant. It has a customer rating of 1 out of 5. It is in riverside near Café Rouge. It is not family-friendly.
name[The Cricketers], eatType[restaurant], food[English], priceRange[high], customer rating[1 out of 5], area[riverside], familyFriendly[yes], near[Café Rouge]	The Cricketers, which offers English cuisine, is a high-priced restaurant. Customer rate The Cricketers, which is in the riverside area by Café Rouge, 1 out of 5. It welcomes children.
name[The Cricketers], eatType[restaurant], food[English], priceRange[high], customer rating[average], area[city centre], familyFriendly[no], near[Café Rouge]	The Cricketers, which serves English food, is an expensive restaurant. It has an average customer rating. Non-child-friendly The Cricketers is located in the city centre near Café Rouge.
name[The Cricketers], eatType[restaurant], food[English], priceRange[high], customer rating[average], area[city centre], familyFriendly[yes], near[Café Rouge]	The Cricketers, which serves English cuisine, is a high-priced restaurant. It has an average customer rating. It is located in the city centre area and can be found near Café Rouge. It welcomes kids.
name[The Cricketers], eatType[restaurant], food[English], priceRange[high], customer rating[average], area[riverside], familyFriendly[no], near[Café Rouge]	The Cricketers, which offers English food, is an expensive restaurant. It has an average customer rating. It is in riverside near Café Rouge. It is not kid-friendly.
name[The Mill], eatType[pub], food[English], priceRange[high], area[riverside], familyFriendly[yes], near[Raja Indian Cuisine]	The Mill, which offers English cuisine, is a high-priced pub. It is in the riverside area by Raja Indian Cuisine. It welcomes families.
name[The Mill], eatType[pub], food[English], priceRange[less than £20], area[city centre], familyFriendly[no], near[Raja Indian Cuisine]	The Mill, which serves English food, is a cheap pub. The Mill, which does not welcome children, is located in the city centre near Raja Indian Cuisine.
name[The Mill], eatType[pub], food[English], priceRange[less than £20], area[city centre], familyFriendly[yes], near[Raja Indian Cuisine]	The Mill, which serves English cuisine, is a low-priced pub. It is located in the city centre area and can be found near Raja Indian Cuisine. It is family-friendly.
name[The Mill], eatType[pub], food[English], priceRange[less than £20], area[riverside], familyFriendly[no], near[Raja Indian Cuisine]	The Mill, which offers English food, is a cheap pub. It is in riverside near Raja Indian Cuisine. It does not welcome kids.
name[The Mill], eatType[pub], food[English], priceRange[less than £20], area[riverside], familyFriendly[yes], near[Raja Indian Cuisine]	The Mill, which offers English cuisine, is a low-priced pub. It is in the riverside area by Raja Indian Cuisine. It is child-friendly.
name[The Mill], eatType[pub], food[English], priceRange[moderate], area[city centre], familyFriendly[no], near[Raja Indian Cuisine]	The Mill, which serves English food, is an average-priced pub. Non-family-friendly The Mill is located in the city centre near Raja Indian Cuisine.
name[The Mill], eatType[pub], food[English], priceRange[moderate], area[city centre], familyFriendly[yes], near[Raja Indian Cuisine]	The Mill, which serves English cuisine, is a pub. It is moderately priced. It is located in the city centre area and can be found near Raja Indian Cuisine. It is kid-friendly.
name[The Mill], eatType[pub], food[English], priceRange[moderate], area[riverside], familyFriendly[no], near[Raja Indian Cuisine]	The Mill, which offers English food, is a mid-priced pub. It is in riverside near Raja Indian Cuisine. It is not child-friendly.
name[The Mill], eatType[pub], food[English], priceRange[moderate], area[riverside], familyFriendly[yes], near[Raja Indian Cuisine]	The Mill, which offers English cuisine, is an average-priced pub. It is in the riverside area by Raja Indian Cuisine. It welcomes children.
name[The Mill], eatType[pub], food[English], priceRange[more than £30], area[riverside], familyFriendly[yes], near[Raja Indian Cuisine]	The Mill, which serves English food, is an expensive pub. The Mill, which welcomes kids, is located in the riverside near Raja Indian Cuisine.
name[The Mill], eatType[pub], food[Fast food], priceRange[£20-25], area[riverside], familyFriendly[yes], near[Raja Indian Cuisine]	The Mill, which serves fast food, is a pub. It is moderately priced. It is located in the riverside area and can be found near Raja Indian Cuisine. It welcomes families.
name[The Mill], eatType[pub], food[Fast food], priceRange[£20-25], customer rating[high], area[city centre], familyFriendly[no], near[Café Rouge]	The Mill, which offers fast food, is a mid-priced pub. It has a high customer rating. It is in city centre near Café Rouge. It is not kid-friendly.
name[The Mill], eatType[pub], food[Fast food], priceRange[£20-25], customer rating[high], area[city centre], familyFriendly[yes], near[Café Rouge]	The Mill, which offers fast food, is an average-priced pub. It has a high customer rating. It is in the city centre area by Café Rouge. It is family-friendly.
name[The Mill], eatType[pub], food[Fast food], priceRange[£20-25], customer rating[high], area[riverside], familyFriendly[no], near[Café Rouge]	The Mill, which serves fast food, is a pub. It is moderately priced. It has a high customer rating. The Mill, which does not welcome children, is located in the riverside near Café Rouge.
name[The Mill], eatType[pub], food[Fast food], priceRange[£20-25], customer rating[high], area[riverside], familyFriendly[yes], near[Café Rouge]	The Mill, which serves fast food, is a mid-priced pub. It has a high customer rating. It is located in the riverside area and can be found near Café Rouge. It is child-friendly.
name[The Mill], eatType[pub], food[Fast food], priceRange[£20-25], customer rating[high], area[riverside], familyFriendly[yes], near[Café Sicilia]	The Mill, which offers fast food, is an average-priced pub. It has a high customer rating. It is in riverside near Café Sicilia. It is kid-friendly.
name[The Mill], eatType[pub], food[Fast food], priceRange[cheap], area[riverside], familyFriendly[yes], near[Raja Indian Cuisine]	The Mill, which offers fast food, is a cheap pub. It is in the riverside area by Raja Indian Cuisine. It welcomes children.
name[The Mill], eatType[pub], food[Fast food], priceRange[cheap], customer rating[5 out of 5], area[city centre], familyFriendly[no], near[Café Sicilia]	The Mill, which serves fast food, is a low-priced pub. It has a customer rating of 5 out of 5. The Mill, which does not welcome kids, is located in the city centre near Café Sicilia.
name[The Mill], eatType[pub], food[Fast food], priceRange[cheap], customer rating[5 out of 5], area[city centre], familyFriendly[yes], near[Café Sicilia]	The Mill, which serves fast food, is a cheap pub. Customer rate The Mill, which welcomes kids, 5 out of 5. It is located in the city centre area and can be found near Café Sicilia.
name[The Mill], eatType[pub], food[Fast food], priceRange[cheap], customer rating[5 out of 5], area[riverside], familyFriendly[no], near[Café Sicilia]	The Mill, which offers fast food, is a low-priced pub. It has a customer rating of 5 out of 5. It is in riverside near Café Sicilia. It is not family-friendly.
name[The Mill], eatType[pub], food[Fast food], priceRange[cheap], customer rating[5 out of 5], area[riverside], familyFriendly[yes], near[Café Sicilia]	The Mill, which offers fast food, is a cheap pub. Customer rate The Mill, which is in the riverside area by Café Sicilia, 5 out of 5. It welcomes families.
name[The Mill], eatType[pub], food[Fast food], priceRange[cheap], customer rating[average], area[city centre], familyFriendly[no], near[Café Sicilia]	The Mill, which serves fast food, is a low-priced pub. It has an average customer rating. Non-child-friendly The Mill is located in the city centre near Café Sicilia.
name[The Mill], eatType[pub], food[Fast food], priceRange[cheap], customer rating[average], area[city centre], familyFriendly[yes], near[Café Sicilia]	The Mill, which serves fast food, is a cheap pub. It has an average customer rating. It is located in the city centre area and can be found near Café Sicilia. It is family-friendly.
name[The Mill], eatType[pub], food[Fast food], priceRange[cheap], customer rating[average], area[riverside], familyFriendly[no], near[Café Sicilia]	The Mill, which offers fast food, is a low-priced pub. It has an average customer rating. It is in riverside near Café Sicilia. It is not kid-friendly.
name[The Mill], eatType[pub], food[Fast food], priceRange[cheap], customer rating[average], area[riverside], familyFriendly[yes], near[Café Sicilia]	The Mill, which offers fast food, is a cheap pub. It has an average customer rating. It is in the riverside area by Café Sicilia. It is child-friendly.
name[The Mill], eatType[pub], food[Fast food], priceRange[high], customer rating[1 out of 5], area[city centre], familyFriendly[no], near[Café Sicilia]	The Mill, which serves fast food, is a high-priced pub. It has a customer rating of 1 out of 5. The Mill, which does not welcome children, is located in the city centre near Café Sicilia.
name[The Mill], eatType[pub], food[Fast food], priceRange[high], customer rating[1 out of 5], area[city centre], familyFriendly[yes], near[Café Sicilia]	The Mill, which serves fast food, is an expensive pub. Customer rate kid-friendly The Mill 1 out of 5. It is located in the city centre area and can be found near Café Sicilia.
name[The Mill], eatType[pub], food[Fast food], priceRange[high], customer rating[1 out of 5], area[riverside], familyFriendly[no], near[Café Sicilia]	The Mill, which offers fast food, is a high-priced pub. It has a customer rating of 1 out of 5. It is in riverside near Café Sicilia. It does not welcome kids.
name[The Mill], eatType[pub], food[Fast food], priceRange[high], customer rating[1 out of 5], area[riverside], familyFriendly[yes], near[Café Sicilia]	The Mill, which offers fast food, is an expensive pub. Customer rate The Mill, which is in the riverside area by Café Sicilia, 1 out of 5. It welcomes children.
name[The Mill], eatType[pub], food[Fast food], priceRange[high], customer rating[average], area[city centre], familyFriendly[no], near[Café Sicilia]	The Mill, which serves fast food, is a high-priced pub. It has an average customer rating. Non-family-friendly The Mill is located in the city centre near Café Sicilia.
name[The Mill], eatType[pub], food[Fast food], priceRange[high], customer rating[average], area[city centre], familyFriendly[yes], near[Café Sicilia]	The Mill, which serves fast food, is an expensive pub. It has an average customer rating. It is located in the city centre area and can be found near Café Sicilia. It welcomes kids.
name[The Mill], eatType[pub], food[Fast food], priceRange[high], customer rating[average], area[riverside], familyFriendly[no], near[Café Sicilia]	The Mill, which offers fast food, is a high-priced pub. It has an average customer rating. It is in riverside near Café Sicilia. It is not child-friendly.
name[The Mill], eatType[pub], food[Fast food], priceRange[high], customer rating[average], area[riverside], familyFriendly[yes], near[Café Sicilia]	The Mill, which offers fast food, is an expensive pub. It has an average customer rating. It is in the riverside area by Café Sicilia. It welcomes families.
name[The Mill], eatType[pub], food[Fast food], priceRange[less than £20], customer rating[low], area[city centre], familyFriendly[no], near[Café Sicilia]	The Mill, which serves fast food, is a low-priced pub. It has a low customer rating. Non-kid-friendly The Mill is located in the city centre near Café Sicilia.
name[The Mill], eatType[pub], food[Fast food], priceRange[less than £20], customer rating[low], area[city centre], familyFriendly[yes], near[Café Sicilia]	The Mill, which serves fast food, is a cheap pub. It has a low customer rating. It is located in the city centre area and can be found near Café Sicilia. It is family-friendly.
name[The Mill], eatType[pub], food[Fast food], priceRange[less than £20], customer rating[low], area[riverside], familyFriendly[no], near[Café Sicilia]	The Mill, which offers fast food, is a low-priced pub. It has a low customer rating. It is in riverside near Café Sicilia. It does not welcome children.
name[The Mill], eatType[pub], food[Fast food], priceRange[less than £20], customer rating[low], area[riverside], familyFriendly[yes], near[Café Sicilia]	The Mill, which offers fast food, is a cheap pub. It has a low customer rating. It is in the riverside area by Café Sicilia. It is child-friendly.
name[The Mill], eatType[pub], food[Fast food], priceRange[moderate], customer rating[1 out of 5], area[city centre], familyFriendly[no], near[Café Sicilia]	The Mill, which serves fast food, is a pub. It is moderately priced. It has a customer rating of 1 out of 5. The Mill, which does not welcome kids, is located in the city centre near Café Sicilia.
name[The Mill], eatType[pub], food[Fast food], priceRange[moderate], customer rating[1 out of 5], area[city centre], familyFriendly[yes], near[Café Sicilia]	The Mill, which serves fast food, is a mid-priced pub. Customer rate kid-friendly The Mill 1 out of 5. It is located in the city centre area and can be found near Café Sicilia.
name[The Mill], eatType[pub], food[Fast food], priceRange[moderate], customer rating[1 out of 5], area[riverside], familyFriendly[no], near[Café Sicilia]	The Mill, which offers fast food, is an average-priced pub. It has a customer rating of 1 out of 5. It is in riverside near Café Sicilia. It is not family-friendly.
name[The Mill], eatType[pub], food[Fast food], priceRange[moderate], customer rating[1 out of 5], area[riverside], familyFriendly[yes], near[Café Sicilia]	The Mill, which offers fast food, is a pub. It is moderately priced. Customer rate The Mill, which is in the riverside area by Café Sicilia, 1 out of 5. It welcomes children.
name[The Mill], eatType[pub], food[Fast food], priceRange[moderate], customer rating[3 out of 5], area[city centre], familyFriendly[no], near[Café Sicilia]	The Mill, which serves fast food, is a mid-priced pub. It has a customer rating of 3 out of 5. Non-child-friendly The Mill is located in the city centre near Café Sicilia.
name[The Mill], eatType[pub], food[Fast food], priceRange[moderate], customer rating[3 out of 5], area[city centre], familyFriendly[yes], near[Café Sicilia]	The Mill, which serves fast food, is an average-priced pub. Customer rate The Mill, which welcomes kids, 3 out of 5. It is located in the city centre area and can be found near Café Sicilia.
name[The Mill], eatType[pub], food[Fast food], priceRange[moderate], customer rating[3 out of 5], area[riverside], familyFriendly[no], near[Café Sicilia]	The Mill, which offers fast food, is a pub. It is moderately priced. It has a customer rating of 3 out of 5. It is in riverside near Café Sicilia. It is not kid-friendly.
name[The Mill], eatType[pub], food[Fast food], priceRange[moderate], customer rating[3 out of 5], area[riverside], familyFriendly[yes], near[Café Sicilia]	The Mill, which offers fast food, is a mid-priced pub. Customer rate The Mill, which is in the riverside area by Café Sicilia, 3 out of 5. It welcomes families.
name[The Mill], eatType[restaurant], food[English], priceRange[high], area[riverside], familyFriendly[yes], near[Raja Indian Cuisine]	The Mill, which serves English food, is a high-priced restaurant. Family-friendly The Mill is located in the riverside near Raja Indian Cuisine.
name[The Mill], eatType[restaurant], food[English], priceRange[high], customer rating[average], area[riverside], familyFriendly[yes], near[Café Rouge]	The Mill, which serves English cuisine, is an expensive restaurant. It has an average customer rating. It is located in the riverside area and can be found near Café Rouge. It is child-friendly.
name[The Mill], eatType[restaurant], food[English], priceRange[less than £20], area[city centre], familyFriendly[no], near[Raja Indian Cuisine]	The Mill, which offers English food, is a low-priced restaurant. It is in city centre near Raja Indian Cuisine. It does not welcome children.
name[The Mill], eatType[restaurant], food[English], priceRange[less than £20], area[city centre], familyFriendly[yes], near[Raja Indian Cuisine]	The Mill, which offers English cuisine, is a cheap restaurant. It is in the city centre area by Raja Indian Cuisine. It is kid-friendly.
name[The Mill], eatType[restaurant], food[English], priceRange[less than £20], area[riverside], familyFriendly[no], near[Raja Indian Cuisine]	The Mill, which serves English food, is a low-priced restaurant. The Mill, which does not welcome kids, is located in the riverside near Raja Indian Cuisine.
name[The Mill], eatType[restaurant], food[English], priceRange[less than £20], area[riverside], familyFriendly[yes], near[Raja Indian Cuisine]	The Mill, which serves English cuisine, is a cheap restaurant. It is located in the riverside area and can be found near Raja Indian Cuisine. It welcomes children.
name[The Mill], eatType[restaurant], food[English], priceRange[less than £20], customer rating[low], area[city centre], familyFriendly[no], near[Café Rouge]	The Mill, which offers English food, is a low-priced restaurant. It has a low customer rating. It is in city centre near Café Rouge. It is not family-friendly.
name[The Mill], eatType[restaurant], food[English], priceRange[less than £20], customer rating[low], area[city centre], familyFriendly[yes], near[Café Rouge]	The Mill, which offers English cuisine, is a cheap restaurant. It has a low customer rating. It is in the city centre area by Café Rouge. It welcomes kids.
name[The Mill], eatType[restaurant], food[English], priceRange[less than £20], customer rating[low], area[riverside], familyFriendly[no], near[Café Rouge]	The Mill, which serves English food, is a low-priced restaurant. It has a low customer rating. Non-child-friendly The Mill is located in the riverside near Café Rouge.
name[The Mill], eatType[restaurant], food[English], priceRange[less than £20], customer rating[low], area[riverside], familyFriendly[yes], near[Café Rouge]	The Mill, which serves English cuisine, is a cheap restaurant. It has a low customer rating. It is located in the riverside area and can be found near Café Rouge. It welcomes families.
name[The Mill], eatType[restaurant], food[English], priceRange[moderate], area[city centre], familyFriendly[no], near[Raja Indian Cuisine]	The Mill, which offers English food, is an average-priced restaurant. It is in city centre near Raja Indian Cuisine. It is not kid-friendly.
name[The Mill], eatType[restaurant], food[English], priceRange[moderate], area[city centre], familyFriendly[yes], near[Raja Indian Cuisine]	The Mill, which offers English cuisine, is a restaurant. It is moderately priced. It is in the city centre area by Raja Indian Cuisine. It is family-friendly.
name[The Mill], eatType[restaurant], food[English], priceRange[moderate], area[riverside], familyFriendly[no], near[Raja Indian Cuisine]	The Mill, which serves English food, is a mid-priced restaurant. The Mill, which does not welcome children, is located in the riverside near Raja Indian Cuisine.
name[The Mill], eatType[restaurant], food[English], priceRange[moderate], area[riverside], familyFriendly[yes], near[Raja Indian Cuisine]	The Mill, which serves English cuisine, is an average-priced restaurant. It is located in the riverside area and can be found near Raja Indian Cuisine. It is child-friendly.
name[The Mill], eatType[restaurant], food[English], priceRange[moderate], customer rating[1 out of 5], area[city centre], familyFriendly[no], near[Café Rouge]	The Mill, which offers English food, is a restaurant. It is moderately priced. It has a customer rating of 1 out of 5. It is in city centre near Café Rouge. It does not welcome kids.
name[The Mill], eatType[restaurant], food[English], priceRange[moderate], customer rating[1 out of 5], area[city centre], familyFriendly[yes], near[Café Rouge]	The Mill, which offers English cuisine, is a mid-priced restaurant. Customer rate The Mill, which is in the city centre area by Café Rouge, 1 out of 5. It is kid-friendly.
name[The Mill], eatType[restaurant], food[English], priceRange[moderate], customer rating[1 out of 5], area[riverside], familyFriendly[no], near[Café Rouge]	The Mill, which serves English food, is an average-priced restaurant. It has a customer rating of 1 out of 5. Non-family-friendly The Mill is located in the riverside near Café Rouge.
name[The Mill], eatType[restaurant], food[English], priceRange[moderate], customer rating[1 out of 5], area[riverside], familyFriendly[yes], near[Café Rouge]	The Mill, which serves English cuisine, is a restaurant. It is moderately priced. Customer rate The Mill, which welcomes children, 1 out of 5. It is located in the riverside area and can be found near Café Rouge.
name[The Mill], eatType[restaurant], food[English], priceRange[moderate], customer rating[3 out of 5], area[city centre], familyFriendly[no], near[Café Rouge]	The Mill, which offers English food, is a mid-priced restaurant. It has a customer rating of 3 out of 5. It is in city centre near Café Rouge. It is not child-friendly.
name[The Mill], eatType[restaurant], food[English], priceRange[moderate], customer rating[3 out of 5], area[city centre], familyFriendly[yes], near[Café Rouge]	The Mill, which offers English cuisine, is an average-priced restaurant. Customer rate The Mill, which is in the city centre area by Café Rouge, 3 out of 5. It welcomes kids.
name[The Mill], eatType[restaurant], food[English], priceRange[moderate], customer rating[3 out of 5], area[riverside], familyFriendly[no], near[Café Rouge]	The Mill, which serves English food, is a restaurant. It is moderately priced. It has a customer rating of 3 out of 5. Non-kid-friendly The Mill is located in the riverside near Café Rouge.
name[The Mill], eatType[restaurant], food[English], priceRange[moderate], customer rating[3 out of 5], area[riverside], familyFriendly[yes], near[Café Rouge]	The Mill, which serves English cuisine, is a mid-priced restaurant. Customer rate The Mill, which welcomes families, 3 out of 5. It is located in the riverside area and can be found near Café Rouge.
name[The Mill], eatType[restaurant], food[English], priceRange[more than £30], area[riverside], familyFriendly[yes], near[Raja Indian Cuisine]	The Mill, which offers English food, is a high-priced restaurant. It is in riverside near Raja Indian Cuisine. It is family-friendly.
name[The Mill], eatType[restaurant], food[English], priceRange[more than £30], customer rating[high], area[city centre], familyFriendly[no], near[Café Rouge]	The Mill, which offers English cuisine, is an expensive restaurant. It has a high customer rating. It is in the city centre area by Café Rouge. It does not welcome children.
name[The Mill], eatType[restaurant], food[English], priceRange[more than £30], customer rating[high], area[city centre], familyFriendly[yes], near[Café Rouge]	The Mill, which serves English food, is a high-priced restaurant. It has a high customer rating. Child-friendly The Mill is located in the city centre near Café Rouge.
name[The Mill], eatType[restaurant], food[English], priceRange[more than £30], customer rating[high], area[riverside], familyFriendly[no], near[Café Rouge]	The Mill, which serves English cuisine, is an expensive restaurant. It has a high customer rating. It is located in the riverside area and can be found near Café Rouge. It does not welcome kids.
name[The Mill], eatType[restaurant], food[English], priceRange[more than £30], customer rating[high], area[riverside], familyFriendly[yes], near[Café Rouge]	The Mill, which offers English food, is a high-priced restaurant. It has a high customer rating. It is in riverside near Café Rouge. It is kid-friendly.
name[The Mill], eatType[restaurant], food[Fast food], priceRange[£20-25], area[riverside], familyFriendly[yes], near[Raja Indian Cuisine]	The Mill, which offers fast food, is an average-priced restaurant. It is in the riverside area by Raja Indian Cuisine. It welcomes children.
name[The Mill], eatType[restaurant], food[Fast food], priceRange[cheap], area[riverside], familyFriendly[yes], near[Raja Indian Cuisine]	The Mill, which serves fast food, is a low-priced restaurant. The Mill, which welcomes kids, is located in the riverside near Raja Indian Cuisine.
name[The Phoenix], eatType[pub], food[Fast food], priceRange[cheap], area[riverside], familyFriendly[yes], near[Raja Indian Cuisine]	The Phoenix, which serves fast food, is a cheap pub. It is located in the riverside area and can be found near Raja Indian Cuisine. It welcomes families.
name[The Phoenix], eatType[pub], food[Fast food], priceRange[high], area[city centre], familyFriendly[no], near[Raja Indian Cuisine]	The Phoenix, which offers fast food, is an expensive pub. It is in city centre near Raja Indian Cuisine. It is not family-friendly.
name[The Phoenix], eatType[pub], food[Fast food], priceRange[high], area[city centre], familyFriendly[yes], near[Raja Indian Cuisine]	The Phoenix, which offers fast food, is a high-priced pub. It is in the city centre area by Raja Indian Cuisine. It is family-friendly.
name[The Phoenix], eatType[pub], food[Fast food], priceRange[high], area[riverside], familyFriendly[no], near[Raja Indian Cuisine]	The Phoenix, which serves fast food, is an expensive pub. Non-child-friendly The Phoenix is located in the riverside near Raja Indian Cuisine.
name[The Phoenix], eatType[pub], food[Fast food], priceRange[high], area[riverside], familyFriendly[yes], near[Raja Indian Cuisine]	The Phoenix, which serves fast food, is a high-priced pub. It is located in the riverside area and can be found near Raja Indian Cuisine. It is child-friendly.
name[The Phoenix], eatType[pub], food[Fast food], priceRange[less than £20], area[city centre], familyFriendly[no], near[Raja Indian Cuisine]	The Phoenix, which offers fast food, is a low-priced pub. It is in city centre near Raja Indian Cuisine. It is not kid-friendly.
name[The Phoenix], eatType[pub], food[Fast food], priceRange[less than £20], area[city centre], familyFriendly[yes], near[Raja Indian Cuisine]	The Phoenix, which offers fast food, is a cheap pub. It is in the city centre area by Raja Indian Cuisine. It is kid-friendly.
name[The Phoenix], eatType[pub], food[Fast food], priceRange[less than £20], area[riverside], familyFriendly[no], near[Raja Indian Cuisine]	The Phoenix, which serves fast food, is a low-priced pub. The Phoenix, which does not welcome children, is located in the riverside near Raja Indian Cuisine.
name[The Phoenix], eatType[pub], food[Fast food], priceRange[less than £20], area[riverside], familyFriendly[yes], near[Raja Indian Cuisine]	The Phoenix, which serves fast food, is a cheap pub. It is located in the riverside area and can be found near Raja Indian Cuisine. It welcomes children.
name[The Phoenix], eatType[pub], food[Fast food], priceRange[moderate], area[city centre], familyFriendly[no], near[Raja Indian Cuisine]	The Phoenix, which offers fast food, is a pub. It is moderately priced. It is in city centre near Raja Indian Cuisine. It does not welcome kids.
name[The Phoenix], eatType[pub], food[Fast food], priceRange[moderate], area[city centre], familyFriendly[yes], near[Raja Indian Cuisine]	The Phoenix, which offers fast food, is a mid-priced pub. It is in the city centre area by Raja Indian Cuisine. It welcomes kids.
name[The Phoenix], eatType[pub], food[Fast food], priceRange[moderate], area[riverside], familyFriendly[no], near[Raja Indian Cuisine]	The Phoenix, which serves fast food, is an average-priced pub. Non-family-friendly The Phoenix is located in the riverside near Raja Indian Cuisine.
name[The Phoenix], eatType[pub], food[Fast food], priceRange[moderate], area[riverside], familyFriendly[yes], near[Raja Indian Cuisine]	The Phoenix, which serves fast food, is a pub. It is moderately priced. It is located in the riverside area and can be found near Raja Indian Cuisine. It welcomes families.
name[The Phoenix], eatType[pub], food[Fast food], priceRange[moderate], customer rating[3 out of 5], area[riverside], familyFriendly[yes], near[Café Sicilia]	The Phoenix, which offers fast food, is a mid-priced pub. It has a customer rating of 3 out of 5. It is in riverside near Café Sicilia. It is family-friendly.
name[The Phoenix], eatType[pub], food[Fast food], priceRange[more than £30], area[riverside], familyFriendly[yes], near[Raja Indian Cuisine]	The Phoenix, which offers fast food, is an expensive pub. It is in the riverside area by Raja Indian Cuisine. It is child-friendly.
name[The Phoenix], eatType[pub], food[Fast food], priceRange[more than £30], customer rating[high], area[city centre], familyFriendly[no], near[Café Sicilia]	The Phoenix, which serves fast food, is a high-priced pub. It has a high customer rating. Non-child-friendly The Phoenix is located in the city centre near Café Sicilia.
name[The Phoenix], eatType[pub], food[Fast food], priceRange[more than £30], customer rating[high], area[city centre], familyFriendly[yes], near[Café Sicilia]	The Phoenix, which serves fast food, is an expensive pub. It has a high customer rating. It is located in the city centre area and can be found near Café Sicilia. It is kid-friendly.
name[The Phoenix], eatType[pub], food[Fast food], priceRange[more than £30], customer rating[high], area[riverside], familyFriendly[no], near[Café Sicilia]	The Phoenix, which offers fast food, is a high-priced pub. It has a high customer rating. It is in riverside near Café Sicilia. It is not kid-friendly.
name[The Phoenix], eatType[pub], food[Fast food], priceRange[more than £30], customer rating[high], area[riverside], familyFriendly[yes], near[Café Sicilia]	The Phoenix, which offers fast food, is an expensive pub. It has a high customer rating. It is in the riverside area by Café Sicilia. It welcomes children.
name[The Phoenix], eatType[pub], food[French], priceRange[£20-25], area[riverside], familyFriendly[yes], near[Raja Indian Cuisine]	The Phoenix, which serves French food, is an average-priced pub. The Phoenix, which welcomes kids, is located in the riverside near Raja Indian Cuisine.
name[The Phoenix], eatType[pub], food[French], priceRange[£20-25], customer rating[3 out of 5], area[city centre], familyFriendly[no], near[Café Sicilia]	The Phoenix, which serves French cuisine, is a pub. It is moderately priced. Customer rate The Phoenix, which does not welcome children, 3 out of 5. It is located in the city centre area and can be found near Café Sicilia.
name[The Phoenix], eatType[pub], food[French], priceRange[£20-25], customer rating[3 out of 5], area[city centre], familyFriendly[yes], near[Café Sicilia]	The Phoenix, which offers French food, is a mid-priced pub. It has a customer rating of 3 out of 5. It is in city centre near Café Sicilia. It welcomes families.
name[The Phoenix], eatType[pub], food[French], priceRange[£20-25], customer rating[3 out of 5], area[riverside], familyFriendly[no], near[Café Sicilia]	The Phoenix, which offers French cuisine, is an average-priced pub. Customer rate The Phoenix, which is in the riverside area by Café Sicilia, 3 out of 5. It does not welcome kids.
name[The Phoenix], eatType[pub], food[French], priceRange[£20-25], customer rating[3 out of 5], area[riverside], familyFriendly[yes], near[Café Sicilia]	The Phoenix, which serves French food, is a pub. It is moderately priced. It has a customer rating of 3 out of 5. Family-friendly The Phoenix is located in the riverside near Café Sicilia.
name[The Phoenix], eatType[pub], food[French], priceRange[£20-25], customer rating[3 out of 5], area[riverside], familyFriendly[yes], near[Crowne Plaza Hotel]	The Phoenix, which serves French cuisine, is a mid-priced pub. Customer rate child-friendly The Phoenix 3 out of 5. It is located in the riverside area and can be found near Crowne Plaza Hotel.
name[The Phoenix], eatType[pub], food[French], priceRange[£20-25], customer rating[high], area[city centre], familyFriendly[no], near[Crowne Plaza Hotel]	The Phoenix, which offers French food, is an average-priced pub. It has a high customer rating. It is in city centre near Crowne Plaza Hotel. It is not family-friendly.
name[The Phoenix], eatType[pub], food[French], priceRange[£20-25], customer rating[high], area[city centre], familyFriendly[yes], near[Crowne Plaza Hotel]	The Phoenix, which offers French cuisine, is a pub. It is moderately priced. It has a high customer rating. It is in the city centre area by Crowne Plaza Hotel. It is kid-friendly.
name[The Phoenix], eatType[pub], food[French], priceRange[£20-25], customer rating[high], area[riverside], familyFriendly[no], near[Crowne Plaza Hotel]	The Phoenix, which serves French food, is a mid-priced pub. It has a high customer rating. Non-child-friendly The Phoenix is located in the riverside near Crowne Plaza Hotel.
name[The Phoenix], eatType[pub], food[French], priceRange[£20-25], customer rating[high], area[riverside], familyFriendly[yes], near[Crowne Plaza Hotel]	The Phoenix, which serves French cuisine, is an average-priced pub. It has a high customer rating. It is located in the riverside area and can be found near Crowne Plaza Hotel. It welcomes children.
name[The Phoenix], eatType[pub], food[French], priceRange[cheap], area[riverside], familyFriendly[yes], near[Raja Indian Cuisine]	The Phoenix, which offers French food, is a low-priced pub. It is in riverside near Raja Indian Cuisine. It welcomes kids.
name[The Phoenix], eatType[pub], food[French], priceRange[cheap], customer rating[5 out of 5], area[city centre], familyFriendly[no], near[Crowne Plaza Hotel]	The Phoenix, which offers French cuisine, is a cheap pub. It has a customer rating of 5 out of 5. It is in the city centre area by Crowne Plaza Hotel. It is not kid-friendly.
name[The Phoenix], eatType[pub], food[French], priceRange[cheap], customer rating[5 out of 5], area[city centre], familyFriendly[yes], near[Crowne Plaza Hotel]	The Phoenix, which serves French food, is a low-priced pub. Customer rate The Phoenix, which is located in the city centre near Crowne Plaza Hotel, 5 out of 5. It welcomes families.
name[The Phoenix], eatType[pub], food[French], priceRange[cheap], customer rating[5 out of 5], area[riverside], familyFriendly[no], near[Crowne Plaza Hotel]	The Phoenix, which serves French cuisine, is a cheap pub. It has a customer rating of 5 out of 5. It is located in the riverside area and can be found near Crowne Plaza Hotel. It does not welcome children.
name[The Phoenix], eatType[pub], food[French], priceRange[cheap], customer rating[5 out of 5], area[riverside], familyFriendly[yes], near[Crowne Plaza Hotel]	The Phoenix, which offers French food, is a low-priced pub. Customer rate The Phoenix, which is in riverside near Crowne Plaza Hotel, 5 out of 5. It is family-friendly.
name[The Phoenix], eatType[pub], food[French], priceRange[high], area[riverside], familyFriendly[yes], near[Raja Indian Cuisine]	The Phoenix, which offers French cuisine, is a high-priced pub. It is in the riverside area by Raja Indian Cuisine. It is child-friendly.
name[The Phoenix], eatType[pub], food[French], priceRange[high], customer rating[3 out of 5], area[city centre], familyFriendly[no], near[Crowne Plaza Hotel]	The Phoenix, which serves French food, is an expensive pub. It has a customer rating of 3 out of 5. The Phoenix, which does not welcome kids, is located in the city centre near Crowne Plaza Hotel.
name[The Phoenix], eatType[pub], food[French], priceRange[high], customer rating[3 out of 5], area[city centre], familyFriendly[yes], near[Crowne Plaza Hotel]	The Phoenix, which serves French cuisine, is a high-priced pub. Customer rate kid-friendly The Phoenix 3 out of 5. It is located in the city centre area and can be found near Crowne Plaza Hotel.
name[The Phoenix], eatType[pub], food[French], priceRange[high], customer rating[3 out of 5], area[riverside], familyFriendly[no], near[Crowne Plaza Hotel]	The Phoenix, which offers French food, is an expensive pub. It has a customer rating of 3 out of 5. It is in riverside near Crowne Plaza Hotel. It is not family-friendly.
name[The Phoenix], eatType[pub], food[French], priceRange[high], customer rating[3 out of 5], area[riverside], familyFriendly[yes], near[Crowne Plaza Hotel]	The Phoenix, which offers French cuisine, is a high-priced pub. Customer rate The Phoenix, which is in the riverside area by Crowne Plaza Hotel, 3 out of 5. It welcomes children.
name[The Phoenix], eatType[pub], food[French], priceRange[less than £20], customer rating[average], area[city centre], familyFriendly[no], near[Crowne Plaza Hotel]	The Phoenix, which serves French food, is a cheap pub. It has an average customer rating. Non-child-friendly The Phoenix is located in the city centre near Crowne Plaza Hotel.
name[The Phoenix], eatType[pub], food[French], priceRange[less than £20], customer rating[average], area[city centre], familyFriendly[yes], near[Crowne Plaza Hotel]	The Phoenix, which serves French cuisine, is a low-priced pub. It has an average customer rating. It is located in the city centre area and can be found near Crowne Plaza Hotel. It welcomes kids.
name[The Phoenix], eatType[pub], food[French], priceRange[less than £20], customer rating[average], area[riverside], familyFriendly[no], near[Crowne Plaza Hotel]	The Phoenix, which offers French food, is a cheap pub. It has an average customer rating. It is in riverside near Crowne Plaza Hotel. It is not kid-friendly.
name[The Phoenix], eatType[pub], food[French], priceRange[less than £20], customer rating[average], area[riverside], familyFriendly[yes], near[Crowne Plaza Hotel]	The Phoenix, which offers French cuisine, is a low-priced pub. It has an average customer rating. It is in the riverside area by Crowne Plaza Hotel. It welcomes families.
name[The Phoenix], eatType[pub], food[French], priceRange[less than £20], customer rating[low], area[city centre], familyFriendly[no], near[Crowne Plaza Hotel]	The Phoenix, which serves French food, is a cheap pub. It has a low customer rating. The Phoenix, which does not welcome children, is located in the city centre near Crowne Plaza Hotel.
name[The Phoenix], eatType[pub], food[French], priceRange[less than £20], customer rating[low], area[city centre], familyFriendly[yes], near[Crowne Plaza Hotel]	The Phoenix, which serves French cuisine, is a low-priced pub. It has a low customer rating. It is located in the city centre area and can be found near Crowne Plaza Hotel. It is family-friendly.
name[The Phoenix], eatType[pub], food[French], priceRange[less than £20], customer rating[low], area[riverside], familyFriendly[no], near[Crowne Plaza Hotel]	The Phoenix, which offers French food, is a cheap pub. It has a low customer rating. It is in riverside near Crowne Plaza Hotel. It does not welcome kids.
name[The Phoenix], eatType[pub], food[French], priceRange[less than £20], customer rating[low], area[riverside], familyFriendly[yes], near[Crowne Plaza Hotel]	The Phoenix, which offers French cuisine, is a low-priced pub. It has a low customer rating. It is in the riverside area by Crowne Plaza Hotel. It is child-friendly.
name[The Phoenix], eatType[pub], food[French], priceRange[moderate], customer rating[1 out of 5], area[city centre], familyFriendly[no], near[Crowne Plaza Hotel]	The Phoenix, which serves French food, is a pub. It is moderately priced. It has a customer rating of 1 out of 5. Non-family-friendly The Phoenix is located in the city centre near Crowne Plaza Hotel.
name[The Phoenix], eatType[pub], food[French], priceRange[moderate], customer rating[1 out of 5], area[city centre], familyFriendly[yes], near[Crowne Plaza Hotel]	The Phoenix, which serves French cuisine, is a mid-priced pub. Customer rate kid-friendly The Phoenix 1 out of 5. It is located in the city centre area and can be found near Crowne Plaza Hotel.
name[The Phoenix], eatType[pub], food[French], priceRange[moderate], customer rating[1 out of 5], area[riverside], familyFriendly[no], near[Crowne Plaza Hotel]	The Phoenix, which offers French food, is an average-priced pub. It has a customer rating of 1 out of 5. It is in riverside near Crowne Plaza Hotel. It is not child-friendly.
name[The Phoenix], eatType[pub], food[French], priceRange[moderate], customer rating[1 out of 5], area[riverside], familyFriendly[yes], near[Crowne Plaza Hotel]	The Phoenix, which offers French cuisine, is a pub. It is moderately priced. Customer rate The Phoenix, which is in the riverside area by Crowne Plaza Hotel, 1 out of 5. It welcomes children.
name[The Phoenix], eatType[pub], food[French], priceRange[more than £30], customer rating[5 out of 5], area[city centre], familyFriendly[no], near[Crowne Plaza Hotel]	The Phoenix, which serves French food, is an expensive pub. It has a customer rating of 5 out of 5. Non-kid-friendly The Phoenix is located in the city centre near Crowne Plaza Hotel.
name[The Phoenix], eatType[pub], food[French], priceRange[more than £30], customer rating[5 out of 5], area[city centre], familyFriendly[yes], near[Crowne Plaza Hotel]	The Phoenix, which serves French cuisine, is a high-priced pub. Customer rate The Phoenix, which welcomes kids, 5 out of 5. It is located in the city centre area and can be found near Crowne Plaza Hotel.
name[The Phoenix], eatType[pub], food[French], priceRange[more than £30], customer rating[5 out of 5], area[riverside], familyFriendly[no], near[Crowne Plaza Hotel]	The Phoenix, which offers French food, is an expensive pub. It has a customer rating of 5 out of 5. It is in riverside near Crowne Plaza Hotel. It does not welcome children.
name[The Phoenix], eatType[pub], food[French], priceRange[more than £30], customer rating[5 out of 5], area[riverside], familyFriendly[yes], near[Crowne Plaza Hotel]	The Phoenix, which offers French cuisine, is a high-priced pub. Customer rate The Phoenix, which is in the riverside area by Crowne Plaza Hotel, 5 out of 5. It welcomes families.
name[The Phoenix], eatType[pub], food[French], priceRange[more than £30], customer rating[low], area[city centre], familyFriendly[no], near[Crowne Plaza Hotel]	The Phoenix, which serves French food, is an expensive pub. It has a low customer rating. The Phoenix, which does not welcome kids, is located in the city centre near Crowne Plaza Hotel.
name[The Phoenix], eatType[pub], food[French], priceRange[more than £30], customer rating[low], area[city centre], familyFriendly[yes], near[Crowne Plaza Hotel]	The Phoenix, which serves French cuisine, is a high-priced pub. It has a low customer rating. It is located in the city centre area and can be found near Crowne Plaza Hotel. It is family-friendly.
name[The Phoenix], eatType[pub], food[French], priceRange[more than £30], customer rating[low], area[riverside], familyFriendly[no], near[Crowne Plaza Hotel]	The Phoenix, which offers French food, is an expensive pub. It has a low customer rating. It is in riverside near Crowne Plaza Hotel. It is not family-friendly.
name[The Phoenix], eatType[pub], food[French], priceRange[more than £30], customer rating[low], area[riverside], familyFriendly[yes], near[Crowne Plaza Hotel]	The Phoenix, which offers French cuisine, is a high-priced pub. It has a low customer rating. It is in the riverside area by Crowne Plaza Hotel. It is child-friendly.
name[The Phoenix], eatType[restaurant], food[Fast food], priceRange[cheap], area[riverside], familyFriendly[yes], near[Raja Indian Cuisine]	The Phoenix, which serves fast food, is a cheap restaurant. Kid-friendly The Phoenix is located in the riverside near Raja Indian Cuisine.
name[The Phoenix], eatType[restaurant], food[Fast food], priceRange[high], area[city centre], familyFriendly[no], near[Raja Indian Cuisine]	The Phoenix, which serves fast food, is an expensive restaurant. It is located in the city centre area and can be found near Raja Indian Cuisine. It is not child-friendly.
name[The Phoenix], eatType[restaurant], food[Fast food], priceRange[high], area[city centre], familyFriendly[yes], near[Raja Indian Cuisine]	The Phoenix, which offers fast food, is a high-priced restaurant. It is in city centre near Raja Indian Cuisine. It welcomes children.
name[The Phoenix], eatType[restaurant], food[Fast food], priceRange[high], area[riverside], familyFriendly[no], near[Raja Indian Cuisine]	The Phoenix, which offers fast food, is an expensive restaurant. It is in the riverside area by Raja Indian Cuisine. It is not kid-friendly.
name[The Phoenix], eatType[restaurant], food[Fast food], priceRange[high], area[riverside], familyFriendly[yes], near[Raja Indian Cuisine]	The Phoenix, which serves fast food, is a high-priced restaurant. The Phoenix, which welcomes kids, is located in the riverside near Raja Indian Cuisine.
name[The Phoenix], eatType[restaurant], food[Fast food], priceRange[less than £20], area[city centre], familyFriendly[no], near[Raja Indian Cuisine]	The Phoenix, which serves fast food, is a low-priced restaurant. It is located in the city centre area and can be found near Raja Indian Cuisine. It does not welcome children.
name[The Phoenix], eatType[restaurant], food[Fast food], priceRange[less than £20], area[city centre], familyFriendly[yes], near[Raja Indian Cuisine]	The Phoenix, which offers fast food, is a cheap restaurant. It is in city centre near Raja Indian Cuisine. It welcomes families.
name[The Phoenix], eatType[restaurant], food[Fast food], priceRange[less than £20], area[riverside], familyFriendly[no], near[Raja Indian Cuisine]	The Phoenix, which offers fast food, is a low-priced restaurant. It is in the riverside area by Raja Indian Cuisine. It does not welcome kids.
name[The Phoenix], eatType[restaurant], food[Fast food], priceRange[less than £20], area[riverside], familyFriendly[yes], near[Raja Indian Cuisine]	The Phoenix, which serves fast food, is a cheap restaurant. Family-friendly The Phoenix is located in the riverside near Raja Indian Cuisine.
name[The Phoenix], eatType[restaurant], food[Fast food], priceRange[moderate], area[city centre], familyFriendly[no], near[Raja Indian Cuisine]	The Phoenix, which serves fast food, is a mid-priced restaurant. It is located in the city centre area and can be found near Raja Indian Cuisine. It is not family-friendly.
name[The Phoenix], eatType[restaurant], food[Fast food], priceRange[moderate], area[city centre], familyFriendly[yes], near[Raja Indian Cuisine]	The Phoenix, which offers fast food, is an average-priced restaurant. It is in city centre near Raja Indian Cuisine. It is child-friendly.
name[The Phoenix], eatType[restaurant], food[Fast food], priceRange[moderate], area[riverside], familyFriendly[no], near[Raja Indian Cuisine]	The Phoenix, which offers fast food, is a restaurant. It is moderately priced. It is in the riverside area by Raja Indian Cuisine. It is not child-friendly.
name[The Phoenix], eatType[restaurant], food[Fast food], priceRange[moderate], area[riverside], familyFriendly[yes], near[Raja Indian Cuisine]	The Phoenix, which serves fast food, is a mid-priced restaurant. Kid-friendly The Phoenix is located in the riverside near Raja Indian Cuisine.
name[The Phoenix], eatType[restaurant], food[Fast food], priceRange[more than £30], area[riverside], familyFriendly[yes], near[Raja Indian Cuisine]	The Phoenix, which serves fast food, is an expensive restaurant. It is located in the riverside area and can be found near Raja Indian Cuisine. It welcomes children.
name[The Phoenix], eatType[restaurant], food[French], priceRange[£20-25], area[riverside], familyFriendly[yes], near[Raja Indian Cuisine]	The Phoenix, which offers French food, is an average-priced restaurant. It is in riverside near Raja Indian Cuisine. It welcomes kids.
name[The Phoenix], eatType[restaurant], food[French], priceRange[cheap], area[riverside], familyFriendly[yes], near[Raja Indian Cuisine]	The Phoenix, which offers French cuisine, is a low-priced restaurant. It is in the riverside area by Raja Indian Cuisine. It welcomes families.
name[The Phoenix], eatType[restaurant], food[French], priceRange[high], area[riverside], familyFriendly[yes], near[Raja Indian Cuisine]	The Phoenix, which serves French food, is a high-priced restaurant. Family-friendly The Phoenix is located in the riverside near Raja Indian Cuisine.
name[The Phoenix], eatType[restaurant], food[Indian], priceRange[£20-25], customer rating[high], area[city centre], familyFriendly[no], near[Crowne Plaza Hotel]	The Phoenix, which serves Indian cuisine, is a restaurant. It is moderately priced. It has a high customer rating. It is located in the city centre area and can be found near Crowne Plaza Hotel. It is not kid-friendly.
name[The Phoenix], eatType[restaurant], food[Indian], priceRange[£20-25], customer rating[high], area[city centre], familyFriendly[yes], near[Crowne Plaza Hotel]	The Phoenix, which offers Indian food, is a mid-priced restaurant. It has a high customer rating. It is in city centre near Crowne Plaza Hotel. It is child-friendly.
name[The Phoenix], eatType[restaurant], food[Indian], priceRange[£20-25], customer rating[high], area[riverside], familyFriendly[no], near[Crowne Plaza Hotel]	The Phoenix, which offers Indian cuisine, is an average-priced restaurant. It has a high customer rating. It is in the riverside area by Crowne Plaza Hotel. It does not welcome children.
name[The Phoenix], eatType[restaurant], food[Indian], priceRange[£20-25], customer rating[high], area[riverside], familyFriendly[yes], near[Crowne Plaza Hotel]	The Phoenix, which serves Indian food, is a restaurant. It is moderately priced. It has a high customer rating. Kid-friendly The Phoenix is located in the riverside near Crowne Plaza Hotel.
name[The Phoenix], eatType[restaurant], food[Indian], priceRange[cheap], customer rating[5 out of 5], area[city centre], familyFriendly[no], near[Crowne Plaza Hotel]	The Phoenix, which serves Indian cuisine, is a cheap restaurant. It has a customer rating of 5 out of 5. It is located in the city centre area and can be found near Crowne Plaza Hotel. It does not welcome kids.
name[The Phoenix], eatType[restaurant], food[Indian], priceRange[cheap], customer rating[5 out of 5], area[city centre], familyFriendly[yes], near[Crowne Plaza Hotel]	The Phoenix, which offers Indian food, is a low-priced restaurant. Customer rate The Phoenix, which is in city centre near Crowne Plaza Hotel, 5 out of 5. It welcomes children.
name[The Phoenix], eatType[restaurant], food[Indian], priceRange[cheap], customer rating[5 out of 5], area[riverside], familyFriendly[no], near[Crowne Plaza Hotel]	The Phoenix, which offers Indian cuisine, is a cheap restaurant. It has a customer rating of 5 out of 5. It is in the riverside area by Crowne Plaza Hotel. It is not family-friendly.
name[The Phoenix], eatType[restaurant], food[Indian], priceRange[cheap], customer rating[5 out of 5], area[riverside], familyFriendly[no], near[Express by Holiday Inn]	The Phoenix, which serves Indian food, is a low-priced restaurant. Customer rate The Phoenix, which is located in the riverside near Express by Holiday Inn, 5 out of 5. It is not child-friendly.
name[The Phoenix], eatType[restaurant], food[Indian], priceRange[cheap], customer rating[5 out of 5], area[riverside], familyFriendly[yes], near[Express by Holiday Inn]	The Phoenix, which serves Indian cuisine, is a cheap restaurant. It has a customer rating of 5 out of 5. It is located in the riverside area and can be found near Express by Holiday Inn. It welcomes kids.
name[The Phoenix], eatType[restaurant], food[Indian], priceRange[cheap], customer rating[average], area[city centre], familyFriendly[no], near[Express by Holiday Inn]	The Phoenix, which offers Indian food, is a low-priced restaurant. It has an average customer rating. It is in city centre near Express by Holiday Inn. It is not kid-friendly.
name[The Plough], eatType[pub], food[Chinese], priceRange[£20-25], area[riverside], familyFriendly[yes], near[Raja Indian Cuisine]	The Plough, which offers Chinese cuisine, is a mid-priced pub. It is in the riverside area by Raja Indian Cuisine. It welcomes families.
name[The Plough], eatType[pub], food[Chinese], priceRange[cheap], area[riverside], familyFriendly[yes], near[Raja Indian Cuisine]	The Plough, which serves Chinese food, is a cheap pub. Family-friendly The Plough is located in the riverside near Raja Indian Cuisine.
name[The Plough], eatType[pub], food[Chinese], priceRange[high], area[city centre], familyFriendly[no], near[Raja Indian Cuisine]	The Plough, which serves Chinese cuisine, is an expensive pub. It is located in the city centre area and can be found near Raja Indian Cuisine. It does not welcome children.
name[The Plough], eatType[pub], food[Chinese], priceRange[high], area[city centre], familyFriendly[yes], near[Raja Indian Cuisine]	The Plough, which offers Chinese food, is a high-priced pub. It is in city centre near Raja Indian Cuisine. It is child-friendly.
name[The Plough], eatType[pub], food[Chinese], priceRange[high], area[riverside], familyFriendly[no], near[Raja Indian Cuisine]	The Plough, which offers Chinese cuisine, is an expensive pub. It is in the riverside area by Raja Indian Cuisine. It does not welcome kids.
name[The Plough], eatType[pub], food[Chinese], priceRange[high], area[riverside], familyFriendly[yes], near[Raja Indian Cuisine]	The Plough, which serves Chinese food, is a high-priced pub. Kid-friendly The Plough is located in the riverside near Raja Indian Cuisine.
name[The Plough], eatType[pub], food[Chinese], priceRange[less than £20], area[city centre], familyFriendly[no], near[Raja Indian Cuisine]	The Plough, which serves Chinese cuisine, is a low-priced pub. It is located in the city centre area and can be found near Raja Indian Cuisine. It is not family-friendly.
name[The Plough], eatType[restaurant], food[Chinese], priceRange[£20-25], area[riverside], familyFriendly[yes], near[Raja Indian Cuisine]	The Plough, which offers Chinese food, is an average-priced restaurant. It is in riverside near Raja Indian Cuisine. It welcomes children.
name[The Plough], eatType[restaurant], food[Chinese], priceRange[cheap], area[riverside], familyFriendly[yes], near[Raja Indian Cuisine]	The Plough, which offers Chinese cuisine, is a cheap restaurant. It is in the riverside area by Raja Indian Cuisine. It welcomes kids.
name[The Plough], eatType[restaurant], food[Chinese], priceRange[high], area[city centre], familyFriendly[no], near[Raja Indian Cuisine]	The Plough, which serves Chinese food, is an expensive restaurant. Non-child-friendly The Plough is located in the city centre near Raja Indian Cuisine.
name[The Plough], eatType[restaurant], food[Chinese], priceRange[high], area[city centre], familyFriendly[yes], near[Raja Indian Cuisine]	The Plough, which serves Chinese cuisine, is a high-priced restaurant. It is located in the city centre area and can be found near Raja Indian Cuisine. It welcomes families.
name[The Plough], eatType[restaurant], food[Chinese], priceRange[high], area[riverside], familyFriendly[no], near[Raja Indian Cuisine]	The Plough, which offers Chinese food, is an expensive restaurant. It is in riverside near Raja Indian Cuisine. It is not kid-friendly.
name[The Plough], eatType[restaurant], food[Chinese], priceRange[high], area[riverside], familyFriendly[yes], near[Raja Indian Cuisine]	The Plough, which offers Chinese cuisine, is a high-priced restaurant. It is in the riverside area by Raja Indian Cuisine. It is family-friendly.
name[The Plough], eatType[restaurant], food[Chinese], priceRange[less than £20], area[city centre], familyFriendly[no], near[Raja Indian Cuisine]	The Plough, which serves Chinese food, is a low-priced restaurant. The Plough, which does not welcome children, is located in the city centre near Raja Indian Cuisine.
name[The Punter], eatType[pub], food[Chinese], priceRange[less than £20], area[city centre], familyFriendly[yes], near[Raja Indian Cuisine]	The Punter, which serves Chinese cuisine, is a cheap pub. It is located in the city centre area and can be found near Raja Indian Cuisine. It is child-friendly.
name[The Punter], eatType[pub], food[Chinese], priceRange[less than £20], area[riverside], familyFriendly[no], near[Raja Indian Cuisine]	The Punter, which offers Chinese food, is a low-priced pub. It is in riverside near Raja Indian Cuisine. It does not welcome kids.
name[The Punter], eatType[pub], food[Chinese], priceRange[less than £20], area[riverside], familyFriendly[yes], near[Raja Indian Cuisine]	The Punter, which offers Chinese cuisine, is a cheap pub. It is in the riverside area by Raja Indian Cuisine. It is kid-friendly.
name[The Punter], eatType[pub], food[Chinese], priceRange[moderate], area[city centre], familyFriendly[no], near[Raja Indian Cuisine]	The Punter, which serves Chinese food, is a pub. It is moderately priced. Non-family-friendly The Punter is located in the city centre near Raja Indian Cuisine.
name[The Punter], eatType[pub], food[Chinese], priceRange[moderate], area[city centre], familyFriendly[yes], near[Raja Indian Cuisine]	The Punter, which serves Chinese cuisine, is a mid-priced pub. It is located in the city centre area and can be found near Raja Indian Cuisine. It welcomes children.
name[The Punter], eatType[pub], food[Chinese], priceRange[moderate], area[riverside], familyFriendly[no], near[Raja Indian Cuisine]	The Punter, which offers Chinese food, is an average-priced pub. It is in riverside near Raja Indian Cuisine. It is not child-friendly.
name[The Punter], eatType[pub], food[Chinese], priceRange[moderate], area[riverside], familyFriendly[yes], near[Raja Indian Cuisine]	The Punter, which offers Chinese cuisine, is a pub. It is moderately priced. It is in the riverside area by Raja Indian Cuisine. It welcomes kids.
name[The Punter], eatType[pub], food[Chinese], priceRange[more than £30], area[riverside], familyFriendly[yes], near[Raja Indian Cuisine]	The Punter, which serves Chinese food, is an expensive pub. The Punter, which welcomes families, is located in the riverside near Raja Indian Cuisine.
name[The Punter], eatType[pub], food[English], priceRange[£20-25], area[riverside], familyFriendly[yes], near[Raja Indian Cuisine]	The Punter, which serves English cuisine, is a mid-priced pub. It is located in the riverside area and can be found near Raja Indian Cuisine. It is family-friendly.
name[The Punter], eatType[pub], food[English], priceRange[cheap], area[riverside], familyFriendly[yes], near[Raja Indian Cuisine]	The Punter, which offers English food, is a low-priced pub. It is in riverside near Raja Indian Cuisine. It is child-friendly.
name[The Punter], eatType[pub], food[English], priceRange[high], area[city centre], familyFriendly[no], near[Raja Indian Cuisine]	The Punter, which offers English cuisine, is a high-priced pub. It is in the city centre area by Raja Indian Cuisine. It is not kid-friendly.
name[The Punter], eatType[pub], food[English], priceRange[high], area[city centre], familyFriendly[yes], near[Raja Indian Cuisine]	The Punter, which serves English food, is an expensive pub. Kid-friendly The Punter is located in the city centre near Raja Indian Cuisine.
name[The Punter], eatType[pub], food[English], priceRange[high], area[riverside], familyFriendly[no], near[Raja Indian Cuisine]	The Punter, which serves English cuisine, is a high-priced pub. It is located in the riverside area and can be found near Raja Indian Cuisine. It does not welcome children.
name[The Punter], eatType[pub], food[English], priceRange[high], area[riverside], familyFriendly[yes], near[Raja Indian Cuisine]	The Punter, which offers English food, is an expensive pub. It is in riverside near Raja Indian Cuisine. It welcomes children.
name[The Punter], eatType[pub], food[Italian], priceRange[high], customer rating[average], area[city centre], familyFriendly[no], near[Rainbow Vegetarian Café]	The Punter, which offers Italian cuisine, is a high-priced pub. It has an average customer rating. It is in the city centre area by Rainbow Vegetarian Café. It does not welcome kids.
name[The Punter], eatType[restaurant], food[Chinese], priceRange[less than £20], area[city centre], familyFriendly[yes], near[Raja Indian Cuisine]	The Punter, which serves Chinese food, is a cheap restaurant. The Punter, which welcomes kids, is located in the city centre near Raja Indian Cuisine.
name[The Punter], eatType[restaurant], food[Chinese], priceRange[less than £20], area[riverside], familyFriendly[no], near[Raja Indian Cuisine]	The Punter, which serves Chinese cuisine, is a low-priced restaurant. It is located in the riverside area and can be found near Raja Indian Cuisine. It is not family-friendly.
name[The Punter], eatType[restaurant], food[Chinese], priceRange[less than £20], area[riverside], familyFriendly[yes], near[Raja Indian Cuisine]	The Punter, which offers Chinese food, is a cheap restaurant. It is in riverside near Raja Indian Cuisine. It welcomes families.
name[The Punter], eatType[restaurant], food[Chinese], priceRange[moderate], area[city centre], familyFriendly[no], near[Raja Indian Cuisine]	The Punter, which offers Chinese cuisine, is an average-priced restaurant. It is in the city centre area by Raja Indian Cuisine. It is not child-friendly.
name[The Punter], eatType[restaurant], food[Chinese], priceRange[moderate], area[city centre], familyFriendly[yes], near[Raja Indian Cuisine]	The Punter, which serves Chinese food, is a restaurant. It is moderately priced. Family-friendly The Punter is located in the city centre near Raja Indian Cuisine.
name[The Punter], eatType[restaurant], food[Chinese], priceRange[moderate], area[riverside], familyFriendly[no], near[Raja Indian Cuisine]	The Punter, which serves Chinese cuisine, is a mid-priced restaurant. It is located in the riverside area and can be found near Raja Indian Cuisine. It is not kid-friendly.
name[The Punter], eatType[restaurant], food[Chinese], priceRange[moderate], area[riverside], familyFriendly[yes], near[Raja Indian Cuisine]	The Punter, which offers Chinese food, is an average-priced restaurant. It is in riverside near Raja Indian Cuisine. It is child-friendly.
name[The Punter], eatType[restaurant], food[Chinese], priceRange[more than £30], area[riverside], familyFriendly[yes], near[Raja Indian Cuisine]	The Punter, which offers Chinese cuisine, is an expensive restaurant. It is in the riverside area by Raja Indian Cuisine. It is kid-friendly.
name[The Punter], eatType[restaurant], food[English], priceRange[£20-25], area[riverside], familyFriendly[yes], near[Raja Indian Cuisine]	The Punter, which serves English food, is a restaurant. It is moderately priced. The Punter, which welcomes children, is located in the riverside near Raja Indian Cuisine.
name[The Punter], eatType[restaurant], food[English], priceRange[cheap], area[riverside], familyFriendly[yes], near[Raja Indian Cuisine]	The Punter, which serves English cuisine, is a low-priced restaurant. It is located in the riverside area and can be found near Raja Indian Cuisine. It welcomes kids.
name[The Punter], eatType[restaurant], food[English], priceRange[high], area[city centre], familyFriendly[no], near[Raja Indian Cuisine]	The Punter, which offers English food, is a high-priced restaurant. It is in city centre near Raja Indian Cuisine. It does not welcome children.
name[The Punter], eatType[restaurant], food[English], priceRange[high], area[city centre], familyFriendly[yes], near[Raja Indian Cuisine]	The Punter, which offers English cuisine, is an expensive restaurant. It is in the city centre area by Raja Indian Cuisine. It welcomes families.
name[The Punter], eatType[restaurant], food[English], priceRange[high], area[riverside], familyFriendly[no], near[Raja Indian Cuisine]	The Punter, which serves English food, is a high-priced restaurant. The Punter, which does not welcome kids, is located in the riverside near Raja Indian Cuisine.
name[The Punter], eatType[restaurant], food[English], priceRange[high], area[riverside], familyFriendly[yes], near[Raja Indian Cuisine]	The Punter, which serves English cuisine, is an expensive restaurant. It is located in the riverside area and can be found near Raja Indian Cuisine. It is family-friendly.
name[The Punter], eatType[restaurant], food[Indian], priceRange[cheap], customer rating[average], area[city centre], familyFriendly[yes], near[Express by Holiday Inn]	The Punter, which offers Indian food, is a cheap restaurant. It has an average customer rating. It is in city centre near Express by Holiday Inn. It is child-friendly.
name[The Punter], eatType[restaurant], food[Indian], priceRange[cheap], customer rating[average], area[riverside], familyFriendly[no], near[Express by Holiday Inn]	The Punter, which offers Indian cuisine, is a low-priced restaurant. It has an average customer rating. It is in the riverside area by Express by Holiday Inn. It is not family-friendly.
name[The Punter], eatType[restaurant], food[Indian], priceRange[cheap], customer rating[average], area[riverside], familyFriendly[yes], near[Express by Holiday Inn]	The Punter, which serves Indian food, is a cheap restaurant. It has an average customer rating. Kid-friendly The Punter is located in the riverside near Express by Holiday Inn.
name[The Punter], eatType[restaurant], food[Indian], priceRange[high], customer rating[1 out of 5], area[city centre], familyFriendly[no], near[Express by Holiday Inn]	The Punter, which serves Indian cuisine, is a high-priced restaurant. Customer rate non-child-friendly The Punter 1 out of 5. It is located in the city centre area and can be found near Express by Holiday Inn.
name[The Punter], eatType[restaurant], food[Indian], priceRange[high], customer rating[1 out of 5], area[city centre], familyFriendly[yes], near[Express by Holiday Inn]	The Punter, which offers Indian food, is an expensive restaurant. It has a customer rating of 1 out of 5. It is in city centre near Express by Holiday Inn. It welcomes children.
name[The Punter], eatType[restaurant], food[Indian], priceRange[high], customer rating[1 out of 5], area[riverside], familyFriendly[no], near[Express by Holiday Inn]	The Punter, which offers Indian cuisine, is a high-priced restaurant. Customer rate The Punter, which is in the riverside area by Express by Holiday Inn, 1 out of 5. It is not kid-friendly.
name[The Punter], eatType[restaurant], food[Indian], priceRange[high], customer rating[1 out of 5], area[riverside], familyFriendly[yes], near[Express by Holiday Inn]	The Punter, which serves Indian food, is an expensive restaurant. It has a customer rating of 1 out of 5. The Punter, which welcomes kids, is located in the riverside near Express by Holiday Inn.
name[The Punter], eatType[restaurant], food[Indian], priceRange[high], customer rating[average], area[city centre], familyFriendly[no], near[Express by Holiday Inn]	The Punter, which serves Indian cuisine, is a high-priced restaurant. It has an average customer rating. It is located in the city centre area and can be found near Express by Holiday Inn. It does not welcome children.
name[The Punter], eatType[restaurant], food[Indian], priceRange[high], customer rating[average], area[city centre], familyFriendly[yes], near[Express by Holiday Inn]	The Punter, which offers Indian food, is an expensive restaurant. It has an average customer rating. It is in city centre near Express by Holiday Inn. It welcomes families.
name[The Punter], eatType[restaurant], food[Indian], priceRange[high], customer rating[average], area[riverside], familyFriendly[no], near[Express by Holiday Inn]	The Punter, which offers Indian cuisine, is a high-priced restaurant. It has an average customer rating. It is in the riverside area by Express by Holiday Inn. It does not welcome kids.
name[The Punter], eatType[restaurant], food[Indian], priceRange[high], customer rating[average], area[riverside], familyFriendly[yes], near[Express by Holiday Inn]	The Punter, which serves Indian food, is an expensive restaurant. It has an average customer rating. Family-friendly The Punter is located in the riverside near Express by Holiday Inn.
name[The Punter], eatType[restaurant], food[Indian], priceRange[less than £20], customer rating[low], area[city centre], familyFriendly[no], near[Express by Holiday Inn]	The Punter, which serves Indian cuisine, is a low-priced restaurant. It has a low customer rating. It is located in the city centre area and can be found near Express by Holiday Inn. It is not family-friendly.
name[The Punter], eatType[restaurant], food[Indian], priceRange[less than £20], customer rating[low], area[city centre], familyFriendly[yes], near[Express by Holiday Inn]	The Punter, which offers Indian food, is a cheap restaurant. It has a low customer rating. It is in city centre near Express by Holiday Inn. It is child-friendly.
name[The Punter], eatType[restaurant], food[Indian], priceRange[less than £20], customer rating[low], area[riverside], familyFriendly[no], near[Express by Holiday Inn]	The Punter, which offers Indian cuisine, is a low-priced restaurant. It has a low customer rating. It is in the riverside area by Express by Holiday Inn. It is not child-friendly.
name[The Punter], eatType[restaurant], food[Indian], priceRange[less than £20], customer rating[low], area[riverside], familyFriendly[yes], near[Express by Holiday Inn]	The Punter, which serves Indian food, is a cheap restaurant. It has a low customer rating. Kid-friendly The Punter is located in the riverside near Express by Holiday Inn.
name[The Punter], eatType[restaurant], food[Indian], priceRange[moderate], customer rating[1 out of 5], area[city centre], familyFriendly[no], near[Express by Holiday Inn]	The Punter, which serves Indian cuisine, is a mid-priced restaurant. Customer rate non-kid-friendly The Punter 1 out of 5. It is located in the city centre area and can be found near Express by Holiday Inn.
name[The Punter], eatType[restaurant], food[Indian], priceRange[moderate], customer rating[1 out of 5], area[city centre], familyFriendly[yes], near[Express by Holiday Inn]	The Punter, which offers Indian food, is an average-priced restaurant. It has a customer rating of 1 out of 5. It is in city centre near Express by Holiday Inn. It welcomes children.
name[The Punter], eatType[restaurant], food[Indian], priceRange[moderate], customer rating[1 out of 5], area[riverside], familyFriendly[no], near[Express by Holiday Inn]	The Punter, which offers Indian cuisine, is a restaurant. It is moderately priced. Customer rate The Punter, which is in the riverside area by Express by Holiday Inn, 1 out of 5. It does not welcome children.
name[The Punter], eatType[restaurant], food[Indian], priceRange[moderate], customer rating[1 out of 5], area[riverside], familyFriendly[yes], near[Express by Holiday Inn]	The Punter, which serves Indian food, is a mid-priced restaurant. It has a customer rating of 1 out of 5. The Punter, which welcomes kids, is located in the riverside near Express by Holiday Inn.
name[The Punter], eatType[restaurant], food[Indian], priceRange[moderate], customer rating[3 out of 5], area[city centre], familyFriendly[no], near[Express by Holiday Inn]	The Punter, which serves Indian cuisine, is an average-priced restaurant. Customer rate The Punter, which does not welcome kids, 3 out of 5. It is located in the city centre area and can be found near Express by Holiday Inn.
name[The Punter], eatType[restaurant], food[Indian], priceRange[moderate], customer rating[3 out of 5], area[city centre], familyFriendly[yes], near[Express by Holiday Inn]	The Punter, which offers Indian food, is a restaurant. It is moderately priced. It has a customer rating of 3 out of 5. It is in city centre near Express by Holiday Inn. It welcomes families.
name[The Punter], eatType[restaurant], food[Indian], priceRange[moderate], customer rating[3 out of 5], area[riverside], familyFriendly[no], near[Express by Holiday Inn]	The Punter, which offers Indian cuisine, is a mid-priced restaurant. Customer rate The Punter, which is in the riverside area by Express by Holiday Inn, 3 out of 5. It is not family-friendly.
name[The Punter], eatType[restaurant], food[Indian], priceRange[moderate], customer rating[3 out of 5], area[riverside], familyFriendly[yes], near[Express by Holiday Inn]	The Punter, which serves Indian food, is an average-priced restaurant. It has a customer rating of 3 out of 5. Family-friendly The Punter is located in the riverside near Express by Holiday Inn.
name[The Punter], eatType[restaurant], food[Indian], priceRange[more than £30], customer rating[high], area[city centre], familyFriendly[no], near[Express by Holiday Inn]	The Punter, which serves Indian cuisine, is a high-priced restaurant. It has a high customer rating. It is located in the city centre area and can be found near Express by Holiday Inn. It is not child-friendly.
name[The Punter], eatType[restaurant], food[Indian], priceRange[more than £30], customer rating[high], area[city centre], familyFriendly[yes], near[Express by Holiday Inn]	The Punter, which offers Indian food, is an expensive restaurant. It has a high customer rating. It is in city centre near Express by Holiday Inn. It is child-friendly.
name[The Punter], eatType[restaurant], food[Indian], priceRange[more than £30], customer rating[high], area[riverside], familyFriendly[no], near[Express by Holiday Inn]	The Punter, which offers Indian cuisine, is a high-priced restaurant. It has a high customer rating. It is in the riverside area by Express by Holiday Inn. It is not kid-friendly.
name[The Punter], eatType[restaurant], food[Indian], priceRange[more than £30], customer rating[high], area[riverside], familyFriendly[yes], near[Express by Holiday Inn]	The Punter, which serves Indian food, is an expensive restaurant. It has a high customer rating. Kid-friendly The Punter is located in the riverside near Express by Holiday Inn.
name[The Punter], eatType[restaurant], food[Italian], priceRange[£20-25], customer rating[high], area[city centre], familyFriendly[no], near[Express by Holiday Inn]	The Punter, which serves Italian cuisine, is a restaurant. It is moderately priced. It has a high customer rating. It is located in the city centre area and can be found near Express by Holiday Inn. It does not welcome children.
name[The Punter], eatType[restaurant], food[Italian], priceRange[£20-25], customer rating[high], area[city centre], familyFriendly[yes], near[Express by Holiday Inn]	The Punter, which offers Italian food, is a mid-priced restaurant. It has a high customer rating. It is in city centre near Express by Holiday Inn. It welcomes children.
name[The Punter], eatType[restaurant], food[Italian], priceRange[£20-25], customer rating[high], area[riverside], familyFriendly[no], near[Express by Holiday Inn]	The Punter, which offers Italian cuisine, is an average-priced restaurant. It has a high customer rating. It is in the riverside area by Express by Holiday Inn. It does not welcome kids.
name[The Punter], eatType[restaurant], food[Italian], priceRange[£20-25], customer rating[high], area[riverside], familyFriendly[yes], near[Express by Holiday Inn]	The Punter, which serves Italian food, is a restaurant. It is moderately priced. It has a high customer rating. The Punter, which welcomes kids, is located in the riverside near Express by Holiday Inn.
name[The Punter], eatType[restaurant], food[Italian], priceRange[cheap], customer rating[5 out of 5], area[city centre], familyFriendly[no], near[Express by Holiday Inn]	The Punter, which serves Italian cuisine, is a low-priced restaurant. Customer rate non-family-friendly The Punter 5 out of 5. It is located in the city centre area and can be found near Express by Holiday Inn.
name[The Punter], eatType[restaurant], food[Italian], priceRange[cheap], customer rating[5 out of 5], area[city centre], familyFriendly[no], near[Rainbow Vegetarian Café]	The Punter, which offers Italian food, is a cheap restaurant. It has a customer rating of 5 out of 5. It is in city centre near Rainbow Vegetarian Café. It is not child-friendly.
name[The Punter], eatType[restaurant], food[Italian], priceRange[cheap], customer rating[5 out of 5], area[city centre], familyFriendly[yes], near[Rainbow Vegetarian Café]	The Punter, which offers Italian cuisine, is a low-priced restaurant. Customer rate The Punter, which is in the city centre area by Rainbow Vegetarian Café, 5 out of 5. It welcomes families.
name[The Punter], eatType[restaurant], food[Italian], priceRange[cheap], customer rating[5 out of 5], area[riverside], familyFriendly[no], near[Rainbow Vegetarian Café]	The Punter, which serves Italian food, is a cheap restaurant. It has a customer rating of 5 out of 5. Non-kid-friendly The Punter is located in the riverside near Rainbow Vegetarian Café.
name[The Punter], eatType[restaurant], food[Italian], priceRange[cheap], customer rating[5 out of 5], area[riverside], familyFriendly[yes], near[Rainbow Vegetarian Café]	The Punter, which serves Italian cuisine, is a low-priced restaurant. Customer rate family-friendly The Punter 5 out of 5. It is located in the riverside area and can be found near Rainbow Vegetarian Café.
name[The Punter], eatType[restaurant], food[Italian], priceRange[cheap], customer rating[average], area[city centre], familyFriendly[no], near[Rainbow Vegetarian Café]	The Punter, which offers Italian food, is a cheap restaurant. It has an average customer rating. It is in city centre near Rainbow Vegetarian Café. It does not welcome children.
name[The Punter], eatType[restaurant], food[Italian], priceRange[cheap], customer rating[average], area[city centre], familyFriendly[yes], near[Rainbow Vegetarian Café]	The Punter, which offers Italian cuisine, is a low-priced restaurant. It has an average customer rating. It is in the city centre area by Rainbow Vegetarian Café. It is child-friendly.
name[The Punter], eatType[restaurant], food[Italian], priceRange[cheap], customer rating[average], area[riverside], familyFriendly[no], near[Rainbow Vegetarian Café]	The Punter, which serves Italian food, is a cheap restaurant. It has an average customer rating. The Punter, which does not welcome kids, is located in the riverside near Rainbow Vegetarian Café.
name[The Punter], eatType[restaurant], food[Italian], priceRange[cheap], customer rating[average], area[riverside], familyFriendly[yes], near[Rainbow Vegetarian Café]	The Punter, which serves Italian cuisine, is a low-priced restaurant. It has an average customer rating. It is located in the riverside area and can be found near Rainbow Vegetarian Café. It is kid-friendly.
name[The Punter], eatType[restaurant], food[Italian], priceRange[high], customer rating[1 out of 5], area[city centre], familyFriendly[no], near[Rainbow Vegetarian Café]	The Punter, which offers Italian food, is a high-priced restaurant. It has a customer rating of 1 out of 5. It is in city centre near Rainbow Vegetarian Café. It is not family-friendly.
name[The Punter], eatType[restaurant], food[Italian], priceRange[high], customer rating[1 out of 5], area[city centre], familyFriendly[yes], near[Rainbow Vegetarian Café]	The Punter, which offers Italian cuisine, is an expensive restaurant. Customer rate The Punter, which is in the city centre area by Rainbow Vegetarian Café, 1 out of 5. It welcomes children.
name[The Punter], eatType[restaurant], food[Italian], priceRange[high], customer rating[1 out of 5], area[riverside], familyFriendly[no], near[Rainbow Vegetarian Café]	The Punter, which serves Italian food, is a high-priced restaurant. It has a customer rating of 1 out of 5. Non-child-friendly The Punter is located in the riverside near Rainbow Vegetarian Café.
name[The Punter], eatType[restaurant], food[Italian], priceRange[high], customer rating[1 out of 5], area[riverside], familyFriendly[yes], near[Rainbow Vegetarian Café]	The Punter, which serves Italian cuisine, is an expensive restaurant. Customer rate The Punter, which welcomes kids, 1 out of 5. It is located in the riverside area and can be found near Rainbow Vegetarian Café.
name[The Vaults], eatType[pub], food[French], priceRange[high], area[riverside], familyFriendly[yes], near[Raja Indian Cuisine]	The Vaults, which offers French food, is a high-priced pub. It is in riverside near Raja Indian Cuisine. It welcomes families.
name[The Vaults], eatType[pub], food[French], priceRange[less than £20], area[city centre], familyFriendly[no], near[Raja Indian Cuisine]	The Vaults, which offers French cuisine, is a cheap pub. It is in the city centre area by Raja Indian Cuisine. It is not kid-friendly.
name[The Vaults], eatType[pub], food[French], priceRange[less than £20], area[city centre], familyFriendly[yes], near[Raja Indian Cuisine]	The Vaults, which serves French food, is a low-priced pub. Family-friendly The Vaults is located in the city centre near Raja Indian Cuisine.
name[The Vaults], eatType[pub], food[French], priceRange[less than £20], area[riverside], familyFriendly[no], near[Raja Indian Cuisine]	The Vaults, which serves French cuisine, is a cheap pub. It is located in the riverside area and can be found near Raja Indian Cuisine. It does not welcome children.
name[The Vaults], eatType[pub], food[French], priceRange[less than £20], area[riverside], familyFriendly[yes], near[Raja Indian Cuisine]	The Vaults, which offers French food, is a low-priced pub. It is in riverside near Raja Indian Cuisine. It is child-friendly.
name[The Vaults], eatType[pub], food[French], priceRange[moderate], area[city centre], familyFriendly[no], near[Raja Indian Cuisine]	The Vaults, which offers French cuisine, is a mid-priced pub. It is in the city centre area by Raja Indian Cuisine. It does not welcome kids.
name[The Vaults], eatType[pub], food[French], priceRange[moderate], area[city centre], familyFriendly[yes], near[Raja Indian Cuisine]	The Vaults, which serves French food, is an average-priced pub. Kid-friendly The Vaults is located in the city centre near Raja Indian Cuisine.
name[The Vaults], eatType[pub], food[French], priceRange[moderate], area[riverside], familyFriendly[no], near[Raja Indian Cuisine]	The Vaults, which serves French cuisine, is a pub. It is moderately priced. It is located in the riverside area and can be found near Raja Indian Cuisine. It is not family-friendly.
name[The Vaults], eatType[pub], food[French], priceRange[moderate], area[riverside], familyFriendly[yes], near[Raja Indian Cuisine]	The Vaults, which offers French food, is a mid-priced pub. It is in riverside near Raja Indian Cuisine. It welcomes children.
name[The Vaults], eatType[pub], food[French], priceRange[more than £30], area[city centre], familyFriendly[no], near[Raja Indian Cuisine]	The Vaults, which offers French cuisine, is an expensive pub. It is in the city centre area by Raja Indian Cuisine. It is not child-friendly.
name[The Vaults], eatType[pub], food[French], priceRange[more than £30], area[city centre], familyFriendly[yes], near[Raja Indian Cuisine]	The Vaults, which serves French food, is a high-priced pub. The Vaults, which welcomes kids, is located in the city centre near Raja Indian Cuisine.
name[The Vaults], eatType[pub], food[French], priceRange[more than £30], area[riverside], familyFriendly[no], near[Raja Indian Cuisine]	The Vaults, which serves French cuisine, is an expensive pub. It is located in the riverside area and can be found near Raja Indian Cuisine. It is not kid-friendly.
name[The Vaults], eatType[pub], food[French], priceRange[more than £30], area[riverside], familyFriendly[yes], near[Raja Indian Cuisine]	The Vaults, which offers French food, is a high-priced pub. It is in riverside near Raja Indian Cuisine. It welcomes families.
name[The Vaults], eatType[pub], food[Indian], priceRange[£20-25], area[riverside], familyFriendly[yes], near[Raja Indian Cuisine]	The Vaults, which offers Indian cuisine, is an average-priced pub. It is in the riverside area by Raja Indian Cuisine. It is family-friendly.
name[The Vaults], eatType[pub], food[Indian], priceRange[cheap], area[riverside], familyFriendly[yes], near[Raja Indian Cuisine]	The Vaults, which serves Indian food, is a cheap pub. Child-friendly The Vaults is located in the riverside near Raja Indian Cuisine.
name[The Vaults], eatType[pub], food[Indian], priceRange[high], area[city centre], familyFriendly[no], near[Raja Indian Cuisine]	The Vaults, which serves Indian cuisine, is an expensive pub. It is located in the city centre area and can be found near Raja Indian Cuisine. It does not welcome children.
name[The Vaults], eatType[pub], food[Indian], priceRange[high], area[city centre], familyFriendly[yes], near[Raja Indian Cuisine]	The Vaults, which offers Indian food, is a high-priced pub. It is in city centre near Raja Indian Cuisine. It is kid-friendly.
name[The Vaults], eatType[pub], food[Italian], priceRange[high], customer rating[average], area[city centre], familyFriendly[no], near[Rainbow Vegetarian Café]	The Vaults, which offers Italian cuisine, is an expensive pub. It has an average customer rating. It is in the city centre area by Rainbow Vegetarian Café. It does not welcome kids.
name[The Vaults], eatType[pub], food[Italian], priceRange[high], customer rating[average], area[city centre], familyFriendly[yes], near[Rainbow Vegetarian Café]	The Vaults, which serves Italian food, is a high-priced pub. It has an average customer rating. The Vaults, which welcomes children, is located in the city centre near Rainbow Vegetarian Café.
name[The Vaults], eatType[pub], food[Italian], priceRange[high], customer rating[average], area[riverside], familyFriendly[no], near[Rainbow Vegetarian Café]	The Vaults, which serves Italian cuisine, is an expensive pub. It has an average customer rating. It is located in the riverside area and can be found near Rainbow Vegetarian Café. It is not family-friendly.
name[The Vaults], eatType[pub], food[Italian], priceRange[high], customer rating[average], area[riverside], familyFriendly[yes], near[Rainbow Vegetarian Café]	The Vaults, which offers Italian food, is a high-priced pub. It has an average customer rating. It is in riverside near Rainbow Vegetarian Café. It welcomes kids.
name[The Vaults], eatType[pub], food[Italian], priceRange[less than £20], customer rating[low], area[city centre], familyFriendly[no], near[Rainbow Vegetarian Café]	The Vaults, which offers Italian cuisine, is a low-priced pub. It has a low customer rating. It is in the city centre area by Rainbow Vegetarian Café. It is not child-friendly.
name[The Vaults], eatType[pub], food[Italian], priceRange[less than £20], customer rating[low], area[city centre], familyFriendly[yes], near[Rainbow Vegetarian Café]	The Vaults, which serves Italian food, is a cheap pub. It has a low customer rating. The Vaults, which welcomes families, is located in the city centre near Rainbow Vegetarian Café.
name[The Vaults], eatType[pub], food[Italian], priceRange[less than £20], customer rating[low], area[riverside], familyFriendly[no], near[Rainbow Vegetarian Café]	The Vaults, which serves Italian cuisine, is a low-priced pub. It has a low customer rating. It is located in the riverside area and can be found near Rainbow Vegetarian Café. It is not kid-friendly.
name[The Vaults], eatType[pub], food[Italian], priceRange[less than £20], customer rating[low], area[riverside], familyFriendly[yes], near[Rainbow Vegetarian Café]	The Vaults, which offers Italian food, is a cheap pub. It has a low customer rating. It is in riverside near Rainbow Vegetarian Café. It is family-friendly.
name[The Vaults], eatType[pub], food[Italian], priceRange[moderate], customer rating[1 out of 5], area[city centre], familyFriendly[no], near[Rainbow Vegetarian Café]	The Vaults, which offers Italian cuisine, is a pub. It is moderately priced. It has a customer rating of 1 out of 5. It is in the, city centre, area by Rainbow Vegetarian Café. It does not welcome children.
name[The Vaults], eatType[pub], food[Italian], priceRange[moderate], customer rating[1 out of 5], area[city centre], familyFriendly[yes], near[Rainbow Vegetarian Café]	The Vaults, which serves Italian food, is a mid-priced pub. Customer rate The Vaults, which is located in the city centre near Rainbow Vegetarian Café, 1 out of 5. It is child-friendly.
name[The Vaults], eatType[pub], food[Italian], priceRange[moderate], customer rating[1 out of 5], area[riverside], familyFriendly[no], near[Rainbow Vegetarian Café]	The Vaults, which serves Italian cuisine, is an average-priced pub. It has a customer rating of 1 out of 5. It is located in the riverside area and can be found near Rainbow Vegetarian Café. It does not welcome kids.
name[The Vaults], eatType[pub], food[Italian], priceRange[moderate], customer rating[1 out of 5], area[riverside], familyFriendly[yes], near[Rainbow Vegetarian Café]	The Vaults, which offers Italian food, is a pub. It is moderately priced. Customer rate The Vaults, which is in riverside near Rainbow Vegetarian Café, 1 out of 5. It is kid-friendly.
name[The Vaults], eatType[pub], food[Italian], priceRange[moderate], customer rating[3 out of 5], area[city centre], familyFriendly[no], near[Rainbow Vegetarian Café]	The Vaults, which offers Italian cuisine, is a mid-priced pub. It has a customer rating of 3 out of 5. It is in the city centre area by Rainbow Vegetarian Café. It is not family-friendly.
name[The Vaults], eatType[pub], food[Italian], priceRange[moderate], customer rating[3 out of 5], area[city centre], familyFriendly[yes], near[Rainbow Vegetarian Café]	The Vaults, which serves Italian food, is an average-priced pub. Customer rate The Vaults, which is located in the city centre near Rainbow Vegetarian Café, 3 out of 5. It welcomes children.
name[The Vaults], eatType[pub], food[Italian], priceRange[moderate], customer rating[3 out of 5], area[riverside], familyFriendly[no], near[Rainbow Vegetarian Café]	The Vaults, which serves Italian cuisine, is a pub. It is moderately priced. It has a customer rating of 3 out of 5. It is located in the, riverside, area and can be found near Rainbow Vegetarian Café. It is not child-friendly.
name[The Vaults], eatType[pub], food[Italian], priceRange[moderate], customer rating[3 out of 5], area[riverside], familyFriendly[yes], near[Rainbow Vegetarian Café]	The Vaults, which offers Italian food, is a mid-priced pub. Customer rate The Vaults, which is in riverside near Rainbow Vegetarian Café, 3 out of 5. It welcomes kids.
name[The Vaults], eatType[pub], food[Italian], priceRange[more than £30], customer rating[high], area[city centre], familyFriendly[no], near[Rainbow Vegetarian Café]	The Vaults, which offers Italian cuisine, is an expensive pub. It has a high customer rating. It is in the city centre area by Rainbow Vegetarian Café. It is not kid-friendly.
name[The Vaults], eatType[pub], food[Italian], priceRange[more than £30], customer rating[high], area[city centre], familyFriendly[yes], near[Rainbow Vegetarian Café]	The Vaults, which serves Italian food, is a high-priced pub. It has a high customer rating. The Vaults, which welcomes families, is located in the city centre near Rainbow Vegetarian Café.
name[The Vaults], eatType[pub], food[Italian], priceRange[more than £30], customer rating[high], area[riverside], familyFriendly[no], near[Rainbow Vegetarian Café]	The Vaults, which serves Italian cuisine, is an expensive pub. It has a high customer rating. It is located in the riverside area and can be found near Rainbow Vegetarian Café. It does not welcome children.
name[The Vaults], eatType[pub], food[Italian], priceRange[more than £30], customer rating[high], area[riverside], familyFriendly[yes], near[Rainbow Vegetarian Café]	The Vaults, which offers Italian food, is a high-priced pub. It has a high customer rating. It is in riverside near Rainbow Vegetarian Café. It is family-friendly.
name[The Vaults], eatType[pub], food[Japanese], priceRange[£20-25], customer rating[3 out of 5], area[city centre], familyFriendly[no], near[Rainbow Vegetarian Café]	The Vaults, which offers Japanese cuisine, is an average-priced pub. It has a customer rating of 3 out of 5. It is in the city centre area by Rainbow Vegetarian Café. It does not welcome kids.
name[The Vaults], eatType[pub], food[Japanese], priceRange[£20-25], customer rating[3 out of 5], area[city centre], familyFriendly[yes], near[Rainbow Vegetarian Café]	The Vaults, which serves Japanese food, is a pub. It is moderately priced. Customer rate The Vaults, which is located in the city centre near Rainbow Vegetarian Café, 3 out of 5. It is child-friendly.
name[The Vaults], eatType[pub], food[Japanese], priceRange[£20-25], customer rating[3 out of 5], area[riverside], familyFriendly[no], near[Rainbow Vegetarian Café]	The Vaults, which serves Japanese cuisine, is a mid-priced pub. It has a customer rating of 3 out of 5. It is located in the riverside area and can be found near Rainbow Vegetarian Café. It is not family-friendly.
name[The Vaults], eatType[pub], food[Japanese], priceRange[£20-25], customer rating[3 out of 5], area[riverside], familyFriendly[yes], near[Rainbow Vegetarian Café]	The Vaults, which offers Japanese food, is an average-priced pub. Customer rate The Vaults, which is in riverside near Rainbow Vegetarian Café, 3 out of 5. It is kid-friendly.
name[The Vaults], eatType[pub], food[Japanese], priceRange[£20-25], customer rating[high], area[city centre], familyFriendly[no], near[Rainbow Vegetarian Café]	The Vaults, which offers Japanese cuisine, is a pub. It is moderately priced. It has a high customer rating. It is in the city centre area by Rainbow Vegetarian Café. It is not child-friendly.
name[The Vaults], eatType[pub], food[Japanese], priceRange[£20-25], customer rating[high], area[city centre], familyFriendly[yes], near[Rainbow Vegetarian Café]	The Vaults, which serves Japanese food, is a mid-priced pub. It has a high customer rating. The Vaults, which welcomes children, is located in the city centre near Rainbow Vegetarian Café.
name[The Vaults], eatType[pub], food[Japanese], priceRange[£20-25], customer rating[high], area[riverside], familyFriendly[no], near[Rainbow Vegetarian Café]	The Vaults, which serves Japanese cuisine, is an average-priced pub. It has a high customer rating. It is located in the riverside area and can be found near Rainbow Vegetarian Café. It is not kid-friendly.
name[The Vaults], eatType[pub], food[Japanese], priceRange[£20-25], customer rating[high], area[riverside], familyFriendly[no], near[Raja Indian Cuisine]	The Vaults, which offers Japanese food, is a pub. It is moderately priced. It has a high customer rating. It is in riverside near Raja Indian Cuisine. It does not welcome children.
name[The Vaults], eatType[pub], food[Japanese], priceRange[£20-25], customer rating[high], area[riverside], familyFriendly[yes], near[Raja Indian Cuisine]	The Vaults, which offers Japanese cuisine, is a mid-priced pub. It has a high customer rating. It is in the riverside area by Raja Indian Cuisine. It welcomes kids.
name[The Vaults], eatType[pub], food[Japanese], priceRange[cheap], customer rating[5 out of 5], area[city centre], familyFriendly[no], near[Raja Indian Cuisine]	The Vaults, which serves Japanese food, is a low-priced pub. It has a customer rating of 5 out of 5. The Vaults, which does not welcome kids, is located in the city centre near Raja Indian Cuisine.
name[The Vaults], eatType[pub], food[Japanese], priceRange[cheap], customer rating[5 out of 5], area[city centre], familyFriendly[yes], near[Raja Indian Cuisine]	The Vaults, which serves Japanese cuisine, is a cheap pub. Customer rate The Vaults, which welcomes families, 5 out of 5. It is located in the city centre area and can be found near Raja Indian Cuisine.
name[The Vaults], eatType[pub], food[Japanese], priceRange[cheap], customer rating[5 out of 5], area[riverside], familyFriendly[no], near[Raja Indian Cuisine]	The Vaults, which offers Japanese food, is a low-priced pub. It has a customer rating of 5 out of 5. It is in riverside near Raja Indian Cuisine. It is not family-friendly.
name[The Vaults], eatType[pub], food[Japanese], priceRange[cheap], customer rating[5 out of 5], area[riverside], familyFriendly[yes], near[Raja Indian Cuisine]	The Vaults, which offers Japanese cuisine, is a cheap pub. Customer rate The Vaults, which is in the riverside area by Raja Indian Cuisine, 5 out of 5. It is family-friendly.
name[The Vaults], eatType[pub], food[Japanese], priceRange[high], customer rating[3 out of 5], area[city centre], familyFriendly[no], near[Raja Indian Cuisine]	The Vaults, which serves Japanese food, is an expensive pub. It has a customer rating of 3 out of 5. Non-child-friendly The Vaults is located in the city centre near Raja Indian Cuisine.
name[The Vaults], eatType[pub], food[Japanese], priceRange[high], customer rating[3 out of 5], area[city centre], familyFriendly[yes], near[Raja Indian Cuisine]	The Vaults, which serves Japanese cuisine, is a high-priced pub. Customer rate child-friendly The Vaults 3 out of 5. It is located in the city centre area and can be found near Raja Indian Cuisine.
name[The Vaults], eatType[pub], food[Japanese], priceRange[high], customer rating[3 out of 5], area[riverside], familyFriendly[no], near[Raja Indian Cuisine]	The Vaults, which offers Japanese food, is an expensive pub. It has a customer rating of 3 out of 5. It is in riverside near Raja Indian Cuisine. It is not kid-friendly.
name[The Vaults], eatType[pub], food[Japanese], priceRange[high], customer rating[3 out of 5], area[riverside], familyFriendly[yes], near[Raja Indian Cuisine]	The Vaults, which offers Japanese cuisine, is a high-priced pub. Customer rate The Vaults, which is in the riverside area by Raja Indian Cuisine, 3 out of 5. It is kid-friendly.
name[The Vaults], eatType[pub], food[Japanese], priceRange[less than £20], customer rating[average], area[city centre], familyFriendly[no], near[Raja Indian Cuisine]	The Vaults, which serves Japanese food, is a low-priced pub. It has an average customer rating. The Vaults, which does not welcome children, is located in the city centre near Raja Indian Cuisine.
name[The Vaults], eatType[pub], food[Japanese], priceRange[less than £20], customer rating[average], area[city centre], familyFriendly[yes], near[Raja Indian Cuisine]	The Vaults, which serves Japanese cuisine, is a cheap pub. It has an average customer rating. It is located in the city centre area and can be found near Raja Indian Cuisine. It welcomes children.
name[The Vaults], eatType[pub], food[Japanese], priceRange[less than £20], customer rating[average], area[riverside], familyFriendly[no], near[Raja Indian Cuisine]	The Vaults, which offers Japanese food, is a low-priced pub. It has an average customer rating. It is in riverside near Raja Indian Cuisine. It does not welcome kids.
name[The Vaults], eatType[pub], food[Japanese], priceRange[less than £20], customer rating[average], area[riverside], familyFriendly[yes], near[Raja Indian Cuisine]	The Vaults, which offers Japanese cuisine, is a cheap pub. It has an average customer rating. It is in the riverside area by Raja Indian Cuisine. It welcomes kids.
name[The Vaults], eatType[pub], food[Japanese], priceRange[less than £20], customer rating[low], area[city centre], familyFriendly[no], near[Raja Indian Cuisine]	The Vaults, which serves Japanese food, is a low-priced pub. It has a low customer rating. Non-family-friendly The Vaults is located in the city centre near Raja Indian Cuisine.
name[The Vaults], eatType[pub], food[Japanese], priceRange[less than £20], customer rating[low], area[city centre], familyFriendly[yes], near[Raja Indian Cuisine]	The Vaults, which serves Japanese cuisine, is a cheap pub. It has a low customer rating. It is located in the city centre area and can be found near Raja Indian Cuisine. It welcomes families.
name[The Vaults], eatType[pub], food[Japanese], priceRange[less than £20], customer rating[low], area[riverside], familyFriendly[no], near[Raja Indian Cuisine]	The Vaults, which offers Japanese food, is a low-priced pub. It has a low customer rating. It is in riverside near Raja Indian Cuisine. It is not child-friendly.
name[The Vaults], eatType[pub], food[Japanese], priceRange[less than £20], customer rating[low], area[riverside], familyFriendly[yes], near[Raja Indian Cuisine]	The Vaults, which offers Japanese cuisine, is a cheap pub. It has a low customer rating. It is in the riverside area by Raja Indian Cuisine. It is family-friendly.
name[The Vaults], eatType[pub], food[Japanese], priceRange[moderate], customer rating[1 out of 5], area[city centre], familyFriendly[no], near[Raja Indian Cuisine]	The Vaults, which serves Japanese food, is an average-priced pub. It has a customer rating of 1 out of 5. Non-kid-friendly The Vaults is located in the city centre near Raja Indian Cuisine.
name[The Vaults], eatType[pub], food[Japanese], priceRange[moderate], customer rating[1 out of 5], area[city centre], familyFriendly[yes], near[Raja Indian Cuisine]	The Vaults, which serves Japanese cuisine, is a pub. It is moderately priced. Customer rate child-friendly The Vaults 1 out of 5. It is located in the city centre area and can be found near Raja Indian Cuisine.
name[The Vaults], eatType[restaurant], food[French], priceRange[high], area[riverside], familyFriendly[yes], near[Raja Indian Cuisine]	The Vaults, which offers French food, is an expensive restaurant. It is in riverside near Raja Indian Cuisine. It is kid-friendly.
name[The Vaults], eatType[restaurant], food[French], priceRange[less than £20], area[city centre], familyFriendly[no], near[Raja Indian Cuisine]	The Vaults, which offers French cuisine, is a low-priced restaurant. It is in the city centre area by Raja Indian Cuisine. It does not welcome children.
name[The Vaults], eatType[restaurant], food[French], priceRange[less than £20], area[city centre], familyFriendly[yes], near[Raja Indian Cuisine]	The Vaults, which serves French food, is a cheap restaurant. The Vaults, which welcomes children, is located in the city centre near Raja Indian Cuisine.
name[The Vaults], eatType[restaurant], food[French], priceRange[less than £20], area[riverside], familyFriendly[no], near[Raja Indian Cuisine]	The Vaults, which serves French cuisine, is a low-priced restaurant. It is located in the riverside area and can be found near Raja Indian Cuisine. It does not welcome kids.
name[The Vaults], eatType[restaurant], food[French], priceRange[less than £20], area[riverside], familyFriendly[yes], near[Raja Indian Cuisine]	The Vaults, which offers French food, is a cheap restaurant. It is in riverside near Raja Indian Cuisine. It welcomes kids.
name[The Vaults], eatType[restaurant], food[French], priceRange[moderate], area[city centre], familyFriendly[no], near[Raja Indian Cuisine]	The Vaults, which offers French cuisine, is a mid-priced restaurant. It is in the city centre area by Raja Indian Cuisine. It is not family-friendly.
name[The Vaults], eatType[restaurant], food[French], priceRange[moderate], area[city centre], familyFriendly[yes], near[Raja Indian Cuisine]	The Vaults, which serves French food, is an average-priced restaurant. The Vaults, which welcomes families, is located in the city centre near Raja Indian Cuisine.
name[The Vaults], eatType[restaurant], food[French], priceRange[moderate], area[riverside], familyFriendly[no], near[Raja Indian Cuisine]	The Vaults, which serves French cuisine, is a restaurant. It is moderately priced. It is located in the riverside area and can be found near Raja Indian Cuisine. It is not child-friendly.
name[The Vaults], eatType[restaurant], food[French], priceRange[moderate], area[riverside], familyFriendly[yes], near[Raja Indian Cuisine]	The Vaults, which offers French food, is a mid-priced restaurant. It is in riverside near Raja Indian Cuisine. It is family-friendly.
name[The Vaults], eatType[restaurant], food[French], priceRange[more than £30], area[city centre], familyFriendly[no], near[Raja Indian Cuisine]	The Vaults, which offers French cuisine, is a high-priced restaurant. It is in the city centre area by Raja Indian Cuisine. It is not kid-friendly.
name[The Vaults], eatType[restaurant], food[French], priceRange[more than £30], area[city centre], familyFriendly[yes], near[Raja Indian Cuisine]	The Vaults, which serves French food, is an expensive restaurant. Child-friendly The Vaults is located in the city centre near Raja Indian Cuisine.
name[The Vaults], eatType[restaurant], food[French], priceRange[more than £30], area[riverside], familyFriendly[no], near[Raja Indian Cuisine]	The Vaults, which serves French cuisine, is a high-priced restaurant. It is located in the riverside area and can be found near Raja Indian Cuisine. It does not welcome children.
name[The Vaults], eatType[restaurant], food[French], priceRange[more than £30], area[riverside], familyFriendly[yes], near[Raja Indian Cuisine]	The Vaults, which offers French food, is an expensive restaurant. It is in riverside near Raja Indian Cuisine. It is kid-friendly.
name[The Vaults], eatType[restaurant], food[Indian], priceRange[£20-25], area[riverside], familyFriendly[yes], near[Raja Indian Cuisine]	The Vaults, which offers Indian cuisine, is an average-priced restaurant. It is in the riverside area by Raja Indian Cuisine. It welcomes children.
name[The Vaults], eatType[restaurant], food[Indian], priceRange[cheap], area[riverside], familyFriendly[yes], near[Raja Indian Cuisine]	The Vaults, which serves Indian food, is a low-priced restaurant. The Vaults, which welcomes kids, is located in the riverside near Raja Indian Cuisine.
name[The Vaults], eatType[restaurant], food[Indian], priceRange[high], area[city centre], familyFriendly[no], near[Raja Indian Cuisine]	The Vaults, which serves Indian cuisine, is a high-priced restaurant. It is located in the city centre area and can be found near Raja Indian Cuisine. It does not welcome kids.
name[The Vaults], eatType[restaurant], food[Indian], priceRange[high], area[city centre], familyFriendly[yes], near[Raja Indian Cuisine]	The Vaults, which offers Indian food, is an expensive restaurant. It is in city centre near Raja Indian Cuisine. It welcomes families.
name[The Waterman], eatType[pub], food[Indian], priceRange[high], area[city centre], familyFriendly[yes], near[Raja Indian Cuisine]	The Waterman, which offers Indian cuisine, is a high-priced pub. It is in the city centre area by Raja Indian Cuisine. It is family-friendly.
name[The Waterman], eatType[pub], food[Indian], priceRange[high], area[riverside], familyFriendly[no], near[Raja Indian Cuisine]	The Waterman, which serves Indian food, is an expensive pub. Non-family-friendly The Waterman is located in the riverside near Raja Indian Cuisine.
name[The Waterman], eatType[pub], food[Indian], priceRange[high], area[riverside], familyFriendly[yes], near[Raja Indian Cuisine]	The Waterman, which serves Indian cuisine, is a high-priced pub. It is located in the riverside area and can be found near Raja Indian Cuisine. It is child-friendly.
name[The Waterman], eatType[pub], food[Indian], priceRange[less than £20], area[city centre], familyFriendly[no], near[Raja Indian Cuisine]	The Waterman, which offers Indian food, is a cheap pub. It is in city centre near Raja Indian Cuisine. It is not child-friendly.
name[The Waterman], eatType[pub], food[Indian], priceRange[less than £20], area[city centre], familyFriendly[yes], near[Raja Indian Cuisine]	The Waterman, which offers Indian cuisine, is a low-priced pub. It is in the city centre area by Raja Indian Cuisine. It is kid-friendly.
name[The Waterman], eatType[pub], food[Indian], priceRange[less than £20], area[riverside], familyFriendly[no], near[Raja Indian Cuisine]	The Waterman, which serves Indian food, is a cheap pub. Non-kid-friendly The Waterman is located in the riverside near Raja Indian Cuisine.
name[The Waterman], eatType[pub], food[Indian], priceRange[less than £20], area[riverside], familyFriendly[yes], near[Raja Indian Cuisine]	The Waterman, which serves Indian cuisine, is a low-priced pub. It is located in the riverside area and can be found near Raja Indian Cuisine. It welcomes children.
name[The Waterman], eatType[pub], food[Indian], priceRange[moderate], area[city centre], familyFriendly[no], near[Raja Indian Cuisine]	The Waterman, which offers Indian food, is a pub. It is moderately priced. It is in city centre near Raja Indian Cuisine. It does not welcome children.
name[The Waterman], eatType[pub], food[Indian], priceRange[moderate], area[city centre], familyFriendly[yes], near[Raja Indian Cuisine]	The Waterman, which offers Indian cuisine, is a mid-priced pub. It is in the city centre area by Raja Indian Cuisine. It welcomes kids.
name[The Waterman], eatType[pub], food[Indian], priceRange[moderate], area[riverside], familyFriendly[no], near[Raja Indian Cuisine]	The Waterman, which serves Indian food, is an average-priced pub. The Waterman, which does not welcome kids, is located in the riverside near Raja Indian Cuisine.
name[The Waterman], eatType[pub], food[Indian], priceRange[moderate], area[riverside], familyFriendly[yes], near[Raja Indian Cuisine]	The Waterman, which serves Indian cuisine, is a pub. It is moderately priced. It is located in the riverside area and can be found near Raja Indian Cuisine. It welcomes families.
name[The Waterman], eatType[pub], food[Indian], priceRange[more than £30], area[riverside], familyFriendly[yes], near[Raja Indian Cuisine]	The Waterman, which offers Indian food, is an expensive pub. It is in riverside near Raja Indian Cuisine. It is family-friendly.
name[The Waterman], eatType[pub], food[Italian], priceRange[£20-25], area[riverside], familyFriendly[yes], near[Raja Indian Cuisine]	The Waterman, which offers Italian cuisine, is a mid-priced pub. It is in the riverside area by Raja Indian Cuisine. It is child-friendly.
name[The Waterman], eatType[pub], food[Italian], priceRange[cheap], area[riverside], familyFriendly[yes], near[Raja Indian Cuisine]	The Waterman, which serves Italian food, is a cheap pub. Kid-friendly The Waterman is located in the riverside near Raja Indian Cuisine.
name[The Waterman], eatType[pub], food[Italian], priceRange[high], area[city centre], familyFriendly[no], near[Raja Indian Cuisine]	The Waterman, which serves Italian cuisine, is a high-priced pub. It is located in the city centre area and can be found near Raja Indian Cuisine. It is not family-friendly.
name[The Waterman], eatType[pub], food[Italian], priceRange[high], area[city centre], familyFriendly[yes], near[Raja Indian Cuisine]	The Waterman, which offers Italian food, is an expensive pub. It is in city centre near Raja Indian Cuisine. It welcomes children.
name[The Waterman], eatType[pub], food[Italian], priceRange[high], area[riverside], familyFriendly[no], near[Raja Indian Cuisine]	The Waterman, which offers Italian cuisine, is a high-priced pub. It is in the riverside area by Raja Indian Cuisine. It is not child-friendly.
name[The Waterman], eatType[pub], food[Italian], priceRange[high], area[riverside], familyFriendly[yes], near[Raja Indian Cuisine]	The Waterman, which serves Italian food, is an expensive pub. The Waterman, which welcomes kids, is located in the riverside near Raja Indian Cuisine.
name[The Waterman], eatType[pub], food[Italian], priceRange[less than £20], area[city centre], familyFriendly[no], near[Raja Indian Cuisine]	The Waterman, which serves Italian cuisine, is a low-priced pub. It is located in the city centre area and can be found near Raja Indian Cuisine. It is not kid-friendly.
name[The Waterman], eatType[pub], food[Italian], priceRange[less than £20], area[city centre], familyFriendly[yes], near[Raja Indian Cuisine]	The Waterman, which offers Italian food, is a cheap pub. It is in city centre near Raja Indian Cuisine. It welcomes families.
name[The Waterman], eatType[pub], food[Italian], priceRange[less than £20], area[riverside], familyFriendly[no], near[Raja Indian Cuisine]	The Waterman, which offers Italian cuisine, is a low-priced pub. It is in the riverside area by Raja Indian Cuisine. It does not welcome children.
name[The Waterman], eatType[restaurant], food[Indian], priceRange[high], area[city centre], familyFriendly[yes], near[Raja Indian Cuisine]	The Waterman, which serves Indian food, is a high-priced restaurant. Family-friendly The Waterman is located in the city centre near Raja Indian Cuisine.
name[The Waterman], eatType[restaurant], food[Indian], priceRange[high], area[riverside], familyFriendly[no], near[Raja Indian Cuisine]	The Waterman, which serves Indian cuisine, is an expensive restaurant. It is located in the riverside area and can be found near Raja Indian Cuisine. It does not welcome kids.
name[The Waterman], eatType[restaurant], food[Indian], priceRange[high], area[riverside], familyFriendly[yes], near[Raja Indian Cuisine]	The Waterman, which offers Indian food, is a high-priced restaurant. It is in riverside near Raja Indian Cuisine. It is child-friendly.
name[The Waterman], eatType[restaurant], food[Indian], priceRange[less than £20], area[city centre], familyFriendly[no], near[Raja Indian Cuisine]	The Waterman, which offers Indian cuisine, is a cheap restaurant. It is in the city centre area by Raja Indian Cuisine. It is not family-friendly.
name[The Waterman], eatType[restaurant], food[Indian], priceRange[less than £20], area[city centre], familyFriendly[yes], near[Raja Indian Cuisine]	The Waterman, which serves Indian food, is a low-priced restaurant. Kid-friendly The Waterman is located in the city centre near Raja Indian Cuisine.
name[The Waterman], eatType[restaurant], food[Indian], priceRange[less than £20], area[riverside], familyFriendly[no], near[Raja Indian Cuisine]	The Waterman, which serves Indian cuisine, is a cheap restaurant. It is located in the riverside area and can be found near Raja Indian Cuisine. It is not child-friendly.
name[The Waterman], eatType[restaurant], food[Indian], priceRange[less than £20], area[riverside], familyFriendly[yes], near[Raja Indian Cuisine]	The Waterman, which offers Indian food, is a low-priced restaurant. It is in riverside near Raja Indian Cuisine. It welcomes children.
name[The Waterman], eatType[restaurant], food[Indian], priceRange[moderate], area[city centre], familyFriendly[no], near[Raja Indian Cuisine]	The Waterman, which offers Indian cuisine, is an average-priced restaurant. It is in the city centre area by Raja Indian Cuisine. It is not kid-friendly.
name[The Waterman], eatType[restaurant], food[Indian], priceRange[moderate], area[city centre], familyFriendly[yes], near[Raja Indian Cuisine]	The Waterman, which serves Indian food, is a restaurant. It is moderately priced. The Waterman, which welcomes kids, is located in the city centre near Raja Indian Cuisine.
name[The Waterman], eatType[restaurant], food[Indian], priceRange[moderate], area[riverside], familyFriendly[no], near[Raja Indian Cuisine]	The Waterman, which serves Indian cuisine, is a mid-priced restaurant. It is located in the riverside area and can be found near Raja Indian Cuisine. It does not welcome children.
name[The Waterman], eatType[restaurant], food[Indian], priceRange[moderate], area[riverside], familyFriendly[yes], near[Raja Indian Cuisine]	The Waterman, which offers Indian food, is an average-priced restaurant. It is in riverside near Raja Indian Cuisine. It welcomes families.
name[The Waterman], eatType[restaurant], food[Indian], priceRange[more than £30], area[riverside], familyFriendly[yes], near[Raja Indian Cuisine]	The Waterman, which offers Indian cuisine, is an expensive restaurant. It is in the riverside area by Raja Indian Cuisine. It is family-friendly.
name[The Waterman], eatType[restaurant], food[Italian], priceRange[£20-25], area[riverside], familyFriendly[yes], near[Raja Indian Cuisine]	The Waterman, which serves Italian food, is a restaurant. It is moderately priced. Child-friendly The Waterman is located in the riverside near Raja Indian Cuisine.
name[The Waterman], eatType[restaurant], food[Italian], priceRange[cheap], area[riverside], familyFriendly[yes], near[Raja Indian Cuisine]	The Waterman, which serves Italian cuisine, is a cheap restaurant. It is located in the riverside area and can be found near Raja Indian Cuisine. It is kid-friendly.
name[The Waterman], eatType[restaurant], food[Italian], priceRange[high], area[city centre], familyFriendly[no], near[Raja Indian Cuisine]	The Waterman, which offers Italian food, is a high-priced restaurant. It is in city centre near Raja Indian Cuisine. It does not welcome kids.
name[The Waterman], eatType[restaurant], food[Italian], priceRange[high], area[city centre], familyFriendly[yes], near[Raja Indian Cuisine]	The Waterman, which offers Italian cuisine, is an expensive restaurant. It is in the city centre area by Raja Indian Cuisine. It welcomes children.
name[The Waterman], eatType[restaurant], food[Italian], priceRange[high], area[riverside], familyFriendly[no], near[Raja Indian Cuisine]	The Waterman, which serves Italian food, is a high-priced restaurant. Non-family-friendly The Waterman is located in the riverside near Raja Indian Cuisine.
name[The Waterman], eatType[restaurant], food[Italian], priceRange[high], area[riverside], familyFriendly[yes], near[Raja Indian Cuisine]	The Waterman, which serves Italian cuisine, is an expensive restaurant. It is located in the riverside area and can be found near Raja Indian Cuisine. It welcomes kids.
name[The Waterman], eatType[restaurant], food[Italian], priceRange[less than £20], area[city centre], familyFriendly[no], near[Raja Indian Cuisine]	The Waterman, which offers Italian food, is a low-priced restaurant. It is in city centre near Raja Indian Cuisine. It is not child-friendly.
name[The Waterman], eatType[restaurant], food[Italian], priceRange[less than £20], area[city centre], familyFriendly[yes], near[Raja Indian Cuisine]	The Waterman, which offers Italian cuisine, is a cheap restaurant. It is in the city centre area by Raja Indian Cuisine. It welcomes families.
name[The Waterman], eatType[restaurant], food[Italian], priceRange[less than £20], area[riverside], familyFriendly[no], near[Raja Indian Cuisine]	The Waterman, which serves Italian food, is a low-priced restaurant. Non-kid-friendly The Waterman is located in the riverside near Raja Indian Cuisine.
name[The Wrestlers], eatType[pub], food[Italian], priceRange[less than £20], area[riverside], familyFriendly[no], near[Raja Indian Cuisine]	The Wrestlers, which serves Italian cuisine, is a cheap pub. It is located in the riverside area and can be found near Raja Indian Cuisine. It does not welcome children.
name[The Wrestlers], eatType[pub], food[Italian], priceRange[less than £20], area[riverside], familyFriendly[yes], near[Raja Indian Cuisine]	The Wrestlers, which offers Italian food, is a low-priced pub. It is in riverside near Raja Indian Cuisine. It is family-friendly.
name[The Wrestlers], eatType[pub], food[Italian], priceRange[moderate], area[city centre], familyFriendly[no], near[Raja Indian Cuisine]	The Wrestlers, which offers Italian cuisine, is a mid-priced pub. It is in the city centre area by Raja Indian Cuisine. It does not welcome kids.
name[The Wrestlers], eatType[pub], food[Italian], priceRange[moderate], area[city centre], familyFriendly[yes], near[Raja Indian Cuisine]	The Wrestlers, which serves Italian food, is an average-priced pub. Child-friendly The Wrestlers is located in the city centre near Raja Indian Cuisine.
name[The Wrestlers], eatType[pub], food[Italian], priceRange[moderate], area[riverside], familyFriendly[no], near[Raja Indian Cuisine]	The Wrestlers, which serves Italian cuisine, is a pub. It is moderately priced. It is located in the riverside area and can be found near Raja Indian Cuisine. It is not family-friendly.
name[The Wrestlers], eatType[pub], food[Italian], priceRange[moderate], area[riverside], familyFriendly[yes], near[Raja Indian Cuisine]	The Wrestlers, which offers Italian food, is a mid-priced pub. It is in riverside near Raja Indian Cuisine. It is kid-friendly.
name[The Wrestlers], eatType[pub], food[Italian], priceRange[more than £30], area[riverside], familyFriendly[yes], near[Raja Indian Cuisine]	The Wrestlers, which offers Italian cuisine, is a high-priced pub. It is in the riverside area by Raja Indian Cuisine. It welcomes children.
name[The Wrestlers], eatType[pub], food[Japanese], priceRange[£20-25], area[riverside], familyFriendly[yes], near[Raja Indian Cuisine]	The Wrestlers, which serves Japanese food, is an average-priced pub. The Wrestlers, which welcomes kids, is located in the riverside near Raja Indian Cuisine.
name[The Wrestlers], eatType[pub], food[Japanese], priceRange[cheap], area[riverside], familyFriendly[yes], near[Raja Indian Cuisine]	The Wrestlers, which serves Japanese cuisine, is a cheap pub. It is located in the riverside area and can be found near Raja Indian Cuisine. It welcomes families.
name[The Wrestlers], eatType[pub], food[Japanese], priceRange[high], area[riverside], familyFriendly[yes], near[Raja Indian Cuisine]	The Wrestlers, which offers Japanese food, is an expensive pub. It is in riverside near Raja Indian Cuisine. It is family-friendly.
name[The Wrestlers], eatType[pub], food[Japanese], priceRange[less than £20], area[city centre], familyFriendly[no], near[Raja Indian Cuisine]	The Wrestlers, which offers Japanese cuisine, is a low-priced pub. It is in the city centre area by Raja Indian Cuisine. It is not child-friendly.
name[The Wrestlers], eatType[pub], food[Japanese], priceRange[less than £20], area[city centre], familyFriendly[yes], near[Raja Indian Cuisine]	The Wrestlers, which serves Japanese food, is a cheap pub. Child-friendly The Wrestlers is located in the city centre near Raja Indian Cuisine.
name[The Wrestlers], eatType[pub], food[Japanese], priceRange[less than £20], area[riverside], familyFriendly[no], near[Raja Indian Cuisine]	The Wrestlers, which serves Japanese cuisine, is a low-priced pub. It is located in the riverside area and can be found near Raja Indian Cuisine. It is not kid-friendly.
name[The Wrestlers], eatType[pub], food[Japanese], priceRange[less than £20], area[riverside], familyFriendly[yes], near[Raja Indian Cuisine]	The Wrestlers, which offers Japanese food, is a cheap pub. It is in riverside near Raja Indian Cuisine. It is kid-friendly.
name[The Wrestlers], eatType[pub], food[Japanese], priceRange[moderate], area[city centre], familyFriendly[no], near[Raja Indian Cuisine]	The Wrestlers, which offers Japanese cuisine, is a pub. It is moderately priced. It is in the city centre area by Raja Indian Cuisine. It does not welcome children.
name[The Wrestlers], eatType[pub], food[Japanese], priceRange[moderate], area[city centre], familyFriendly[yes], near[Raja Indian Cuisine]	The Wrestlers, which serves Japanese food, is a mid-priced pub. The Wrestlers, which welcomes children, is located in the city centre near Raja Indian Cuisine.
name[The Wrestlers], eatType[pub], food[Japanese], priceRange[moderate], area[riverside], familyFriendly[no], near[Raja Indian Cuisine]	The Wrestlers, which serves Japanese cuisine, is an average-priced pub. It is located in the riverside area and can be found near Raja Indian Cuisine. It does not welcome kids.
name[The Wrestlers], eatType[pub], food[Japanese], priceRange[moderate], area[riverside], familyFriendly[yes], near[Raja Indian Cuisine]	The Wrestlers, which offers Japanese food, is a pub. It is moderately priced. It is in riverside near Raja Indian Cuisine. It welcomes kids.
name[The Wrestlers], eatType[pub], food[Japanese], priceRange[moderate], customer rating[1 out of 5], area[city centre], familyFriendly[yes], near[Raja Indian Cuisine]	The Wrestlers, which offers Japanese cuisine, is a mid-priced pub. It has a customer rating of 1 out of 5. It is in the city centre area by Raja Indian Cuisine. It welcomes families.
name[The Wrestlers], eatType[pub], food[Japanese], priceRange[moderate], customer rating[1 out of 5], area[riverside], familyFriendly[no], near[Raja Indian Cuisine]	The Wrestlers, which serves Japanese food, is an average-priced pub. Customer rate The Wrestlers, which is located in the riverside near Raja Indian Cuisine, 1 out of 5. It is not family-friendly.
name[The Wrestlers], eatType[pub], food[Japanese], priceRange[moderate], customer rating[1 out of 5], area[riverside], familyFriendly[yes], near[Raja Indian Cuisine]	The Wrestlers, which serves Japanese cuisine, is a pub. It is moderately priced. It has a customer rating of 1 out of 5. It is located in the riverside area and can be found near Raja Indian Cuisine. It is family-friendly.
name[The Wrestlers], eatType[pub], food[Japanese], priceRange[more than £30], area[city centre], familyFriendly[no], near[Raja Indian Cuisine]	The Wrestlers, which offers Japanese food, is a high-priced pub. It is in city centre near Raja Indian Cuisine. It is not child-friendly.
name[The Wrestlers], eatType[pub], food[Japanese], priceRange[more than £30], area[city centre], familyFriendly[yes], near[Raja Indian Cuisine]	The Wrestlers, which offers Japanese cuisine, is an expensive pub. It is in the city centre area by Raja Indian Cuisine. It is child-friendly.
name[The Wrestlers], eatType[pub], food[Japanese], priceRange[more than £30], area[riverside], familyFriendly[no], near[Raja Indian Cuisine]	The Wrestlers, which serves Japanese food, is a high-priced pub. Non-kid-friendly The Wrestlers is located in the riverside near Raja Indian Cuisine.
name[The Wrestlers], eatType[pub], food[Japanese], priceRange[more than £30], area[riverside], familyFriendly[yes], near[Raja Indian Cuisine]	The Wrestlers, which serves Japanese cuisine, is an expensive pub. It is located in the riverside area and can be found near Raja Indian Cuisine. It is kid-friendly.
name[The Wrestlers], eatType[pub], food[Japanese], priceRange[more than £30], customer rating[5 out of 5], area[city centre], familyFriendly[no], near[Raja Indian Cuisine]	The Wrestlers, which offers Japanese food, is a high-priced pub. Customer rate The Wrestlers, which is in city centre near Raja Indian Cuisine, 5 out of 5. It does not welcome children.
name[The Wrestlers], eatType[pub], food[Japanese], priceRange[more than £30], customer rating[5 out of 5], area[city centre], familyFriendly[yes], near[Raja Indian Cuisine]	The Wrestlers, which offers Japanese cuisine, is an expensive pub. It has a customer rating of 5 out of 5. It is in the city centre area by Raja Indian Cuisine. It welcomes children.
name[The Wrestlers], eatType[pub], food[Japanese], priceRange[more than £30], customer rating[5 out of 5], area[riverside], familyFriendly[no], near[Raja Indian Cuisine]	The Wrestlers, which serves Japanese food, is a high-priced pub. Customer rate The Wrestlers, which is located in the riverside near Raja Indian Cuisine, 5 out of 5. It does not welcome kids.
name[The Wrestlers], eatType[pub], food[Japanese], priceRange[more than £30], customer rating[5 out of 5], area[riverside], familyFriendly[yes], near[Raja Indian Cuisine]	The Wrestlers, which serves Japanese cuisine, is an expensive pub. It has a customer rating of 5 out of 5. It is located in the riverside area and can be found near Raja Indian Cuisine. It welcomes kids.
name[The Wrestlers], eatType[pub], food[Japanese], priceRange[more than £30], customer rating[low], area[city centre], familyFriendly[no], near[Raja Indian Cuisine]	The Wrestlers, which offers Japanese food, is a high-priced pub. It has a low customer rating. It is in city centre near Raja Indian Cuisine. It is not family-friendly.
name[The Wrestlers], eatType[pub], food[Japanese], priceRange[more than £30], customer rating[low], area[city centre], familyFriendly[yes], near[Raja Indian Cuisine]	The Wrestlers, which offers Japanese cuisine, is an expensive pub. It has a low customer rating. It is in the city centre area by Raja Indian Cuisine. It welcomes families.
name[The Wrestlers], eatType[pub], food[Japanese], priceRange[more than £30], customer rating[low], area[riverside], familyFriendly[no], near[Raja Indian Cuisine]	The Wrestlers, which serves Japanese food, is a high-priced pub. It has a low customer rating. Non-child-friendly The Wrestlers is located in the riverside near Raja Indian Cuisine.
name[The Wrestlers], eatType[pub], food[Japanese], priceRange[more than £30], customer rating[low], area[riverside], familyFriendly[yes], near[Raja Indian Cuisine]	The Wrestlers, which serves Japanese cuisine, is an expensive pub. It has a low customer rating. It is located in the riverside area and can be found near Raja Indian Cuisine. It is family-friendly.
name[The Wrestlers], eatType[restaurant], food[Italian], priceRange[less than £20], area[riverside], familyFriendly[no], near[Raja Indian Cuisine]	The Wrestlers, which offers Italian food, is a low-priced restaurant. It is in riverside near Raja Indian Cuisine. It is not kid-friendly.
name[The Wrestlers], eatType[restaurant], food[Italian], priceRange[less than £20], area[riverside], familyFriendly[yes], near[Raja Indian Cuisine]	The Wrestlers, which offers Italian cuisine, is a cheap restaurant. It is in the riverside area by Raja Indian Cuisine. It is child-friendly.
name[The Wrestlers], eatType[restaurant], food[Italian], priceRange[moderate], area[city centre], familyFriendly[no], near[Raja Indian Cuisine]	The Wrestlers, which serves Italian food, is a mid-priced restaurant. The Wrestlers, which does not welcome children, is located in the city centre near Raja Indian Cuisine.
name[The Wrestlers], eatType[restaurant], food[Italian], priceRange[moderate], area[city centre], familyFriendly[yes], near[Raja Indian Cuisine]	The Wrestlers, which serves Italian cuisine, is an average-priced restaurant. It is located in the city centre area and can be found near Raja Indian Cuisine. It is kid-friendly.
name[The Wrestlers], eatType[restaurant], food[Italian], priceRange[moderate], area[riverside], familyFriendly[no], near[Raja Indian Cuisine]	The Wrestlers, which offers Italian food, is a restaurant. It is moderately priced. It is in riverside near Raja Indian Cuisine. It does not welcome kids.
name[The Wrestlers], eatType[restaurant], food[Italian], priceRange[moderate], area[riverside], familyFriendly[yes], near[Raja Indian Cuisine]	The Wrestlers, which offers Italian cuisine, is a mid-priced restaurant. It is in the riverside area by Raja Indian Cuisine. It welcomes children.
name[The Wrestlers], eatType[restaurant], food[Italian], priceRange[more than £30], area[riverside], familyFriendly[yes], near[Raja Indian Cuisine]	The Wrestlers, which serves Italian food, is a high-priced restaurant. The Wrestlers, which welcomes kids, is located in the riverside near Raja Indian Cuisine.
name[The Wrestlers], eatType[restaurant], food[Japanese], priceRange[£20-25], area[riverside], familyFriendly[yes], near[Raja Indian Cuisine]	The Wrestlers, which serves Japanese cuisine, is an average-priced restaurant. It is located in the riverside area and can be found near Raja Indian Cuisine. It welcomes families.
name[The Wrestlers], eatType[restaurant], food[Japanese], priceRange[cheap], area[riverside], familyFriendly[yes], near[Raja Indian Cuisine]	The Wrestlers, which offers Japanese food, is a low-priced restaurant. It is in riverside near Raja Indian Cuisine. It is family-friendly.
name[The Wrestlers], eatType[restaurant], food[Japanese], priceRange[high], area[riverside], familyFriendly[yes], near[Raja Indian Cuisine]	The Wrestlers, which offers Japanese cuisine, is an expensive restaurant. It is in the riverside area by Raja Indian Cuisine. It is child-friendly.
name[The Wrestlers], eatType[restaurant], food[Japanese], priceRange[less than £20], area[city centre], familyFriendly[no], near[Raja Indian Cuisine]	The Wrestlers, which serves Japanese food, is a cheap restaurant. Non-family-friendly The Wrestlers is located in the city centre near Raja Indian Cuisine.
name[The Wrestlers], eatType[restaurant], food[Japanese], priceRange[less than £20], area[city centre], familyFriendly[yes], near[Raja Indian Cuisine]	The Wrestlers, which serves Japanese cuisine, is a low-priced restaurant. It is located in the city centre area and can be found near Raja Indian Cuisine. It is kid-friendly.
name[The Wrestlers], eatType[restaurant], food[Japanese], priceRange[less than £20], area[riverside], familyFriendly[no], near[Raja Indian Cuisine]	The Wrestlers, which offers Japanese food, is a cheap restaurant. It is in riverside near Raja Indian Cuisine. It is not child-friendly.
name[The Wrestlers], eatType[restaurant], food[Japanese], priceRange[less than £20], area[riverside], familyFriendly[yes], near[Raja Indian Cuisine]	The Wrestlers, which offers Japanese cuisine, is a low-priced restaurant. It is in the riverside area by Raja Indian Cuisine. It welcomes children.
name[The Wrestlers], eatType[restaurant], food[Japanese], priceRange[moderate], area[city centre], familyFriendly[no], near[Raja Indian Cuisine]	The Wrestlers, which serves Japanese food, is a restaurant. It is moderately priced. Non-kid-friendly The Wrestlers is located in the city centre near Raja Indian Cuisine.
name[The Wrestlers], eatType[restaurant], food[Japanese], priceRange[moderate], area[city centre], familyFriendly[yes], near[Raja Indian Cuisine]	The Wrestlers, which serves Japanese cuisine, is a mid-priced restaurant. It is located in the, city centre, area and can be found near Raja Indian Cuisine. It welcomes kids.
name[The Wrestlers], eatType[restaurant], food[Japanese], priceRange[moderate], area[riverside], familyFriendly[no], near[Raja Indian Cuisine]	The Wrestlers, which offers Japanese food, is an average-priced restaurant. It is in riverside near Raja Indian Cuisine. It does not welcome children.
name[The Wrestlers], eatType[restaurant], food[Japanese], priceRange[moderate], area[riverside], familyFriendly[yes], near[Raja Indian Cuisine]	The Wrestlers, which offers Japanese cuisine, is a restaurant. It is moderately priced. It is in the riverside area by Raja Indian Cuisine. It welcomes families.
name[The Wrestlers], eatType[restaurant], food[Japanese], priceRange[more than £30], area[city centre], familyFriendly[no], near[Raja Indian Cuisine]	The Wrestlers, which serves Japanese food, is a high-priced restaurant. The Wrestlers, which does not welcome kids, is located in the city centre near Raja Indian Cuisine.
name[The Wrestlers], eatType[restaurant], food[Japanese], priceRange[more than £30], area[city centre], familyFriendly[yes], near[Raja Indian Cuisine]	The Wrestlers, which serves Japanese cuisine, is an expensive restaurant. It is located in the city centre area and can be found near Raja Indian Cuisine. It is family-friendly.
name[The Wrestlers], eatType[restaurant], food[Japanese], priceRange[more than £30], area[riverside], familyFriendly[no], near[Raja Indian Cuisine]	The Wrestlers, which offers Japanese food, is a high-priced restaurant. It is in riverside near Raja Indian Cuisine. It is not family-friendly.
name[The Wrestlers], eatType[restaurant], food[Japanese], priceRange[more than £30], area[riverside], familyFriendly[yes], near[Raja Indian Cuisine]	The Wrestlers, which offers Japanese cuisine, is an expensive restaurant. It is in the riverside area by Raja Indian Cuisine. It is child-friendly.
name[Wildwood], eatType[coffee shop], area[riverside]	The coffee shop Wildwood is located in the riverside.
name[Wildwood], eatType[pub], area[riverside]	The pub Wildwood is located in the riverside area.
name[Wildwood], eatType[pub], food[French], area[riverside], familyFriendly[yes], near[Raja Indian Cuisine]	Wildwood, which serves French food, is a kid-friendly pub. It is in riverside and is located near Raja Indian Cuisine.
name[Wildwood], eatType[pub], food[Indian], area[city centre], familyFriendly[no], near[Raja Indian Cuisine]	Wildwood, which serves Indian cuisine, is a non-child-friendly pub. It is in the city centre area and can be found near Raja Indian Cuisine.
name[Wildwood], eatType[pub], food[Indian], area[city centre], familyFriendly[yes], near[Raja Indian Cuisine]	The pub Wildwood is located in the city centre. It offers Indian food. Wildwood, which is near Raja Indian Cuisine, welcomes children.
name[Wildwood], eatType[pub], food[Indian], area[riverside], familyFriendly[no], near[Raja Indian Cuisine]	Wildwood, which offers Indian cuisine, is a non-kid-friendly pub. It is located in the riverside area by Raja Indian Cuisine.
name[Wildwood], eatType[pub], food[Indian], area[riverside], familyFriendly[yes], near[Raja Indian Cuisine]	The pub Wildwood is in riverside. It serves Indian food. Wildwood, which is located near Raja Indian Cuisine, welcomes kids.
name[Wildwood], eatType[pub], food[Italian], area[city centre], familyFriendly[no], near[Raja Indian Cuisine]	The pub Wildwood is in the city centre area. It serves Italian cuisine. Wildwood which can be found near Raja Indian Cuisine does not welcome children.
name[Wildwood], eatType[pub], food[Italian], area[city centre], familyFriendly[yes], near[Raja Indian Cuisine]	The pub Wildwood is located in the city centre. It offers Italian food. Wildwood, which is near Raja Indian Cuisine, welcomes families.
name[Wildwood], eatType[pub], food[Italian], area[riverside], familyFriendly[no], near[Raja Indian Cuisine]	The pub Wildwood is located in the riverside area. It offers Italian cuisine. Wildwood, which is by Raja Indian Cuisine, does not welcome kids.
name[Wildwood], eatType[pub], food[Italian], area[riverside], familyFriendly[yes], near[Raja Indian Cuisine]	Wildwood, which serves Italian food, is a family-friendly pub. It is in riverside and is located near Raja Indian Cuisine.
name[Wildwood], eatType[restaurant], food[French], area[riverside], familyFriendly[yes], near[Raja Indian Cuisine]	Wildwood, which serves French cuisine, is a child-friendly restaurant. It is in the riverside area and can be found near Raja Indian Cuisine.
name[Wildwood], eatType[restaurant], food[Indian], area[city centre], familyFriendly[no], near[Raja Indian Cuisine]	Wildwood, which offers Indian food, is a non-family-friendly restaurant. It is located in the city centre near Raja Indian Cuisine.
name[Wildwood], eatType[restaurant], food[Indian], area[city centre], familyFriendly[yes], near[Raja Indian Cuisine]	Wildwood, which offers Indian cuisine, is a kid-friendly restaurant. It is located in the city centre area by Raja Indian Cuisine.
name[Wildwood], eatType[restaurant], food[Indian], area[riverside], familyFriendly[no], near[Raja Indian Cuisine]	Wildwood, which serves Indian food, is a non-child-friendly restaurant. It is in riverside and is located near Raja Indian Cuisine.
name[Wildwood], eatType[restaurant], food[Indian], area[riverside], familyFriendly[yes], near[Raja Indian Cuisine]	The restaurant Wildwood is in the riverside area. It serves Indian cuisine. Wildwood which can be found near Raja Indian Cuisine welcomes children.
name[Wildwood], eatType[restaurant], food[Italian], area[city centre], familyFriendly[no], near[Raja Indian Cuisine]	Wildwood, which offers Italian food, is a non-kid-friendly restaurant. It is located in the city centre near Raja Indian Cuisine.
name[Wildwood], eatType[restaurant], food[Italian], area[city centre], familyFriendly[yes], near[Raja Indian Cuisine]	The restaurant Wildwood is located in the city centre area. It offers Italian cuisine. Wildwood, which is by Raja Indian Cuisine, welcomes kids.
name[Wildwood], eatType[restaurant], food[Italian], area[riverside], familyFriendly[no], near[Raja Indian Cuisine]	The restaurant Wildwood is in riverside. It serves Italian food. Wildwood, which is located near Raja Indian Cuisine, does not welcome children.
name[Wildwood], eatType[restaurant], food[Italian], area[riverside], familyFriendly[yes], near[Raja Indian Cuisine]	The restaurant Wildwood is in the riverside area. It serves Italian cuisine. Wildwood which can be found near Raja Indian Cuisine welcomes families.
name[Zizzi], eatType[coffee shop], area[riverside]	The coffee shop Zizzi is located in the riverside.
name[Zizzi], eatType[coffee shop], customer rating[average], near[Burger King]	The coffee shop Zizzi is near Burger King. It has an average customer rating.
name[Zizzi], eatType[coffee shop], customer rating[high], near[Burger King]	The coffee shop Zizzi is by Burger King. It has a high customer rating.
name[Zizzi], eatType[coffee shop], near[The Sorrento]	The coffee shop Zizzi is located near The Sorrento.
name[Zizzi], eatType[pub], area[riverside]	The pub Zizzi is located in the riverside area.
name[Zizzi], eatType[pub], customer rating[average], near[Burger King]	The pub Zizzi can be found near Burger King. It has an average customer rating.
name[Zizzi], eatType[pub], customer rating[high], near[Burger King]	The pub Zizzi is near Burger King. It has a high customer rating.
name[Zizzi], eatType[pub], near[The Sorrento]	The pub Zizzi is by The Sorrento.
