MR	ref
name[Blue Spice], eatType[coffee shop], area[city centre]	Blue Spice is a coffee shop located in the city centre.
name[Blue Spice], eatType[coffee shop], area[riverside]	Blue Spice is a riverside coffee shop with a high price range.
name[Blue Spice], eatType[coffee shop], customer rating[5 out of 5], near[Crowne Plaza Hotel]	Blue Spice is a 5 out of 5 rated coffee shop near Crowne Plaza Hotel.
name[Blue Spice], eatType[coffee shop], customer rating[average], near[Burger King]	Blue Spice is an average rated coffee shop near Burger King.
name[Blue Spice], eatType[coffee shop], customer rating[average], near[Crowne Plaza Hotel]	Blue Spice is an average rated coffee shop near Crowne Plaza Hotel.
name[Blue Spice], eatType[pub], area[city centre]	Blue Spice is a pub in the city centre.
name[Blue Spice], eatType[pub], area[riverside]	Blue Spice is a pub in the riverside area.
name[Blue Spice], eatType[pub], customer rating[5 out of 5], near[Crowne Plaza Hotel]	Blue Spice is a 5 out of 5 rated pub near the Crowne Plaza Hotel.
name[Blue Spice], eatType[pub], customer rating[average], near[Burger King]	Blue Spice is a pub near Burger King with an average customer rating.
name[Blue Spice], eatType[pub], customer rating[average], near[Crowne Plaza Hotel]	There is a pub near the Crowne Plaza Hotel called Blue Spice. It has an average customer rating.
name[Blue Spice], eatType[pub], food[Chinese], area[city centre], familyFriendly[no], near[Rainbow Vegetarian Café]	Blue Spice is a pub that provides Chinese food. It is located in the city centre and is near Rainbow Vegetarian Café.
name[Blue Spice], eatType[pub], food[Chinese], area[city centre], familyFriendly[yes], near[Rainbow Vegetarian Café]	Blue Spice is a pub that provides Chinese food. It is located in the city centre and is near Rainbow Vegetarian Café.
name[Blue Spice], eatType[pub], food[Chinese], area[riverside], familyFriendly[no], near[Rainbow Vegetarian Café]	Blue Spice is a pub that provides Chinese food. It is located in the riverside and is near Rainbow Vegetarian Café.
name[Blue Spice], eatType[pub], food[Chinese], area[riverside], familyFriendly[yes], near[Rainbow Vegetarian Café]	Blue Spice is a pub that provides Chinese food. It is located in the riverside and is near Rainbow Vegetarian Café.
name[Blue Spice], eatType[pub], food[English], area[city centre], familyFriendly[no], near[Rainbow Vegetarian Café]	Blue Spice is an English pub near Rainbow Vegetarian Café in the city centre. It is not family-friendly.
name[Blue Spice], eatType[pub], food[English], area[city centre], familyFriendly[yes], near[Rainbow Vegetarian Café]	Blue Spice is a family-friendly pub that serves English food. It is located in the city centre near Rainbow Vegetarian Café.
name[Blue Spice], eatType[pub], food[English], area[riverside], familyFriendly[no], near[Rainbow Vegetarian Café]	Blue Spice is an English pub near Rainbow Vegetarian Café in the riverside area. It is not family-friendly.
name[Blue Spice], eatType[pub], food[English], area[riverside], familyFriendly[yes], near[Rainbow Vegetarian Café]	Blue Spice is a family friendly pub that serves English food. It is located near Rainbow Vegetarian Café in the riverside area.
name[Blue Spice], eatType[restaurant], food[Chinese], area[city centre], familyFriendly[no], near[Rainbow Vegetarian Café]	Blue Spice is a Chinese restaurant located in the city centre near Rainbow Vegetarian Café. It is not family friendly.
name[Blue Spice], eatType[restaurant], food[Chinese], area[city centre], familyFriendly[yes], near[Rainbow Vegetarian Café]	There is a family friendly Chinese restaurant in the city centre near Rainbow Vegetarian Café called Blue Spice.
name[Blue Spice], eatType[restaurant], food[Chinese], area[riverside], familyFriendly[no], near[Rainbow Vegetarian Café]	Blue Spice is a Chinese restaurant located in the riverside area near Rainbow Vegetarian Café. It is not family friendly.
name[Blue Spice], eatType[restaurant], food[Chinese], area[riverside], familyFriendly[yes], near[Rainbow Vegetarian Café]	Blue Spice is a family friendly Chinese restaurant in the riverside area near Rainbow Vegetarian Café.
name[Blue Spice], eatType[restaurant], food[English], area[city centre], familyFriendly[no], near[Rainbow Vegetarian Café]	Blue Spice is a restaurant located in the city centre near Rainbow Vegetarian Café. It serves English food and is not family-friendly.
name[Blue Spice], eatType[restaurant], food[English], area[city centre], familyFriendly[yes], near[Rainbow Vegetarian Café]	Blue Spice is a family-friendly restaurant that serves English food. It is located in the city centre near Rainbow Vegetarian Café.
name[Blue Spice], eatType[restaurant], food[English], area[riverside], familyFriendly[no], near[Rainbow Vegetarian Café]	Blue Spice is an English restaurant near the Rainbow Vegetarian Café in the riverside area. It is not family-friendly.
name[Blue Spice], eatType[restaurant], food[English], area[riverside], familyFriendly[yes], near[Rainbow Vegetarian Café]	Blue Spice is a family friendly English restaurant near the Rainbow Vegetarian Café in the riverside area.
name[Clowns], eatType[coffee shop], customer rating[3 out of 5], near[All Bar One]	Clowns is a coffee shop near All Bar One with a customer rating of 3 out of 5.
name[Clowns], eatType[coffee shop], customer rating[5 out of 5], near[Crowne Plaza Hotel]	Clowns is a coffee shop near Crowne Plaza Hotel with a customer rating of 5 out of 5.
name[Clowns], eatType[coffee shop], near[The Sorrento]	Clowns is a coffee shop near The Sorrento.
name[Clowns], eatType[pub], customer rating[3 out of 5], near[All Bar One]	Clowns is a pub near All Bar One with a customer rating of 3 out of 5.
name[Clowns], eatType[pub], customer rating[5 out of 5], near[Crowne Plaza Hotel]	Clowns is a pub near the Crowne Plaza Hotel with a customer rating of 5 out of 5.
name[Clowns], eatType[pub], near[The Sorrento]	Clowns is a pub near The Sorrento.
name[Cocum], eatType[coffee shop], customer rating[high], near[Burger King]	There is a highly rated coffee shop named Cocum near Burger King.
name[Cocum], eatType[coffee shop], customer rating[high], near[Café Sicilia]	A highly rated coffee shop near Café Sicilia is Cocum.
name[Cocum], eatType[coffee shop], customer rating[low], near[Café Sicilia]	The coffee shop, Cocum, is located near Café Sicilia. It has a low customer rating.
name[Cocum], eatType[coffee shop], customer rating[low], near[Express by Holiday Inn]	There is a low rated coffee shop named Cocum near Express by Holiday Inn.
name[Cocum], eatType[coffee shop], near[The Rice Boat]	There is a coffee shop named Cocum near The Rice Boat. It is in the low price range.
name[Cocum], eatType[coffee shop], near[The Sorrento]	A coffee shop named Cocum is located near The Sorrento.
name[Cocum], eatType[pub], customer rating[high], near[Burger King]	The highly rated Cocum is a pub near the Burger King.
name[Cocum], eatType[pub], customer rating[high], near[Café Sicilia]	Near Café Sicilia is a pub named Cocum with a high customer rating.
name[Cocum], eatType[pub], customer rating[low], near[Café Sicilia]	The pub Cocum is located near Café Sicilia. It has a low customer rating.
name[Cocum], eatType[pub], customer rating[low], near[Express by Holiday Inn]	There is a pub near the Express by Holiday Inn called Cocum. It has a low customer rating.
name[Cocum], eatType[pub], near[The Rice Boat]	The pub Cocum is located near The Rice Boat.
name[Cocum], eatType[pub], near[The Sorrento]	The pub called Cocum is located near The Sorrento.
name[Cotto], eatType[coffee shop], near[The Bakers]	Cotto is a coffee shop near The Bakers.
name[Cotto], eatType[pub], near[The Bakers]	Cotto is a pub near The Bakers.
name[Giraffe], eatType[coffee shop], near[The Bakers]	Giraffe is a coffee shop located near The Bakers.
name[Giraffe], eatType[coffee shop], near[The Rice Boat]	Giraffe is a coffee shop located near The Rice Boat.
name[Giraffe], eatType[pub], food[English], area[riverside], familyFriendly[yes], near[Rainbow Vegetarian Café]	Near the Rainbow Vegetarian Café in the riverside area is a family friendly pub called Giraffe that serves English food.
name[Giraffe], eatType[pub], food[Fast food], area[city centre], familyFriendly[no], near[Rainbow Vegetarian Café]	The Giraffe is a fast food pub located in the city centre near Rainbow Vegetarian Café. It is not family-friendly.
name[Giraffe], eatType[pub], food[Fast food], area[city centre], familyFriendly[yes], near[Rainbow Vegetarian Café]	The Giraffe is a family-friendly fast food pub in the city centre near Rainbow Vegetarian Café.
name[Giraffe], eatType[pub], food[Fast food], area[riverside], familyFriendly[no], near[Rainbow Vegetarian Café]	The Giraffe is a pub located near the Rainbow Vegetarian Café. It is not family friendly.
name[Giraffe], eatType[pub], food[Fast food], area[riverside], familyFriendly[yes], near[Rainbow Vegetarian Café]	Near the Rainbow Vegetarian Café in the riverside area is a family friendly pub called Giraffe that serves fast food.
name[Giraffe], eatType[pub], food[Fast food], area[riverside], familyFriendly[yes], near[Raja Indian Cuisine]	Giraffe is a family friendly pub that serves fast food. It is located in the riverside area near Raja Indian Cuisine.
name[Giraffe], eatType[pub], food[French], area[city centre], familyFriendly[no], near[Raja Indian Cuisine]	Giraffe is a pub located in the city centre near Raja Indian Cuisine. It serves French food and is not family-friendly.
name[Giraffe], eatType[pub], food[French], area[city centre], familyFriendly[yes], near[Raja Indian Cuisine]	Giraffe is a family-friendly pub serving French food in the city centre near Raja Indian Cuisine.
name[Giraffe], eatType[pub], food[French], area[riverside], familyFriendly[no], near[Raja Indian Cuisine]	Giraffe is a pub located in the riverside area near Raja Indian Cuisine. It is not family-friendly.
name[Giraffe], eatType[pub], food[French], area[riverside], familyFriendly[yes], near[Raja Indian Cuisine]	Giraffe is a family friendly French pub in the riverside area near Raja Indian Cuisine.
name[Giraffe], eatType[pub], near[The Bakers]	Giraffe is a pub near The Bakers.
name[Giraffe], eatType[pub], near[The Rice Boat]	Giraffe is a pub near The Rice Boat.
name[Giraffe], eatType[restaurant], food[English], area[riverside], familyFriendly[yes], near[Rainbow Vegetarian Café]	The Giraffe is a family friendly English restaurant near the Rainbow Vegetarian Café in the riverside area.
name[Giraffe], eatType[restaurant], food[Fast food], area[city centre], familyFriendly[no], near[Rainbow Vegetarian Café]	The Giraffe is a fast food restaurant located in the city centre near Rainbow Vegetarian Café. It is not family-friendly.
name[Giraffe], eatType[restaurant], food[Fast food], area[city centre], familyFriendly[yes], near[Rainbow Vegetarian Café]	The Giraffe is a family-friendly fast food restaurant in the city centre near Rainbow Vegetarian Café.
name[Giraffe], eatType[restaurant], food[Fast food], area[riverside], familyFriendly[no], near[Rainbow Vegetarian Café]	The Giraffe is a fast food restaurant in the riverside area near Rainbow Vegetarian Café. It is not family-friendly.
name[Giraffe], eatType[restaurant], food[Fast food], area[riverside], familyFriendly[yes], near[Rainbow Vegetarian Café]	The Giraffe is a family friendly fast food restaurant near the Rainbow Vegetarian Café in the riverside area.
name[Giraffe], eatType[restaurant], food[Fast food], area[riverside], familyFriendly[yes], near[Raja Indian Cuisine]	Giraffe is a family friendly fast food restaurant in the riverside area near Raja Indian Cuisine.
name[Giraffe], eatType[restaurant], food[French], area[city centre], familyFriendly[no], near[Raja Indian Cuisine]	Giraffe is a French restaurant located in the city centre near Raja Indian Cuisine. It is not family-friendly.
name[Giraffe], eatType[restaurant], food[French], area[city centre], familyFriendly[yes], near[Raja Indian Cuisine]	Giraffe is a family-friendly French restaurant located in the city centre near Raja Indian Cuisine.
name[Giraffe], eatType[restaurant], food[French], area[riverside], familyFriendly[no], near[Raja Indian Cuisine]	Giraffe is a French restaurant located in the riverside area near Raja Indian Cuisine. It is not family-friendly.
name[Giraffe], eatType[restaurant], food[French], area[riverside], familyFriendly[yes], near[Raja Indian Cuisine]	Giraffe is a family friendly French restaurant in the riverside area near Raja Indian Cuisine.
name[Green Man], eatType[coffee shop], customer rating[1 out of 5], near[All Bar One]	The Green Man is a coffee shop near All Bar One. It has a customer rating of 1 out of 5.
name[Green Man], eatType[coffee shop], customer rating[3 out of 5], near[All Bar One]	The Green Man is a coffee shop near All Bar One. It has a customer rating of 3 out of 5.
name[Green Man], eatType[pub], customer rating[1 out of 5], near[All Bar One]	The Green Man is a pub near All Bar One with a customer rating of 1 out of 5.
name[Green Man], eatType[pub], customer rating[3 out of 5], near[All Bar One]	The Green Man is a pub near All Bar One with a customer rating of 3 out of 5.
name[Green Man], eatType[pub], food[Italian], area[riverside], familyFriendly[yes], near[Express by Holiday Inn]	Near the Express by Holiday Inn in the riverside area is a family friendly Italian pub called Green Man.
name[Green Man], eatType[pub], food[Italian], area[riverside], familyFriendly[yes], near[Raja Indian Cuisine]	Green Man is a family friendly Italian pub near Raja Indian Cuisine in the riverside area.
name[Green Man], eatType[pub], food[Japanese], area[city centre], familyFriendly[no], near[Express by Holiday Inn]	The Green Man is a pub located in the city centre near Express by Holiday Inn. It serves Japanese food and is not family-friendly.
name[Green Man], eatType[pub], food[Japanese], area[city centre], familyFriendly[yes], near[Express by Holiday Inn]	Green Man is a family-friendly pub serving Japanese food. It is located in the city centre near Express by Holiday Inn.
name[Green Man], eatType[pub], food[Japanese], area[riverside], familyFriendly[no], near[Express by Holiday Inn]	The Green Man is a pub serving Japanese food. It is located in the riverside area near the Express by Holiday Inn and is not family-friendly.
name[Green Man], eatType[pub], food[Japanese], area[riverside], familyFriendly[yes], near[Express by Holiday Inn]	Green Man is a family friendly Japanese pub near the Express by Holiday Inn in the riverside area.
name[Green Man], eatType[restaurant], food[Italian], area[riverside], familyFriendly[yes], near[Express by Holiday Inn]	Green Man is a family friendly Italian restaurant near the Express by Holiday Inn in the riverside area.
name[Green Man], eatType[restaurant], food[Italian], area[riverside], familyFriendly[yes], near[Raja Indian Cuisine]	Green Man is a family friendly Italian restaurant in the riverside area near Raja Indian Cuisine.
name[Green Man], eatType[restaurant], food[Japanese], area[city centre], familyFriendly[no], near[Express by Holiday Inn]	The Green Man is a Japanese restaurant located in the city centre near Express by Holiday Inn. It is not family-friendly.
name[Green Man], eatType[restaurant], food[Japanese], area[city centre], familyFriendly[yes], near[Express by Holiday Inn]	The Green Man is a family-friendly restaurant serving Japanese food in the city centre near Express by Holiday Inn.
name[Green Man], eatType[restaurant], food[Japanese], area[riverside], familyFriendly[no], near[Express by Holiday Inn]	The Green Man is a Japanese restaurant located in the riverside area near the Express by Holiday Inn. It is not family-friendly.
name[Green Man], eatType[restaurant], food[Japanese], area[riverside], familyFriendly[yes], near[Express by Holiday Inn]	Green Man is a family friendly Japanese restaurant near the Express by Holiday Inn in the riverside area.
name[Loch Fyne], eatType[coffee shop], area[riverside]	Loch Fyne is a riverside coffee shop that serves Japanese food.
name[Loch Fyne], eatType[pub], area[riverside]	A pub named Loch Fyne is located in the riverside area.
name[Strada], eatType[coffee shop], area[city centre]	Located in the city centre, Strada is a coffee shop with a customer rating of 1 out of 5.
name[Strada], eatType[coffee shop], customer rating[1 out of 5], near[All Bar One]	Strada is a coffee shop near All Bar One. It has a customer rating of 1 out of 5.
name[Strada], eatType[coffee shop], customer rating[1 out of 5], near[Rainbow Vegetarian Café]	Strada is a coffee shop near Rainbow Vegetarian Café with a customer rating of 1 out of 5.
name[Strada], eatType[coffee shop], customer rating[low], near[Express by Holiday Inn]	Near the Express by Holiday Inn is a low rated coffee shop named Strada.
name[Strada], eatType[pub], area[city centre]	The pub, Strada, is located in the city centre.
name[Strada], eatType[pub], customer rating[1 out of 5], near[All Bar One]	Strada is a pub near All Bar One with a customer rating of 1 out of 5.
name[Strada], eatType[pub], customer rating[1 out of 5], near[Rainbow Vegetarian Café]	Strada is a pub near Rainbow Vegetarian Café with a customer rating of 1 out of 5.
name[Strada], eatType[pub], customer rating[low], near[Express by Holiday Inn]	Strada is a low rated pub near Express by Holiday Inn.
name[The Cricketers], eatType[coffee shop], customer rating[1 out of 5], familyFriendly[yes], near[Avalon]	The Cricketers is a kid friendly coffee shop near Avalon. It has a customer rating of 1 out of 5.
name[The Cricketers], eatType[coffee shop], customer rating[3 out of 5], familyFriendly[yes], near[Avalon]	The Cricketers is a kid friendly coffee shop near Avalon. It has a customer rating of 3 out of 5.
name[The Cricketers], eatType[coffee shop], customer rating[3 out of 5], familyFriendly[yes], near[Crowne Plaza Hotel]	The Cricketers is a kid friendly coffee shop near Crowne Plaza Hotel with a customer rating of 3 out of 5.
name[The Cricketers], eatType[coffee shop], customer rating[5 out of 5], familyFriendly[no], near[Crowne Plaza Hotel]	The Cricketers is a non family-friendly coffee shop near Crowne Plaza Hotel with a customer rating of 5 out of 5.
name[The Cricketers], eatType[coffee shop], customer rating[5 out of 5], familyFriendly[yes], near[Crowne Plaza Hotel]	The Cricketers is a family friendly coffee shop near Crowne Plaza Hotel with a customer rating of 5 out of 5.
name[The Cricketers], eatType[coffee shop], customer rating[average], familyFriendly[no], near[Café Sicilia]	The adult-friendly coffee shop, The Punter, has an average customer rating and is located near Café Sicilia.
name[The Cricketers], eatType[coffee shop], customer rating[average], familyFriendly[no], near[Crowne Plaza Hotel]	The Cricketers is a non family-friendly coffee shop near Crowne Plaza Hotel with an average customer rating.
name[The Cricketers], eatType[coffee shop], customer rating[average], familyFriendly[yes], near[Café Sicilia]	The Cricketers is a family friendly coffee shop near Café Sicilia with an average customer rating.
name[The Cricketers], eatType[coffee shop], customer rating[high], familyFriendly[yes], near[Café Sicilia]	The child friendly coffee shop, The Punter, has a high customer rating and is located near Café Sicilia.
name[The Cricketers], eatType[coffee shop], customer rating[high], familyFriendly[yes], near[Express by Holiday Inn]	The child friendly coffee shop, The Wrestlers, is located near Express by Holiday Inn and has a high customer rating.
name[The Cricketers], eatType[coffee shop], customer rating[low], familyFriendly[no], near[Express by Holiday Inn]	The Cricketers is a low rated coffee shop near Express by Holiday Inn. It is not family-friendly.
name[The Cricketers], eatType[coffee shop], customer rating[low], familyFriendly[no], near[Ranch]	The Cricketers is a coffee shop near Ranch. It is not family-friendly and has a low customer rating.
name[The Cricketers], eatType[coffee shop], customer rating[low], familyFriendly[yes], near[Ranch]	The Cricketers is a family friendly coffee shop near Ranch with a low customer rating.
name[The Cricketers], eatType[restaurant], customer rating[1 out of 5], familyFriendly[yes], near[Avalon]	The Cricketers is a kid friendly restaurant near Avalon with a customer rating of 1 out of 5.
name[The Cricketers], eatType[restaurant], customer rating[3 out of 5], familyFriendly[yes], near[Avalon]	Located near Avalon, The Cricketers is a kid friendly restaurant with a customer rating of 3 out of 5.
name[The Cricketers], eatType[restaurant], customer rating[3 out of 5], familyFriendly[yes], near[Crowne Plaza Hotel]	The Cricketers is a kid friendly restaurant near the Crowne Plaza Hotel with a customer rating of 3 out of 5.
name[The Cricketers], eatType[restaurant], customer rating[5 out of 5], familyFriendly[no], near[Crowne Plaza Hotel]	The highly rated restaurant The Cricketers is located near Crowne Plaza Hotel and is not family-friendly.
name[The Cricketers], eatType[restaurant], customer rating[5 out of 5], familyFriendly[yes], near[Crowne Plaza Hotel]	The Cricketers is a family friendly restaurant near Crowne Plaza Hotel with a customer rating of 5 out of 5.
name[The Cricketers], eatType[restaurant], customer rating[average], familyFriendly[no], near[Café Sicilia]	The Café Sicilia is an average rated restaurant called The Cricketers. It is not family-friendly.
name[The Cricketers], eatType[restaurant], customer rating[average], familyFriendly[no], near[Crowne Plaza Hotel]	The Crowne Plaza Hotel is an average rated restaurant called The Cricketers. It is not family-friendly.
name[The Cricketers], eatType[restaurant], customer rating[average], familyFriendly[yes], near[Café Sicilia]	Located near Café Sicilia, The Cricketers is a family friendly restaurant with an average customer rating.
name[The Cricketers], eatType[restaurant], customer rating[high], familyFriendly[yes], near[Café Sicilia]	Located near Café Sicilia, The Cricketers is a child friendly restaurant with a high customer rating.
name[The Cricketers], eatType[restaurant], customer rating[high], familyFriendly[yes], near[Express by Holiday Inn]	The Cricketers is a child friendly restaurant with a high customer rating. It is located near Express by Holiday Inn.
name[The Cricketers], eatType[restaurant], customer rating[low], familyFriendly[no], near[Express by Holiday Inn]	The Cricketers is a restaurant near Express by Holiday Inn. It is not family-friendly and has a low customer rating.
name[The Cricketers], eatType[restaurant], customer rating[low], familyFriendly[no], near[Ranch]	The Cricketers is a low rated restaurant near Ranch. It is not family-friendly.
name[The Cricketers], eatType[restaurant], customer rating[low], familyFriendly[yes], near[Ranch]	The Cricketers is a family friendly restaurant near Ranch with a low customer rating.
name[The Cricketers], eatType[restaurant], food[Chinese], priceRange[£20-25], customer rating[high], area[city centre], familyFriendly[no], near[All Bar One]	The Wrestlers is a restaurant providing Chinese food in the £20-25 price range. It is located in the city centre and is near All Bar One. Its customer rating is high.
name[The Cricketers], eatType[restaurant], food[Chinese], priceRange[£20-25], customer rating[high], area[city centre], familyFriendly[yes], near[All Bar One]	The Wrestlers is a restaurant providing Chinese food in the £20-25 price range. It is located in the city centre and is near All Bar One. Its customer rating is high.
name[The Cricketers], eatType[restaurant], food[Chinese], priceRange[£20-25], customer rating[high], area[riverside], familyFriendly[no], near[All Bar One]	The Cricketers is a Chinese restaurant with a price range of £20-25. It has a high customer rating and is not kid friendly. It is located in the riverside area near All Bar One.
name[The Cricketers], eatType[restaurant], food[Chinese], priceRange[£20-25], customer rating[high], area[riverside], familyFriendly[yes], near[All Bar One]	The Cricketers is a restaurant providing Chinese food in the £20-25 price range. It is located in the riverside and is near All Bar One. Its customer rating is high.
name[The Cricketers], eatType[restaurant], food[Chinese], priceRange[cheap], customer rating[5 out of 5], area[city centre], familyFriendly[no], near[All Bar One]	The Wrestlers is a cheap Chinese restaurant located in the city centre near All Bar One. It has a customer rating of 5 out of 5 and is not family friendly.
name[The Cricketers], eatType[restaurant], food[Chinese], priceRange[cheap], customer rating[5 out of 5], area[city centre], familyFriendly[yes], near[All Bar One]	The Wrestlers is a family friendly Chinese restaurant with a cheap price range. It is located in the city centre near All Bar One and has a customer rating of 5 out of 5.
name[The Cricketers], eatType[restaurant], food[Chinese], priceRange[cheap], customer rating[5 out of 5], area[riverside], familyFriendly[no], near[All Bar One]	The Cricketers is a cheap Chinese restaurant with a 5 out of 5 customer rating. It is located in the riverside area near All Bar One and is not family friendly.
name[The Cricketers], eatType[restaurant], food[Chinese], priceRange[cheap], customer rating[5 out of 5], area[riverside], familyFriendly[yes], near[All Bar One]	The Cricketers is a family friendly Chinese restaurant with a cheap price range. It is located in the riverside area near All Bar One and has a customer rating of 5 out of 5.
name[The Cricketers], eatType[restaurant], food[Chinese], priceRange[cheap], customer rating[average], area[city centre], familyFriendly[no], near[All Bar One]	The Wrestlers is a cheap Chinese restaurant located in the city centre near All Bar One. It has an average customer rating and is not family friendly.
name[The Cricketers], eatType[restaurant], food[Chinese], priceRange[cheap], customer rating[average], area[city centre], familyFriendly[yes], near[All Bar One]	The Wrestlers is a family friendly Chinese restaurant with a cheap price range and an average customer rating. It is located in the city centre near All Bar One.
name[The Cricketers], eatType[restaurant], food[Chinese], priceRange[cheap], customer rating[average], area[riverside], familyFriendly[no], near[All Bar One]	The Cricketers is a Chinese restaurant with a cheap price range. It has an average customer rating and is not family friendly. It is located in the riverside area near All Bar One.
name[The Cricketers], eatType[restaurant], food[Chinese], priceRange[cheap], customer rating[average], area[riverside], familyFriendly[yes], near[All Bar One]	The Cricketers is a family friendly Chinese restaurant with a cheap price range and an average customer rating. It is located in the riverside area near All Bar One.
name[The Cricketers], eatType[restaurant], food[Chinese], priceRange[high], customer rating[1 out of 5], area[city centre], familyFriendly[no], near[All Bar One]	The Wrestlers is a Chinese restaurant in the city centre near All Bar One. It has a high price range and a customer rating of 1 out of 5. It is not children friendly.
name[The Cricketers], eatType[restaurant], food[Chinese], priceRange[high], customer rating[1 out of 5], area[city centre], familyFriendly[yes], near[All Bar One]	The Wrestlers is a restaurant providing Chinese food in the high price range. It is located in the city centre and is near All Bar One.
name[The Cricketers], eatType[restaurant], food[Chinese], priceRange[high], customer rating[1 out of 5], area[riverside], familyFriendly[no], near[All Bar One]	The Cricketers is a restaurant providing Chinese food in the high price range. It is located in the riverside and is near All Bar One.
name[The Cricketers], eatType[restaurant], food[Chinese], priceRange[high], customer rating[1 out of 5], area[riverside], familyFriendly[yes], near[All Bar One]	The Cricketers is a restaurant providing Chinese food in the high price range. It is located in the riverside and is near All Bar One.
name[The Cricketers], eatType[restaurant], food[Chinese], priceRange[high], customer rating[average], area[city centre], familyFriendly[no], near[All Bar One]	The Cricketers is a high priced Chinese restaurant with an average customer rating. It is located in the city centre near All Bar One and is not child friendly.
name[The Cricketers], eatType[restaurant], food[Chinese], priceRange[high], customer rating[average], area[city centre], familyFriendly[yes], near[All Bar One]	The Cricketers is a restaurant providing Chinese food in the high price range. It is located in the city centre and is near All Bar One.
name[The Cricketers], eatType[restaurant], food[Chinese], priceRange[high], customer rating[average], area[riverside], familyFriendly[no], near[All Bar One]	The Cricketers is a restaurant providing Chinese food in the high price range. It is located in the riverside and is near All Bar One. Its customer rating is average.
name[The Cricketers], eatType[restaurant], food[Chinese], priceRange[high], customer rating[average], area[riverside], familyFriendly[yes], near[All Bar One]	The Cricketers is a restaurant providing Chinese food in the high price range. It is located in the riverside and is near All Bar One. Its customer rating is average.
name[The Cricketers], eatType[restaurant], food[Chinese], priceRange[less than £20], customer rating[low], area[city centre], familyFriendly[no], near[All Bar One]	The Cricketers is a Chinese restaurant located in the city centre near All Bar One. It is not family friendly and has a low customer rating.
name[The Cricketers], eatType[restaurant], food[Chinese], priceRange[less than £20], customer rating[low], area[city centre], familyFriendly[yes], near[All Bar One]	The Wrestlers is a family friendly Chinese restaurant with a low customer rating. It is located in the city centre near All Bar One.
name[The Cricketers], eatType[restaurant], food[Chinese], priceRange[less than £20], customer rating[low], area[riverside], familyFriendly[no], near[All Bar One]	The Cricketers is a Chinese restaurant in the low price range. It is located near All Bar One.
name[The Cricketers], eatType[restaurant], food[Chinese], priceRange[less than £20], customer rating[low], area[riverside], familyFriendly[yes], near[All Bar One]	The Cricketers is a family friendly Chinese restaurant with a price range less than £20. It has a low customer rating and is located in the riverside area near All Bar One.
name[The Cricketers], eatType[restaurant], food[Chinese], priceRange[moderate], customer rating[1 out of 5], area[city centre], familyFriendly[no], near[All Bar One]	The Wrestlers is a restaurant providing Chinese food in the moderate price range. It is located in the city centre and is near All Bar One.
name[The Cricketers], eatType[restaurant], food[Chinese], priceRange[moderate], customer rating[1 out of 5], area[city centre], familyFriendly[yes], near[All Bar One]	The Wrestlers is a restaurant providing Chinese food in the moderate price range. It is located in the city centre and is near All Bar One.
name[The Cricketers], eatType[restaurant], food[Chinese], priceRange[moderate], customer rating[1 out of 5], area[riverside], familyFriendly[no], near[All Bar One]	The Cricketers is a Chinese restaurant with a moderate price range. It has a customer rating of 1 out of 5 and is not kid friendly. It is located in the riverside area near All Bar One.
name[The Cricketers], eatType[restaurant], food[Chinese], priceRange[moderate], customer rating[1 out of 5], area[riverside], familyFriendly[yes], near[All Bar One]	The Cricketers is a restaurant providing Chinese food in the moderate price range. It is located in the riverside and is near All Bar One. Its customer rating is 1 out of 5.
name[The Cricketers], eatType[restaurant], food[Chinese], priceRange[moderate], customer rating[3 out of 5], area[city centre], familyFriendly[no], near[All Bar One]	The Wrestlers is a restaurant providing Chinese food in the moderate price range. It is located in the city centre and is near All Bar One.
name[The Cricketers], eatType[restaurant], food[Chinese], priceRange[moderate], customer rating[3 out of 5], area[city centre], familyFriendly[yes], near[All Bar One]	The Wrestlers is a restaurant providing Chinese food in the moderate price range. It is located in the city centre and is near All Bar One.
name[The Cricketers], eatType[restaurant], food[Chinese], priceRange[moderate], customer rating[3 out of 5], area[riverside], familyFriendly[no], near[All Bar One]	The Cricketers is a restaurant providing Chinese food in the moderate price range. It is located in the riverside and is near All Bar One.
name[The Cricketers], eatType[restaurant], food[Chinese], priceRange[moderate], customer rating[3 out of 5], area[riverside], familyFriendly[yes], near[All Bar One]	The Cricketers is a restaurant providing Chinese food in the moderate price range. It is located in the riverside and is near All Bar One.
name[The Cricketers], eatType[restaurant], food[Chinese], priceRange[more than £30], customer rating[high], area[city centre], familyFriendly[no], near[All Bar One]	The Cricketers is a restaurant providing Chinese food in the more than £30 price range. It is located in the city centre and is near All Bar One.
name[The Cricketers], eatType[restaurant], food[Chinese], priceRange[more than £30], customer rating[high], area[city centre], familyFriendly[yes], near[All Bar One]	The Cricketers is a restaurant providing Chinese food in the more than £30 price range. It is located in the city centre and is near All Bar One. Its customer rating is high.
name[The Cricketers], eatType[restaurant], food[Chinese], priceRange[more than £30], customer rating[high], area[riverside], familyFriendly[no], near[All Bar One]	The Cricketers is a restaurant providing Chinese food in the more than £30 price range. It is located in the riverside and is near All Bar One. Its customer rating is high.
name[The Cricketers], eatType[restaurant], food[Chinese], priceRange[more than £30], customer rating[high], area[riverside], familyFriendly[yes], near[All Bar One]	The Cricketers is a restaurant providing Chinese food in the more than £30 price range. It is located in the riverside and is near All Bar One. Its customer rating is high.
name[The Cricketers], eatType[restaurant], food[English], priceRange[£20-25], customer rating[high], area[city centre], familyFriendly[no], near[All Bar One]	The Wrestlers is an English restaurant located in the city centre near All Bar One. It is not kid friendly and has a price range of £20-25.
name[The Cricketers], eatType[restaurant], food[English], priceRange[£20-25], customer rating[high], area[city centre], familyFriendly[yes], near[All Bar One]	The Wrestlers is a kid friendly English restaurant with a high customer rating. It is located in the city centre near All Bar One and has a price range of £20-25.
name[The Cricketers], eatType[restaurant], food[English], priceRange[£20-25], customer rating[high], area[riverside], familyFriendly[no], near[All Bar One]	The Cricketers is an English restaurant located in the riverside area near All Bar One. It is not kid friendly and has a price range of £20-25.
name[The Cricketers], eatType[restaurant], food[English], priceRange[£20-25], customer rating[high], area[riverside], familyFriendly[yes], near[All Bar One]	The Cricketers is a family friendly restaurant located near All Bar One.
name[The Cricketers], eatType[restaurant], food[English], priceRange[cheap], customer rating[5 out of 5], area[city centre], familyFriendly[no], near[Café Rouge]	The Wrestlers is a cheap English restaurant located in the city centre near Café Rouge. It has a customer rating of 5 out of 5 and is not family-friendly.
name[The Cricketers], eatType[restaurant], food[English], priceRange[cheap], customer rating[5 out of 5], area[city centre], familyFriendly[yes], near[Café Rouge]	The Wrestlers is a family-friendly English restaurant with a cheap price range. It is located in the city centre near Café Rouge and has a customer rating of 5 out of 5.
name[The Cricketers], eatType[restaurant], food[English], priceRange[cheap], customer rating[5 out of 5], area[riverside], familyFriendly[no], near[Café Rouge]	The English restaurant, The Wrestlers, is located in the riverside area near Café Rouge. It has a cheap price range and a customer rating of 5 out of 5. It is not family-friendly.
name[The Cricketers], eatType[restaurant], food[English], priceRange[cheap], customer rating[5 out of 5], area[riverside], familyFriendly[yes], near[Café Rouge]	The Wrestlers is a family friendly English restaurant with a low price range. It is located in the riverside area near Café Rouge and has a customer rating of 5 out of 5.
name[The Cricketers], eatType[restaurant], food[English], priceRange[cheap], customer rating[average], area[city centre], familyFriendly[no], near[Café Rouge]	The Wrestlers is a cheap English restaurant located in the city centre near Café Rouge. It has an average customer rating and is not family-friendly.
name[The Cricketers], eatType[restaurant], food[English], priceRange[cheap], customer rating[average], area[city centre], familyFriendly[yes], near[Café Rouge]	The family-friendly restaurant, The Wrestlers, is located in the city centre near Café Rouge. It serves cheap English food and has an average customer rating.
name[The Cricketers], eatType[restaurant], food[English], priceRange[cheap], customer rating[average], area[riverside], familyFriendly[no], near[Café Rouge]	The Plough is a cheap English restaurant located in riverside near Café Rouge. It has an average customer rating and is not family-friendly.
name[The Cricketers], eatType[restaurant], food[English], priceRange[cheap], customer rating[average], area[riverside], familyFriendly[yes], near[Café Rouge]	The family friendly restaurant, The Wrestlers, is located near Café Rouge in the riverside area. It serves cheap English food and has an average customer rating.
name[The Cricketers], eatType[restaurant], food[English], priceRange[high], customer rating[1 out of 5], area[city centre], familyFriendly[no], near[Café Rouge]	The English restaurant, The Wrestlers, is located in the city centre near Café Rouge. It has a high price range and a customer rating of 1 out of 5. It is not children friendly.
name[The Cricketers], eatType[restaurant], food[English], priceRange[high], customer rating[1 out of 5], area[city centre], familyFriendly[yes], near[Café Rouge]	The child friendly English restaurant, The Wrestlers, is located near Café Rouge in the city centre. It has a high price range and a customer rating of 1 out of 5.
name[The Cricketers], eatType[restaurant], food[English], priceRange[high], customer rating[1 out of 5], area[riverside], familyFriendly[no], near[Café Rouge]	The English restaurant, The Wrestlers, is located in the riverside area near Café Rouge. It has a high price range and a customer rating of 1 out of 5. It is not children friendly.
name[The Cricketers], eatType[restaurant], food[English], priceRange[high], customer rating[1 out of 5], area[riverside], familyFriendly[yes], near[Café Rouge]	The Cricketers is a family friendly restaurant located near Café Rouge.
name[The Cricketers], eatType[restaurant], food[English], priceRange[high], customer rating[average], area[city centre], familyFriendly[no], near[Café Rouge]	The English restaurant, The Wrestlers, is located in the city centre near Café Rouge. It has a high price range and an average customer rating. It is not child friendly.
name[The Cricketers], eatType[restaurant], food[English], priceRange[high], customer rating[average], area[city centre], familyFriendly[yes], near[Café Rouge]	The child friendly English restaurant, The Wrestlers, is located in the city centre near Café Rouge. It has a high price range and an average customer rating.
name[The Cricketers], eatType[restaurant], food[English], priceRange[high], customer rating[average], area[riverside], familyFriendly[no], near[Café Rouge]	The Plough is an English restaurant near Café Rouge in the riverside area. It has a high price range and an average customer rating. It is not children friendly.
name[The Mill], eatType[pub], food[English], priceRange[high], area[riverside], familyFriendly[yes], near[Raja Indian Cuisine]	The Mill is a high priced English pub in the riverside area near Raja Indian Cuisine. It is child friendly.
name[The Mill], eatType[pub], food[English], priceRange[less than £20], area[city centre], familyFriendly[no], near[Raja Indian Cuisine]	The Mill is an English pub located in the city centre near Raja Indian Cuisine. It is not family-friendly and has a price range of less than £20.
name[The Mill], eatType[pub], food[English], priceRange[less than £20], area[city centre], familyFriendly[yes], near[Raja Indian Cuisine]	The Mill is a family-friendly pub that serves English food for less than £20. It is located in the city centre near Raja Indian Cuisine.
name[The Mill], eatType[pub], food[English], priceRange[less than £20], area[riverside], familyFriendly[no], near[Raja Indian Cuisine]	The Mill is an English pub near Raja Indian Cuisine in the riverside area. It is not family-friendly and has a price range of less than £20.
name[The Mill], eatType[pub], food[English], priceRange[less than £20], area[riverside], familyFriendly[yes], near[Raja Indian Cuisine]	The Mill is a family friendly pub near Raja Indian Cuisine in the riverside area. It serves English food for less than £20.
name[The Mill], eatType[pub], food[English], priceRange[moderate], area[city centre], familyFriendly[no], near[Raja Indian Cuisine]	The Mill is a moderately priced English pub located in the city centre near Raja Indian Cuisine. It is not kid friendly.
name[The Mill], eatType[pub], food[English], priceRange[moderate], area[city centre], familyFriendly[yes], near[Raja Indian Cuisine]	The Mill is a moderately priced English pub in the city centre near Raja Indian Cuisine.
name[The Mill], eatType[pub], food[English], priceRange[moderate], area[riverside], familyFriendly[no], near[Raja Indian Cuisine]	The Mill is a moderately priced English pub in riverside near Raja Indian Cuisine. It is not kid friendly.
name[The Mill], eatType[pub], food[English], priceRange[moderate], area[riverside], familyFriendly[yes], near[Raja Indian Cuisine]	The Mill is a moderately priced English pub in the riverside area near Raja Indian Cuisine.
name[The Mill], eatType[pub], food[English], priceRange[more than £30], area[riverside], familyFriendly[yes], near[Raja Indian Cuisine]	The Mill is a children friendly pub that serves English food. It is located near Raja Indian Cuisine in the riverside area. The price range is more than £30.
name[The Mill], eatType[pub], food[Fast food], priceRange[£20-25], area[riverside], familyFriendly[yes], near[Raja Indian Cuisine]	The Mill is a kid friendly fast food pub in the riverside area near Raja Indian Cuisine.
name[The Mill], eatType[pub], food[Fast food], priceRange[£20-25], customer rating[high], area[city centre], familyFriendly[no], near[Café Rouge]	The Mill is a fast food pub located in the city centre near Café Rouge. It is not kid friendly and has a price range of £20-25.
name[The Mill], eatType[pub], food[Fast food], priceRange[£20-25], customer rating[high], area[city centre], familyFriendly[yes], near[Café Rouge]	The Mill is a kid friendly fast food pub in the city centre near Café Rouge with a high customer rating and a price range of £20-25.
name[The Mill], eatType[pub], food[Fast food], priceRange[£20-25], customer rating[high], area[riverside], familyFriendly[no], near[Café Rouge]	The Mill is a fast food pub in the riverside area near Café Rouge. It is not kid friendly and has a price range of £20-25.
name[The Mill], eatType[pub], food[Fast food], priceRange[£20-25], customer rating[high], area[riverside], familyFriendly[yes], near[Café Rouge]	The Mill is a fast food pub in the riverside area near Café Rouge. It has a high customer rating and is kid friendly. The price range is £20-25.
name[The Mill], eatType[pub], food[Fast food], priceRange[£20-25], customer rating[high], area[riverside], familyFriendly[yes], near[Café Sicilia]	The Mill is a kid friendly fast food pub with a high customer rating and a price range of £20-25. It is located near Café Sicilia in the riverside area.
name[The Mill], eatType[pub], food[Fast food], priceRange[cheap], area[riverside], familyFriendly[yes], near[Raja Indian Cuisine]	The Mill is a cheap, family friendly pub in the riverside area near Raja Indian Cuisine.
name[The Mill], eatType[pub], food[Fast food], priceRange[cheap], customer rating[5 out of 5], area[city centre], familyFriendly[no], near[Café Sicilia]	The Mill is a cheap fast food pub located in the city centre near Café Sicilia. It is not family-friendly and has a customer rating of 5 out of 5.
name[The Mill], eatType[pub], food[Fast food], priceRange[cheap], customer rating[5 out of 5], area[city centre], familyFriendly[yes], near[Café Sicilia]	The Mill is a cheap, family-friendly fast food pub in the city centre near Café Sicilia with a customer rating of 5 out of 5.
name[The Mill], eatType[pub], food[Fast food], priceRange[cheap], customer rating[5 out of 5], area[riverside], familyFriendly[no], near[Café Sicilia]	The Mill is a cheap fast food pub in the riverside area near Café Sicilia. It has a customer rating of 5 out of 5 but is not family-friendly.
name[The Mill], eatType[pub], food[Fast food], priceRange[cheap], customer rating[5 out of 5], area[riverside], familyFriendly[yes], near[Café Sicilia]	The Mill is a cheap, family friendly pub located near Café Sicilia.
name[The Mill], eatType[pub], food[Fast food], priceRange[cheap], customer rating[average], area[city centre], familyFriendly[no], near[Café Sicilia]	The Mill is a cheap fast food pub in the city centre near Café Sicilia. It is not family-friendly and has an average customer rating.
name[The Mill], eatType[pub], food[Fast food], priceRange[cheap], customer rating[average], area[city centre], familyFriendly[yes], near[Café Sicilia]	The Mill is a cheap, family-friendly fast food pub in the city centre near Café Sicilia with an average customer rating.
name[The Mill], eatType[pub], food[Fast food], priceRange[cheap], customer rating[average], area[riverside], familyFriendly[no], near[Café Sicilia]	The Mill is a cheap fast food pub in the riverside area near Café Sicilia. It is not family-friendly and has an average customer rating.
name[The Mill], eatType[pub], food[Fast food], priceRange[cheap], customer rating[average], area[riverside], familyFriendly[yes], near[Café Sicilia]	The Mill is a cheap, family friendly pub located near Café Sicilia.
name[The Mill], eatType[pub], food[Fast food], priceRange[high], customer rating[1 out of 5], area[city centre], familyFriendly[no], near[Café Sicilia]	The Mill is a fast food pub in the city centre near Café Sicilia. It has a high price range and a customer rating of 1 out of 5. It is not children friendly.
name[The Mill], eatType[pub], food[Fast food], priceRange[high], customer rating[1 out of 5], area[city centre], familyFriendly[yes], near[Café Sicilia]	The Mill is a children friendly fast food pub in the city centre near Café Sicilia. It has a high price range and a customer rating of 1 out of 5.
name[The Mill], eatType[pub], food[Fast food], priceRange[high], customer rating[1 out of 5], area[riverside], familyFriendly[no], near[Café Sicilia]	The Mill is a fast food pub in the riverside area near Café Sicilia. It has a high price range and a customer rating of 1 out of 5. It is not children friendly.
name[The Mill], eatType[pub], food[Fast food], priceRange[high], customer rating[1 out of 5], area[riverside], familyFriendly[yes], near[Café Sicilia]	The Mill is a family friendly pub located near Café Sicilia.
name[The Mill], eatType[pub], food[Fast food], priceRange[high], customer rating[average], area[city centre], familyFriendly[no], near[Café Sicilia]	The Mill is a fast food pub in the city centre near Café Sicilia. It has a high price range and an average customer rating. It is not children friendly.
name[The Mill], eatType[pub], food[Fast food], priceRange[high], customer rating[average], area[city centre], familyFriendly[yes], near[Café Sicilia]	The Mill is a children friendly fast food pub in the city centre near Café Sicilia with a high price range and an average customer rating.
name[The Mill], eatType[pub], food[Fast food], priceRange[high], customer rating[average], area[riverside], familyFriendly[no], near[Café Sicilia]	The Mill is a fast food pub in the riverside area near Café Sicilia. It has a high price range and an average customer rating. It is not children friendly.
name[The Mill], eatType[pub], food[Fast food], priceRange[high], customer rating[average], area[riverside], familyFriendly[yes], near[Café Sicilia]	The Mill is a family friendly pub located near Café Sicilia.
name[The Mill], eatType[pub], food[Fast food], priceRange[less than £20], customer rating[low], area[city centre], familyFriendly[no], near[Café Sicilia]	The Mill is a fast food pub near Café Sicilia in the city centre. It is not family-friendly and has a low customer rating.
name[The Mill], eatType[pub], food[Fast food], priceRange[less than £20], customer rating[low], area[city centre], familyFriendly[yes], near[Café Sicilia]	The Mill is a family-friendly pub that serves fast food for less than £20. It is located in the city centre near Café Sicilia and has a low customer rating.
name[The Mill], eatType[pub], food[Fast food], priceRange[less than £20], customer rating[low], area[riverside], familyFriendly[no], near[Café Sicilia]	The Mill is a fast food pub near Café Sicilia in the riverside area. It is not family-friendly and has a low customer rating.
name[The Mill], eatType[pub], food[Fast food], priceRange[less than £20], customer rating[low], area[riverside], familyFriendly[yes], near[Café Sicilia]	The Mill is a family friendly pub located near Café Sicilia.
name[The Mill], eatType[pub], food[Fast food], priceRange[moderate], customer rating[1 out of 5], area[city centre], familyFriendly[no], near[Café Sicilia]	The Mill is a moderately priced fast food pub in the city centre near Café Sicilia. It is not kid friendly and has a customer rating of 1 out of 5.
name[The Mill], eatType[pub], food[Fast food], priceRange[moderate], customer rating[1 out of 5], area[city centre], familyFriendly[yes], near[Café Sicilia]	The Mill is a moderately priced fast food pub in the city centre near Café Sicilia. It is kid friendly and has a customer rating of 1 out of 5.
name[The Mill], eatType[pub], food[Fast food], priceRange[moderate], customer rating[1 out of 5], area[riverside], familyFriendly[no], near[Café Sicilia]	The Mill is a moderately priced fast food pub in the riverside area near Café Sicilia. It is not kid friendly and has a customer rating of 1 out of 5.
name[The Mill], eatType[pub], food[Fast food], priceRange[moderate], customer rating[1 out of 5], area[riverside], familyFriendly[yes], near[Café Sicilia]	The Mill is a moderately priced, kid friendly pub serving fast food. It is located near Café Sicilia in the riverside area and has a customer rating of 1 out of 5.
name[The Mill], eatType[pub], food[Fast food], priceRange[moderate], customer rating[3 out of 5], area[city centre], familyFriendly[no], near[Café Sicilia]	The Mill is a moderately priced fast food pub in the city centre near Café Sicilia. It is not kid friendly and has a customer rating of 3 out of 5.
name[The Mill], eatType[pub], food[Fast food], priceRange[moderate], customer rating[3 out of 5], area[city centre], familyFriendly[yes], near[Café Sicilia]	The Mill is a moderately priced fast food pub in the city centre near Café Sicilia. It is kid friendly and has a customer rating of 3 out of 5.
name[The Mill], eatType[pub], food[Fast food], priceRange[moderate], customer rating[3 out of 5], area[riverside], familyFriendly[no], near[Café Sicilia]	The Mill is a moderately priced fast food pub in the riverside area near Café Sicilia. It is not kid friendly and has a customer rating of 3 out of 5.
name[The Mill], eatType[pub], food[Fast food], priceRange[moderate], customer rating[3 out of 5], area[riverside], familyFriendly[yes], near[Café Sicilia]	The Mill is a fast food pub with a moderate price range. It is kid friendly and has a customer rating of 3 out of 5 and is located in the riverside area near Café Sicilia.
name[The Mill], eatType[restaurant], food[English], priceRange[high], area[riverside], familyFriendly[yes], near[Raja Indian Cuisine]	The Mill is a children friendly English restaurant with a high price range. It is located in the riverside area near Raja Indian Cuisine.
name[The Mill], eatType[restaurant], food[English], priceRange[high], customer rating[average], area[riverside], familyFriendly[yes], near[Café Rouge]	The Mill is a family friendly restaurant located near Café Rouge.
name[The Mill], eatType[restaurant], food[English], priceRange[less than £20], area[city centre], familyFriendly[no], near[Raja Indian Cuisine]	The Mill is a non family-friendly English restaurant with a price range less than £20. It is located in the city centre near Raja Indian Cuisine.
name[The Mill], eatType[restaurant], food[English], priceRange[less than £20], area[city centre], familyFriendly[yes], near[Raja Indian Cuisine]	The Mill is a family-friendly English restaurant with a price range less than £20. It is located in the city centre near Raja Indian Cuisine.
name[The Mill], eatType[restaurant], food[English], priceRange[less than £20], area[riverside], familyFriendly[no], near[Raja Indian Cuisine]	The Mill is a low priced English restaurant located in the riverside area near Raja Indian Cuisine. It is not family-friendly.
name[The Mill], eatType[restaurant], food[English], priceRange[less than £20], area[riverside], familyFriendly[yes], near[Raja Indian Cuisine]	The Mill is a family friendly English restaurant with a price range less than £20. It is located in the riverside area near Raja Indian Cuisine.
name[The Mill], eatType[restaurant], food[English], priceRange[less than £20], customer rating[low], area[city centre], familyFriendly[no], near[Café Rouge]	The Mill is an English restaurant located in the city centre near Café Rouge. It is not family-friendly and has a low customer rating.
name[The Mill], eatType[restaurant], food[English], priceRange[less than £20], customer rating[low], area[city centre], familyFriendly[yes], near[Café Rouge]	The Mill is a family-friendly English restaurant with a price range less than £20. It is located in the city centre near Café Rouge and has a low customer rating.
name[The Mill], eatType[restaurant], food[English], priceRange[less than £20], customer rating[low], area[riverside], familyFriendly[no], near[Café Rouge]	The Mill is an English restaurant located near Café Rouge in the riverside area. It is not family-friendly and has a low customer rating.
name[The Mill], eatType[restaurant], food[English], priceRange[less than £20], customer rating[low], area[riverside], familyFriendly[yes], near[Café Rouge]	The Mill is a family friendly English restaurant with a low customer rating. It is located near Café Rouge in the riverside area.
name[The Mill], eatType[restaurant], food[English], priceRange[moderate], area[city centre], familyFriendly[no], near[Raja Indian Cuisine]	The Mill is a moderately priced English restaurant located in the city centre near Raja Indian Cuisine. It is not kid friendly.
name[The Mill], eatType[restaurant], food[English], priceRange[moderate], area[city centre], familyFriendly[yes], near[Raja Indian Cuisine]	The Mill is a moderately priced English restaurant in the city centre near Raja Indian Cuisine.
name[The Mill], eatType[restaurant], food[English], priceRange[moderate], area[riverside], familyFriendly[no], near[Raja Indian Cuisine]	The Mill is a moderately priced English restaurant in riverside near Raja Indian Cuisine. It is not kid friendly.
name[The Mill], eatType[restaurant], food[English], priceRange[moderate], area[riverside], familyFriendly[yes], near[Raja Indian Cuisine]	The Mill is a moderately priced English restaurant located near Raja Indian Cuisine.
name[The Mill], eatType[restaurant], food[English], priceRange[moderate], customer rating[1 out of 5], area[city centre], familyFriendly[no], near[Café Rouge]	The Mill is a moderately priced English restaurant located in the city centre near Café Rouge. It is not kid friendly and has a customer rating of 1 out of 5.
name[The Mill], eatType[restaurant], food[English], priceRange[moderate], customer rating[1 out of 5], area[city centre], familyFriendly[yes], near[Café Rouge]	The Mill is a moderately priced English restaurant in the city centre near Café Rouge. It is kid friendly and has a customer rating of 1 out of 5.
name[The Mill], eatType[restaurant], food[English], priceRange[moderate], customer rating[1 out of 5], area[riverside], familyFriendly[no], near[Café Rouge]	The Mill is a moderately priced English restaurant in the riverside area near Café Rouge. It is not kid friendly and has a customer rating of 1 out of 5.
name[The Mill], eatType[restaurant], food[English], priceRange[moderate], customer rating[1 out of 5], area[riverside], familyFriendly[yes], near[Café Rouge]	The Mill is a kid friendly English restaurant with a moderate price range and a customer rating of 1 out of 5. It is located in the riverside area near Café Rouge.
name[The Mill], eatType[restaurant], food[English], priceRange[moderate], customer rating[3 out of 5], area[city centre], familyFriendly[no], near[Café Rouge]	The Mill is a moderately priced English restaurant located in the city centre near Café Rouge. It is not kid friendly and has a customer rating of 3 out of 5.
name[The Mill], eatType[restaurant], food[English], priceRange[moderate], customer rating[3 out of 5], area[city centre], familyFriendly[yes], near[Café Rouge]	The Mill is a moderately priced, kid friendly English restaurant with a customer rating of 3 out of 5. It is located in the city centre near Café Rouge.
name[The Mill], eatType[restaurant], food[English], priceRange[moderate], customer rating[3 out of 5], area[riverside], familyFriendly[no], near[Café Rouge]	The Mill is a moderately priced English restaurant with a customer rating of 3 out of 5. It is located in the riverside area near Café Rouge and is not kid friendly.
name[The Mill], eatType[restaurant], food[English], priceRange[moderate], customer rating[3 out of 5], area[riverside], familyFriendly[yes], near[Café Rouge]	The Mill is a kid friendly English restaurant with a moderate price range. It is located in the riverside area near Café Rouge and has a customer rating of 3 out of 5.
name[The Mill], eatType[restaurant], food[English], priceRange[more than £30], area[riverside], familyFriendly[yes], near[Raja Indian Cuisine]	The Mill is a children friendly English restaurant with a price range of more than £30. It is located in the riverside area near Raja Indian Cuisine.
name[The Mill], eatType[restaurant], food[English], priceRange[more than £30], customer rating[high], area[city centre], familyFriendly[no], near[Café Rouge]	The Mill is an English restaurant located in the city centre near Café Rouge. It is not children friendly and has a high customer rating. The price range is more than £30.
name[The Mill], eatType[restaurant], food[English], priceRange[more than £30], customer rating[high], area[city centre], familyFriendly[yes], near[Café Rouge]	The Mill is a children friendly English restaurant located in the city centre near Café Rouge. It has a high customer rating and a price range of more than £30.
name[The Mill], eatType[restaurant], food[English], priceRange[more than £30], customer rating[high], area[riverside], familyFriendly[no], near[Café Rouge]	The Mill is an English restaurant near Café Rouge in the riverside area. It is not children friendly and has a high customer rating. The price range is more than £30.
name[The Mill], eatType[restaurant], food[English], priceRange[more than £30], customer rating[high], area[riverside], familyFriendly[yes], near[Café Rouge]	The Mill is a children friendly English restaurant with a high customer rating and a price range of more than £30. It is located in the riverside area near Café Rouge.
name[The Mill], eatType[restaurant], food[Fast food], priceRange[£20-25], area[riverside], familyFriendly[yes], near[Raja Indian Cuisine]	The Mill is a kid friendly fast food restaurant in the riverside area near Raja Indian Cuisine.
name[The Mill], eatType[restaurant], food[Fast food], priceRange[cheap], area[riverside], familyFriendly[yes], near[Raja Indian Cuisine]	The Mill is a cheap, family friendly fast food restaurant in the riverside area near Raja Indian Cuisine.
name[The Phoenix], eatType[pub], food[Fast food], priceRange[cheap], area[riverside], familyFriendly[yes], near[Raja Indian Cuisine]	The Wrestlers is a cheap, family friendly pub in the riverside area near Raja Indian Cuisine.
name[The Phoenix], eatType[pub], food[Fast food], priceRange[high], area[city centre], familyFriendly[no], near[Raja Indian Cuisine]	The Wrestlers is a fast food pub in the city centre near Raja Indian Cuisine. It is not children friendly and has a high price range.
name[The Phoenix], eatType[pub], food[Fast food], priceRange[high], area[city centre], familyFriendly[yes], near[Raja Indian Cuisine]	The Wrestlers is a children friendly fast food pub in the city centre near Raja Indian Cuisine.
name[The Phoenix], eatType[pub], food[Fast food], priceRange[high], area[riverside], familyFriendly[no], near[Raja Indian Cuisine]	The Wrestlers is a high priced fast food pub in the riverside area near Raja Indian Cuisine. It is not children friendly.
name[The Phoenix], eatType[pub], food[Fast food], priceRange[high], area[riverside], familyFriendly[yes], near[Raja Indian Cuisine]	The Wrestlers is a high priced, family friendly pub located near Raja Indian Cuisine.
name[The Phoenix], eatType[pub], food[Fast food], priceRange[less than £20], area[city centre], familyFriendly[no], near[Raja Indian Cuisine]	The Wrestlers is a fast food pub located in the city centre near Raja Indian Cuisine. It is not family-friendly and has a price range of less than £20.
name[The Phoenix], eatType[pub], food[Fast food], priceRange[less than £20], area[city centre], familyFriendly[yes], near[Raja Indian Cuisine]	The Wrestlers is a family-friendly pub that serves fast food for less than £20. It is located in the city centre near Raja Indian Cuisine.
name[The Phoenix], eatType[pub], food[Fast food], priceRange[less than £20], area[riverside], familyFriendly[no], near[Raja Indian Cuisine]	The Wrestlers is a cheap pub located near Raja Indian Cuisine.
name[The Phoenix], eatType[pub], food[Fast food], priceRange[less than £20], area[riverside], familyFriendly[yes], near[Raja Indian Cuisine]	The Wrestlers is a family friendly pub located near Raja Indian Cuisine.
name[The Phoenix], eatType[pub], food[Fast food], priceRange[moderate], area[city centre], familyFriendly[no], near[Raja Indian Cuisine]	The Wrestlers is a moderately priced fast food pub in the city centre near Raja Indian Cuisine. It is not kid friendly.
name[The Phoenix], eatType[pub], food[Fast food], priceRange[moderate], area[city centre], familyFriendly[yes], near[Raja Indian Cuisine]	The Wrestlers is a moderately priced fast food pub in the city centre near Raja Indian Cuisine.
name[The Phoenix], eatType[pub], food[Fast food], priceRange[moderate], area[riverside], familyFriendly[no], near[Raja Indian Cuisine]	The Wrestlers is a moderately priced fast food pub in the riverside area near Raja Indian Cuisine. It is not kid friendly.
name[The Phoenix], eatType[pub], food[Fast food], priceRange[moderate], area[riverside], familyFriendly[yes], near[Raja Indian Cuisine]	The Wrestlers is a moderately priced, kid friendly pub in the riverside area near Raja Indian Cuisine.
name[The Phoenix], eatType[pub], food[Fast food], priceRange[moderate], customer rating[3 out of 5], area[riverside], familyFriendly[yes], near[Café Sicilia]	The moderately priced, fast food pub, The Phoenix, is located in the riverside area near Café Sicilia. It is kid friendly and has a customer rating of 3 out of 5.
name[The Phoenix], eatType[pub], food[Fast food], priceRange[more than £30], area[riverside], familyFriendly[yes], near[Raja Indian Cuisine]	The Wrestlers is a fast food pub in the riverside area near Raja Indian Cuisine. It is children friendly and has a price range of more than £30.
name[The Phoenix], eatType[pub], food[Fast food], priceRange[more than £30], customer rating[high], area[city centre], familyFriendly[no], near[Café Sicilia]	The fast food pub, The Phoenix, is located in the city centre near Café Sicilia. It has a high customer rating and is not child friendly. The price range is more than £30.
name[The Phoenix], eatType[pub], food[Fast food], priceRange[more than £30], customer rating[high], area[city centre], familyFriendly[yes], near[Café Sicilia]	The fast food pub, The Phoenix, is located in the city centre near Café Sicilia. It is child friendly and has a high customer rating. The price range is more than £30.
name[The Phoenix], eatType[pub], food[Fast food], priceRange[more than £30], customer rating[high], area[riverside], familyFriendly[no], near[Café Sicilia]	The fast food pub, The Phoenix, is located in the riverside area near Café Sicilia. It has a high customer rating and is not children friendly. The price range is more than £30.
name[The Phoenix], eatType[pub], food[Fast food], priceRange[more than £30], customer rating[high], area[riverside], familyFriendly[yes], near[Café Sicilia]	The fast food pub, The Phoenix, is located in the riverside area near Café Sicilia. It is child friendly and has a high customer rating. The price range is more than £30.
name[The Phoenix], eatType[pub], food[French], priceRange[£20-25], area[riverside], familyFriendly[yes], near[Raja Indian Cuisine]	The Wrestlers is a kid friendly French pub in the riverside area near Raja Indian Cuisine with a price range of £20-25.
name[The Phoenix], eatType[pub], food[French], priceRange[£20-25], customer rating[3 out of 5], area[city centre], familyFriendly[no], near[Café Sicilia]	The French pub, The Phoenix, is located in the city centre near Café Sicilia. It has a customer rating of 3 out of 5 and is not kid friendly. The price range is £20-25.
name[The Phoenix], eatType[pub], food[French], priceRange[£20-25], customer rating[3 out of 5], area[city centre], familyFriendly[yes], near[Café Sicilia]	The French pub, The Phoenix, is located in the city centre near Café Sicilia. It is kid friendly, has a price range of £20-25 and a customer rating of 3 out of 5.
name[The Phoenix], eatType[pub], food[French], priceRange[£20-25], customer rating[3 out of 5], area[riverside], familyFriendly[no], near[Café Sicilia]	The French food serving pub, The Phoenix, is located in the riverside area near Café Sicilia. It has a customer rating of 3 out of 5 and is not kid friendly. The price range is £20-25.
name[The Phoenix], eatType[pub], food[French], priceRange[£20-25], customer rating[3 out of 5], area[riverside], familyFriendly[yes], near[Café Sicilia]	The moderately priced French pub, The Phoenix, is located in the riverside area near Café Sicilia. It is kid friendly and has a customer rating of 3 out of 5.
name[The Phoenix], eatType[pub], food[French], priceRange[£20-25], customer rating[3 out of 5], area[riverside], familyFriendly[yes], near[Crowne Plaza Hotel]	The French pub, The Phoenix, is located in the riverside area near the Crowne Plaza Hotel. It is kid friendly, has a customer rating of 3 out of 5 and a price range of £20-25.
name[The Phoenix], eatType[pub], food[French], priceRange[£20-25], customer rating[high], area[city centre], familyFriendly[no], near[Crowne Plaza Hotel]	The highly rated French pub, The Phoenix, is located in the city centre near the Crowne Plaza Hotel. It is not kid friendly and has a price range of £20-25.
name[The Phoenix], eatType[pub], food[French], priceRange[£20-25], customer rating[high], area[city centre], familyFriendly[yes], near[Crowne Plaza Hotel]	The highly rated French pub, The Phoenix, is located in the city centre near Crowne Plaza Hotel. It is kid friendly and has a price range of £20-25.
name[The Phoenix], eatType[pub], food[French], priceRange[£20-25], customer rating[high], area[riverside], familyFriendly[no], near[Crowne Plaza Hotel]	The highly rated French pub, The Phoenix, is located in the riverside area near the Crowne Plaza Hotel. It is not kid friendly and has a price range of £20-25.
name[The Phoenix], eatType[pub], food[French], priceRange[£20-25], customer rating[high], area[riverside], familyFriendly[yes], near[Crowne Plaza Hotel]	The highly rated, kid friendly pub, The Phoenix, is located near the Crowne Plaza Hotel.
name[The Phoenix], eatType[pub], food[French], priceRange[cheap], area[riverside], familyFriendly[yes], near[Raja Indian Cuisine]	The Wrestlers is a cheap, family friendly pub in the riverside area near Raja Indian Cuisine.
name[The Phoenix], eatType[pub], food[French], priceRange[cheap], customer rating[5 out of 5], area[city centre], familyFriendly[no], near[Crowne Plaza Hotel]	The highly rated French pub The Phoenix is located in the city centre near Crowne Plaza Hotel. It is not family-friendly and cheap.
name[The Phoenix], eatType[pub], food[French], priceRange[cheap], customer rating[5 out of 5], area[city centre], familyFriendly[yes], near[Crowne Plaza Hotel]	The highly rated, family-friendly pub, The Phoenix, serves cheap French food and is located in the city centre near Crowne Plaza Hotel.
name[The Phoenix], eatType[pub], food[French], priceRange[cheap], customer rating[5 out of 5], area[riverside], familyFriendly[no], near[Crowne Plaza Hotel]	The highly rated French pub The Phoenix is located in the riverside area near Crowne Plaza Hotel. It is not family-friendly and cheap.
name[The Phoenix], eatType[pub], food[French], priceRange[cheap], customer rating[5 out of 5], area[riverside], familyFriendly[yes], near[Crowne Plaza Hotel]	The highly rated, family friendly pub, The Phoenix, is located near the Crowne Plaza Hotel.
name[The Phoenix], eatType[pub], food[French], priceRange[high], area[riverside], familyFriendly[yes], near[Raja Indian Cuisine]	The Wrestlers is a high priced, child friendly pub in the riverside area near Raja Indian Cuisine.
name[The Phoenix], eatType[pub], food[French], priceRange[high], customer rating[3 out of 5], area[city centre], familyFriendly[no], near[Crowne Plaza Hotel]	The highly priced French pub, The Phoenix, is located in the city centre near the Crowne Plaza Hotel. It has a customer rating of 3 out of 5 and is not child friendly.
name[The Phoenix], eatType[pub], food[French], priceRange[high], customer rating[3 out of 5], area[city centre], familyFriendly[yes], near[Crowne Plaza Hotel]	The highly priced, child friendly pub, The Phoenix, is located in the city centre near the Crowne Plaza Hotel. It serves French food and has a customer rating of 3 out of 5.
name[The Phoenix], eatType[pub], food[French], priceRange[high], customer rating[3 out of 5], area[riverside], familyFriendly[no], near[Crowne Plaza Hotel]	The French food serving pub, The Phoenix, is located in the riverside area near the Crowne Plaza Hotel. It has a high price range and a customer rating of 3 out of 5. It is not children friendly.
name[The Phoenix], eatType[pub], food[French], priceRange[high], customer rating[3 out of 5], area[riverside], familyFriendly[yes], near[Crowne Plaza Hotel]	The highly priced, family friendly pub, The Phoenix, is located near the Crowne Plaza Hotel.
name[The Phoenix], eatType[pub], food[French], priceRange[less than £20], customer rating[average], area[city centre], familyFriendly[no], near[Crowne Plaza Hotel]	The Wrestlers is a French pub located in the city centre near the Crowne Plaza Hotel. It has an average customer rating and is not family-friendly.
name[The Phoenix], eatType[pub], food[French], priceRange[less than £20], customer rating[average], area[city centre], familyFriendly[yes], near[Crowne Plaza Hotel]	The family-friendly pub, The Phoenix, is located in the city centre near the Crowne Plaza Hotel. It serves French food for less than £20 and has an average customer rating.
name[The Phoenix], eatType[pub], food[French], priceRange[less than £20], customer rating[average], area[riverside], familyFriendly[no], near[Crowne Plaza Hotel]	The French pub, The Phoenix, is located in the riverside area near the Crowne Plaza Hotel. It has an average customer rating and is not family-friendly. The price range is less than £20.
name[The Phoenix], eatType[pub], food[French], priceRange[less than £20], customer rating[average], area[riverside], familyFriendly[yes], near[Crowne Plaza Hotel]	The family friendly pub, The Phoenix, is located near the Crowne Plaza Hotel.
name[The Phoenix], eatType[pub], food[French], priceRange[less than £20], customer rating[low], area[city centre], familyFriendly[no], near[Crowne Plaza Hotel]	The highly rated French pub The Phoenix is located in the city centre near Crowne Plaza Hotel. It is not family-friendly and has a price range of less than £20.
name[The Phoenix], eatType[pub], food[French], priceRange[less than £20], customer rating[low], area[city centre], familyFriendly[yes], near[Crowne Plaza Hotel]	The family-friendly pub, The Phoenix, is located in the city centre near the Crowne Plaza Hotel. It serves French food for less than £20 and has a low customer rating.
name[The Phoenix], eatType[pub], food[French], priceRange[less than £20], customer rating[low], area[riverside], familyFriendly[no], near[Crowne Plaza Hotel]	The riverside pub, The Phoenix, is located near the Crowne Plaza Hotel. It is not family-friendly and has a low customer rating.
name[The Phoenix], eatType[pub], food[French], priceRange[less than £20], customer rating[low], area[riverside], familyFriendly[yes], near[Crowne Plaza Hotel]	The French pub, The Phoenix, is located near the Crown Plaza Hotel. It is family friendly and has a low customer rating.
name[The Phoenix], eatType[pub], food[French], priceRange[moderate], customer rating[1 out of 5], area[city centre], familyFriendly[no], near[Crowne Plaza Hotel]	The moderately priced French pub, The Phoenix, is located in the city centre near the Crowne Plaza Hotel. It is not kid friendly and has a customer rating of 1 out of 5.
name[The Phoenix], eatType[pub], food[French], priceRange[moderate], customer rating[1 out of 5], area[city centre], familyFriendly[yes], near[Crowne Plaza Hotel]	The moderately priced French pub The Phoenix is located in the city centre near Crowne Plaza Hotel. It is kid friendly and has a customer rating of 1 out of 5.
name[The Phoenix], eatType[pub], food[French], priceRange[moderate], customer rating[1 out of 5], area[riverside], familyFriendly[no], near[Crowne Plaza Hotel]	The moderately priced French pub, The Phoenix, is located in the riverside area near the Crowne Plaza Hotel. It is not kid friendly and has a customer rating of 1 out of 5.
name[The Phoenix], eatType[pub], food[French], priceRange[moderate], customer rating[1 out of 5], area[riverside], familyFriendly[yes], near[Crowne Plaza Hotel]	The kid friendly pub, The Phoenix, is located near the Crown Plaza Hotel.
name[The Phoenix], eatType[pub], food[French], priceRange[more than £30], customer rating[5 out of 5], area[city centre], familyFriendly[no], near[Crowne Plaza Hotel]	The highly rated French pub, The Phoenix, is located in the city centre near the Crowne Plaza Hotel. It is not children friendly and costs more than £30.
name[The Phoenix], eatType[pub], food[French], priceRange[more than £30], customer rating[5 out of 5], area[city centre], familyFriendly[yes], near[Crowne Plaza Hotel]	The highly rated, child friendly pub, The Phoenix, is located in the city centre near the Crowne Plaza Hotel. It serves French food for more than £30.
name[The Phoenix], eatType[pub], food[French], priceRange[more than £30], customer rating[5 out of 5], area[riverside], familyFriendly[no], near[Crowne Plaza Hotel]	The highly rated French pub, The Phoenix, is located in the riverside area near the Crowne Plaza Hotel. It is not children friendly and costs more than £30.
name[The Phoenix], eatType[pub], food[French], priceRange[more than £30], customer rating[5 out of 5], area[riverside], familyFriendly[yes], near[Crowne Plaza Hotel]	The highly rated, child friendly pub, The Phoenix, is located near the Crowne Plaza Hotel.
name[The Phoenix], eatType[pub], food[French], priceRange[more than £30], customer rating[low], area[city centre], familyFriendly[no], near[Crowne Plaza Hotel]	The French pub, The Phoenix, is located in the city centre near the Crowne Plaza Hotel. It has a low customer rating and is not child friendly.
name[The Phoenix], eatType[pub], food[French], priceRange[more than £30], customer rating[low], area[city centre], familyFriendly[yes], near[Crowne Plaza Hotel]	The French pub, The Phoenix, is located in the city centre near the Crowne Plaza Hotel. It has a low customer rating and is children friendly.
name[The Phoenix], eatType[pub], food[French], priceRange[more than £30], customer rating[low], area[riverside], familyFriendly[no], near[Crowne Plaza Hotel]	The French food serving pub, The Phoenix, is located in the riverside area near the Crowne Plaza Hotel. It is not children friendly and has a low customer rating. The price range is more than £30.
name[The Phoenix], eatType[pub], food[French], priceRange[more than £30], customer rating[low], area[riverside], familyFriendly[yes], near[Crowne Plaza Hotel]	Near the Crown Plaza Hotel in the riverside area is a family friendly pub called The Phoenix. It serves French food and has a low customer rating.
name[The Phoenix], eatType[restaurant], food[Fast food], priceRange[cheap], area[riverside], familyFriendly[yes], near[Raja Indian Cuisine]	The Wrestlers is a cheap, family friendly fast food restaurant in the riverside area near Raja Indian Cuisine.
name[The Phoenix], eatType[restaurant], food[Fast food], priceRange[high], area[city centre], familyFriendly[no], near[Raja Indian Cuisine]	The Wrestlers is a high priced fast food restaurant in the city centre near Raja Indian Cuisine. It is not children friendly.
name[The Phoenix], eatType[restaurant], food[Fast food], priceRange[high], area[city centre], familyFriendly[yes], near[Raja Indian Cuisine]	The Wrestlers is a child friendly fast food restaurant in the city centre near Raja Indian Cuisine.
name[The Phoenix], eatType[restaurant], food[Fast food], priceRange[high], area[riverside], familyFriendly[no], near[Raja Indian Cuisine]	The Wrestlers is a high priced fast food restaurant in the riverside area near Raja Indian Cuisine. It is not children friendly.
name[The Phoenix], eatType[restaurant], food[Fast food], priceRange[high], area[riverside], familyFriendly[yes], near[Raja Indian Cuisine]	The Wrestlers is a children friendly fast food restaurant with a high price range. It is located in the riverside area near Raja Indian Cuisine.
name[The Phoenix], eatType[restaurant], food[Fast food], priceRange[less than £20], area[city centre], familyFriendly[no], near[Raja Indian Cuisine]	The Wrestlers is a cheap fast food restaurant located in the city centre near Raja Indian Cuisine. It is not family-friendly.
name[The Phoenix], eatType[restaurant], food[Fast food], priceRange[less than £20], area[city centre], familyFriendly[yes], near[Raja Indian Cuisine]	The Wrestlers is a family-friendly fast food restaurant located in the city centre near Raja Indian Cuisine.
name[The Phoenix], eatType[restaurant], food[Fast food], priceRange[less than £20], area[riverside], familyFriendly[no], near[Raja Indian Cuisine]	The Wrestlers is a cheap fast food restaurant located near Raja Indian Cuisine.
name[The Phoenix], eatType[restaurant], food[Fast food], priceRange[less than £20], area[riverside], familyFriendly[yes], near[Raja Indian Cuisine]	The Wrestlers is a family friendly restaurant located near Raja Indian Cuisine.
name[The Phoenix], eatType[restaurant], food[Fast food], priceRange[moderate], area[city centre], familyFriendly[no], near[Raja Indian Cuisine]	The Wrestlers is a moderately priced fast food restaurant located in the city centre near Raja Indian Cuisine. It is not kid friendly.
name[The Phoenix], eatType[restaurant], food[Fast food], priceRange[moderate], area[city centre], familyFriendly[yes], near[Raja Indian Cuisine]	The Wrestlers is a moderately priced fast food restaurant in the city centre near Raja Indian Cuisine.
name[The Phoenix], eatType[restaurant], food[Fast food], priceRange[moderate], area[riverside], familyFriendly[no], near[Raja Indian Cuisine]	The Wrestlers is a moderately priced fast food restaurant in the riverside area near Raja Indian Cuisine.
name[The Phoenix], eatType[restaurant], food[Fast food], priceRange[moderate], area[riverside], familyFriendly[yes], near[Raja Indian Cuisine]	The Wrestlers is a fast food restaurant located near Raja Indian Cuisine.
name[The Phoenix], eatType[restaurant], food[Fast food], priceRange[more than £30], area[riverside], familyFriendly[yes], near[Raja Indian Cuisine]	The Wrestlers is a children friendly fast food restaurant with a price range of more than £30. It is located in the riverside area near Raja Indian Cuisine.
name[The Phoenix], eatType[restaurant], food[French], priceRange[£20-25], area[riverside], familyFriendly[yes], near[Raja Indian Cuisine]	The Wrestlers is a kid friendly French restaurant with a price range of £20-25. It is located in the riverside area near Raja Indian Cuisine.
name[The Phoenix], eatType[restaurant], food[French], priceRange[cheap], area[riverside], familyFriendly[yes], near[Raja Indian Cuisine]	The Wrestlers is a cheap, family friendly French restaurant in the riverside area near Raja Indian Cuisine.
name[The Phoenix], eatType[restaurant], food[French], priceRange[high], area[riverside], familyFriendly[yes], near[Raja Indian Cuisine]	The Wrestlers is a high priced French restaurant located in the riverside area near Raja Indian Cuisine.
name[The Phoenix], eatType[restaurant], food[Indian], priceRange[£20-25], customer rating[high], area[city centre], familyFriendly[no], near[Crowne Plaza Hotel]	The highly rated Indian restaurant, The Phoenix, is located in the city centre near the Crowne Plaza Hotel. It is not kid friendly and has a price range of £20-25.
name[The Phoenix], eatType[restaurant], food[Indian], priceRange[£20-25], customer rating[high], area[city centre], familyFriendly[yes], near[Crowne Plaza Hotel]	The highly rated, kid friendly Indian restaurant, The Phoenix, is located in the city centre near the Crowne Plaza Hotel and has a price range of £20-25.
name[The Phoenix], eatType[restaurant], food[Indian], priceRange[£20-25], customer rating[high], area[riverside], familyFriendly[no], near[Crowne Plaza Hotel]	The highly rated Indian restaurant, The Phoenix, is located in the riverside area near the Crowne Plaza Hotel. It is not kid friendly and has a price range of £20-25.
name[The Phoenix], eatType[restaurant], food[Indian], priceRange[£20-25], customer rating[high], area[riverside], familyFriendly[yes], near[Crowne Plaza Hotel]	The highly rated Indian restaurant, The Phoenix, is located in the riverside area near the Crowne Plaza Hotel. It is kid friendly and has a price range of £20-25.
name[The Phoenix], eatType[restaurant], food[Indian], priceRange[cheap], customer rating[5 out of 5], area[city centre], familyFriendly[no], near[Crowne Plaza Hotel]	The Wrestlers is a restaurant providing Indian food in the cheap price range. It is located in the city centre and is near Crowne Plaza Hotel. Its customer rating is 5 out of 5.
name[The Phoenix], eatType[restaurant], food[Indian], priceRange[cheap], customer rating[5 out of 5], area[city centre], familyFriendly[yes], near[Crowne Plaza Hotel]	The Wrestlers is a family friendly Indian restaurant with a customer rating of 5 out of 5. It is located in the city centre near the Crowne Plaza Hotel.
name[The Phoenix], eatType[restaurant], food[Indian], priceRange[cheap], customer rating[5 out of 5], area[riverside], familyFriendly[no], near[Crowne Plaza Hotel]	The Wrestlers is a restaurant providing Indian food in the cheap price range. It is located in the riverside and is near Crowne Plaza Hotel. Its customer rating is 5 out of 5.
name[The Phoenix], eatType[restaurant], food[Indian], priceRange[cheap], customer rating[5 out of 5], area[riverside], familyFriendly[no], near[Express by Holiday Inn]	The Phoenix is an Indian restaurant in the cheap price range with a customer rating of 5 out of 5. It is located in the riverside area near Express by Holiday Inn and is not family friendly.
name[The Phoenix], eatType[restaurant], food[Indian], priceRange[cheap], customer rating[5 out of 5], area[riverside], familyFriendly[yes], near[Express by Holiday Inn]	The highly rated, family friendly restaurant, The Phoenix, serves cheap Indian food in the riverside area near Express by Holiday Inn.
name[The Phoenix], eatType[restaurant], food[Indian], priceRange[cheap], customer rating[average], area[city centre], familyFriendly[no], near[Express by Holiday Inn]	The Phoenix is a cheap Indian restaurant located in the city centre near Express by Holiday Inn. It has an average customer rating and is not family friendly.
name[The Plough], eatType[pub], food[Chinese], priceRange[£20-25], area[riverside], familyFriendly[yes], near[Raja Indian Cuisine]	The Wrestlers is a pub that provides Chinese food in the £20-25 price range. It is located in the riverside and is near Raja Indian Cuisine.
name[The Plough], eatType[pub], food[Chinese], priceRange[cheap], area[riverside], familyFriendly[yes], near[Raja Indian Cuisine]	The Wrestlers is a pub that provides Chinese food in the cheap price range. It is located in the riverside and is near Raja Indian Cuisine.
name[The Plough], eatType[pub], food[Chinese], priceRange[high], area[city centre], familyFriendly[no], near[Raja Indian Cuisine]	The Plough is a pub that provides Chinese food in the high price range. It is located in the city centre and is near Raja Indian Cuisine.
name[The Plough], eatType[pub], food[Chinese], priceRange[high], area[city centre], familyFriendly[yes], near[Raja Indian Cuisine]	The Wrestlers is a pub that provides Chinese food in the high price range. It is located in the city centre and is near Raja Indian Cuisine.
name[The Plough], eatType[pub], food[Chinese], priceRange[high], area[riverside], familyFriendly[no], near[Raja Indian Cuisine]	The Plough is a pub that provides Chinese food in the high price range. It is located in the riverside and is near Raja Indian Cuisine.
name[The Plough], eatType[pub], food[Chinese], priceRange[high], area[riverside], familyFriendly[yes], near[Raja Indian Cuisine]	The Wrestlers is a pub that provides Chinese food in the high price range. It is located in the riverside and is near Raja Indian Cuisine.
name[The Plough], eatType[pub], food[Chinese], priceRange[less than £20], area[city centre], familyFriendly[no], near[Raja Indian Cuisine]	The Wrestlers is a pub that provides Chinese food in the less than £20 price range. It is located in the city centre and is near Raja Indian Cuisine.
name[The Plough], eatType[restaurant], food[Chinese], priceRange[£20-25], area[riverside], familyFriendly[yes], near[Raja Indian Cuisine]	The Wrestlers is a restaurant providing Chinese food in the £20-25 price range. It is located in the riverside and is near Raja Indian Cuisine.
name[The Plough], eatType[restaurant], food[Chinese], priceRange[cheap], area[riverside], familyFriendly[yes], near[Raja Indian Cuisine]	The Wrestlers is a cheap, family friendly Chinese restaurant in riverside near Raja Indian Cuisine.
name[The Plough], eatType[restaurant], food[Chinese], priceRange[high], area[city centre], familyFriendly[no], near[Raja Indian Cuisine]	The Wrestlers is a restaurant providing Chinese food in the high price range. It is located in the city centre near Raja Indian Cuisine and is not children friendly.
name[The Plough], eatType[restaurant], food[Chinese], priceRange[high], area[city centre], familyFriendly[yes], near[Raja Indian Cuisine]	The Wrestlers is a restaurant providing Chinese food in the high price range. It is located in the city centre near Raja Indian Cuisine.
name[The Plough], eatType[restaurant], food[Chinese], priceRange[high], area[riverside], familyFriendly[no], near[Raja Indian Cuisine]	The Wrestlers is a high priced Chinese restaurant in the riverside area near Raja Indian Cuisine. It is not children friendly.
name[The Plough], eatType[restaurant], food[Chinese], priceRange[high], area[riverside], familyFriendly[yes], near[Raja Indian Cuisine]	The Wrestlers is a restaurant providing Chinese food in the high price range. It is located in the riverside and is near Raja Indian Cuisine.
name[The Plough], eatType[restaurant], food[Chinese], priceRange[less than £20], area[city centre], familyFriendly[no], near[Raja Indian Cuisine]	The Wrestlers is a restaurant providing Chinese food in the less than £20 price range. It is located in the city centre and is near Raja Indian Cuisine.
name[The Punter], eatType[pub], food[Chinese], priceRange[less than £20], area[city centre], familyFriendly[yes], near[Raja Indian Cuisine]	The Punter is a pub that provides Chinese food in the less than £20 price range. It is located in the city centre and is near Raja Indian Cuisine.
name[The Punter], eatType[pub], food[Chinese], priceRange[less than £20], area[riverside], familyFriendly[no], near[Raja Indian Cuisine]	The Punter is a pub that provides Chinese food in the less than £20 price range. It is located in the riverside and is near Raja Indian Cuisine.
name[The Punter], eatType[pub], food[Chinese], priceRange[less than £20], area[riverside], familyFriendly[yes], near[Raja Indian Cuisine]	The Punter is a pub that provides Chinese food in the less than £20 price range. It is located in the riverside and is near Raja Indian Cuisine.
name[The Punter], eatType[pub], food[Chinese], priceRange[moderate], area[city centre], familyFriendly[no], near[Raja Indian Cuisine]	The Punter is a pub that provides Chinese food in the moderate price range. It is located in the city centre and is near Raja Indian Cuisine.
name[The Punter], eatType[pub], food[Chinese], priceRange[moderate], area[city centre], familyFriendly[yes], near[Raja Indian Cuisine]	The Punter is a pub that provides Chinese food in the moderate price range. It is located in the city centre and is near Raja Indian Cuisine.
name[The Punter], eatType[pub], food[Chinese], priceRange[moderate], area[riverside], familyFriendly[no], near[Raja Indian Cuisine]	The Punter is a pub that provides Chinese food in the moderate price range. It is located in the riverside and is near Raja Indian Cuisine.
name[The Punter], eatType[pub], food[Chinese], priceRange[moderate], area[riverside], familyFriendly[yes], near[Raja Indian Cuisine]	The Punter is a pub that provides Chinese food in the moderate price range. It is located in the riverside and is near Raja Indian Cuisine.
name[The Punter], eatType[pub], food[Chinese], priceRange[more than £30], area[riverside], familyFriendly[yes], near[Raja Indian Cuisine]	The Punter is a pub providing Chinese food in the more than £30 price range. It is located in the riverside and is near Raja Indian Cuisine.
name[The Punter], eatType[pub], food[English], priceRange[£20-25], area[riverside], familyFriendly[yes], near[Raja Indian Cuisine]	The kids friendly pub, The Punter, is located in the riverside area near Raja Indian Cuisine. It serves English food for £20-25.
name[The Punter], eatType[pub], food[English], priceRange[cheap], area[riverside], familyFriendly[yes], near[Raja Indian Cuisine]	Near Raja Indian Cuisine in the riverside area is a cheap, family friendly pub called The Punter.
name[The Punter], eatType[pub], food[English], priceRange[high], area[city centre], familyFriendly[no], near[Raja Indian Cuisine]	The Punter is a high priced English pub located in the city centre near Raja Indian Cuisine. It is not children friendly.
name[The Punter], eatType[pub], food[English], priceRange[high], area[city centre], familyFriendly[yes], near[Raja Indian Cuisine]	The Punter is a children friendly English pub in the city centre near Raja Indian Cuisine. It has a high price range.
name[The Punter], eatType[pub], food[English], priceRange[high], area[riverside], familyFriendly[no], near[Raja Indian Cuisine]	The Punter is a high priced English pub in the riverside area near Raja Indian Cuisine. It is not children friendly.
name[The Punter], eatType[pub], food[English], priceRange[high], area[riverside], familyFriendly[yes], near[Raja Indian Cuisine]	The Punter is a child friendly pub located near Raja Indian Cuisine in the riverside area. It serves English food and has a high price range.
name[The Punter], eatType[pub], food[Italian], priceRange[high], customer rating[average], area[city centre], familyFriendly[no], near[Rainbow Vegetarian Café]	The Punter is an Italian pub near Rainbow Vegetarian Café in the city centre. It has a high price range and an average customer rating. It is not children friendly.
name[The Punter], eatType[restaurant], food[Chinese], priceRange[less than £20], area[city centre], familyFriendly[yes], near[Raja Indian Cuisine]	The Punter is a family friendly Chinese restaurant located in the city centre near Raja Indian Cuisine.
name[The Punter], eatType[restaurant], food[Chinese], priceRange[less than £20], area[riverside], familyFriendly[no], near[Raja Indian Cuisine]	The Punter is a restaurant providing Chinese food in the less than £20 price range. It is located in the riverside and is near Raja Indian Cuisine.
name[The Punter], eatType[restaurant], food[Chinese], priceRange[less than £20], area[riverside], familyFriendly[yes], near[Raja Indian Cuisine]	The Punter is a restaurant providing Chinese food in the less than £20 price range. It is located in the riverside and is near Raja Indian Cuisine.
name[The Punter], eatType[restaurant], food[Chinese], priceRange[moderate], area[city centre], familyFriendly[no], near[Raja Indian Cuisine]	The Punter is a restaurant providing Chinese food in the moderate price range. It is located in the city centre near Raja Indian Cuisine.
name[The Punter], eatType[restaurant], food[Chinese], priceRange[moderate], area[city centre], familyFriendly[yes], near[Raja Indian Cuisine]	The Punter is a restaurant providing Chinese food in the moderate price range. It is located in the city centre and is near Raja Indian Cuisine.
name[The Punter], eatType[restaurant], food[Chinese], priceRange[moderate], area[riverside], familyFriendly[no], near[Raja Indian Cuisine]	The Punter is a Chinese restaurant in the moderate price range. It is located in the riverside area near Raja Indian Cuisine and is not kid friendly.
name[The Punter], eatType[restaurant], food[Chinese], priceRange[moderate], area[riverside], familyFriendly[yes], near[Raja Indian Cuisine]	The Punter is a restaurant providing Chinese food in the moderate price range. It is located in the riverside and is near Raja Indian Cuisine.
name[The Punter], eatType[restaurant], food[Chinese], priceRange[more than £30], area[riverside], familyFriendly[yes], near[Raja Indian Cuisine]	The Punter is a restaurant providing Chinese food in the more than £30 price range. It is located in the riverside and is near Raja Indian Cuisine.
name[The Punter], eatType[restaurant], food[English], priceRange[£20-25], area[riverside], familyFriendly[yes], near[Raja Indian Cuisine]	The kids friendly restaurant, The Punter, is located near Raja Indian Cuisine.
name[The Punter], eatType[restaurant], food[English], priceRange[cheap], area[riverside], familyFriendly[yes], near[Raja Indian Cuisine]	The Punter is a cheap, family friendly English restaurant in the riverside area near Raja Indian Cuisine.
name[The Punter], eatType[restaurant], food[English], priceRange[high], area[city centre], familyFriendly[no], near[Raja Indian Cuisine]	The Punter is a high priced English restaurant located in the city centre near Raja Indian Cuisine. It is not children friendly.
name[The Punter], eatType[restaurant], food[English], priceRange[high], area[city centre], familyFriendly[yes], near[Raja Indian Cuisine]	The Punter is a children friendly English restaurant with a high price range. It is located in the city centre near Raja Indian Cuisine.
name[The Punter], eatType[restaurant], food[English], priceRange[high], area[riverside], familyFriendly[no], near[Raja Indian Cuisine]	The Punter is a high priced English restaurant located in the riverside area near Raja Indian Cuisine. It is not children friendly.
name[The Punter], eatType[restaurant], food[English], priceRange[high], area[riverside], familyFriendly[yes], near[Raja Indian Cuisine]	The Punter is a children friendly English restaurant with a high price range. It is located in the riverside area near Raja Indian Cuisine.
name[The Punter], eatType[restaurant], food[Indian], priceRange[cheap], customer rating[average], area[city centre], familyFriendly[yes], near[Express by Holiday Inn]	The Punter is a cheap Indian restaurant in the city centre near Express by Holiday Inn. It has an average customer rating and is family friendly.
name[The Punter], eatType[restaurant], food[Indian], priceRange[cheap], customer rating[average], area[riverside], familyFriendly[no], near[Express by Holiday Inn]	The Punter is a restaurant providing Indian food in the cheap price range. It is located in the riverside and is near Express by Holiday Inn. Its customer rating is average.
name[The Punter], eatType[restaurant], food[Indian], priceRange[cheap], customer rating[average], area[riverside], familyFriendly[yes], near[Express by Holiday Inn]	The Punter is a restaurant providing Indian food in the cheap price range. It is located in the riverside and is near Express by Holiday Inn. Its customer rating is average.
name[The Punter], eatType[restaurant], food[Indian], priceRange[high], customer rating[1 out of 5], area[city centre], familyFriendly[no], near[Express by Holiday Inn]	The Punter is a restaurant providing Indian food in the high price range. It is located in the city centre and is near Express by Holiday Inn. Its customer rating is 1 out of 5.
name[The Punter], eatType[restaurant], food[Indian], priceRange[high], customer rating[1 out of 5], area[city centre], familyFriendly[yes], near[Express by Holiday Inn]	The Punter is a restaurant providing Indian food in the high price range. It is located in the city centre and is near Express by Holiday Inn. Its customer rating is 1 out of 5.
name[The Punter], eatType[restaurant], food[Indian], priceRange[high], customer rating[1 out of 5], area[riverside], familyFriendly[no], near[Express by Holiday Inn]	The Punter is a restaurant providing Indian food in the high price range. It is located in the riverside and is near Express by Holiday Inn. Its customer rating is 1 out of 5.
name[The Punter], eatType[restaurant], food[Indian], priceRange[high], customer rating[1 out of 5], area[riverside], familyFriendly[yes], near[Express by Holiday Inn]	The Punter is a restaurant providing Indian food in the high price range. It is located in the riverside and is near Express by Holiday Inn. Its customer rating is 1 out of 5.
name[The Punter], eatType[restaurant], food[Indian], priceRange[high], customer rating[average], area[city centre], familyFriendly[no], near[Express by Holiday Inn]	The Punter is a restaurant providing Indian food in the high price range. It is located in the city centre and is near Express by Holiday Inn. Its customer rating is average.
name[The Punter], eatType[restaurant], food[Indian], priceRange[high], customer rating[average], area[city centre], familyFriendly[yes], near[Express by Holiday Inn]	The Punter is a restaurant providing Indian food in the high price range. It is located in the city centre and is near Express by Holiday Inn. Its customer rating is average.
name[The Punter], eatType[restaurant], food[Indian], priceRange[high], customer rating[average], area[riverside], familyFriendly[no], near[Express by Holiday Inn]	The Punter is a restaurant providing Indian food in the high price range. It is located in the riverside and is near Express by Holiday Inn. Its customer rating is average.
name[The Punter], eatType[restaurant], food[Indian], priceRange[high], customer rating[average], area[riverside], familyFriendly[yes], near[Express by Holiday Inn]	The Punter is a restaurant providing Indian food in the high price range. It is located in the riverside and is near Express by Holiday Inn. Its customer rating is average.
name[The Punter], eatType[restaurant], food[Indian], priceRange[less than £20], customer rating[low], area[city centre], familyFriendly[no], near[Express by Holiday Inn]	The Punter is a restaurant providing Indian food in the less than £20 price range. It is located in the city centre and is near Express by Holiday Inn. Its customer rating is low.
name[The Punter], eatType[restaurant], food[Indian], priceRange[less than £20], customer rating[low], area[city centre], familyFriendly[yes], near[Express by Holiday Inn]	The Punter is a restaurant providing Indian food in the less than £20 price range. It is located in the city centre and is near Express by Holiday Inn. Its customer rating is low.
name[The Punter], eatType[restaurant], food[Indian], priceRange[less than £20], customer rating[low], area[riverside], familyFriendly[no], near[Express by Holiday Inn]	The Punter is a restaurant providing Indian food in the less than £20 price range. It is located in the riverside and is near Express by Holiday Inn. Its customer rating is low.
name[The Punter], eatType[restaurant], food[Indian], priceRange[less than £20], customer rating[low], area[riverside], familyFriendly[yes], near[Express by Holiday Inn]	The Punter is a restaurant providing Indian food in the less than £20 price range. It is located in the riverside and is near Express by Holiday Inn. Its customer rating is low.
name[The Punter], eatType[restaurant], food[Indian], priceRange[moderate], customer rating[1 out of 5], area[city centre], familyFriendly[no], near[Express by Holiday Inn]	The Punter is a restaurant providing Indian food in the moderate price range. It is located in the city centre and is near Express by Holiday Inn. Its customer rating is 1 out of 5.
name[The Punter], eatType[restaurant], food[Indian], priceRange[moderate], customer rating[1 out of 5], area[city centre], familyFriendly[yes], near[Express by Holiday Inn]	The Punter is a restaurant providing Indian food in the moderate price range. It is located in the city centre and is near Express by Holiday Inn. Its customer rating is 1 out of 5.
name[The Punter], eatType[restaurant], food[Indian], priceRange[moderate], customer rating[1 out of 5], area[riverside], familyFriendly[no], near[Express by Holiday Inn]	The Punter is a restaurant providing Indian food in the moderate price range. It is located in the riverside and is near Express by Holiday Inn. Its customer rating is 1 out of 5.
name[The Punter], eatType[restaurant], food[Indian], priceRange[moderate], customer rating[1 out of 5], area[riverside], familyFriendly[yes], near[Express by Holiday Inn]	The Punter is a restaurant providing Indian food in the moderate price range. It is located in the riverside and is near Express by Holiday Inn. Its customer rating is 1 out of 5.
name[The Punter], eatType[restaurant], food[Indian], priceRange[moderate], customer rating[3 out of 5], area[city centre], familyFriendly[no], near[Express by Holiday Inn]	The Punter is a restaurant providing Indian food in the moderate price range. It is located in the city centre and is near Express by Holiday Inn. Its customer rating is 3 out of 5.
name[The Punter], eatType[restaurant], food[Indian], priceRange[moderate], customer rating[3 out of 5], area[city centre], familyFriendly[yes], near[Express by Holiday Inn]	The Punter is a restaurant providing Indian food in the moderate price range. It is located in the city centre and is near Express by Holiday Inn. Its customer rating is 3 out of 5.
name[The Punter], eatType[restaurant], food[Indian], priceRange[moderate], customer rating[3 out of 5], area[riverside], familyFriendly[no], near[Express by Holiday Inn]	The Punter is a restaurant providing Indian food in the moderate price range. It is located in the riverside and is near Express by Holiday Inn. Its customer rating is 3 out of 5.
name[The Punter], eatType[restaurant], food[Indian], priceRange[moderate], customer rating[3 out of 5], area[riverside], familyFriendly[yes], near[Express by Holiday Inn]	The Punter is a restaurant providing Indian food in the moderate price range. It is located in the riverside and is near Express by Holiday Inn. Its customer rating is 3 out of 5.
name[The Punter], eatType[restaurant], food[Indian], priceRange[more than £30], customer rating[high], area[city centre], familyFriendly[no], near[Express by Holiday Inn]	The Punter is a restaurant providing Indian food in the more than £30 price range. It is located in the city centre and is near Express by Holiday Inn. Its customer rating is high.
name[The Punter], eatType[restaurant], food[Indian], priceRange[more than £30], customer rating[high], area[city centre], familyFriendly[yes], near[Express by Holiday Inn]	The Punter is a restaurant providing Indian food in the more than £30 price range. It is located in the city centre and is near Express by Holiday Inn. Its customer rating is high.
name[The Punter], eatType[restaurant], food[Indian], priceRange[more than £30], customer rating[high], area[riverside], familyFriendly[no], near[Express by Holiday Inn]	The Punter is a restaurant providing Indian food in the more than £30 price range. It is located in the riverside and is near Express by Holiday Inn. Its customer rating is high.
name[The Punter], eatType[restaurant], food[Indian], priceRange[more than £30], customer rating[high], area[riverside], familyFriendly[yes], near[Express by Holiday Inn]	The Punter is a restaurant providing Indian food in the more than £30 price range. It is located in the riverside and is near Express by Holiday Inn. Its customer rating is high.
name[The Punter], eatType[restaurant], food[Italian], priceRange[£20-25], customer rating[high], area[city centre], familyFriendly[no], near[Express by Holiday Inn]	The Punter is an Italian restaurant located in the city centre near Express by Holiday Inn. It has a high customer rating and a price range of £20-25. It is not kid friendly.
name[The Punter], eatType[restaurant], food[Italian], priceRange[£20-25], customer rating[high], area[city centre], familyFriendly[yes], near[Express by Holiday Inn]	The Punter is an Italian restaurant located in the city centre near Express by Holiday Inn. It has a high customer rating, is kid friendly, and has a price range of £20-25.
name[The Punter], eatType[restaurant], food[Italian], priceRange[£20-25], customer rating[high], area[riverside], familyFriendly[no], near[Express by Holiday Inn]	The Punter is an Italian restaurant located in the riverside area near Express by Holiday Inn. It has a high customer rating and a price range of £20-25. It is not kid friendly.
name[The Punter], eatType[restaurant], food[Italian], priceRange[£20-25], customer rating[high], area[riverside], familyFriendly[yes], near[Express by Holiday Inn]	The Punter is a kid friendly Italian restaurant with a high customer rating and a price range of £20-25. It is located in the riverside area near the Express by Holiday Inn.
name[The Punter], eatType[restaurant], food[Italian], priceRange[cheap], customer rating[5 out of 5], area[city centre], familyFriendly[no], near[Express by Holiday Inn]	The Punter is a cheap Italian restaurant located in the city centre near Express by Holiday Inn. It has a customer rating of 5 out of 5 and is not family-friendly.
name[The Punter], eatType[restaurant], food[Italian], priceRange[cheap], customer rating[5 out of 5], area[city centre], familyFriendly[no], near[Rainbow Vegetarian Café]	The Punter is a cheap Italian restaurant located in the city centre near Rainbow Vegetarian Café. It has a customer rating of 5 out of 5 and is not family-friendly.
name[The Punter], eatType[restaurant], food[Italian], priceRange[cheap], customer rating[5 out of 5], area[city centre], familyFriendly[yes], near[Rainbow Vegetarian Café]	The Punter is a cheap, family-friendly Italian restaurant located in the city centre near Rainbow Vegetarian Café. It has a customer rating of 5 out of 5.
name[The Punter], eatType[restaurant], food[Italian], priceRange[cheap], customer rating[5 out of 5], area[riverside], familyFriendly[no], near[Rainbow Vegetarian Café]	The Punter is a cheap Italian restaurant located in riverside near Rainbow Vegetarian Café. It has a customer rating of 5 out of 5 but is not family-friendly.
name[The Punter], eatType[restaurant], food[Italian], priceRange[cheap], customer rating[5 out of 5], area[riverside], familyFriendly[yes], near[Rainbow Vegetarian Café]	The Punter is a cheap, family friendly Italian restaurant with a customer rating of 5 out of 5. It is located in the riverside area near Rainbow Vegetarian Café.
name[The Punter], eatType[restaurant], food[Italian], priceRange[cheap], customer rating[average], area[city centre], familyFriendly[no], near[Rainbow Vegetarian Café]	The Punter is a cheap Italian restaurant located in the city centre near Rainbow Vegetarian Café. It is not family-friendly and has an average customer rating.
name[The Punter], eatType[restaurant], food[Italian], priceRange[cheap], customer rating[average], area[city centre], familyFriendly[yes], near[Rainbow Vegetarian Café]	The Punter is a cheap Italian restaurant in the city centre near Rainbow Vegetarian Café. It is family-friendly and has an average customer rating.
name[The Punter], eatType[restaurant], food[Italian], priceRange[cheap], customer rating[average], area[riverside], familyFriendly[no], near[Rainbow Vegetarian Café]	The Punter is a cheap Italian restaurant located in the riverside area near Rainbow Vegetarian Café. It has an average customer rating and is not family-friendly.
name[The Punter], eatType[restaurant], food[Italian], priceRange[cheap], customer rating[average], area[riverside], familyFriendly[yes], near[Rainbow Vegetarian Café]	The Punter is a cheap, family friendly Italian restaurant in the riverside area near Rainbow Vegetarian Café. It has an average customer rating.
name[The Punter], eatType[restaurant], food[Italian], priceRange[high], customer rating[1 out of 5], area[city centre], familyFriendly[no], near[Rainbow Vegetarian Café]	The Punter is a high priced Italian restaurant located in the city centre near Rainbow Vegetarian Café. It is not children friendly and has a customer rating of 1 out of 5.
name[The Punter], eatType[restaurant], food[Italian], priceRange[high], customer rating[1 out of 5], area[city centre], familyFriendly[yes], near[Rainbow Vegetarian Café]	The Punter is a child friendly Italian restaurant in the city centre near Rainbow Vegetarian Café. It has a high price range and a customer rating of 1 out of 5.
name[The Punter], eatType[restaurant], food[Italian], priceRange[high], customer rating[1 out of 5], area[riverside], familyFriendly[no], near[Rainbow Vegetarian Café]	The Punter is a high priced Italian restaurant located near the Rainbow Vegetarian Café. It is not children friendly and has a customer rating of 1 out of 5.
name[The Punter], eatType[restaurant], food[Italian], priceRange[high], customer rating[1 out of 5], area[riverside], familyFriendly[yes], near[Rainbow Vegetarian Café]	The Punter is a family friendly restaurant located near Rainbow Vegetarian Café.
name[The Vaults], eatType[pub], food[French], priceRange[high], area[riverside], familyFriendly[yes], near[Raja Indian Cuisine]	The Vaults is a high priced, child friendly pub in the riverside area near Raja Indian Cuisine.
name[The Vaults], eatType[pub], food[French], priceRange[less than £20], area[city centre], familyFriendly[no], near[Raja Indian Cuisine]	The Vaults is a French pub located in the city centre near Raja Indian Cuisine. It is not family-friendly and has a price range of less than £20.
name[The Vaults], eatType[pub], food[French], priceRange[less than £20], area[city centre], familyFriendly[yes], near[Raja Indian Cuisine]	The Vaults is a family-friendly pub that serves French food for less than £20. It is located in the city centre near Raja Indian Cuisine.
name[The Vaults], eatType[pub], food[French], priceRange[less than £20], area[riverside], familyFriendly[no], near[Raja Indian Cuisine]	The Vaults is a low-priced pub that is not family friendly. It is located near Raja Indian Cuisine.
name[The Vaults], eatType[pub], food[French], priceRange[less than £20], area[riverside], familyFriendly[yes], near[Raja Indian Cuisine]	The Vaults is a family friendly pub located near Raja Indian Cuisine.
name[The Vaults], eatType[pub], food[French], priceRange[moderate], area[city centre], familyFriendly[no], near[Raja Indian Cuisine]	The Vaults is a moderately priced French pub located in the city centre near Raja Indian Cuisine. It is not kid friendly.
name[The Vaults], eatType[pub], food[French], priceRange[moderate], area[city centre], familyFriendly[yes], near[Raja Indian Cuisine]	The Vaults is a moderately priced French pub in the city centre near Raja Indian Cuisine.
name[The Vaults], eatType[pub], food[French], priceRange[moderate], area[riverside], familyFriendly[no], near[Raja Indian Cuisine]	The Vaults is a moderately priced French pub in the riverside area near Raja Indian Cuisine. It is not kid friendly.
name[The Vaults], eatType[pub], food[French], priceRange[moderate], area[riverside], familyFriendly[yes], near[Raja Indian Cuisine]	The Vaults is a moderately priced, kid friendly pub in the riverside area near Raja Indian Cuisine.
name[The Vaults], eatType[pub], food[French], priceRange[more than £30], area[city centre], familyFriendly[no], near[Raja Indian Cuisine]	The Vaults is a French pub located in the city centre near Raja Indian Cuisine. It is not children friendly and costs more than £30.
name[The Vaults], eatType[pub], food[French], priceRange[more than £30], area[city centre], familyFriendly[yes], near[Raja Indian Cuisine]	The Vaults is a children friendly French pub in the city centre near Raja Indian Cuisine. The price range is more than £30.
name[The Vaults], eatType[pub], food[French], priceRange[more than £30], area[riverside], familyFriendly[no], near[Raja Indian Cuisine]	The Vaults is a French pub in the riverside area near Raja Indian Cuisine. It is not children friendly and costs more than £30.
name[The Vaults], eatType[pub], food[French], priceRange[more than £30], area[riverside], familyFriendly[yes], near[Raja Indian Cuisine]	The Vaults is a children friendly pub that serves French food. It is located near Raja Indian Cuisine in the riverside area. The price range is more than £30.
name[The Vaults], eatType[pub], food[Indian], priceRange[£20-25], area[riverside], familyFriendly[yes], near[Raja Indian Cuisine]	The Vaults is a pub that provides Indian food in the £20-25 price range. It is located in the riverside and is near Raja Indian Cuisine.
name[The Vaults], eatType[pub], food[Indian], priceRange[cheap], area[riverside], familyFriendly[yes], near[Raja Indian Cuisine]	The Vaults is a pub that provides Indian food in the cheap price range. It is located in the riverside and is near Raja Indian Cuisine.
name[The Vaults], eatType[pub], food[Indian], priceRange[high], area[city centre], familyFriendly[no], near[Raja Indian Cuisine]	The Vaults is a pub that provides Indian food in the high price range. It is located in the city centre and is near Raja Indian Cuisine.
name[The Vaults], eatType[pub], food[Indian], priceRange[high], area[city centre], familyFriendly[yes], near[Raja Indian Cuisine]	The Vaults is a pub that provides Indian food in the high price range. It is located in the city centre and is near Raja Indian Cuisine.
name[The Vaults], eatType[pub], food[Italian], priceRange[high], customer rating[average], area[city centre], familyFriendly[no], near[Rainbow Vegetarian Café]	The Vaults is an Italian pub near Rainbow Vegetarian Café in the city centre. It has a high price range and an average customer rating. It is not children friendly.
name[The Vaults], eatType[pub], food[Italian], priceRange[high], customer rating[average], area[city centre], familyFriendly[yes], near[Rainbow Vegetarian Café]	The Vaults is a children friendly Italian pub in the city centre near Rainbow Vegetarian Café with a high price range and an average customer rating.
name[The Vaults], eatType[pub], food[Italian], priceRange[high], customer rating[average], area[riverside], familyFriendly[no], near[Rainbow Vegetarian Café]	The Vaults is an Italian pub near the Rainbow Vegetarian Café in the riverside area. It has a high price range and an average customer rating. It is not children friendly.
name[The Vaults], eatType[pub], food[Italian], priceRange[high], customer rating[average], area[riverside], familyFriendly[yes], near[Rainbow Vegetarian Café]	The Vaults is a high priced, three star, family friendly pub located near the Rainbow Vegetarian Café.
name[The Vaults], eatType[pub], food[Italian], priceRange[less than £20], customer rating[low], area[city centre], familyFriendly[no], near[Rainbow Vegetarian Café]	The Vaults is an Italian pub near Rainbow Vegetarian Café in the city centre. It is not family-friendly and has a low customer rating.
name[The Vaults], eatType[pub], food[Italian], priceRange[less than £20], customer rating[low], area[city centre], familyFriendly[yes], near[Rainbow Vegetarian Café]	The Vaults is a family-friendly pub that serves Italian food for less than £20. It is located in the city centre near Rainbow Vegetarian Café and has a low customer rating.
name[The Vaults], eatType[pub], food[Italian], priceRange[less than £20], customer rating[low], area[riverside], familyFriendly[no], near[Rainbow Vegetarian Café]	The Vaults is an Italian pub near Rainbow Vegetarian Café in the riverside area. It is not family-friendly and has a low customer rating.
name[The Vaults], eatType[pub], food[Italian], priceRange[less than £20], customer rating[low], area[riverside], familyFriendly[yes], near[Rainbow Vegetarian Café]	The Vaults is a family friendly pub located near the Rainbow Vegetarian Café.
name[The Vaults], eatType[pub], food[Italian], priceRange[moderate], customer rating[1 out of 5], area[city centre], familyFriendly[no], near[Rainbow Vegetarian Café]	The Vaults is a moderately priced Italian pub located in the city centre near Rainbow Vegetarian Café. It is not kid friendly and has a customer rating of 1 out of 5.
name[The Vaults], eatType[pub], food[Italian], priceRange[moderate], customer rating[1 out of 5], area[city centre], familyFriendly[yes], near[Rainbow Vegetarian Café]	The Vaults is a kid friendly Italian pub near Rainbow Vegetarian Café in the city centre. It has a moderate price range and a customer rating of 1 out of 5.
name[The Vaults], eatType[pub], food[Italian], priceRange[moderate], customer rating[1 out of 5], area[riverside], familyFriendly[no], near[Rainbow Vegetarian Café]	The Vaults is a moderately priced Italian pub near the Rainbow Vegetarian Café in the riverside area. It is not kid friendly and has a customer rating of 1 out of 5.
name[The Vaults], eatType[pub], food[Italian], priceRange[moderate], customer rating[1 out of 5], area[riverside], familyFriendly[yes], near[Rainbow Vegetarian Café]	The Vaults is a mid-priced family friendly pub located near the Rainbow Vegetarian Café.
name[The Vaults], eatType[pub], food[Italian], priceRange[moderate], customer rating[3 out of 5], area[city centre], familyFriendly[no], near[Rainbow Vegetarian Café]	The Vaults is a moderately priced Italian pub located in the city centre near Rainbow Vegetarian Café. It is not kid friendly and has a customer rating of 3 out of 5.
name[The Vaults], eatType[pub], food[Italian], priceRange[moderate], customer rating[3 out of 5], area[city centre], familyFriendly[yes], near[Rainbow Vegetarian Café]	The Vaults is a moderately priced, kid friendly Italian pub in the city centre near Rainbow Vegetarian Café. It has a customer rating of 3 out of 5.
name[The Vaults], eatType[pub], food[Italian], priceRange[moderate], customer rating[3 out of 5], area[riverside], familyFriendly[no], near[Rainbow Vegetarian Café]	The Vaults is an Italian pub near the Rainbow Vegetarian Café in the riverside area. It is not kid friendly, has a moderate price range and a customer rating of 3 out of 5.
name[The Vaults], eatType[pub], food[Italian], priceRange[moderate], customer rating[3 out of 5], area[riverside], familyFriendly[yes], near[Rainbow Vegetarian Café]	The Vaults is a moderately priced, family friendly pub located near the Rainbow Vegetarian Café.
name[The Vaults], eatType[pub], food[Italian], priceRange[more than £30], customer rating[high], area[city centre], familyFriendly[no], near[Rainbow Vegetarian Café]	The Vaults is an Italian pub located in the city centre near Rainbow Vegetarian Café. It has a high customer rating and is not children friendly. The price range is more than £30.
name[The Vaults], eatType[pub], food[Italian], priceRange[more than £30], customer rating[high], area[city centre], familyFriendly[yes], near[Rainbow Vegetarian Café]	The Vaults is a child friendly Italian pub in the city centre near Rainbow Vegetarian Café. It has a high customer rating and the price range is more than £30.
name[The Vaults], eatType[pub], food[Italian], priceRange[more than £30], customer rating[high], area[riverside], familyFriendly[no], near[Rainbow Vegetarian Café]	The Vaults is an Italian pub near the Rainbow Vegetarian Café in the riverside area. It has a high customer rating and is not children friendly. The price range is more than £30.
name[The Vaults], eatType[pub], food[Italian], priceRange[more than £30], customer rating[high], area[riverside], familyFriendly[yes], near[Rainbow Vegetarian Café]	The Vaults is a family friendly pub located near the Rainbow Vegetarian Café.
name[The Vaults], eatType[pub], food[Japanese], priceRange[£20-25], customer rating[3 out of 5], area[city centre], familyFriendly[no], near[Rainbow Vegetarian Café]	The Vaults is a Japanese pub located in the city centre near Rainbow Vegetarian Café. It has a customer rating of 3 out of 5 and is not kid friendly. The price range is £20-25.
name[The Vaults], eatType[pub], food[Japanese], priceRange[£20-25], customer rating[3 out of 5], area[city centre], familyFriendly[yes], near[Rainbow Vegetarian Café]	The Vaults is a kid friendly Japanese pub in the city centre near Rainbow Vegetarian Café. It has a customer rating of 3 out of 5 and a price range of £20-25.
name[The Vaults], eatType[pub], food[Japanese], priceRange[£20-25], customer rating[3 out of 5], area[riverside], familyFriendly[no], near[Rainbow Vegetarian Café]	The Vaults is a Japanese pub near Rainbow Vegetarian Café in the riverside area. It has a customer rating of 3 out of 5 and is not kid friendly. The price range is £20-25.
name[The Vaults], eatType[pub], food[Japanese], priceRange[£20-25], customer rating[3 out of 5], area[riverside], familyFriendly[yes], near[Rainbow Vegetarian Café]	The Vaults is a family friendly pub located near the Rainbow Vegetarian Café.
name[The Vaults], eatType[pub], food[Japanese], priceRange[£20-25], customer rating[high], area[city centre], familyFriendly[no], near[Rainbow Vegetarian Café]	The Vaults is a Japanese pub located in the city centre near Rainbow Vegetarian Café. It has a high customer rating and is not kid friendly. The price range is £20-25.
name[The Vaults], eatType[pub], food[Japanese], priceRange[£20-25], customer rating[high], area[city centre], familyFriendly[yes], near[Rainbow Vegetarian Café]	The Vaults is a Japanese pub located near the Rainbow Vegetarian Café in the city centre. It is kid friendly, has a high customer rating and a price range of £20-25.
name[The Vaults], eatType[pub], food[Japanese], priceRange[£20-25], customer rating[high], area[riverside], familyFriendly[no], near[Rainbow Vegetarian Café]	The Vaults is a Japanese pub near the Rainbow Vegetarian Café in the riverside area. It has a high customer rating and is not kid friendly. The price range is £20-25.
name[The Vaults], eatType[pub], food[Japanese], priceRange[£20-25], customer rating[high], area[riverside], familyFriendly[no], near[Raja Indian Cuisine]	The Vaults is a Japanese pub near Raja Indian Cuisine in the riverside area. It is not kid friendly and has a price range of £20-25.
name[The Vaults], eatType[pub], food[Japanese], priceRange[£20-25], customer rating[high], area[riverside], familyFriendly[yes], near[Raja Indian Cuisine]	The Vaults is a Japanese pub located near Raja Indian Cuisine in the riverside area. It is kid friendly and has a high customer rating. The price range is £20-25.
name[The Vaults], eatType[pub], food[Japanese], priceRange[cheap], customer rating[5 out of 5], area[city centre], familyFriendly[no], near[Raja Indian Cuisine]	The Vaults is a cheap Japanese pub located in the city centre near Raja Indian Cuisine. It is not family-friendly.
name[The Vaults], eatType[pub], food[Japanese], priceRange[cheap], customer rating[5 out of 5], area[city centre], familyFriendly[yes], near[Raja Indian Cuisine]	The Vaults is a cheap, family-friendly Japanese pub in the city centre near Raja Indian Cuisine.
name[The Vaults], eatType[pub], food[Japanese], priceRange[cheap], customer rating[5 out of 5], area[riverside], familyFriendly[no], near[Raja Indian Cuisine]	The Vaults is a cheap Japanese pub in the riverside area near Raja Indian Cuisine with a customer rating of 5 out of 5 but not family-friendly
name[The Vaults], eatType[pub], food[Japanese], priceRange[cheap], customer rating[5 out of 5], area[riverside], familyFriendly[yes], near[Raja Indian Cuisine]	The Vaults is a cheap, family friendly pub located near Raja Indian Cuisine.
name[The Vaults], eatType[pub], food[Japanese], priceRange[high], customer rating[3 out of 5], area[city centre], familyFriendly[no], near[Raja Indian Cuisine]	The Vaults is a high priced Japanese pub located in the city centre near Raja Indian Cuisine. It is not children friendly and has a customer rating of 3 out of 5.
name[The Vaults], eatType[pub], food[Japanese], priceRange[high], customer rating[3 out of 5], area[city centre], familyFriendly[yes], near[Raja Indian Cuisine]	The Vaults is a children friendly Japanese pub with a high price range and a customer rating of 3 out of 5. It is located in the city centre near Raja Indian Cuisine.
name[The Vaults], eatType[pub], food[Japanese], priceRange[high], customer rating[3 out of 5], area[riverside], familyFriendly[no], near[Raja Indian Cuisine]	The Vaults is a Japanese pub near Raja Indian Cuisine in the riverside area. It has a high price range and a customer rating of 3 out of 5. It is not children friendly.
name[The Vaults], eatType[pub], food[Japanese], priceRange[high], customer rating[3 out of 5], area[riverside], familyFriendly[yes], near[Raja Indian Cuisine]	The coffee shop, The Vaults, is located in the riverside area near Raja Indian Cuisine. It serves Japanese food in the high price range and is child friendly. It has a customer rating of 3 out of 5.
name[The Vaults], eatType[pub], food[Japanese], priceRange[less than £20], customer rating[average], area[city centre], familyFriendly[no], near[Raja Indian Cuisine]	The Vaults is a Japanese pub located in the city centre near Raja Indian Cuisine. It has an average customer rating and is not family-friendly.
name[The Vaults], eatType[pub], food[Japanese], priceRange[less than £20], customer rating[average], area[city centre], familyFriendly[yes], near[Raja Indian Cuisine]	The Vaults is a family-friendly pub that serves Japanese food for less than £20. It is located in the city centre near Raja Indian Cuisine.
name[The Vaults], eatType[pub], food[Japanese], priceRange[less than £20], customer rating[average], area[riverside], familyFriendly[no], near[Raja Indian Cuisine]	The Vaults is a Japanese pub near Raja Indian Cuisine in the riverside area. It has an average customer rating and is not family-friendly. The price range is less than £20.
name[The Vaults], eatType[pub], food[Japanese], priceRange[less than £20], customer rating[average], area[riverside], familyFriendly[yes], near[Raja Indian Cuisine]	The Vaults is a family friendly pub located near Raja Indian Cuisine.
name[The Vaults], eatType[pub], food[Japanese], priceRange[less than £20], customer rating[low], area[city centre], familyFriendly[no], near[Raja Indian Cuisine]	The Vaults is a Japanese pub located in the city centre near Raja Indian Cuisine. It is not family-friendly and has a low customer rating.
name[The Vaults], eatType[pub], food[Japanese], priceRange[less than £20], customer rating[low], area[city centre], familyFriendly[yes], near[Raja Indian Cuisine]	The Vaults is a family-friendly pub that serves Japanese food for less than £20. It is located in the city centre near Raja Indian Cuisine.
name[The Vaults], eatType[pub], food[Japanese], priceRange[less than £20], customer rating[low], area[riverside], familyFriendly[no], near[Raja Indian Cuisine]	The coffee shop, The Vaults, is located near Raja Indian Cuisine in the riverside area. It serves Japanese food for less than £20 and has a low customer rating.
name[The Vaults], eatType[pub], food[Japanese], priceRange[less than £20], customer rating[low], area[riverside], familyFriendly[yes], near[Raja Indian Cuisine]	The Vaults is a family friendly pub that serves Japanese food for less than £20. It is located in the riverside area near Raja Indian Cuisine and has a low customer rating.
name[The Vaults], eatType[pub], food[Japanese], priceRange[moderate], customer rating[1 out of 5], area[city centre], familyFriendly[no], near[Raja Indian Cuisine]	The Vaults is a moderately priced Japanese pub in the city centre near Raja Indian Cuisine. It is not kid friendly and has a customer rating of 1 out of 5.
name[The Vaults], eatType[pub], food[Japanese], priceRange[moderate], customer rating[1 out of 5], area[city centre], familyFriendly[yes], near[Raja Indian Cuisine]	The Vaults is a kid friendly Japanese pub in the moderate price range. It is located in the city centre near Raja Indian Cuisine.
name[The Vaults], eatType[restaurant], food[French], priceRange[high], area[riverside], familyFriendly[yes], near[Raja Indian Cuisine]	The Vaults is a high priced French restaurant located in the riverside area near Raja Indian Cuisine.
name[The Vaults], eatType[restaurant], food[French], priceRange[less than £20], area[city centre], familyFriendly[no], near[Raja Indian Cuisine]	The Vaults is a French restaurant located in the city centre near Raja Indian Cuisine. It is not family-friendly and has a price range of less than £20.
name[The Vaults], eatType[restaurant], food[French], priceRange[less than £20], area[city centre], familyFriendly[yes], near[Raja Indian Cuisine]	The Vaults is a family-friendly French restaurant with a price range less than £20. It is located in the city centre near Raja Indian Cuisine.
name[The Vaults], eatType[restaurant], food[French], priceRange[less than £20], area[riverside], familyFriendly[no], near[Raja Indian Cuisine]	The Vaults is a French restaurant located in the riverside area near Raja Indian Cuisine. It is not family-friendly and has a price range of less than £20.
name[The Vaults], eatType[restaurant], food[French], priceRange[less than £20], area[riverside], familyFriendly[yes], near[Raja Indian Cuisine]	The Vaults is a family friendly French restaurant with a price range less than £20. It is located in the riverside area near Raja Indian Cuisine.
name[The Vaults], eatType[restaurant], food[French], priceRange[moderate], area[city centre], familyFriendly[no], near[Raja Indian Cuisine]	The Vaults is a moderately priced French restaurant located in the city centre near Raja Indian Cuisine. It is not kid friendly.
name[The Vaults], eatType[restaurant], food[French], priceRange[moderate], area[city centre], familyFriendly[yes], near[Raja Indian Cuisine]	The Vaults is a moderately priced French restaurant in the city centre near Raja Indian Cuisine.
name[The Vaults], eatType[restaurant], food[French], priceRange[moderate], area[riverside], familyFriendly[no], near[Raja Indian Cuisine]	The Vaults is a moderately priced French restaurant near Raja Indian Cuisine in riverside.
name[The Vaults], eatType[restaurant], food[French], priceRange[moderate], area[riverside], familyFriendly[yes], near[Raja Indian Cuisine]	The Vaults is a moderately priced, kid friendly French restaurant in the riverside area near Raja Indian Cuisine.
name[The Vaults], eatType[restaurant], food[French], priceRange[more than £30], area[city centre], familyFriendly[no], near[Raja Indian Cuisine]	The Vaults is a French restaurant located in the city centre near Raja Indian Cuisine. It is not children friendly and costs more than £30.
name[The Vaults], eatType[restaurant], food[French], priceRange[more than £30], area[city centre], familyFriendly[yes], near[Raja Indian Cuisine]	The Vaults is a child friendly French restaurant with a price range of more than £30. It is located in the city centre near Raja Indian Cuisine.
name[The Vaults], eatType[restaurant], food[French], priceRange[more than £30], area[riverside], familyFriendly[no], near[Raja Indian Cuisine]	The Vaults is a French restaurant located in the riverside area near Raja Indian Cuisine. It is not children friendly and costs more than £30.
name[The Vaults], eatType[restaurant], food[French], priceRange[more than £30], area[riverside], familyFriendly[yes], near[Raja Indian Cuisine]	The Vaults is a children friendly French restaurant with a price range of more than £30. It is located in the riverside area near Raja Indian Cuisine.
name[The Vaults], eatType[restaurant], food[Indian], priceRange[£20-25], area[riverside], familyFriendly[yes], near[Raja Indian Cuisine]	The Vaults is a restaurant providing Indian food in the £20-25 price range. It is located in the riverside and is near Raja Indian Cuisine.
name[The Vaults], eatType[restaurant], food[Indian], priceRange[cheap], area[riverside], familyFriendly[yes], near[Raja Indian Cuisine]	The Vaults is a cheap, family friendly Indian restaurant in the riverside area near Raja Indian Cuisine.
name[The Vaults], eatType[restaurant], food[Indian], priceRange[high], area[city centre], familyFriendly[no], near[Raja Indian Cuisine]	The Vaults is a restaurant providing Indian food in the high price range. It is located in the city centre and is near Raja Indian Cuisine.
name[The Vaults], eatType[restaurant], food[Indian], priceRange[high], area[city centre], familyFriendly[yes], near[Raja Indian Cuisine]	The Vaults is a restaurant providing Indian food in the high price range. It is located in the city centre and is near Raja Indian Cuisine.
name[The Waterman], eatType[pub], food[Indian], priceRange[high], area[city centre], familyFriendly[yes], near[Raja Indian Cuisine]	The Waterman is a pub that provides Indian food in the high price range. It is located in the city centre and is near Raja Indian Cuisine.
name[The Waterman], eatType[pub], food[Indian], priceRange[high], area[riverside], familyFriendly[no], near[Raja Indian Cuisine]	The Waterman is a pub that provides Indian food in the high price range. It is located in the riverside and is near Raja Indian Cuisine.
name[The Waterman], eatType[pub], food[Indian], priceRange[high], area[riverside], familyFriendly[yes], near[Raja Indian Cuisine]	The Waterman is a pub that provides Indian food in the high price range. It is located in the riverside and is near Raja Indian Cuisine.
name[The Waterman], eatType[pub], food[Indian], priceRange[less than £20], area[city centre], familyFriendly[no], near[Raja Indian Cuisine]	The Waterman is a pub that provides Indian food in the less than £20 price range. It is located in the city centre and is near Raja Indian Cuisine.
name[The Waterman], eatType[pub], food[Indian], priceRange[less than £20], area[city centre], familyFriendly[yes], near[Raja Indian Cuisine]	The Waterman is a pub that provides Indian food in the less than £20 price range. It is located in the city centre and is near Raja Indian Cuisine.
name[The Waterman], eatType[pub], food[Indian], priceRange[less than £20], area[riverside], familyFriendly[no], near[Raja Indian Cuisine]	The Waterman is a pub providing Indian food in the less than £20 price range. It is located in the riverside and is near Raja Indian Cuisine.
name[The Waterman], eatType[pub], food[Indian], priceRange[less than £20], area[riverside], familyFriendly[yes], near[Raja Indian Cuisine]	The Waterman is a pub that provides Indian food in the less than £20 price range. It is located in the riverside and is near Raja Indian Cuisine.
name[The Waterman], eatType[pub], food[Indian], priceRange[moderate], area[city centre], familyFriendly[no], near[Raja Indian Cuisine]	The Waterman is a pub that provides Indian food in the moderate price range. It is located in the city centre and is near Raja Indian Cuisine.
name[The Waterman], eatType[pub], food[Indian], priceRange[moderate], area[city centre], familyFriendly[yes], near[Raja Indian Cuisine]	The Waterman is a pub that provides Indian food in the moderate price range. It is located in the city centre and is near Raja Indian Cuisine.
name[The Waterman], eatType[pub], food[Indian], priceRange[moderate], area[riverside], familyFriendly[no], near[Raja Indian Cuisine]	The Waterman is a pub that provides Indian food in the moderate price range. It is located in the riverside and is near Raja Indian Cuisine.
name[The Waterman], eatType[pub], food[Indian], priceRange[moderate], area[riverside], familyFriendly[yes], near[Raja Indian Cuisine]	The Waterman is a pub that provides Indian food in the moderate price range. It is located in the riverside and is near Raja Indian Cuisine.
name[The Waterman], eatType[pub], food[Indian], priceRange[more than £30], area[riverside], familyFriendly[yes], near[Raja Indian Cuisine]	The Waterman is a pub that provides Indian food in the more than £30 price range. It is located in the riverside and is near Raja Indian Cuisine.
name[The Waterman], eatType[pub], food[Italian], priceRange[£20-25], area[riverside], familyFriendly[yes], near[Raja Indian Cuisine]	The Waterman is a kid friendly pub serving Italian food in the riverside area near Raja Indian Cuisine. The price range is £20-25.
name[The Waterman], eatType[pub], food[Italian], priceRange[cheap], area[riverside], familyFriendly[yes], near[Raja Indian Cuisine]	The Waterman is a cheap, family friendly pub in the riverside area near Raja Indian Cuisine.
name[The Waterman], eatType[pub], food[Italian], priceRange[high], area[city centre], familyFriendly[no], near[Raja Indian Cuisine]	The Waterman is an Italian pub in the city centre near Raja Indian Cuisine. It is not children friendly and has a high price range.
name[The Waterman], eatType[pub], food[Italian], priceRange[high], area[city centre], familyFriendly[yes], near[Raja Indian Cuisine]	The Waterman is a child friendly Italian pub in the city centre near Raja Indian Cuisine.
name[The Waterman], eatType[pub], food[Italian], priceRange[high], area[riverside], familyFriendly[no], near[Raja Indian Cuisine]	The Waterman is a high priced Italian pub in the riverside area near Raja Indian Cuisine. It is not children friendly.
name[The Waterman], eatType[pub], food[Italian], priceRange[high], area[riverside], familyFriendly[yes], near[Raja Indian Cuisine]	The Waterman is a high priced, child friendly pub in the riverside area near Raja Indian Cuisine.
name[The Waterman], eatType[pub], food[Italian], priceRange[less than £20], area[city centre], familyFriendly[no], near[Raja Indian Cuisine]	The Waterman is an Italian pub located in the city centre near Raja Indian Cuisine. It is not family-friendly and has a price range of less than £20.
name[The Waterman], eatType[pub], food[Italian], priceRange[less than £20], area[city centre], familyFriendly[yes], near[Raja Indian Cuisine]	The Waterman is a family-friendly pub that serves Italian food for less than £20. It is located in the city centre near Raja Indian Cuisine.
name[The Waterman], eatType[pub], food[Italian], priceRange[less than £20], area[riverside], familyFriendly[no], near[Raja Indian Cuisine]	The Waterman is an Italian pub near Raja Indian Cuisine in the riverside area. It is not family-friendly and has a price range of less than £20.
name[The Waterman], eatType[restaurant], food[Indian], priceRange[high], area[city centre], familyFriendly[yes], near[Raja Indian Cuisine]	The Waterman is a restaurant providing Indian food in the high price range. It is located in the city centre and is near Raja Indian Cuisine.
name[The Waterman], eatType[restaurant], food[Indian], priceRange[high], area[riverside], familyFriendly[no], near[Raja Indian Cuisine]	The Waterman is a restaurant providing Indian food in the high price range. It is located in the riverside and is near Raja Indian Cuisine.
name[The Waterman], eatType[restaurant], food[Indian], priceRange[high], area[riverside], familyFriendly[yes], near[Raja Indian Cuisine]	The Waterman is a restaurant providing Indian food in the high price range. It is located in the riverside and is near Raja Indian Cuisine.
name[The Waterman], eatType[restaurant], food[Indian], priceRange[less than £20], area[city centre], familyFriendly[no], near[Raja Indian Cuisine]	The Waterman is a restaurant providing Indian food in the less than £20 price range. It is located in the city centre and is near Raja Indian Cuisine.
name[The Waterman], eatType[restaurant], food[Indian], priceRange[less than £20], area[city centre], familyFriendly[yes], near[Raja Indian Cuisine]	The Waterman is a restaurant providing Indian food in the less than £20 price range. It is located in the city centre and is near Raja Indian Cuisine.
name[The Waterman], eatType[restaurant], food[Indian], priceRange[less than £20], area[riverside], familyFriendly[no], near[Raja Indian Cuisine]	The Waterman is a restaurant providing Indian food in the less than £20 price range. It is located in the riverside and is near Raja Indian Cuisine.
name[The Waterman], eatType[restaurant], food[Indian], priceRange[less than £20], area[riverside], familyFriendly[yes], near[Raja Indian Cuisine]	The Waterman is a restaurant providing Indian food in the less than £20 price range. It is located in the riverside and is near Raja Indian Cuisine.
name[The Waterman], eatType[restaurant], food[Indian], priceRange[moderate], area[city centre], familyFriendly[no], near[Raja Indian Cuisine]	The Waterman is a restaurant providing Indian food in the moderate price range. It is located in the city centre and is near Raja Indian Cuisine.
name[The Waterman], eatType[restaurant], food[Indian], priceRange[moderate], area[city centre], familyFriendly[yes], near[Raja Indian Cuisine]	The Waterman is a restaurant providing Indian food in the moderate price range. It is located in the city centre and is near Raja Indian Cuisine.
name[The Waterman], eatType[restaurant], food[Indian], priceRange[moderate], area[riverside], familyFriendly[no], near[Raja Indian Cuisine]	The Waterman is a restaurant providing Indian food in the moderate price range. It is located in the riverside and is near Raja Indian Cuisine.
name[The Waterman], eatType[restaurant], food[Indian], priceRange[moderate], area[riverside], familyFriendly[yes], near[Raja Indian Cuisine]	The Waterman is a restaurant providing Indian food in the moderate price range. It is located in the riverside and is near Raja Indian Cuisine.
name[The Waterman], eatType[restaurant], food[Indian], priceRange[more than £30], area[riverside], familyFriendly[yes], near[Raja Indian Cuisine]	The Waterman is a restaurant providing Indian food in the more than £30 price range. It is located in the riverside and is near Raja Indian Cuisine.
name[The Waterman], eatType[restaurant], food[Italian], priceRange[£20-25], area[riverside], familyFriendly[yes], near[Raja Indian Cuisine]	The Waterman is a kid friendly Italian restaurant in the riverside area near Raja Indian Cuisine with a price range of £20-25.
name[The Waterman], eatType[restaurant], food[Italian], priceRange[cheap], area[riverside], familyFriendly[yes], near[Raja Indian Cuisine]	The Waterman is a cheap, family friendly Italian restaurant in the riverside area near Raja Indian Cuisine.
name[The Waterman], eatType[restaurant], food[Italian], priceRange[high], area[city centre], familyFriendly[no], near[Raja Indian Cuisine]	The Waterman is a high priced Italian restaurant located in the city centre near Raja Indian Cuisine. It is not children friendly.
name[The Waterman], eatType[restaurant], food[Italian], priceRange[high], area[city centre], familyFriendly[yes], near[Raja Indian Cuisine]	The Waterman is a child friendly Italian restaurant in the city centre near Raja Indian Cuisine.
name[The Waterman], eatType[restaurant], food[Italian], priceRange[high], area[riverside], familyFriendly[no], near[Raja Indian Cuisine]	The Waterman is a high priced Italian restaurant located in the riverside area near Raja Indian Cuisine. It is not children friendly.
name[The Waterman], eatType[restaurant], food[Italian], priceRange[high], area[riverside], familyFriendly[yes], near[Raja Indian Cuisine]	The Waterman is a high priced Italian restaurant located near Raja Indian Cuisine.
name[The Waterman], eatType[restaurant], food[Italian], priceRange[less than £20], area[city centre], familyFriendly[no], near[Raja Indian Cuisine]	The Waterman is an Italian restaurant located in the city centre near Raja Indian Cuisine. It is not family-friendly and has a price range of less than £20.
name[The Waterman], eatType[restaurant], food[Italian], priceRange[less than £20], area[city centre], familyFriendly[yes], near[Raja Indian Cuisine]	The Waterman is a family-friendly restaurant providing Italian food in the low price range. It is located in the city centre near Raja Indian Cuisine.
name[The Waterman], eatType[restaurant], food[Italian], priceRange[less than £20], area[riverside], familyFriendly[no], near[Raja Indian Cuisine]	The Waterman is a restaurant providing Italian food in the low price range. It is located near Raja Indian Cuisine.
name[The Wrestlers], eatType[pub], food[Italian], priceRange[less than £20], area[riverside], familyFriendly[no], near[Raja Indian Cuisine]	The Wrestlers is an Italian pub near Raja Indian Cuisine in the riverside area. The price range is less than £20 and it is not family-friendly.
name[The Wrestlers], eatType[pub], food[Italian], priceRange[less than £20], area[riverside], familyFriendly[yes], near[Raja Indian Cuisine]	The Wrestlers is a family friendly pub located near Raja Indian Cuisine.
name[The Wrestlers], eatType[pub], food[Italian], priceRange[moderate], area[city centre], familyFriendly[no], near[Raja Indian Cuisine]	The Wrestlers is an Italian pub in the city centre near Raja Indian Cuisine. It is moderately priced and not kid friendly.
name[The Wrestlers], eatType[pub], food[Italian], priceRange[moderate], area[city centre], familyFriendly[yes], near[Raja Indian Cuisine]	The Wrestlers is a moderately priced Italian pub in the city centre near Raja Indian Cuisine.
name[The Wrestlers], eatType[pub], food[Italian], priceRange[moderate], area[riverside], familyFriendly[no], near[Raja Indian Cuisine]	The Wrestlers is an Italian pub located in the riverside area near Raja Indian Cuisine. It is moderately priced and not kid friendly.
name[The Wrestlers], eatType[pub], food[Italian], priceRange[moderate], area[riverside], familyFriendly[yes], near[Raja Indian Cuisine]	The Wrestlers is a family friendly pub located near Raja Indian Cuisine.
name[The Wrestlers], eatType[pub], food[Italian], priceRange[more than £30], area[riverside], familyFriendly[yes], near[Raja Indian Cuisine]	The Wrestlers is a children friendly Italian pub near Raja Indian Cuisine in the riverside area. The price range is more than £30.
name[The Wrestlers], eatType[pub], food[Japanese], priceRange[£20-25], area[riverside], familyFriendly[yes], near[Raja Indian Cuisine]	The Wrestlers is a kid friendly Japanese pub in the riverside area near Raja Indian Cuisine with a price range of £20-25.
name[The Wrestlers], eatType[pub], food[Japanese], priceRange[cheap], area[riverside], familyFriendly[yes], near[Raja Indian Cuisine]	The Wrestlers is a cheap, family friendly pub in the riverside area near Raja Indian Cuisine.
name[The Wrestlers], eatType[pub], food[Japanese], priceRange[high], area[riverside], familyFriendly[yes], near[Raja Indian Cuisine]	The Wrestlers is a child friendly pub that serves Japanese food in the high price range. It is located in the riverside area near Raja Indian Cuisine.
name[The Wrestlers], eatType[pub], food[Japanese], priceRange[less than £20], area[city centre], familyFriendly[no], near[Raja Indian Cuisine]	The Wrestlers is a Japanese pub located in the city centre near Raja Indian Cuisine. It is not family-friendly and has a price range of less than £20.
name[The Wrestlers], eatType[pub], food[Japanese], priceRange[less than £20], area[city centre], familyFriendly[yes], near[Raja Indian Cuisine]	The Wrestlers is a family-friendly pub that serves Japanese food for less than £20. It is located in the city centre near Raja Indian Cuisine.
name[The Wrestlers], eatType[pub], food[Japanese], priceRange[less than £20], area[riverside], familyFriendly[no], near[Raja Indian Cuisine]	The Wrestlers is a cheap pub located near Raja Indian Cuisine.
name[The Wrestlers], eatType[pub], food[Japanese], priceRange[less than £20], area[riverside], familyFriendly[yes], near[Raja Indian Cuisine]	The Wrestlers is a family friendly pub that serves Japanese food for less than £20. It is located near Raja Indian Cuisine in the riverside area.
name[The Wrestlers], eatType[pub], food[Japanese], priceRange[moderate], area[city centre], familyFriendly[no], near[Raja Indian Cuisine]	The Wrestlers is a Japanese pub in the moderate price range. It is located in the city centre near Raja Indian Cuisine and is not kids friendly.
name[The Wrestlers], eatType[pub], food[Japanese], priceRange[moderate], area[city centre], familyFriendly[yes], near[Raja Indian Cuisine]	The Wrestlers is a pub that serves Japanese food. It is located in the city centre near Raja Indian Cuisine and is kid friendly.
name[The Wrestlers], eatType[pub], food[Japanese], priceRange[moderate], area[riverside], familyFriendly[no], near[Raja Indian Cuisine]	The Wrestlers is a pub serving Japanese food in the moderate price range. It is located in the riverside area near Raja Indian Cuisine and is not kids friendly.
name[The Wrestlers], eatType[pub], food[Japanese], priceRange[moderate], area[riverside], familyFriendly[yes], near[Raja Indian Cuisine]	The Wrestlers is a family friendly pub located near Raja Indian Cuisine.
name[The Wrestlers], eatType[pub], food[Japanese], priceRange[moderate], customer rating[1 out of 5], area[city centre], familyFriendly[yes], near[Raja Indian Cuisine]	The Wrestlers is a kid friendly pub that serves Japanese food. It is located in the city centre near Raja Indian Cuisine. It has a moderate price range and a customer rating of 1 out of 5.
name[The Wrestlers], eatType[pub], food[Japanese], priceRange[moderate], customer rating[1 out of 5], area[riverside], familyFriendly[no], near[Raja Indian Cuisine]	The Wrestlers is a moderately priced Japanese pub in the riverside area near Raja Indian Cuisine. It is not kid friendly and has a customer rating of 1 out of 5.
name[The Wrestlers], eatType[pub], food[Japanese], priceRange[moderate], customer rating[1 out of 5], area[riverside], familyFriendly[yes], near[Raja Indian Cuisine]	The Wrestlers is a family friendly pub located near Raja Indian Cuisine.
name[The Wrestlers], eatType[pub], food[Japanese], priceRange[more than £30], area[city centre], familyFriendly[no], near[Raja Indian Cuisine]	The Wrestlers is a Japanese pub located in the city centre near Raja Indian Cuisine. It is not children friendly and has a price range of more than £30.
name[The Wrestlers], eatType[pub], food[Japanese], priceRange[more than £30], area[city centre], familyFriendly[yes], near[Raja Indian Cuisine]	The Wrestlers is a children friendly Japanese pub in the city centre near Raja Indian Cuisine. The price range is more than £30.
name[The Wrestlers], eatType[pub], food[Japanese], priceRange[more than £30], area[riverside], familyFriendly[no], near[Raja Indian Cuisine]	The Wrestlers is a Japanese pub located in the riverside area near Raja Indian Cuisine. It is not children friendly and costs more than £30.
name[The Wrestlers], eatType[pub], food[Japanese], priceRange[more than £30], area[riverside], familyFriendly[yes], near[Raja Indian Cuisine]	The Wrestlers is a family friendly pub located near Raja Indian Cuisine.
name[The Wrestlers], eatType[pub], food[Japanese], priceRange[more than £30], customer rating[5 out of 5], area[city centre], familyFriendly[no], near[Raja Indian Cuisine]	The Wrestlers is a Japanese pub located in the city centre near Raja Indian Cuisine. It is not children friendly and has a price range of more than £30.
name[The Wrestlers], eatType[pub], food[Japanese], priceRange[more than £30], customer rating[5 out of 5], area[city centre], familyFriendly[yes], near[Raja Indian Cuisine]	The Wrestlers is a child friendly Japanese pub in the city centre near Raja Indian Cuisine. It has a customer rating of 5 out of 5 and a price range of more than £30.
name[The Wrestlers], eatType[pub], food[Japanese], priceRange[more than £30], customer rating[5 out of 5], area[riverside], familyFriendly[no], near[Raja Indian Cuisine]	The Wrestlers is a Japanese pub in the riverside area near Raja Indian Cuisine. It is not children friendly and has a price range of more than £30.
name[The Wrestlers], eatType[pub], food[Japanese], priceRange[more than £30], customer rating[5 out of 5], area[riverside], familyFriendly[yes], near[Raja Indian Cuisine]	The Wrestlers is a family friendly pub located near Raja Indian Cuisine.
name[The Wrestlers], eatType[pub], food[Japanese], priceRange[more than £30], customer rating[low], area[city centre], familyFriendly[no], near[Raja Indian Cuisine]	The Wrestlers is a Japanese pub located in the city centre near Raja Indian Cuisine. It is not children friendly and has a low customer rating. The price range is more than £30.
name[The Wrestlers], eatType[pub], food[Japanese], priceRange[more than £30], customer rating[low], area[city centre], familyFriendly[yes], near[Raja Indian Cuisine]	The Wrestlers is a Japanese pub in the city centre near Raja Indian Cuisine. It is child friendly and has a low customer rating.
name[The Wrestlers], eatType[pub], food[Japanese], priceRange[more than £30], customer rating[low], area[riverside], familyFriendly[no], near[Raja Indian Cuisine]	The Wrestlers is a Japanese pub near Raja Indian Cuisine in the riverside area. It is not children friendly and has a low customer rating. The price range is more than £30.
name[The Wrestlers], eatType[pub], food[Japanese], priceRange[more than £30], customer rating[low], area[riverside], familyFriendly[yes], near[Raja Indian Cuisine]	The Wrestlers is a family friendly pub located near Raja Indian Cuisine.
name[The Wrestlers], eatType[restaurant], food[Italian], priceRange[less than £20], area[riverside], familyFriendly[no], near[Raja Indian Cuisine]	The Wrestlers is a cheap Italian restaurant located near Raja Indian Cuisine in the city centre. It is not family friendly.
name[The Wrestlers], eatType[restaurant], food[Italian], priceRange[less than £20], area[riverside], familyFriendly[yes], near[Raja Indian Cuisine]	The Wrestlers is a low priced family friendly restaurant located near Raja Indian Cuisine.
name[The Wrestlers], eatType[restaurant], food[Italian], priceRange[moderate], area[city centre], familyFriendly[no], near[Raja Indian Cuisine]	The Wrestlers is a moderately priced Italian restaurant located in the city centre near Raja Indian Cuisine. It is not kid friendly.
name[The Wrestlers], eatType[restaurant], food[Italian], priceRange[moderate], area[city centre], familyFriendly[yes], near[Raja Indian Cuisine]	The Wrestlers is a moderately priced Italian restaurant located in the city centre near Raja Indian Cuisine.
name[The Wrestlers], eatType[restaurant], food[Italian], priceRange[moderate], area[riverside], familyFriendly[no], near[Raja Indian Cuisine]	The Wrestlers is a moderately priced Italian restaurant in riverside near Raja Indian Cuisine. It is not kid friendly.
name[The Wrestlers], eatType[restaurant], food[Italian], priceRange[moderate], area[riverside], familyFriendly[yes], near[Raja Indian Cuisine]	The Wrestlers is a moderately priced Italian restaurant located near Raja Indian Cuisine.
name[The Wrestlers], eatType[restaurant], food[Italian], priceRange[more than £30], area[riverside], familyFriendly[yes], near[Raja Indian Cuisine]	The Wrestlers is a child friendly Italian restaurant located in the riverside area near Raja Indian Cuisine. The price range is more than £30.
name[The Wrestlers], eatType[restaurant], food[Japanese], priceRange[£20-25], area[riverside], familyFriendly[yes], near[Raja Indian Cuisine]	The Wrestlers is a kid friendly Japanese restaurant in the riverside area near Raja Indian Cuisine with a price range of £20-25.
name[The Wrestlers], eatType[restaurant], food[Japanese], priceRange[cheap], area[riverside], familyFriendly[yes], near[Raja Indian Cuisine]	The Wrestlers is a cheap, family friendly Japanese restaurant in the riverside area near Raja Indian Cuisine.
name[The Wrestlers], eatType[restaurant], food[Japanese], priceRange[high], area[riverside], familyFriendly[yes], near[Raja Indian Cuisine]	The Wrestlers is a child friendly Japanese restaurant with a high price range. It is located in the riverside area near Raja Indian Cuisine.
name[The Wrestlers], eatType[restaurant], food[Japanese], priceRange[less than £20], area[city centre], familyFriendly[no], near[Raja Indian Cuisine]	The Wrestlers is a Japanese restaurant located in the city centre near Raja Indian Cuisine. It is not family-friendly and has a price range of less than £20.
name[The Wrestlers], eatType[restaurant], food[Japanese], priceRange[less than £20], area[city centre], familyFriendly[yes], near[Raja Indian Cuisine]	The Wrestlers is a family-friendly Japanese restaurant in the city centre near Raja Indian Cuisine. The price range is less than £20.
name[The Wrestlers], eatType[restaurant], food[Japanese], priceRange[less than £20], area[riverside], familyFriendly[no], near[Raja Indian Cuisine]	The Wrestlers is a cheap Japanese restaurant located in the city centre near Raja Indian Cuisine. It is not family friendly.
name[The Wrestlers], eatType[restaurant], food[Japanese], priceRange[less than £20], area[riverside], familyFriendly[yes], near[Raja Indian Cuisine]	The Wrestlers is a family friendly Japanese restaurant with a price range less than £20. It is located in the riverside area near Raja Indian Cuisine.
name[The Wrestlers], eatType[restaurant], food[Japanese], priceRange[moderate], area[city centre], familyFriendly[no], near[Raja Indian Cuisine]	The Wrestlers is a moderately priced Japanese restaurant located in the city centre near Raja Indian Cuisine. It is not kid friendly.
name[The Wrestlers], eatType[restaurant], food[Japanese], priceRange[moderate], area[city centre], familyFriendly[yes], near[Raja Indian Cuisine]	The Wrestlers is a kid friendly Japanese restaurant with a moderate price range. It is located in the city centre near Raja Indian Cuisine.
name[The Wrestlers], eatType[restaurant], food[Japanese], priceRange[moderate], area[riverside], familyFriendly[no], near[Raja Indian Cuisine]	The Wrestlers is a moderately priced Japanese restaurant in the riverside area near Raja Indian Cuisine. It is not kid friendly.
name[The Wrestlers], eatType[restaurant], food[Japanese], priceRange[moderate], area[riverside], familyFriendly[yes], near[Raja Indian Cuisine]	The Wrestlers is a family friendly restaurant located near Raja Indian Cuisine.
name[The Wrestlers], eatType[restaurant], food[Japanese], priceRange[more than £30], area[city centre], familyFriendly[no], near[Raja Indian Cuisine]	The Wrestlers is a Japanese restaurant located in the city centre near Raja Indian Cuisine. It is not children friendly and costs more than £30.
name[The Wrestlers], eatType[restaurant], food[Japanese], priceRange[more than £30], area[city centre], familyFriendly[yes], near[Raja Indian Cuisine]	The Wrestlers is a children friendly Japanese restaurant in the city centre near Raja Indian Cuisine. It has a price range of more than £30.
name[The Wrestlers], eatType[restaurant], food[Japanese], priceRange[more than £30], area[riverside], familyFriendly[no], near[Raja Indian Cuisine]	The Wrestlers is a Japanese restaurant located in the riverside area near Raja Indian Cuisine. It is not children friendly and costs more than £30.
name[The Wrestlers], eatType[restaurant], food[Japanese], priceRange[more than £30], area[riverside], familyFriendly[yes], near[Raja Indian Cuisine]	The Wrestlers is a children friendly Japanese restaurant located near Raja Indian Cuisine in the riverside area. The price range is more than £30.
name[Wildwood], eatType[coffee shop], area[riverside]	There is a coffee shop in the riverside area called Wildwood. It has a low customer rating.
name[Wildwood], eatType[pub], area[riverside]	The pub Wildwood is located in the riverside area.
name[Wildwood], eatType[pub], food[French], area[riverside], familyFriendly[yes], near[Raja Indian Cuisine]	Near Raja Indian Cuisine in the riverside area is a family friendly French pub called the Wildwood.
name[Wildwood], eatType[pub], food[Indian], area[city centre], familyFriendly[no], near[Raja Indian Cuisine]	The Indian pub Wildwood is located in the city centre near Raja Indian Cuisine and is not family friendly.
name[Wildwood], eatType[pub], food[Indian], area[city centre], familyFriendly[yes], near[Raja Indian Cuisine]	The Indian pub Wildwood is located near Raja Indian Cuisine in the city centre.
name[Wildwood], eatType[pub], food[Indian], area[riverside], familyFriendly[no], near[Raja Indian Cuisine]	The Indian pub Wildwood is located in the riverside area near Raja Indian Cuisine. It is not family friendly.
name[Wildwood], eatType[pub], food[Indian], area[riverside], familyFriendly[yes], near[Raja Indian Cuisine]	There is a pub that serves Indian food in the riverside area near Raja Indian Cuisine called Wildwood.
name[Wildwood], eatType[pub], food[Italian], area[city centre], familyFriendly[no], near[Raja Indian Cuisine]	The Italian pub Wildwood is located in the city centre near Raja Indian Cuisine. It is not family-friendly.
name[Wildwood], eatType[pub], food[Italian], area[city centre], familyFriendly[yes], near[Raja Indian Cuisine]	Near Raja Indian Cuisine in the city centre is a family-friendly pub called Wildwood that serves Italian food.
name[Wildwood], eatType[pub], food[Italian], area[riverside], familyFriendly[no], near[Raja Indian Cuisine]	There is an Italian pub near Raja Indian Cuisine in the riverside area called Wildwood. It is not family-friendly.
name[Wildwood], eatType[pub], food[Italian], area[riverside], familyFriendly[yes], near[Raja Indian Cuisine]	Near Raja Indian Cuisine in the riverside area is a family friendly pub called Wildwood that serves Italian food.
name[Wildwood], eatType[restaurant], food[French], area[riverside], familyFriendly[yes], near[Raja Indian Cuisine]	There is a family friendly French restaurant in the riverside area near Raja Indian Cuisine called Wildwood.
name[Wildwood], eatType[restaurant], food[Indian], area[city centre], familyFriendly[no], near[Raja Indian Cuisine]	The Indian restaurant Wildwood is located in the city centre near Raja Indian Cuisine and is not family friendly.
name[Wildwood], eatType[restaurant], food[Indian], area[city centre], familyFriendly[yes], near[Raja Indian Cuisine]	There is a family friendly Indian restaurant in the city centre near Raja Indian Cuisine called Wildwood.
name[Wildwood], eatType[restaurant], food[Indian], area[riverside], familyFriendly[no], near[Raja Indian Cuisine]	There is an Indian restaurant in the riverside area near Raja Indian Cuisine called Wildwood. It is not family friendly.
name[Wildwood], eatType[restaurant], food[Indian], area[riverside], familyFriendly[yes], near[Raja Indian Cuisine]	There is a family friendly Indian restaurant in the riverside area near Raja Indian Cuisine called Wildwood.
name[Wildwood], eatType[restaurant], food[Italian], area[city centre], familyFriendly[no], near[Raja Indian Cuisine]	The Italian restaurant Wildwood is located in the city centre near Raja Indian Cuisine. It is not family-friendly.
name[Wildwood], eatType[restaurant], food[Italian], area[city centre], familyFriendly[yes], near[Raja Indian Cuisine]	The family-friendly restaurant Wildwood is located in the city centre near Raja Indian Cuisine.
name[Wildwood], eatType[restaurant], food[Italian], area[riverside], familyFriendly[no], near[Raja Indian Cuisine]	The Italian restaurant Wildwood is located in the riverside area near Raja Indian Cuisine. It is not family-friendly.
name[Wildwood], eatType[restaurant], food[Italian], area[riverside], familyFriendly[yes], near[Raja Indian Cuisine]	There is a family friendly Italian restaurant in the riverside area near Raja Indian Cuisine called Wildwood.
name[Zizzi], eatType[coffee shop], area[riverside]	In the riverside area there is a coffee shop called Zizzi. It has a customer rating of 1 out of 5.
name[Zizzi], eatType[coffee shop], customer rating[average], near[Burger King]	Zizzi is a coffee shop near Burger King with an average customer rating.
name[Zizzi], eatType[coffee shop], customer rating[high], near[Burger King]	Zizzi is a highly rated coffee shop near Burger King.
name[Zizzi], eatType[coffee shop], near[The Sorrento]	Zizzi is a coffee shop located near The Sorrento.
name[Zizzi], eatType[pub], area[riverside]	Zizzi is a pub in the riverside area.
name[Zizzi], eatType[pub], customer rating[average], near[Burger King]	Zizzi is a pub near Burger King with an average customer rating.
name[Zizzi], eatType[pub], customer rating[high], near[Burger King]	Zizzi is a highly rated pub near Burger King.
name[Zizzi], eatType[pub], near[The Sorrento]	Zizzi is a pub located near The Sorrento.