'name[Blue Spice], eatType[coffee shop], area[city centre]'	'Blue Spice is in city centre and it is a coffee shop.'
'name[Blue Spice], eatType[coffee shop], area[riverside]'	'Blue Spice is in riverside and it is a coffee shop.'
'name[Blue Spice], eatType[coffee shop], customer rating[5 out of 5], near[Crowne Plaza Hotel]'	'Blue Spice is near Crowne Plaza Hotel with a 5 out of 5 rating and it is a coffee shop.'
'name[Blue Spice], eatType[coffee shop], customer rating[average], near[Burger King]'	'Blue Spice is near Burger King with an average rating and it is a coffee shop.'
'name[Blue Spice], eatType[coffee shop], customer rating[average], near[Crowne Plaza Hotel]'	'Blue Spice is near Crowne Plaza Hotel with an average rating and it is a coffee shop.'
'name[Blue Spice], eatType[pub], area[city centre]'	'Blue Spice is in city centre and it is a pub.'
'name[Blue Spice], eatType[pub], area[riverside]'	'Blue Spice is in riverside and it is a pub.'
'name[Blue Spice], eatType[pub], customer rating[5 out of 5], near[Crowne Plaza Hotel]'	'Blue Spice is near Crowne Plaza Hotel with a 5 out of 5 rating and it is a pub.'
'name[Blue Spice], eatType[pub], customer rating[average], near[Burger King]'	'Blue Spice is near Burger King with an average rating and it is a pub.'
'name[Blue Spice], eatType[pub], customer rating[average], near[Crowne Plaza Hotel]'	'Blue Spice is near Crowne Plaza Hotel with an average rating and it is a pub.'
'name[Blue Spice], eatType[pub], food[Chinese], area[city centre], familyFriendly[no], near[Rainbow Vegetarian Café]'	'Blue Spice is a pub, it is in city centre near Rainbow Vegetarian Café, it is a chinese restaurant and it is n 't kid friendly.'
'name[Blue Spice], eatType[pub], food[Chinese], area[city centre], familyFriendly[yes], near[Rainbow Vegetarian Café]'	'Blue Spice is a pub, it is in city centre near Rainbow Vegetarian Café and it is a chinese restaurant and family friendly.'
'name[Blue Spice], eatType[pub], food[Chinese], area[riverside], familyFriendly[no], near[Rainbow Vegetarian Café]'	'Blue Spice is in riverside near Rainbow Vegetarian Café, it is a pub, it is a chinese restaurant and it is n 't kid friendly.'
'name[Blue Spice], eatType[pub], food[Chinese], area[riverside], familyFriendly[yes], near[Rainbow Vegetarian Café]'	'Blue Spice is a pub, it is in riverside near Rainbow Vegetarian Café and it is a chinese restaurant and family friendly.'
'name[Blue Spice], eatType[pub], food[English], area[city centre], familyFriendly[no], near[Rainbow Vegetarian Café]'	'Blue Spice is n 't kid friendly, it 's near Rainbow Vegetarian Café in city centre, it is an english restaurant and it is a pub.'
'name[Blue Spice], eatType[pub], food[English], area[city centre], familyFriendly[yes], near[Rainbow Vegetarian Café]'	'Blue Spice is in city centre near Rainbow Vegetarian Café, it is an english restaurant and family friendly and it is a pub.'
'name[Blue Spice], eatType[pub], food[English], area[riverside], familyFriendly[no], near[Rainbow Vegetarian Café]'	'Blue Spice is a pub, it is near Rainbow Vegetarian Café in riverside, it is an english restaurant and it is n 't kid friendly.'
'name[Blue Spice], eatType[pub], food[English], area[riverside], familyFriendly[yes], near[Rainbow Vegetarian Café]'	'Blue Spice is in riverside near Rainbow Vegetarian Café, it is an english restaurant and family friendly and it is a pub.'
'name[Blue Spice], eatType[restaurant], food[Chinese], area[city centre], familyFriendly[no], near[Rainbow Vegetarian Café]'	'Blue Spice is near Rainbow Vegetarian Café in city centre, it is a chinese restaurant and it is n 't family friendly.'
'name[Blue Spice], eatType[restaurant], food[Chinese], area[city centre], familyFriendly[yes], near[Rainbow Vegetarian Café]'	'Blue Spice is near Rainbow Vegetarian Café in city centre, it is a chinese restaurant and it is kid friendly.'
'name[Blue Spice], eatType[restaurant], food[Chinese], area[riverside], familyFriendly[no], near[Rainbow Vegetarian Café]'	'Blue Spice is near Rainbow Vegetarian Café in riverside, it is a chinese restaurant and it is n 't kid friendly.'
'name[Blue Spice], eatType[restaurant], food[Chinese], area[riverside], familyFriendly[yes], near[Rainbow Vegetarian Café]'	'Blue Spice is near Rainbow Vegetarian Café in riverside, it is a chinese restaurant and it is kid friendly.'
'name[Blue Spice], eatType[restaurant], food[English], area[city centre], familyFriendly[no], near[Rainbow Vegetarian Café]'	'Blue Spice is near Rainbow Vegetarian Café in city centre, it is an english restaurant and it is n 't family friendly.'
'name[Blue Spice], eatType[restaurant], food[English], area[city centre], familyFriendly[yes], near[Rainbow Vegetarian Café]'	'Blue Spice is in city centre near Rainbow Vegetarian Café, it is an english restaurant and family friendly and it is a restaurant.'
'name[Blue Spice], eatType[restaurant], food[English], area[riverside], familyFriendly[no], near[Rainbow Vegetarian Café]'	'Blue Spice is near Rainbow Vegetarian Café in riverside, it is an english restaurant and it is n 't kid friendly.'
'name[Blue Spice], eatType[restaurant], food[English], area[riverside], familyFriendly[yes], near[Rainbow Vegetarian Café]'	'Blue Spice is an english restaurant and kid friendly, it is in riverside near Rainbow Vegetarian Café and it is a restaurant.'
'name[Clowns], eatType[coffee shop], customer rating[3 out of 5], near[All Bar One]'	'Clowns is near All Bar One with a 3 out of 5 rating and it is a coffee shop.'
'name[Clowns], eatType[coffee shop], customer rating[5 out of 5], near[Crowne Plaza Hotel]'	'Clowns is near Crowne Plaza Hotel with a 5 out of 5 rating and it is a coffee shop.'
'name[Clowns], eatType[coffee shop], near[The Sorrento]'	'Well, Clowns is near The Sorrento, it is a coffee shop.'
'name[Clowns], eatType[pub], customer rating[3 out of 5], near[All Bar One]'	'Clowns is near All Bar One with a 3 out of 5 rating and it is a pub.'
'name[Clowns], eatType[pub], customer rating[5 out of 5], near[Crowne Plaza Hotel]'	'Clowns is near Crowne Plaza Hotel with a 5 out of 5 rating and it is a pub.'
'name[Clowns], eatType[pub], near[The Sorrento]'	'Clowns is near The Sorrento and it is a pub.'
'name[Cocum], eatType[coffee shop], customer rating[high], near[Burger King]'	'Cocum is near Burger King with a high rating and it is a coffee shop.'
'name[Cocum], eatType[coffee shop], customer rating[high], near[Café Sicilia]'	'Cocum is near Café Sicilia with a high rating and it is a coffee shop.'
'name[Cocum], eatType[coffee shop], customer rating[low], near[Café Sicilia]'	'Well, Cocum is near Café Sicilia, it is a coffee shop and it has a low rating.'
'name[Cocum], eatType[coffee shop], customer rating[low], near[Express by Holiday Inn]'	'Well, Cocum is near Express by Holiday Inn, it is a coffee shop and it has a low rating.'
'name[Cocum], eatType[coffee shop], near[The Rice Boat]'	'Well, Cocum is near The Rice Boat, it is a coffee shop.'
'name[Cocum], eatType[coffee shop], near[The Sorrento]'	'Well, Cocum is near The Sorrento, it is a coffee shop.'
'name[Cocum], eatType[pub], customer rating[high], near[Burger King]'	'Cocum is a pub with a high rating and it is near Burger King.'
'name[Cocum], eatType[pub], customer rating[high], near[Café Sicilia]'	'Cocum is a pub with a high rating and it is near Café Sicilia.'
'name[Cocum], eatType[pub], customer rating[low], near[Café Sicilia]'	'Cocum is near Café Sicilia with a low rating and it is a pub.'
'name[Cocum], eatType[pub], customer rating[low], near[Express by Holiday Inn]'	'Cocum is near Express by Holiday Inn with a low rating and it is a pub.'
'name[Cocum], eatType[pub], near[The Rice Boat]'	'Cocum is near The Rice Boat and it is a pub.'
'name[Cocum], eatType[pub], near[The Sorrento]'	'Cocum is near The Sorrento and it is a pub.'
'name[Cotto], eatType[coffee shop], near[The Bakers]'	'Well, Cotto is near The Bakers, it is a coffee shop.'
'name[Cotto], eatType[pub], near[The Bakers]'	'Cotto is near The Bakers and it is a pub.'
'name[Giraffe], eatType[coffee shop], near[The Bakers]'	'Well, Giraffe is near The Bakers, it is a coffee shop.'
'name[Giraffe], eatType[coffee shop], near[The Rice Boat]'	'Well, Giraffe is near The Rice Boat, it is a coffee shop.'
'name[Giraffe], eatType[pub], food[English], area[riverside], familyFriendly[yes], near[Rainbow Vegetarian Café]'	'Giraffe is in riverside near Rainbow Vegetarian Café, it is an english restaurant and family friendly and it is a pub.'
'name[Giraffe], eatType[pub], food[Fast food], area[city centre], familyFriendly[no], near[Rainbow Vegetarian Café]'	'Giraffe is in city centre near Rainbow Vegetarian Café, it is a pub, it is a fast food restaurant and it is n 't family friendly.'
'name[Giraffe], eatType[pub], food[Fast food], area[city centre], familyFriendly[yes], near[Rainbow Vegetarian Café]'	'Giraffe is in city centre near Rainbow Vegetarian Café, it is a fast food restaurant and family friendly and it is a pub.'
'name[Giraffe], eatType[pub], food[Fast food], area[riverside], familyFriendly[no], near[Rainbow Vegetarian Café]'	'Giraffe is in riverside near Rainbow Vegetarian Café, it is a pub, it is a fast food restaurant and it is n 't kid friendly.'
'name[Giraffe], eatType[pub], food[Fast food], area[riverside], familyFriendly[yes], near[Rainbow Vegetarian Café]'	'Giraffe is in riverside near Rainbow Vegetarian Café, it is a fast food restaurant and family friendly and it is a pub.'
'name[Giraffe], eatType[pub], food[Fast food], area[riverside], familyFriendly[yes], near[Raja Indian Cuisine]'	'Giraffe is in riverside near Raja Indian Cuisine, it is a fast food restaurant and family friendly and it is a pub.'
'name[Giraffe], eatType[pub], food[French], area[city centre], familyFriendly[no], near[Raja Indian Cuisine]'	'Giraffe is n 't kid friendly, it 's near Raja Indian Cuisine in city centre, it is a french restaurant and it is a pub.'
'name[Giraffe], eatType[pub], food[French], area[city centre], familyFriendly[yes], near[Raja Indian Cuisine]'	'Giraffe is in city centre near Raja Indian Cuisine, it is a french restaurant and family friendly and it is a pub.'
'name[Giraffe], eatType[pub], food[French], area[riverside], familyFriendly[no], near[Raja Indian Cuisine]'	'Giraffe is a pub, it is near Raja Indian Cuisine in riverside, it is a french restaurant and it is n 't kid friendly.'
'name[Giraffe], eatType[pub], food[French], area[riverside], familyFriendly[yes], near[Raja Indian Cuisine]'	'Giraffe is in riverside near Raja Indian Cuisine, it is a pub and it is kid friendly and a french restaurant.'
'name[Giraffe], eatType[pub], near[The Bakers]'	'Giraffe is near The Bakers and it is a pub.'
'name[Giraffe], eatType[pub], near[The Rice Boat]'	'Giraffe is near The Rice Boat and it is a pub.'
'name[Giraffe], eatType[restaurant], food[English], area[riverside], familyFriendly[yes], near[Rainbow Vegetarian Café]'	'Giraffe is an english restaurant and kid friendly, it is in riverside near Rainbow Vegetarian Café and it is a restaurant.'
'name[Giraffe], eatType[restaurant], food[Fast food], area[city centre], familyFriendly[no], near[Rainbow Vegetarian Café]'	'Giraffe is near Rainbow Vegetarian Café in city centre, it is a fast food restaurant and it is n 't family friendly.'
'name[Giraffe], eatType[restaurant], food[Fast food], area[city centre], familyFriendly[yes], near[Rainbow Vegetarian Café]'	'Giraffe is in city centre near Rainbow Vegetarian Café, it is a fast food restaurant and family friendly and it is a restaurant.'
'name[Giraffe], eatType[restaurant], food[Fast food], area[riverside], familyFriendly[no], near[Rainbow Vegetarian Café]'	'Giraffe is near Rainbow Vegetarian Café in riverside, it is a fast food restaurant and it is n 't family friendly.'
'name[Giraffe], eatType[restaurant], food[Fast food], area[riverside], familyFriendly[yes], near[Rainbow Vegetarian Café]'	'Giraffe is a fast food restaurant and kid friendly, it is in riverside near Rainbow Vegetarian Café and it is a restaurant.'
'name[Giraffe], eatType[restaurant], food[Fast food], area[riverside], familyFriendly[yes], near[Raja Indian Cuisine]'	'Giraffe is a fast food restaurant and kid friendly, it is in riverside near Raja Indian Cuisine and it is a restaurant.'
'name[Giraffe], eatType[restaurant], food[French], area[city centre], familyFriendly[no], near[Raja Indian Cuisine]'	'Giraffe is near Raja Indian Cuisine in city centre, it is a french restaurant and it is n 't family friendly.'
'name[Giraffe], eatType[restaurant], food[French], area[city centre], familyFriendly[yes], near[Raja Indian Cuisine]'	'Giraffe is in city centre near Raja Indian Cuisine, it is a french restaurant and family friendly and it is a restaurant.'
'name[Giraffe], eatType[restaurant], food[French], area[riverside], familyFriendly[no], near[Raja Indian Cuisine]'	'Giraffe is near Raja Indian Cuisine in riverside, it is a french restaurant and it is n 't kid friendly.'
'name[Giraffe], eatType[restaurant], food[French], area[riverside], familyFriendly[yes], near[Raja Indian Cuisine]'	'Giraffe is a french restaurant and kid friendly, it is in riverside near Raja Indian Cuisine and it is a restaurant.'
'name[Green Man], eatType[coffee shop], customer rating[1 out of 5], near[All Bar One]'	'Green Man is near All Bar One with a 1 out of 5 rating and it is a coffee shop.'
'name[Green Man], eatType[coffee shop], customer rating[3 out of 5], near[All Bar One]'	'Green Man is near All Bar One with a 3 out of 5 rating and it is a coffee shop.'
'name[Green Man], eatType[pub], customer rating[1 out of 5], near[All Bar One]'	'Green Man is near All Bar One with a 1 out of 5 rating and it is a pub.'
'name[Green Man], eatType[pub], customer rating[3 out of 5], near[All Bar One]'	'Green Man is near All Bar One with a 3 out of 5 rating and it is a pub.'
'name[Green Man], eatType[pub], food[Italian], area[riverside], familyFriendly[yes], near[Express by Holiday Inn]'	'Green Man is in riverside near Express by Holiday Inn, it is an italian restaurant and family friendly and it is a pub.'
'name[Green Man], eatType[pub], food[Italian], area[riverside], familyFriendly[yes], near[Raja Indian Cuisine]'	'Green Man is in riverside near Raja Indian Cuisine, it is an italian restaurant and family friendly and it is a pub.'
'name[Green Man], eatType[pub], food[Japanese], area[city centre], familyFriendly[no], near[Express by Holiday Inn]'	'Green Man is n 't kid friendly, it 's near Express by Holiday Inn in city centre, it is a japanese restaurant and it is a pub.'
'name[Green Man], eatType[pub], food[Japanese], area[city centre], familyFriendly[yes], near[Express by Holiday Inn]'	'Green Man is in city centre near Express by Holiday Inn, it is a japanese restaurant and family friendly and it is a pub.'
'name[Green Man], eatType[pub], food[Japanese], area[riverside], familyFriendly[no], near[Express by Holiday Inn]'	'Green Man is in riverside near Express by Holiday Inn, it is a pub, it is a japanese restaurant and it is n 't kid friendly.'
'name[Green Man], eatType[pub], food[Japanese], area[riverside], familyFriendly[yes], near[Express by Holiday Inn]'	'Green Man is in riverside near Express by Holiday Inn, it is a japanese restaurant and kid friendly and it is a pub.'
'name[Green Man], eatType[restaurant], food[Italian], area[riverside], familyFriendly[yes], near[Express by Holiday Inn]'	'Green Man is in riverside near Express by Holiday Inn, it is an italian restaurant and kid friendly and it is a restaurant.'
'name[Green Man], eatType[restaurant], food[Italian], area[riverside], familyFriendly[yes], near[Raja Indian Cuisine]'	'Green Man is in riverside near Raja Indian Cuisine, it is an italian restaurant and kid friendly and it is a restaurant.'
'name[Green Man], eatType[restaurant], food[Japanese], area[city centre], familyFriendly[no], near[Express by Holiday Inn]'	'Green Man is near Express by Holiday Inn in city centre, it is a japanese restaurant and it is n 't family friendly.'
'name[Green Man], eatType[restaurant], food[Japanese], area[city centre], familyFriendly[yes], near[Express by Holiday Inn]'	'Green Man is in city centre near Express by Holiday Inn, it is a japanese restaurant and family friendly and it is a restaurant.'
'name[Green Man], eatType[restaurant], food[Japanese], area[riverside], familyFriendly[no], near[Express by Holiday Inn]'	'Green Man is near Express by Holiday Inn in riverside, it is a japanese restaurant and it is n 't kid friendly.'
'name[Green Man], eatType[restaurant], food[Japanese], area[riverside], familyFriendly[yes], near[Express by Holiday Inn]'	'Green Man is near Express by Holiday Inn in riverside, it is a japanese restaurant and it is kid friendly.'
'name[Loch Fyne], eatType[coffee shop], area[riverside]'	'Loch Fyne is in riverside and it is a coffee shop.'
'name[Loch Fyne], eatType[pub], area[riverside]'	'Loch Fyne is in riverside and it is a pub.'
'name[Strada], eatType[coffee shop], area[city centre]'	'Strada is in city centre and it is a coffee shop.'
'name[Strada], eatType[coffee shop], customer rating[1 out of 5], near[All Bar One]'	'Strada is near All Bar One with a 1 out of 5 rating and it is a coffee shop.'
'name[Strada], eatType[coffee shop], customer rating[1 out of 5], near[Rainbow Vegetarian Café]'	'Strada is near Rainbow Vegetarian Café with a 1 out of 5 rating and it is a coffee shop.'
'name[Strada], eatType[coffee shop], customer rating[low], near[Express by Holiday Inn]'	'Well, Strada is near Express by Holiday Inn, it is a coffee shop and it has a low rating.'
'name[Strada], eatType[pub], area[city centre]'	'Strada is in city centre and it is a pub.'
'name[Strada], eatType[pub], customer rating[1 out of 5], near[All Bar One]'	'Strada is near All Bar One with a 1 out of 5 rating and it is a pub.'
'name[Strada], eatType[pub], customer rating[1 out of 5], near[Rainbow Vegetarian Café]'	'Strada is near Rainbow Vegetarian Café with a 1 out of 5 rating and it is a pub.'
'name[Strada], eatType[pub], customer rating[low], near[Express by Holiday Inn]'	'Strada is near Express by Holiday Inn with a low rating and it is a pub.'
'name[The Cricketers], eatType[coffee shop], customer rating[1 out of 5], familyFriendly[yes], near[Avalon]'	'The Cricketers is near Avalon with a 1 out of 5 rating, it is a coffee shop and it is kid friendly.'
'name[The Cricketers], eatType[coffee shop], customer rating[3 out of 5], familyFriendly[yes], near[Avalon]'	'The Cricketers is near Avalon with a 3 out of 5 rating, it is a coffee shop and it is kid friendly.'
'name[The Cricketers], eatType[coffee shop], customer rating[3 out of 5], familyFriendly[yes], near[Crowne Plaza Hotel]'	'The Cricketers is near Crowne Plaza Hotel with a 3 out of 5 rating, it is a coffee shop and it is kid friendly.'
'name[The Cricketers], eatType[coffee shop], customer rating[5 out of 5], familyFriendly[no], near[Crowne Plaza Hotel]'	'The Cricketers is near Crowne Plaza Hotel with a 5 out of 5 rating, it is a coffee shop and it is n 't family friendly.'
'name[The Cricketers], eatType[coffee shop], customer rating[5 out of 5], familyFriendly[yes], near[Crowne Plaza Hotel]'	'The Cricketers is near Crowne Plaza Hotel with a 5 out of 5 rating, it is a coffee shop and it is family friendly.'
'name[The Cricketers], eatType[coffee shop], customer rating[average], familyFriendly[no], near[Café Sicilia]'	'The Cricketers is near Café Sicilia with an average rating, it is a coffee shop and it is n 't family friendly.'
'name[The Cricketers], eatType[coffee shop], customer rating[average], familyFriendly[no], near[Crowne Plaza Hotel]'	'The Cricketers is near Crowne Plaza Hotel with an average rating, it is a coffee shop and it is n 't family friendly.'
'name[The Cricketers], eatType[coffee shop], customer rating[average], familyFriendly[yes], near[Café Sicilia]'	'The Cricketers is near Café Sicilia with an average rating, it is a coffee shop and it is family friendly.'
'name[The Cricketers], eatType[coffee shop], customer rating[high], familyFriendly[yes], near[Café Sicilia]'	'The Cricketers is near Café Sicilia with a high rating, it is kid friendly and it 's a coffee shop.'
'name[The Cricketers], eatType[coffee shop], customer rating[high], familyFriendly[yes], near[Express by Holiday Inn]'	'The Cricketers is near Express by Holiday Inn with a high rating, it is kid friendly and it 's a coffee shop.'
'name[The Cricketers], eatType[coffee shop], customer rating[low], familyFriendly[no], near[Express by Holiday Inn]'	'The Cricketers is near Express by Holiday Inn with a low rating, it is a coffee shop and it is n 't kid friendly.'
'name[The Cricketers], eatType[coffee shop], customer rating[low], familyFriendly[no], near[Ranch]'	'The Cricketers is near Ranch with a low rating, it is a coffee shop and it is n 't kid friendly.'
'name[The Cricketers], eatType[coffee shop], customer rating[low], familyFriendly[yes], near[Ranch]'	'The Cricketers is near Ranch with a low rating, it is a coffee shop and it is family friendly.'
'name[The Cricketers], eatType[restaurant], customer rating[1 out of 5], familyFriendly[yes], near[Avalon]'	'The Cricketers is kid friendly with a 1 out of 5 rating, it is near Avalon and it is a restaurant.'
'name[The Cricketers], eatType[restaurant], customer rating[3 out of 5], familyFriendly[yes], near[Avalon]'	'The Cricketers is near Avalon with a 3 out of 5 rating, it is a restaurant and it is kid friendly.'
'name[The Cricketers], eatType[restaurant], customer rating[3 out of 5], familyFriendly[yes], near[Crowne Plaza Hotel]'	'The Cricketers is near Crowne Plaza Hotel with a 3 out of 5 rating, it is a restaurant and it is kid friendly.'
'name[The Cricketers], eatType[restaurant], customer rating[5 out of 5], familyFriendly[no], near[Crowne Plaza Hotel]'	'The Cricketers is near Crowne Plaza Hotel with a 5 out of 5 rating, it is a restaurant and it is n 't family friendly.'
'name[The Cricketers], eatType[restaurant], customer rating[5 out of 5], familyFriendly[yes], near[Crowne Plaza Hotel]'	'The Cricketers is near Crowne Plaza Hotel with a 5 out of 5 rating, it is a restaurant and it is kid friendly.'
'name[The Cricketers], eatType[restaurant], customer rating[average], familyFriendly[no], near[Café Sicilia]'	'The Cricketers is near Café Sicilia with an average rating, it is a restaurant and it is n 't family friendly.'
'name[The Cricketers], eatType[restaurant], customer rating[average], familyFriendly[no], near[Crowne Plaza Hotel]'	'The Cricketers is near Crowne Plaza Hotel with an average rating, it is a restaurant and it is n 't family friendly.'
'name[The Cricketers], eatType[restaurant], customer rating[average], familyFriendly[yes], near[Café Sicilia]'	'The Cricketers is near Café Sicilia with an average rating, it is a restaurant and it is kid friendly.'
'name[The Cricketers], eatType[restaurant], customer rating[high], familyFriendly[yes], near[Café Sicilia]'	'The Cricketers is near Café Sicilia with a high rating, it is a restaurant and it is kid friendly.'
'name[The Cricketers], eatType[restaurant], customer rating[high], familyFriendly[yes], near[Express by Holiday Inn]'	'The Cricketers is near Express by Holiday Inn with a high rating, it is a restaurant and it is kid friendly.'
'name[The Cricketers], eatType[restaurant], customer rating[low], familyFriendly[no], near[Express by Holiday Inn]'	'The Cricketers is near Express by Holiday Inn with a low rating, it is a restaurant and it is n 't family friendly.'
'name[The Cricketers], eatType[restaurant], customer rating[low], familyFriendly[no], near[Ranch]'	'The Cricketers is near Ranch with a low rating, it is a restaurant and it is n 't family friendly.'
'name[The Cricketers], eatType[restaurant], customer rating[low], familyFriendly[yes], near[Ranch]'	'The Cricketers is near Ranch with a low rating, it is a restaurant and it is kid friendly.'
'name[The Cricketers], eatType[restaurant], food[Chinese], priceRange[£20-25], customer rating[high], area[city centre], familyFriendly[no], near[All Bar One]'	'The Cricketers is a chinese restaurant with a price range of £20-25 with a high rating, it is near All Bar One in city centre and it is n 't kid friendly.'
'name[The Cricketers], eatType[restaurant], food[Chinese], priceRange[£20-25], customer rating[high], area[city centre], familyFriendly[yes], near[All Bar One]'	'The Cricketers is in city centre near All Bar One with a price range of £20-25 with a high rating, it is kid friendly and a chinese restaurant and it is a restaurant.'
'name[The Cricketers], eatType[restaurant], food[Chinese], priceRange[£20-25], customer rating[high], area[riverside], familyFriendly[no], near[All Bar One]'	'The Cricketers is a chinese restaurant with a price range of £20-25 with a high rating, it is near All Bar One in riverside and it is n 't kid friendly.'
'name[The Cricketers], eatType[restaurant], food[Chinese], priceRange[£20-25], customer rating[high], area[riverside], familyFriendly[yes], near[All Bar One]'	'The Cricketers is a chinese restaurant and kid friendly with a price range of £20-25 with a high rating and it is near All Bar One in riverside.'
'name[The Cricketers], eatType[restaurant], food[Chinese], priceRange[cheap], customer rating[5 out of 5], area[city centre], familyFriendly[no], near[All Bar One]'	'The Cricketers is near All Bar One in city centre with a 5 out of 5 rating, it is a chinese restaurant and cheap and it is n 't family friendly.'
'name[The Cricketers], eatType[restaurant], food[Chinese], priceRange[cheap], customer rating[5 out of 5], area[city centre], familyFriendly[yes], near[All Bar One]'	'The Cricketers is in city centre near All Bar One with a 5 out of 5 rating, it is a chinese restaurant and family friendly and it is cheap.'
'name[The Cricketers], eatType[restaurant], food[Chinese], priceRange[cheap], customer rating[5 out of 5], area[riverside], familyFriendly[no], near[All Bar One]'	'The Cricketers is a chinese restaurant and cheap with a 5 out of 5 rating, it is near All Bar One in riverside and it is n 't kid friendly.'
'name[The Cricketers], eatType[restaurant], food[Chinese], priceRange[cheap], customer rating[5 out of 5], area[riverside], familyFriendly[yes], near[All Bar One]'	'The Cricketers is in riverside near All Bar One with a 5 out of 5 rating, it is a chinese restaurant and family friendly and it is cheap.'
'name[The Cricketers], eatType[restaurant], food[Chinese], priceRange[cheap], customer rating[average], area[city centre], familyFriendly[no], near[All Bar One]'	'The Cricketers is near All Bar One in city centre with an average rating, it is a chinese restaurant and cheap and it is n 't family friendly.'
'name[The Cricketers], eatType[restaurant], food[Chinese], priceRange[cheap], customer rating[average], area[city centre], familyFriendly[yes], near[All Bar One]'	'The Cricketers is in city centre near All Bar One with an average rating, it is a chinese restaurant and family friendly and it is cheap.'
'name[The Cricketers], eatType[restaurant], food[Chinese], priceRange[cheap], customer rating[average], area[riverside], familyFriendly[no], near[All Bar One]'	'The Cricketers is a chinese restaurant and cheap with an average rating, it is near All Bar One in riverside and it is n 't kid friendly.'
'name[The Cricketers], eatType[restaurant], food[Chinese], priceRange[cheap], customer rating[average], area[riverside], familyFriendly[yes], near[All Bar One]'	'The Cricketers is in riverside near All Bar One with an average rating, it is a chinese restaurant and family friendly and it is cheap.'
'name[The Cricketers], eatType[restaurant], food[Chinese], priceRange[high], customer rating[1 out of 5], area[city centre], familyFriendly[no], near[All Bar One]'	'The Cricketers is in city centre near All Bar One with a 1 out of 5 rating, it is a chinese restaurant and expensive and it is n 't family friendly.'
'name[The Cricketers], eatType[restaurant], food[Chinese], priceRange[high], customer rating[1 out of 5], area[city centre], familyFriendly[yes], near[All Bar One]'	'The Cricketers is in city centre near All Bar One with a 1 out of 5 rating, it is a chinese restaurant and kid friendly and it is expensive.'
'name[The Cricketers], eatType[restaurant], food[Chinese], priceRange[high], customer rating[1 out of 5], area[riverside], familyFriendly[no], near[All Bar One]'	'The Cricketers is in riverside near All Bar One with a 1 out of 5 rating, it is a chinese restaurant and expensive and it is n 't kid friendly.'
'name[The Cricketers], eatType[restaurant], food[Chinese], priceRange[high], customer rating[1 out of 5], area[riverside], familyFriendly[yes], near[All Bar One]'	'The Cricketers is in riverside near All Bar One with a 1 out of 5 rating, it is a chinese restaurant and expensive and it is kid friendly.'
'name[The Cricketers], eatType[restaurant], food[Chinese], priceRange[high], customer rating[average], area[city centre], familyFriendly[no], near[All Bar One]'	'The Cricketers is in city centre near All Bar One with an average rating, it is a chinese restaurant and expensive and it is n 't family friendly.'
'name[The Cricketers], eatType[restaurant], food[Chinese], priceRange[high], customer rating[average], area[city centre], familyFriendly[yes], near[All Bar One]'	'The Cricketers is in city centre near All Bar One with an average rating, it is a chinese restaurant and kid friendly and it is expensive.'
'name[The Cricketers], eatType[restaurant], food[Chinese], priceRange[high], customer rating[average], area[riverside], familyFriendly[no], near[All Bar One]'	'The Cricketers is in riverside near All Bar One with an average rating, it is a chinese restaurant and expensive and it is n 't kid friendly.'
'name[The Cricketers], eatType[restaurant], food[Chinese], priceRange[high], customer rating[average], area[riverside], familyFriendly[yes], near[All Bar One]'	'The Cricketers is in riverside near All Bar One with an average rating, it is a chinese restaurant and kid friendly and it is expensive.'
'name[The Cricketers], eatType[restaurant], food[Chinese], priceRange[less than £20], customer rating[low], area[city centre], familyFriendly[no], near[All Bar One]'	'The Cricketers costs less than £20 with a low rating, it is near All Bar One in city centre, it is a chinese restaurant and it is n 't family friendly.'
'name[The Cricketers], eatType[restaurant], food[Chinese], priceRange[less than £20], customer rating[low], area[city centre], familyFriendly[yes], near[All Bar One]'	'The Cricketers costs less than £20 with a low rating, it is near All Bar One in city centre and it is a chinese restaurant and family friendly.'
'name[The Cricketers], eatType[restaurant], food[Chinese], priceRange[less than £20], customer rating[low], area[riverside], familyFriendly[no], near[All Bar One]'	'The Cricketers costs less than £20 with a low rating, it is near All Bar One in riverside, it is a chinese restaurant and it is n 't kid friendly.'
'name[The Cricketers], eatType[restaurant], food[Chinese], priceRange[less than £20], customer rating[low], area[riverside], familyFriendly[yes], near[All Bar One]'	'The Cricketers is in riverside near All Bar One with a low rating, it is a chinese restaurant and family friendly and it costs less than £20.'
'name[The Cricketers], eatType[restaurant], food[Chinese], priceRange[moderate], customer rating[1 out of 5], area[city centre], familyFriendly[no], near[All Bar One]'	'The Cricketers is in city centre near All Bar One with a 1 out of 5 rating, it is a chinese restaurant and moderately priced and it is n 't kid friendly.'
'name[The Cricketers], eatType[restaurant], food[Chinese], priceRange[moderate], customer rating[1 out of 5], area[city centre], familyFriendly[yes], near[All Bar One]'	'The Cricketers is in city centre near All Bar One with a 1 out of 5 rating, it is a chinese restaurant and kid friendly and it is moderately priced.'
'name[The Cricketers], eatType[restaurant], food[Chinese], priceRange[moderate], customer rating[1 out of 5], area[riverside], familyFriendly[no], near[All Bar One]'	'The Cricketers is in riverside near All Bar One with a 1 out of 5 rating, it is a chinese restaurant and moderately priced and it is n 't kid friendly.'
'name[The Cricketers], eatType[restaurant], food[Chinese], priceRange[moderate], customer rating[1 out of 5], area[riverside], familyFriendly[yes], near[All Bar One]'	'The Cricketers is in riverside near All Bar One with a 1 out of 5 rating, it is a chinese restaurant and kid friendly and it is moderately priced.'
'name[The Cricketers], eatType[restaurant], food[Chinese], priceRange[moderate], customer rating[3 out of 5], area[city centre], familyFriendly[no], near[All Bar One]'	'The Cricketers is in city centre near All Bar One with a 3 out of 5 rating, it is a chinese restaurant and moderately priced and it is n 't kid friendly.'
'name[The Cricketers], eatType[restaurant], food[Chinese], priceRange[moderate], customer rating[3 out of 5], area[city centre], familyFriendly[yes], near[All Bar One]'	'The Cricketers is in city centre near All Bar One with a 3 out of 5 rating, it is a chinese restaurant, moderately priced and kid friendly and it is a restaurant.'
'name[The Cricketers], eatType[restaurant], food[Chinese], priceRange[moderate], customer rating[3 out of 5], area[riverside], familyFriendly[no], near[All Bar One]'	'The Cricketers is in riverside near All Bar One with a 3 out of 5 rating, it is a chinese restaurant and moderately priced and it is n 't kid friendly.'
'name[The Cricketers], eatType[restaurant], food[Chinese], priceRange[moderate], customer rating[3 out of 5], area[riverside], familyFriendly[yes], near[All Bar One]'	'The Cricketers is in riverside near All Bar One with a 3 out of 5 rating, it is a chinese restaurant, moderately priced and kid friendly and it is a restaurant.'
'name[The Cricketers], eatType[restaurant], food[Chinese], priceRange[more than £30], customer rating[high], area[city centre], familyFriendly[no], near[All Bar One]'	'The Cricketers costs more than £30 with a high rating, it is near All Bar One in city centre, it is a chinese restaurant and it is n 't family friendly.'
'name[The Cricketers], eatType[restaurant], food[Chinese], priceRange[more than £30], customer rating[high], area[city centre], familyFriendly[yes], near[All Bar One]'	'The Cricketers costs more than £30 with a high rating, it is near All Bar One in city centre and it is a chinese restaurant and family friendly.'
'name[The Cricketers], eatType[restaurant], food[Chinese], priceRange[more than £30], customer rating[high], area[riverside], familyFriendly[no], near[All Bar One]'	'The Cricketers costs more than £30 with a high rating, it is near All Bar One in riverside, it is a chinese restaurant and it is n 't kid friendly.'
'name[The Cricketers], eatType[restaurant], food[Chinese], priceRange[more than £30], customer rating[high], area[riverside], familyFriendly[yes], near[All Bar One]'	'The Cricketers is in riverside near All Bar One with a high rating, it is a chinese restaurant and kid friendly and it costs more than £30.'
'name[The Cricketers], eatType[restaurant], food[English], priceRange[£20-25], customer rating[high], area[city centre], familyFriendly[no], near[All Bar One]'	'The Cricketers is an english restaurant with a price range of £20-25 with a high rating, it is near All Bar One in city centre and it is n 't kid friendly.'
'name[The Cricketers], eatType[restaurant], food[English], priceRange[£20-25], customer rating[high], area[city centre], familyFriendly[yes], near[All Bar One]'	'The Cricketers is in city centre near All Bar One with a high rating with a price range of £20-25, it is an english restaurant and family friendly and it is a restaurant.'
'name[The Cricketers], eatType[restaurant], food[English], priceRange[£20-25], customer rating[high], area[riverside], familyFriendly[no], near[All Bar One]'	'The Cricketers is an english restaurant with a price range of £20-25 with a high rating, it is near All Bar One in riverside and it is n 't kid friendly.'
'name[The Cricketers], eatType[restaurant], food[English], priceRange[£20-25], customer rating[high], area[riverside], familyFriendly[yes], near[All Bar One]'	'The Cricketers is in riverside near All Bar One with a high rating with a price range of £20-25, it is an english restaurant and family friendly.'
'name[The Cricketers], eatType[restaurant], food[English], priceRange[cheap], customer rating[5 out of 5], area[city centre], familyFriendly[no], near[Café Rouge]'	'The Cricketers is in city centre near Café Rouge with a 5 out of 5 rating, it is an english restaurant and cheap and it is n 't family friendly.'
'name[The Cricketers], eatType[restaurant], food[English], priceRange[cheap], customer rating[5 out of 5], area[city centre], familyFriendly[yes], near[Café Rouge]'	'The Cricketers is in city centre near Café Rouge with a 5 out of 5 rating, it is an english restaurant and family friendly and it is cheap.'
'name[The Cricketers], eatType[restaurant], food[English], priceRange[cheap], customer rating[5 out of 5], area[riverside], familyFriendly[no], near[Café Rouge]'	'The Cricketers is in riverside near Café Rouge with a 5 out of 5 rating, it is an english restaurant and cheap and it is n 't family friendly.'
'name[The Cricketers], eatType[restaurant], food[English], priceRange[cheap], customer rating[5 out of 5], area[riverside], familyFriendly[yes], near[Café Rouge]'	'The Cricketers is in riverside near Café Rouge with a 5 out of 5 rating, it is an english restaurant and family friendly and it is cheap.'
'name[The Cricketers], eatType[restaurant], food[English], priceRange[cheap], customer rating[average], area[city centre], familyFriendly[no], near[Café Rouge]'	'The Cricketers is an english restaurant and cheap with an average rating, it is near Café Rouge in city centre and it is n 't family friendly.'
'name[The Cricketers], eatType[restaurant], food[English], priceRange[cheap], customer rating[average], area[city centre], familyFriendly[yes], near[Café Rouge]'	'The Cricketers is in city centre near Café Rouge with an average rating, it is cheap and an english restaurant and family friendly.'
'name[The Cricketers], eatType[restaurant], food[English], priceRange[cheap], customer rating[average], area[riverside], familyFriendly[no], near[Café Rouge]'	'The Cricketers is in riverside near Café Rouge with an average rating, it is an english restaurant and cheap and it is n 't family friendly.'
'name[The Cricketers], eatType[restaurant], food[English], priceRange[cheap], customer rating[average], area[riverside], familyFriendly[yes], near[Café Rouge]'	'The Cricketers is in riverside near Café Rouge with an average rating, it is cheap and an english restaurant and family friendly.'
'name[The Cricketers], eatType[restaurant], food[English], priceRange[high], customer rating[1 out of 5], area[city centre], familyFriendly[no], near[Café Rouge]'	'The Cricketers is in city centre near Café Rouge with a 1 out of 5 rating, it is an english restaurant and expensive and it is n 't family friendly.'
'name[The Cricketers], eatType[restaurant], food[English], priceRange[high], customer rating[1 out of 5], area[city centre], familyFriendly[yes], near[Café Rouge]'	'The Cricketers is in city centre near Café Rouge with a 1 out of 5 rating, it is an english restaurant and family friendly and it is expensive.'
'name[The Cricketers], eatType[restaurant], food[English], priceRange[high], customer rating[1 out of 5], area[riverside], familyFriendly[no], near[Café Rouge]'	'The Cricketers is in riverside near Café Rouge with a 1 out of 5 rating, it is an english restaurant and expensive and it is n 't kid friendly.'
'name[The Cricketers], eatType[restaurant], food[English], priceRange[high], customer rating[1 out of 5], area[riverside], familyFriendly[yes], near[Café Rouge]'	'The Cricketers is in riverside near Café Rouge with a 1 out of 5 rating, it is an english restaurant and kid friendly and it is expensive.'
'name[The Cricketers], eatType[restaurant], food[English], priceRange[high], customer rating[average], area[city centre], familyFriendly[no], near[Café Rouge]'	'The Cricketers is in city centre near Café Rouge with an average rating, it is an english restaurant and expensive and it is n 't family friendly.'
'name[The Cricketers], eatType[restaurant], food[English], priceRange[high], customer rating[average], area[city centre], familyFriendly[yes], near[Café Rouge]'	'The Cricketers is in city centre near Café Rouge with an average rating, it is an english restaurant and family friendly and it is expensive.'
'name[The Cricketers], eatType[restaurant], food[English], priceRange[high], customer rating[average], area[riverside], familyFriendly[no], near[Café Rouge]'	'The Cricketers is in riverside near Café Rouge with an average rating, it is an english restaurant and expensive and it is n 't kid friendly.'
'name[The Mill], eatType[pub], food[English], priceRange[high], area[riverside], familyFriendly[yes], near[Raja Indian Cuisine]'	'The Mill is expensive, an english restaurant and kid friendly, it is in riverside near Raja Indian Cuisine and it is a pub.'
'name[The Mill], eatType[pub], food[English], priceRange[less than £20], area[city centre], familyFriendly[no], near[Raja Indian Cuisine]'	'The Mill is in city centre near Raja Indian Cuisine, it is an english restaurant, it is a pub, it is n 't family friendly and it costs less than £20.'
'name[The Mill], eatType[pub], food[English], priceRange[less than £20], area[city centre], familyFriendly[yes], near[Raja Indian Cuisine]'	'The Mill costs less than £20, it 's near Raja Indian Cuisine in city centre, it is an english restaurant and family friendly and it is a pub.'
'name[The Mill], eatType[pub], food[English], priceRange[less than £20], area[riverside], familyFriendly[no], near[Raja Indian Cuisine]'	'The Mill is a pub, it costs less than £20, it 's near Raja Indian Cuisine in riverside, it is an english restaurant and it is n 't kid friendly.'
'name[The Mill], eatType[pub], food[English], priceRange[less than £20], area[riverside], familyFriendly[yes], near[Raja Indian Cuisine]'	'The Mill costs less than £20, it 's near Raja Indian Cuisine in riverside, it is an english restaurant and family friendly and it is a pub.'
'name[The Mill], eatType[pub], food[English], priceRange[moderate], area[city centre], familyFriendly[no], near[Raja Indian Cuisine]'	'The Mill is moderately priced and an english restaurant, it is in city centre near Raja Indian Cuisine, it is a pub and it is n 't kid friendly.'
'name[The Mill], eatType[pub], food[English], priceRange[moderate], area[city centre], familyFriendly[yes], near[Raja Indian Cuisine]'	'The Mill is moderately priced, an english restaurant and kid friendly, it is near Raja Indian Cuisine in city centre and it is a pub.'
'name[The Mill], eatType[pub], food[English], priceRange[moderate], area[riverside], familyFriendly[no], near[Raja Indian Cuisine]'	'The Mill is an english restaurant and moderately priced, it is in riverside near Raja Indian Cuisine, it is a pub and it is n 't kid friendly.'
'name[The Mill], eatType[pub], food[English], priceRange[moderate], area[riverside], familyFriendly[yes], near[Raja Indian Cuisine]'	'The Mill is moderately priced, an english restaurant and kid friendly, it is in riverside near Raja Indian Cuisine and it is a pub.'
'name[The Mill], eatType[pub], food[English], priceRange[more than £30], area[riverside], familyFriendly[yes], near[Raja Indian Cuisine]'	'The Mill costs more than £30, it 's near Raja Indian Cuisine in riverside, it is an english restaurant and family friendly and it is a pub.'
'name[The Mill], eatType[pub], food[Fast food], priceRange[£20-25], area[riverside], familyFriendly[yes], near[Raja Indian Cuisine]'	'The Mill is in riverside near Raja Indian Cuisine with a price range of £20-25, it is a pub and it is kid friendly and a fast food restaurant.'
'name[The Mill], eatType[pub], food[Fast food], priceRange[£20-25], customer rating[high], area[city centre], familyFriendly[no], near[Café Rouge]'	'The Mill is a fast food restaurant with a price range of £20-25 with a high rating, it is in city centre near Café Rouge, it is a pub and it is n 't kid friendly.'
'name[The Mill], eatType[pub], food[Fast food], priceRange[£20-25], customer rating[high], area[city centre], familyFriendly[yes], near[Café Rouge]'	'The Mill is a fast food restaurant and kid friendly with a price range of £20-25 with a high rating, it is in city centre near Café Rouge and it is a pub.'
'name[The Mill], eatType[pub], food[Fast food], priceRange[£20-25], customer rating[high], area[riverside], familyFriendly[no], near[Café Rouge]'	'The Mill is a fast food place with a high rating with a price range of £20-25, it is in riverside near Café Rouge, it is a pub and it is n 't kid friendly.'
'name[The Mill], eatType[pub], food[Fast food], priceRange[£20-25], customer rating[high], area[riverside], familyFriendly[yes], near[Café Rouge]'	'The Mill is a fast food restaurant and kid friendly with a price range of £20-25 with a high rating, it is in riverside near Café Rouge and it is a pub.'
'name[The Mill], eatType[pub], food[Fast food], priceRange[£20-25], customer rating[high], area[riverside], familyFriendly[yes], near[Café Sicilia]'	'The Mill is a fast food restaurant and kid friendly with a price range of £20-25 with a high rating, it is in riverside near Café Sicilia and it is a pub.'
'name[The Mill], eatType[pub], food[Fast food], priceRange[cheap], area[riverside], familyFriendly[yes], near[Raja Indian Cuisine]'	'The Mill is cheap, kid friendly and a fast food restaurant, it is near Raja Indian Cuisine in riverside and it is a pub.'
'name[The Mill], eatType[pub], food[Fast food], priceRange[cheap], customer rating[5 out of 5], area[city centre], familyFriendly[no], near[Café Sicilia]'	'The Mill is a fast food restaurant and cheap with a 5 out of 5 rating, it is in city centre near Café Sicilia, it is a pub and it is n 't kid friendly.'
'name[The Mill], eatType[pub], food[Fast food], priceRange[cheap], customer rating[5 out of 5], area[city centre], familyFriendly[yes], near[Café Sicilia]'	'The Mill is in city centre near Café Sicilia with a 5 out of 5 rating, it is a pub, it is family friendly and a fast food place and cheap.'
'name[The Mill], eatType[pub], food[Fast food], priceRange[cheap], customer rating[5 out of 5], area[riverside], familyFriendly[no], near[Café Sicilia]'	'The Mill is cheap and a fast food restaurant with a 5 out of 5 rating, it is near Café Sicilia in riverside, it is a pub and it is n 't kid friendly.'
'name[The Mill], eatType[pub], food[Fast food], priceRange[cheap], customer rating[5 out of 5], area[riverside], familyFriendly[yes], near[Café Sicilia]'	'The Mill is cheap, a fast food restaurant and kid friendly with a 5 out of 5 rating, it is near Café Sicilia in riverside and it is a pub.'
'name[The Mill], eatType[pub], food[Fast food], priceRange[cheap], customer rating[average], area[city centre], familyFriendly[no], near[Café Sicilia]'	'The Mill is a fast food restaurant and cheap with an average rating, it is in city centre near Café Sicilia, it is a pub and it is n 't kid friendly.'
'name[The Mill], eatType[pub], food[Fast food], priceRange[cheap], customer rating[average], area[city centre], familyFriendly[yes], near[Café Sicilia]'	'The Mill is near Café Sicilia in city centre with an average rating, it is a fast food restaurant, cheap and family friendly and it is a pub.'
'name[The Mill], eatType[pub], food[Fast food], priceRange[cheap], customer rating[average], area[riverside], familyFriendly[no], near[Café Sicilia]'	'The Mill is a fast food restaurant and cheap with an average rating, it is in riverside near Café Sicilia, it is a pub and it is n 't kid friendly.'
'name[The Mill], eatType[pub], food[Fast food], priceRange[cheap], customer rating[average], area[riverside], familyFriendly[yes], near[Café Sicilia]'	'The Mill is in riverside near Café Sicilia with an average rating, it is a fast food restaurant, cheap and kid friendly and it is a pub.'
'name[The Mill], eatType[pub], food[Fast food], priceRange[high], customer rating[1 out of 5], area[city centre], familyFriendly[no], near[Café Sicilia]'	'The Mill is in city centre near Café Sicilia with a 1 out of 5 rating, it is a fast food restaurant and expensive, it is n 't kid friendly and it 's a pub.'
'name[The Mill], eatType[pub], food[Fast food], priceRange[high], customer rating[1 out of 5], area[city centre], familyFriendly[yes], near[Café Sicilia]'	'The Mill is in city centre near Café Sicilia with a 1 out of 5 rating, it is a fast food restaurant, kid friendly and expensive and it is a pub.'
'name[The Mill], eatType[pub], food[Fast food], priceRange[high], customer rating[1 out of 5], area[riverside], familyFriendly[no], near[Café Sicilia]'	'The Mill is in riverside near Café Sicilia with a 1 out of 5 rating, it is a fast food restaurant and expensive, it is n 't kid friendly and it 's a pub.'
'name[The Mill], eatType[pub], food[Fast food], priceRange[high], customer rating[1 out of 5], area[riverside], familyFriendly[yes], near[Café Sicilia]'	'The Mill is in riverside near Café Sicilia with a 1 out of 5 rating, it is a fast food restaurant, expensive and kid friendly and it is a pub.'
'name[The Mill], eatType[pub], food[Fast food], priceRange[high], customer rating[average], area[city centre], familyFriendly[no], near[Café Sicilia]'	'The Mill is in city centre near Café Sicilia with an average rating, it is a fast food restaurant and expensive, it is n 't kid friendly and it 's a pub.'
'name[The Mill], eatType[pub], food[Fast food], priceRange[high], customer rating[average], area[city centre], familyFriendly[yes], near[Café Sicilia]'	'The Mill is in city centre near Café Sicilia with an average rating, it is a fast food restaurant, kid friendly and expensive and it is a pub.'
'name[The Mill], eatType[pub], food[Fast food], priceRange[high], customer rating[average], area[riverside], familyFriendly[no], near[Café Sicilia]'	'The Mill is in riverside near Café Sicilia with an average rating, it is a fast food restaurant and expensive, it is n 't kid friendly and it 's a pub.'
'name[The Mill], eatType[pub], food[Fast food], priceRange[high], customer rating[average], area[riverside], familyFriendly[yes], near[Café Sicilia]'	'The Mill is in riverside near Café Sicilia with an average rating, it is a fast food restaurant, expensive and kid friendly and it is a pub.'
'name[The Mill], eatType[pub], food[Fast food], priceRange[less than £20], customer rating[low], area[city centre], familyFriendly[no], near[Café Sicilia]'	'The Mill is a fast food restaurant with a low rating, it is in city centre near Café Sicilia, it is a pub, it is n 't family friendly and it costs less than £20.'
'name[The Mill], eatType[pub], food[Fast food], priceRange[less than £20], customer rating[low], area[city centre], familyFriendly[yes], near[Café Sicilia]'	'The Mill is in city centre near Café Sicilia with a low rating, it is a fast food restaurant and family friendly, it costs less than £20 and it 's a pub.'
'name[The Mill], eatType[pub], food[Fast food], priceRange[less than £20], customer rating[low], area[riverside], familyFriendly[no], near[Café Sicilia]'	'The Mill costs less than £20 with a low rating, it is near Café Sicilia in riverside, it is a fast food restaurant, it is n 't kid friendly and it 's a pub.'
'name[The Mill], eatType[pub], food[Fast food], priceRange[less than £20], customer rating[low], area[riverside], familyFriendly[yes], near[Café Sicilia]'	'The Mill is in riverside near Café Sicilia with a low rating, it is a fast food restaurant and family friendly, it costs less than £20 and it 's a pub.'
'name[The Mill], eatType[pub], food[Fast food], priceRange[moderate], customer rating[1 out of 5], area[city centre], familyFriendly[no], near[Café Sicilia]'	'The Mill is moderately priced and a fast food restaurant with a 1 out of 5 rating, it is in city centre near Café Sicilia, it is a pub and it is n 't kid friendly.'
'name[The Mill], eatType[pub], food[Fast food], priceRange[moderate], customer rating[1 out of 5], area[city centre], familyFriendly[yes], near[Café Sicilia]'	'The Mill is in city centre near Café Sicilia with a 1 out of 5 rating, it is a fast food restaurant, kid friendly and moderately priced and it is a pub.'
'name[The Mill], eatType[pub], food[Fast food], priceRange[moderate], customer rating[1 out of 5], area[riverside], familyFriendly[no], near[Café Sicilia]'	'The Mill is moderately priced and a fast food restaurant with a 1 out of 5 rating, it is in riverside near Café Sicilia, it is a pub and it is n 't kid friendly.'
'name[The Mill], eatType[pub], food[Fast food], priceRange[moderate], customer rating[1 out of 5], area[riverside], familyFriendly[yes], near[Café Sicilia]'	'The Mill is in riverside near Café Sicilia with a 1 out of 5 rating, it is a fast food restaurant, kid friendly and moderately priced and it is a pub.'
'name[The Mill], eatType[pub], food[Fast food], priceRange[moderate], customer rating[3 out of 5], area[city centre], familyFriendly[no], near[Café Sicilia]'	'The Mill is n 't kid friendly with a 3 out of 5 rating, it is moderately priced and a fast food restaurant, it is near Café Sicilia in city centre and it is a pub.'
'name[The Mill], eatType[pub], food[Fast food], priceRange[moderate], customer rating[3 out of 5], area[city centre], familyFriendly[yes], near[Café Sicilia]'	'The Mill is in city centre near Café Sicilia with a 3 out of 5 rating, it is a fast food place, kid friendly and moderately priced and it is a pub.'
'name[The Mill], eatType[pub], food[Fast food], priceRange[moderate], customer rating[3 out of 5], area[riverside], familyFriendly[no], near[Café Sicilia]'	'The Mill is moderately priced and a fast food restaurant with a 3 out of 5 rating, it is in riverside near Café Sicilia, it is a pub and it is n 't kid friendly.'
'name[The Mill], eatType[pub], food[Fast food], priceRange[moderate], customer rating[3 out of 5], area[riverside], familyFriendly[yes], near[Café Sicilia]'	'The Mill is in riverside near Café Sicilia with a 3 out of 5 rating, it is a fast food place, kid friendly and moderately priced and it is a pub.'
'name[The Mill], eatType[restaurant], food[English], priceRange[high], area[riverside], familyFriendly[yes], near[Raja Indian Cuisine]'	'The Mill is in riverside near Raja Indian Cuisine, it is an english restaurant and kid friendly and it is expensive.'
'name[The Mill], eatType[restaurant], food[English], priceRange[high], customer rating[average], area[riverside], familyFriendly[yes], near[Café Rouge]'	'The Mill is in riverside near Café Rouge with an average rating, it is an english restaurant and kid friendly and it is expensive.'
'name[The Mill], eatType[restaurant], food[English], priceRange[less than £20], area[city centre], familyFriendly[no], near[Raja Indian Cuisine]'	'The Mill costs less than £20, it 's near Raja Indian Cuisine in city centre, it is an english restaurant and it is n 't family friendly.'
'name[The Mill], eatType[restaurant], food[English], priceRange[less than £20], area[city centre], familyFriendly[yes], near[Raja Indian Cuisine]'	'The Mill costs less than £20, it 's near Raja Indian Cuisine in city centre and it is an english restaurant and family friendly.'
'name[The Mill], eatType[restaurant], food[English], priceRange[less than £20], area[riverside], familyFriendly[no], near[Raja Indian Cuisine]'	'The Mill costs less than £20, it 's near Raja Indian Cuisine in riverside, it is an english restaurant and it is n 't kid friendly.'
'name[The Mill], eatType[restaurant], food[English], priceRange[less than £20], area[riverside], familyFriendly[yes], near[Raja Indian Cuisine]'	'The Mill is in riverside near Raja Indian Cuisine, it is an english restaurant and family friendly and it costs less than £20.'
'name[The Mill], eatType[restaurant], food[English], priceRange[less than £20], customer rating[low], area[city centre], familyFriendly[no], near[Café Rouge]'	'The Mill costs less than £20 with a low rating, it is near Café Rouge in city centre, it is an english restaurant and it is n 't family friendly.'
'name[The Mill], eatType[restaurant], food[English], priceRange[less than £20], customer rating[low], area[city centre], familyFriendly[yes], near[Café Rouge]'	'The Mill costs less than £20 with a low rating, it is near Café Rouge in city centre and it is an english restaurant and family friendly.'
'name[The Mill], eatType[restaurant], food[English], priceRange[less than £20], customer rating[low], area[riverside], familyFriendly[no], near[Café Rouge]'	'The Mill costs less than £20 with a low rating, it is near Café Rouge in riverside, it is an english restaurant and it is n 't kid friendly.'
'name[The Mill], eatType[restaurant], food[English], priceRange[less than £20], customer rating[low], area[riverside], familyFriendly[yes], near[Café Rouge]'	'The Mill is in riverside near Café Rouge with a low rating, it is an english restaurant and family friendly and it costs less than £20.'
'name[The Mill], eatType[restaurant], food[English], priceRange[moderate], area[city centre], familyFriendly[no], near[Raja Indian Cuisine]'	'The Mill is moderately priced and an english restaurant, it is near Raja Indian Cuisine in city centre and it is n 't kid friendly.'
'name[The Mill], eatType[restaurant], food[English], priceRange[moderate], area[city centre], familyFriendly[yes], near[Raja Indian Cuisine]'	'The Mill is in city centre near Raja Indian Cuisine, it is moderately priced and an english restaurant and it is kid friendly.'
'name[The Mill], eatType[restaurant], food[English], priceRange[moderate], area[riverside], familyFriendly[no], near[Raja Indian Cuisine]'	'The Mill is in riverside near Raja Indian Cuisine, it is an english restaurant and moderately priced and it is n 't kid friendly.'
'name[The Mill], eatType[restaurant], food[English], priceRange[moderate], area[riverside], familyFriendly[yes], near[Raja Indian Cuisine]'	'The Mill is in riverside near Raja Indian Cuisine, it is moderately priced and an english restaurant and it is kid friendly.'
'name[The Mill], eatType[restaurant], food[English], priceRange[moderate], customer rating[1 out of 5], area[city centre], familyFriendly[no], near[Café Rouge]'	'The Mill is in city centre near Café Rouge with a 1 out of 5 rating, it is an english restaurant and moderately priced and it is n 't family friendly.'
'name[The Mill], eatType[restaurant], food[English], priceRange[moderate], customer rating[1 out of 5], area[city centre], familyFriendly[yes], near[Café Rouge]'	'The Mill is moderately priced, an english restaurant and kid friendly with a 1 out of 5 rating, it is in city centre near Café Rouge and it is a restaurant.'
'name[The Mill], eatType[restaurant], food[English], priceRange[moderate], customer rating[1 out of 5], area[riverside], familyFriendly[no], near[Café Rouge]'	'The Mill is in riverside near Café Rouge with a 1 out of 5 rating, it is an english restaurant and moderately priced and it is n 't kid friendly.'
'name[The Mill], eatType[restaurant], food[English], priceRange[moderate], customer rating[1 out of 5], area[riverside], familyFriendly[yes], near[Café Rouge]'	'The Mill is in riverside near Café Rouge with a 1 out of 5 rating, it is moderately priced and an english restaurant and it is kid friendly.'
'name[The Mill], eatType[restaurant], food[English], priceRange[moderate], customer rating[3 out of 5], area[city centre], familyFriendly[no], near[Café Rouge]'	'The Mill is in city centre near Café Rouge with a 3 out of 5 rating, it is an english restaurant and moderately priced and it is n 't kid friendly.'
'name[The Mill], eatType[restaurant], food[English], priceRange[moderate], customer rating[3 out of 5], area[city centre], familyFriendly[yes], near[Café Rouge]'	'The Mill is moderately priced, an english restaurant and kid friendly with a 3 out of 5 rating, it is in city centre near Café Rouge and it is a restaurant.'
'name[The Mill], eatType[restaurant], food[English], priceRange[moderate], customer rating[3 out of 5], area[riverside], familyFriendly[no], near[Café Rouge]'	'The Mill is in riverside near Café Rouge with a 3 out of 5 rating, it is an english restaurant and moderately priced and it is n 't kid friendly.'
'name[The Mill], eatType[restaurant], food[English], priceRange[moderate], customer rating[3 out of 5], area[riverside], familyFriendly[yes], near[Café Rouge]'	'The Mill is in riverside near Café Rouge with a 3 out of 5 rating, it is moderately priced and an english restaurant and it is kid friendly.'
'name[The Mill], eatType[restaurant], food[English], priceRange[more than £30], area[riverside], familyFriendly[yes], near[Raja Indian Cuisine]'	'The Mill is in riverside near Raja Indian Cuisine, it is an english restaurant and family friendly and it costs more than £30.'
'name[The Mill], eatType[restaurant], food[English], priceRange[more than £30], customer rating[high], area[city centre], familyFriendly[no], near[Café Rouge]'	'The Mill costs more than £30 with a high rating, it is near Café Rouge in city centre, it is an english restaurant and it is n 't family friendly.'
'name[The Mill], eatType[restaurant], food[English], priceRange[more than £30], customer rating[high], area[city centre], familyFriendly[yes], near[Café Rouge]'	'The Mill costs more than £30 with a high rating, it is near Café Rouge in city centre and it is an english restaurant and family friendly.'
'name[The Mill], eatType[restaurant], food[English], priceRange[more than £30], customer rating[high], area[riverside], familyFriendly[no], near[Café Rouge]'	'The Mill costs more than £30 with a high rating, it is near Café Rouge in riverside, it is an english restaurant and it is n 't kid friendly.'
'name[The Mill], eatType[restaurant], food[English], priceRange[more than £30], customer rating[high], area[riverside], familyFriendly[yes], near[Café Rouge]'	'The Mill costs more than £30 with a high rating, it is near Café Rouge in riverside and it is an english restaurant and family friendly.'
'name[The Mill], eatType[restaurant], food[Fast food], priceRange[£20-25], area[riverside], familyFriendly[yes], near[Raja Indian Cuisine]'	'The Mill is in riverside near Raja Indian Cuisine with a price range of £20-25, it is a fast food restaurant and kid friendly.'
'name[The Mill], eatType[restaurant], food[Fast food], priceRange[cheap], area[riverside], familyFriendly[yes], near[Raja Indian Cuisine]'	'The Mill is in riverside near Raja Indian Cuisine, it is cheap and a fast food restaurant and family friendly.'
'name[The Phoenix], eatType[pub], food[Fast food], priceRange[cheap], area[riverside], familyFriendly[yes], near[Raja Indian Cuisine]'	'The Phoenix is cheap, kid friendly and a fast food restaurant, it is near Raja Indian Cuisine in riverside and it is a pub.'
'name[The Phoenix], eatType[pub], food[Fast food], priceRange[high], area[city centre], familyFriendly[no], near[Raja Indian Cuisine]'	'The Phoenix is a fast food restaurant and expensive, it is in city centre near Raja Indian Cuisine, it is a pub and it is n 't kid friendly.'
'name[The Phoenix], eatType[pub], food[Fast food], priceRange[high], area[city centre], familyFriendly[yes], near[Raja Indian Cuisine]'	'The Phoenix is a fast food restaurant, kid friendly and expensive, it is near Raja Indian Cuisine in city centre and it is a pub.'
'name[The Phoenix], eatType[pub], food[Fast food], priceRange[high], area[riverside], familyFriendly[no], near[Raja Indian Cuisine]'	'The Phoenix is a fast food restaurant and expensive, it is in riverside near Raja Indian Cuisine, it is a pub and it is n 't kid friendly.'
'name[The Phoenix], eatType[pub], food[Fast food], priceRange[high], area[riverside], familyFriendly[yes], near[Raja Indian Cuisine]'	'The Phoenix is a fast food restaurant, kid friendly and expensive, it is in riverside near Raja Indian Cuisine and it is a pub.'
'name[The Phoenix], eatType[pub], food[Fast food], priceRange[less than £20], area[city centre], familyFriendly[no], near[Raja Indian Cuisine]'	'The Phoenix costs less than £20, it 's in city centre near Raja Indian Cuisine, it is a pub, it is a fast food restaurant and it is n 't family friendly.'
'name[The Phoenix], eatType[pub], food[Fast food], priceRange[less than £20], area[city centre], familyFriendly[yes], near[Raja Indian Cuisine]'	'The Phoenix is a fast food restaurant and family friendly, it costs less than £20, it 's near Raja Indian Cuisine in city centre and it is a pub.'
'name[The Phoenix], eatType[pub], food[Fast food], priceRange[less than £20], area[riverside], familyFriendly[no], near[Raja Indian Cuisine]'	'The Phoenix is near Raja Indian Cuisine in riverside, it is a fast food restaurant, it is a pub, it costs less than £20 and it is n 't kid friendly.'
'name[The Phoenix], eatType[pub], food[Fast food], priceRange[less than £20], area[riverside], familyFriendly[yes], near[Raja Indian Cuisine]'	'The Phoenix is in riverside near Raja Indian Cuisine, it is a fast food restaurant and family friendly, it costs less than £20 and it 's a pub.'
'name[The Phoenix], eatType[pub], food[Fast food], priceRange[moderate], area[city centre], familyFriendly[no], near[Raja Indian Cuisine]'	'The Phoenix is a fast food restaurant and moderately priced, it is in city centre near Raja Indian Cuisine, it is a pub and it is n 't kid friendly.'
'name[The Phoenix], eatType[pub], food[Fast food], priceRange[moderate], area[city centre], familyFriendly[yes], near[Raja Indian Cuisine]'	'The Phoenix is a fast food restaurant, kid friendly and moderately priced, it is near Raja Indian Cuisine in city centre and it is a pub.'
'name[The Phoenix], eatType[pub], food[Fast food], priceRange[moderate], area[riverside], familyFriendly[no], near[Raja Indian Cuisine]'	'The Phoenix is a fast food restaurant and moderately priced, it is in riverside near Raja Indian Cuisine, it is a pub and it is n 't kid friendly.'
'name[The Phoenix], eatType[pub], food[Fast food], priceRange[moderate], area[riverside], familyFriendly[yes], near[Raja Indian Cuisine]'	'The Phoenix is a fast food restaurant, kid friendly and moderately priced, it is in riverside near Raja Indian Cuisine and it is a pub.'
'name[The Phoenix], eatType[pub], food[Fast food], priceRange[moderate], customer rating[3 out of 5], area[riverside], familyFriendly[yes], near[Café Sicilia]'	'The Phoenix is in riverside near Café Sicilia with a 3 out of 5 rating, it is a fast food place, kid friendly and moderately priced and it is a pub.'
'name[The Phoenix], eatType[pub], food[Fast food], priceRange[more than £30], area[riverside], familyFriendly[yes], near[Raja Indian Cuisine]'	'The Phoenix costs more than £30, it 's in riverside near Raja Indian Cuisine, it is a fast food restaurant and kid friendly and it is a pub.'
'name[The Phoenix], eatType[pub], food[Fast food], priceRange[more than £30], customer rating[high], area[city centre], familyFriendly[no], near[Café Sicilia]'	'The Phoenix is a fast food restaurant with a high rating, it is in city centre near Café Sicilia, it is a pub, it is n 't kid friendly and it costs more than £30.'
'name[The Phoenix], eatType[pub], food[Fast food], priceRange[more than £30], customer rating[high], area[city centre], familyFriendly[yes], near[Café Sicilia]'	'The Phoenix is in city centre near Café Sicilia with a high rating, it is a fast food restaurant and kid friendly, it costs more than £30 and it 's a pub.'
'name[The Phoenix], eatType[pub], food[Fast food], priceRange[more than £30], customer rating[high], area[riverside], familyFriendly[no], near[Café Sicilia]'	'The Phoenix is a fast food restaurant with a high rating, it is in riverside near Café Sicilia, it is a pub, it is n 't kid friendly and it costs more than £30.'
'name[The Phoenix], eatType[pub], food[Fast food], priceRange[more than £30], customer rating[high], area[riverside], familyFriendly[yes], near[Café Sicilia]'	'The Phoenix is in riverside near Café Sicilia with a high rating, it is a fast food restaurant and kid friendly, it costs more than £30 and it 's a pub.'
'name[The Phoenix], eatType[pub], food[French], priceRange[£20-25], area[riverside], familyFriendly[yes], near[Raja Indian Cuisine]'	'The Phoenix is in riverside near Raja Indian Cuisine with a price range of £20-25, it is a pub and it is kid friendly and a french restaurant.'
'name[The Phoenix], eatType[pub], food[French], priceRange[£20-25], customer rating[3 out of 5], area[city centre], familyFriendly[no], near[Café Sicilia]'	'The Phoenix is a french restaurant with a 3 out of 5 rating with a price range of £20-25, it is in city centre near Café Sicilia, it is a pub and it is n 't kid friendly.'
'name[The Phoenix], eatType[pub], food[French], priceRange[£20-25], customer rating[3 out of 5], area[city centre], familyFriendly[yes], near[Café Sicilia]'	'The Phoenix is in city centre near Café Sicilia with a 3 out of 5 rating with a price range of £20-25, it is kid friendly and a french restaurant and it is a pub.'
'name[The Phoenix], eatType[pub], food[French], priceRange[£20-25], customer rating[3 out of 5], area[riverside], familyFriendly[no], near[Café Sicilia]'	'The Phoenix is a french restaurant with a 3 out of 5 rating with a price range of £20-25, it is in riverside near Café Sicilia, it is a pub and it is n 't kid friendly.'
'name[The Phoenix], eatType[pub], food[French], priceRange[£20-25], customer rating[3 out of 5], area[riverside], familyFriendly[yes], near[Café Sicilia]'	'The Phoenix is a french place and kid friendly with a 3 out of 5 rating with a price range of £20-25, it is in riverside near Café Sicilia and it is a pub.'
'name[The Phoenix], eatType[pub], food[French], priceRange[£20-25], customer rating[3 out of 5], area[riverside], familyFriendly[yes], near[Crowne Plaza Hotel]'	'The Phoenix is a french place and kid friendly with a 3 out of 5 rating with a price range of £20-25, it is in riverside near Crowne Plaza Hotel and it is a pub.'
'name[The Phoenix], eatType[pub], food[French], priceRange[£20-25], customer rating[high], area[city centre], familyFriendly[no], near[Crowne Plaza Hotel]'	'The Phoenix is a french restaurant with a high rating with a price range of £20-25, it is in city centre near Crowne Plaza Hotel, it is a pub and it is n 't kid friendly.'
'name[The Phoenix], eatType[pub], food[French], priceRange[£20-25], customer rating[high], area[city centre], familyFriendly[yes], near[Crowne Plaza Hotel]'	'The Phoenix is in city centre near Crowne Plaza Hotel with a high rating with a price range of £20-25, it is kid friendly and a french restaurant and it is a pub.'
'name[The Phoenix], eatType[pub], food[French], priceRange[£20-25], customer rating[high], area[riverside], familyFriendly[no], near[Crowne Plaza Hotel]'	'The Phoenix is a french restaurant with a high rating with a price range of £20-25, it is in riverside near Crowne Plaza Hotel, it is a pub and it is n 't kid friendly.'
'name[The Phoenix], eatType[pub], food[French], priceRange[£20-25], customer rating[high], area[riverside], familyFriendly[yes], near[Crowne Plaza Hotel]'	'The Phoenix is a french place and kid friendly with a high rating with a price range of £20-25, it is in riverside near Crowne Plaza Hotel and it is a pub.'
'name[The Phoenix], eatType[pub], food[French], priceRange[cheap], area[riverside], familyFriendly[yes], near[Raja Indian Cuisine]'	'The Phoenix is cheap, kid friendly and a french restaurant, it is near Raja Indian Cuisine in riverside and it is a pub.'
'name[The Phoenix], eatType[pub], food[French], priceRange[cheap], customer rating[5 out of 5], area[city centre], familyFriendly[no], near[Crowne Plaza Hotel]'	'The Phoenix is in city centre near Crowne Plaza Hotel with a 5 out of 5 rating, it is a pub, it is cheap and a french restaurant and it is n 't kid friendly.'
'name[The Phoenix], eatType[pub], food[French], priceRange[cheap], customer rating[5 out of 5], area[city centre], familyFriendly[yes], near[Crowne Plaza Hotel]'	'The Phoenix is in city centre near Crowne Plaza Hotel with a 5 out of 5 rating, it is a pub, it is kid friendly and a french restaurant and it is cheap.'
'name[The Phoenix], eatType[pub], food[French], priceRange[cheap], customer rating[5 out of 5], area[riverside], familyFriendly[no], near[Crowne Plaza Hotel]'	'The Phoenix is in riverside near Crowne Plaza Hotel with a 5 out of 5 rating, it is a pub, it is cheap and a french restaurant and it is n 't kid friendly.'
'name[The Phoenix], eatType[pub], food[French], priceRange[cheap], customer rating[5 out of 5], area[riverside], familyFriendly[yes], near[Crowne Plaza Hotel]'	'The Phoenix is a french place, cheap and kid friendly with a 5 out of 5 rating, it is near Crowne Plaza Hotel in riverside and it is a pub.'
'name[The Phoenix], eatType[pub], food[French], priceRange[high], area[riverside], familyFriendly[yes], near[Raja Indian Cuisine]'	'The Phoenix is a french restaurant, expensive and kid friendly, it is in riverside near Raja Indian Cuisine and it is a pub.'
'name[The Phoenix], eatType[pub], food[French], priceRange[high], customer rating[3 out of 5], area[city centre], familyFriendly[no], near[Crowne Plaza Hotel]'	'The Phoenix is in city centre near Crowne Plaza Hotel with a 3 out of 5 rating, it is a french restaurant and expensive, it is n 't kid friendly and it 's a pub.'
'name[The Phoenix], eatType[pub], food[French], priceRange[high], customer rating[3 out of 5], area[city centre], familyFriendly[yes], near[Crowne Plaza Hotel]'	'The Phoenix is in city centre near Crowne Plaza Hotel with a 3 out of 5 rating, it is a french restaurant, expensive and kid friendly and it is a pub.'
'name[The Phoenix], eatType[pub], food[French], priceRange[high], customer rating[3 out of 5], area[riverside], familyFriendly[no], near[Crowne Plaza Hotel]'	'The Phoenix is a french restaurant and expensive with a 3 out of 5 rating, it is in riverside near Crowne Plaza Hotel, it is a pub and it is n 't kid friendly.'
'name[The Phoenix], eatType[pub], food[French], priceRange[high], customer rating[3 out of 5], area[riverside], familyFriendly[yes], near[Crowne Plaza Hotel]'	'The Phoenix is in riverside near Crowne Plaza Hotel with a 3 out of 5 rating, it is a french restaurant, expensive and kid friendly and it is a pub.'
'name[The Phoenix], eatType[pub], food[French], priceRange[less than £20], customer rating[average], area[city centre], familyFriendly[no], near[Crowne Plaza Hotel]'	'The Phoenix costs less than £20 with an average rating, it is in city centre near Crowne Plaza Hotel, it is a pub, it is a french restaurant and it is n 't kid friendly.'
'name[The Phoenix], eatType[pub], food[French], priceRange[less than £20], customer rating[average], area[city centre], familyFriendly[yes], near[Crowne Plaza Hotel]'	'The Phoenix is in city centre near Crowne Plaza Hotel with an average rating, it is a pub, it costs less than £20 and it 's family friendly and a french restaurant.'
'name[The Phoenix], eatType[pub], food[French], priceRange[less than £20], customer rating[average], area[riverside], familyFriendly[no], near[Crowne Plaza Hotel]'	'The Phoenix costs less than £20 with an average rating, it is near Crowne Plaza Hotel in riverside, it is a pub, it is a french restaurant and it is n 't kid friendly.'
'name[The Phoenix], eatType[pub], food[French], priceRange[less than £20], customer rating[average], area[riverside], familyFriendly[yes], near[Crowne Plaza Hotel]'	'The Phoenix is in riverside near Crowne Plaza Hotel with an average rating, it is a pub, it costs less than £20 and it 's kid friendly and a french restaurant.'
'name[The Phoenix], eatType[pub], food[French], priceRange[less than £20], customer rating[low], area[city centre], familyFriendly[no], near[Crowne Plaza Hotel]'	'The Phoenix costs less than £20 with a low rating, it is near Crowne Plaza Hotel in city centre, it is a pub, it is n 't family friendly and it 's a french restaurant.'
'name[The Phoenix], eatType[pub], food[French], priceRange[less than £20], customer rating[low], area[city centre], familyFriendly[yes], near[Crowne Plaza Hotel]'	'The Phoenix costs less than £20 with a low rating, it is near Crowne Plaza Hotel in city centre, it is a pub and it is family friendly and a french restaurant.'
'name[The Phoenix], eatType[pub], food[French], priceRange[less than £20], customer rating[low], area[riverside], familyFriendly[no], near[Crowne Plaza Hotel]'	'The Phoenix costs less than £20 with a low rating, it is near Crowne Plaza Hotel in riverside, it is a french restaurant, it is a pub and it is n 't kid friendly.'
'name[The Phoenix], eatType[pub], food[French], priceRange[less than £20], customer rating[low], area[riverside], familyFriendly[yes], near[Crowne Plaza Hotel]'	'The Phoenix costs less than £20 with a low rating, it is near Crowne Plaza Hotel in riverside, it is a pub and it is family friendly and a french restaurant.'
'name[The Phoenix], eatType[pub], food[French], priceRange[moderate], customer rating[1 out of 5], area[city centre], familyFriendly[no], near[Crowne Plaza Hotel]'	'The Phoenix is a french restaurant and moderately priced with a 1 out of 5 rating, it is in city centre near Crowne Plaza Hotel, it is a pub and it is n 't kid friendly.'
'name[The Phoenix], eatType[pub], food[French], priceRange[moderate], customer rating[1 out of 5], area[city centre], familyFriendly[yes], near[Crowne Plaza Hotel]'	'The Phoenix is in city centre near Crowne Plaza Hotel with a 1 out of 5 rating, it is a french restaurant, kid friendly and moderately priced and it is a pub.'
'name[The Phoenix], eatType[pub], food[French], priceRange[moderate], customer rating[1 out of 5], area[riverside], familyFriendly[no], near[Crowne Plaza Hotel]'	'The Phoenix is a french restaurant and moderately priced with a 1 out of 5 rating, it is in riverside near Crowne Plaza Hotel, it is a pub and it is n 't kid friendly.'
'name[The Phoenix], eatType[pub], food[French], priceRange[moderate], customer rating[1 out of 5], area[riverside], familyFriendly[yes], near[Crowne Plaza Hotel]'	'The Phoenix is in riverside near Crowne Plaza Hotel with a 1 out of 5 rating, it is a french restaurant, kid friendly and moderately priced and it is a pub.'
'name[The Phoenix], eatType[pub], food[French], priceRange[more than £30], customer rating[5 out of 5], area[city centre], familyFriendly[no], near[Crowne Plaza Hotel]'	'The Phoenix costs more than £30 with a 5 out of 5 rating, it is near Crowne Plaza Hotel in city centre, it is a pub, it is a french restaurant and it is n 't kid friendly.'
'name[The Phoenix], eatType[pub], food[French], priceRange[more than £30], customer rating[5 out of 5], area[city centre], familyFriendly[yes], near[Crowne Plaza Hotel]'	'The Phoenix costs more than £30 with a 5 out of 5 rating, it is in city centre near Crowne Plaza Hotel, it is a french restaurant and family friendly and it is a pub.'
'name[The Phoenix], eatType[pub], food[French], priceRange[more than £30], customer rating[5 out of 5], area[riverside], familyFriendly[no], near[Crowne Plaza Hotel]'	'The Phoenix costs more than £30 with a 5 out of 5 rating, it is near Crowne Plaza Hotel in riverside, it is a french restaurant, it is a pub and it is n 't kid friendly.'
'name[The Phoenix], eatType[pub], food[French], priceRange[more than £30], customer rating[5 out of 5], area[riverside], familyFriendly[yes], near[Crowne Plaza Hotel]'	'The Phoenix costs more than £30 with a 5 out of 5 rating, it is in riverside near Crowne Plaza Hotel, it is a french restaurant and kid friendly and it is a pub.'
'name[The Phoenix], eatType[pub], food[French], priceRange[more than £30], customer rating[low], area[city centre], familyFriendly[no], near[Crowne Plaza Hotel]'	'The Phoenix costs more than £30 with a low rating, it is in city centre near Crowne Plaza Hotel, it is a pub, it is a french restaurant and it is n 't kid friendly.'
'name[The Phoenix], eatType[pub], food[French], priceRange[more than £30], customer rating[low], area[city centre], familyFriendly[yes], near[Crowne Plaza Hotel]'	'The Phoenix costs more than £30 with a low rating, it is near Crowne Plaza Hotel in city centre, it is a pub and it is family friendly and a french restaurant.'
'name[The Phoenix], eatType[pub], food[French], priceRange[more than £30], customer rating[low], area[riverside], familyFriendly[no], near[Crowne Plaza Hotel]'	'The Phoenix is a french restaurant with a low rating, it is in riverside near Crowne Plaza Hotel, it is a pub, it is n 't kid friendly and it costs more than £30.'
'name[The Phoenix], eatType[pub], food[French], priceRange[more than £30], customer rating[low], area[riverside], familyFriendly[yes], near[Crowne Plaza Hotel]'	'The Phoenix costs more than £30 with a low rating, it is near Crowne Plaza Hotel in riverside, it is a french restaurant and kid friendly and it is a pub.'
'name[The Phoenix], eatType[restaurant], food[Fast food], priceRange[cheap], area[riverside], familyFriendly[yes], near[Raja Indian Cuisine]'	'The Phoenix is in riverside near Raja Indian Cuisine, it is cheap and a fast food restaurant and family friendly.'
'name[The Phoenix], eatType[restaurant], food[Fast food], priceRange[high], area[city centre], familyFriendly[no], near[Raja Indian Cuisine]'	'The Phoenix is in city centre near Raja Indian Cuisine, it is a fast food restaurant and expensive and it is n 't family friendly.'
'name[The Phoenix], eatType[restaurant], food[Fast food], priceRange[high], area[city centre], familyFriendly[yes], near[Raja Indian Cuisine]'	'The Phoenix is in city centre near Raja Indian Cuisine, it is a fast food restaurant and kid friendly and it is expensive.'
'name[The Phoenix], eatType[restaurant], food[Fast food], priceRange[high], area[riverside], familyFriendly[no], near[Raja Indian Cuisine]'	'The Phoenix is in riverside near Raja Indian Cuisine, it is a fast food restaurant and expensive and it is n 't kid friendly.'
'name[The Phoenix], eatType[restaurant], food[Fast food], priceRange[high], area[riverside], familyFriendly[yes], near[Raja Indian Cuisine]'	'The Phoenix is in riverside near Raja Indian Cuisine, it is a fast food restaurant and kid friendly and it is expensive.'
'name[The Phoenix], eatType[restaurant], food[Fast food], priceRange[less than £20], area[city centre], familyFriendly[no], near[Raja Indian Cuisine]'	'The Phoenix costs less than £20, it 's near Raja Indian Cuisine in city centre, it is a fast food restaurant and it is n 't family friendly.'
'name[The Phoenix], eatType[restaurant], food[Fast food], priceRange[less than £20], area[city centre], familyFriendly[yes], near[Raja Indian Cuisine]'	'The Phoenix costs less than £20, it 's near Raja Indian Cuisine in city centre and it is a fast food restaurant and family friendly.'
'name[The Phoenix], eatType[restaurant], food[Fast food], priceRange[less than £20], area[riverside], familyFriendly[no], near[Raja Indian Cuisine]'	'The Phoenix costs less than £20, it 's near Raja Indian Cuisine in riverside, it is a fast food restaurant and it is n 't family friendly.'
'name[The Phoenix], eatType[restaurant], food[Fast food], priceRange[less than £20], area[riverside], familyFriendly[yes], near[Raja Indian Cuisine]'	'The Phoenix costs less than £20, it 's near Raja Indian Cuisine in riverside, it is a fast food restaurant and family friendly.'
'name[The Phoenix], eatType[restaurant], food[Fast food], priceRange[moderate], area[city centre], familyFriendly[no], near[Raja Indian Cuisine]'	'The Phoenix is near Raja Indian Cuisine in city centre, it is a fast food restaurant and moderately priced and it is n 't family friendly.'
'name[The Phoenix], eatType[restaurant], food[Fast food], priceRange[moderate], area[city centre], familyFriendly[yes], near[Raja Indian Cuisine]'	'The Phoenix is in city centre near Raja Indian Cuisine, it is a fast food restaurant and kid friendly and it is moderately priced.'
'name[The Phoenix], eatType[restaurant], food[Fast food], priceRange[moderate], area[riverside], familyFriendly[no], near[Raja Indian Cuisine]'	'The Phoenix is near Raja Indian Cuisine in riverside, it is a fast food restaurant and moderately priced and it is n 't kid friendly.'
'name[The Phoenix], eatType[restaurant], food[Fast food], priceRange[moderate], area[riverside], familyFriendly[yes], near[Raja Indian Cuisine]'	'The Phoenix is in riverside near Raja Indian Cuisine, it is a fast food restaurant and kid friendly and it is moderately priced.'
'name[The Phoenix], eatType[restaurant], food[Fast food], priceRange[more than £30], area[riverside], familyFriendly[yes], near[Raja Indian Cuisine]'	'The Phoenix is in riverside near Raja Indian Cuisine, it is a fast food restaurant and kid friendly and it costs more than £30.'
'name[The Phoenix], eatType[restaurant], food[French], priceRange[£20-25], area[riverside], familyFriendly[yes], near[Raja Indian Cuisine]'	'The Phoenix is a french restaurant and kid friendly with a price range of £20-25, it is near Raja Indian Cuisine in riverside and it is a restaurant.'
'name[The Phoenix], eatType[restaurant], food[French], priceRange[cheap], area[riverside], familyFriendly[yes], near[Raja Indian Cuisine]'	'The Phoenix is in riverside near Raja Indian Cuisine, it is a french restaurant and family friendly and it is cheap.'
'name[The Phoenix], eatType[restaurant], food[French], priceRange[high], area[riverside], familyFriendly[yes], near[Raja Indian Cuisine]'	'The Phoenix is in riverside near Raja Indian Cuisine, it is a french restaurant and kid friendly and it is expensive.'
'name[The Phoenix], eatType[restaurant], food[Indian], priceRange[£20-25], customer rating[high], area[city centre], familyFriendly[no], near[Crowne Plaza Hotel]'	'The Phoenix is an indian restaurant with a price range of £20-25 with a high rating, it is near Crowne Plaza Hotel in city centre and it is n 't kid friendly.'
'name[The Phoenix], eatType[restaurant], food[Indian], priceRange[£20-25], customer rating[high], area[city centre], familyFriendly[yes], near[Crowne Plaza Hotel]'	'The Phoenix is in city centre near Crowne Plaza Hotel with a price range of £20-25 with a high rating, it is kid friendly and an indian restaurant and it is a restaurant.'
'name[The Phoenix], eatType[restaurant], food[Indian], priceRange[£20-25], customer rating[high], area[riverside], familyFriendly[no], near[Crowne Plaza Hotel]'	'The Phoenix is an indian restaurant with a price range of £20-25 with a high rating, it is near Crowne Plaza Hotel in riverside and it is n 't kid friendly.'
'name[The Phoenix], eatType[restaurant], food[Indian], priceRange[£20-25], customer rating[high], area[riverside], familyFriendly[yes], near[Crowne Plaza Hotel]'	'The Phoenix is in riverside near Crowne Plaza Hotel with a price range of £20-25 with a high rating, it is kid friendly and an indian restaurant and it is a restaurant.'
'name[The Phoenix], eatType[restaurant], food[Indian], priceRange[cheap], customer rating[5 out of 5], area[city centre], familyFriendly[no], near[Crowne Plaza Hotel]'	'The Phoenix is an indian restaurant and cheap with a 5 out of 5 rating, it is near Crowne Plaza Hotel in city centre and it is n 't family friendly.'
'name[The Phoenix], eatType[restaurant], food[Indian], priceRange[cheap], customer rating[5 out of 5], area[city centre], familyFriendly[yes], near[Crowne Plaza Hotel]'	'The Phoenix is cheap, an indian restaurant and kid friendly with a 5 out of 5 rating, it is near Crowne Plaza Hotel in city centre and it is a restaurant.'
'name[The Phoenix], eatType[restaurant], food[Indian], priceRange[cheap], customer rating[5 out of 5], area[riverside], familyFriendly[no], near[Crowne Plaza Hotel]'	'The Phoenix is cheap and an indian restaurant with a 5 out of 5 rating, it is near Crowne Plaza Hotel in riverside and it is n 't kid friendly.'
'name[The Phoenix], eatType[restaurant], food[Indian], priceRange[cheap], customer rating[5 out of 5], area[riverside], familyFriendly[no], near[Express by Holiday Inn]'	'The Phoenix is cheap and an indian restaurant with a 5 out of 5 rating, it is near Express by Holiday Inn in riverside and it is n 't kid friendly.'
'name[The Phoenix], eatType[restaurant], food[Indian], priceRange[cheap], customer rating[5 out of 5], area[riverside], familyFriendly[yes], near[Express by Holiday Inn]'	'The Phoenix is cheap, an indian restaurant and kid friendly with a 5 out of 5 rating, it is near Express by Holiday Inn in riverside and it is a restaurant.'
'name[The Phoenix], eatType[restaurant], food[Indian], priceRange[cheap], customer rating[average], area[city centre], familyFriendly[no], near[Express by Holiday Inn]'	'The Phoenix is an indian restaurant and cheap with an average rating, it is near Express by Holiday Inn in city centre and it is n 't family friendly.'
'name[The Plough], eatType[pub], food[Chinese], priceRange[£20-25], area[riverside], familyFriendly[yes], near[Raja Indian Cuisine]'	'The Plough is a chinese restaurant and kid friendly with a price range of £20-25, it is in riverside near Raja Indian Cuisine and it is a pub.'
'name[The Plough], eatType[pub], food[Chinese], priceRange[cheap], area[riverside], familyFriendly[yes], near[Raja Indian Cuisine]'	'The Plough is cheap, kid friendly and a chinese restaurant, it is near Raja Indian Cuisine in riverside and it is a pub.'
'name[The Plough], eatType[pub], food[Chinese], priceRange[high], area[city centre], familyFriendly[no], near[Raja Indian Cuisine]'	'The Plough is in city centre near Raja Indian Cuisine, it is a pub, it is a chinese restaurant and expensive and it is n 't kid friendly.'
'name[The Plough], eatType[pub], food[Chinese], priceRange[high], area[city centre], familyFriendly[yes], near[Raja Indian Cuisine]'	'The Plough is a pub, it is in city centre near Raja Indian Cuisine and it is a chinese restaurant, kid friendly and expensive.'
'name[The Plough], eatType[pub], food[Chinese], priceRange[high], area[riverside], familyFriendly[no], near[Raja Indian Cuisine]'	'The Plough is a chinese restaurant and expensive, it is in riverside near Raja Indian Cuisine, it is a pub and it is n 't kid friendly.'
'name[The Plough], eatType[pub], food[Chinese], priceRange[high], area[riverside], familyFriendly[yes], near[Raja Indian Cuisine]'	'The Plough is a pub, it is in riverside near Raja Indian Cuisine and it is a chinese restaurant, expensive and kid friendly.'
'name[The Plough], eatType[pub], food[Chinese], priceRange[less than £20], area[city centre], familyFriendly[no], near[Raja Indian Cuisine]'	'The Plough costs less than £20, it 's in city centre near Raja Indian Cuisine, it is a pub, it is n 't family friendly and it 's a chinese restaurant.'
'name[The Plough], eatType[restaurant], food[Chinese], priceRange[£20-25], area[riverside], familyFriendly[yes], near[Raja Indian Cuisine]'	'The Plough is near Raja Indian Cuisine in riverside with a price range of £20-25, it is a chinese restaurant and it is kid friendly.'
'name[The Plough], eatType[restaurant], food[Chinese], priceRange[cheap], area[riverside], familyFriendly[yes], near[Raja Indian Cuisine]'	'The Plough is in riverside near Raja Indian Cuisine, it is a chinese restaurant and cheap and it is kid friendly.'
'name[The Plough], eatType[restaurant], food[Chinese], priceRange[high], area[city centre], familyFriendly[no], near[Raja Indian Cuisine]'	'The Plough is in city centre near Raja Indian Cuisine, it is a chinese restaurant and expensive and it is n 't family friendly.'
'name[The Plough], eatType[restaurant], food[Chinese], priceRange[high], area[city centre], familyFriendly[yes], near[Raja Indian Cuisine]'	'The Plough is in city centre near Raja Indian Cuisine, it is a chinese restaurant and kid friendly and it is expensive.'
'name[The Plough], eatType[restaurant], food[Chinese], priceRange[high], area[riverside], familyFriendly[no], near[Raja Indian Cuisine]'	'The Plough is in riverside near Raja Indian Cuisine, it is a chinese restaurant and expensive and it is n 't kid friendly.'
'name[The Plough], eatType[restaurant], food[Chinese], priceRange[high], area[riverside], familyFriendly[yes], near[Raja Indian Cuisine]'	'The Plough is in riverside near Raja Indian Cuisine, it is a chinese restaurant and kid friendly and it is expensive.'
'name[The Plough], eatType[restaurant], food[Chinese], priceRange[less than £20], area[city centre], familyFriendly[no], near[Raja Indian Cuisine]'	'The Plough costs less than £20, it 's near Raja Indian Cuisine in city centre, it is a chinese restaurant and it is n 't family friendly.'
'name[The Punter], eatType[pub], food[Chinese], priceRange[less than £20], area[city centre], familyFriendly[yes], near[Raja Indian Cuisine]'	'The Punter costs less than £20, it 's a pub, it is in city centre near Raja Indian Cuisine and it is a chinese restaurant and family friendly.'
'name[The Punter], eatType[pub], food[Chinese], priceRange[less than £20], area[riverside], familyFriendly[no], near[Raja Indian Cuisine]'	'The Punter is a chinese restaurant, it is in riverside near Raja Indian Cuisine, it is a pub, it costs less than £20 and it is n 't kid friendly.'
'name[The Punter], eatType[pub], food[Chinese], priceRange[less than £20], area[riverside], familyFriendly[yes], near[Raja Indian Cuisine]'	'The Punter is a chinese restaurant and family friendly, it costs less than £20, it 's in riverside near Raja Indian Cuisine and it is a pub.'
'name[The Punter], eatType[pub], food[Chinese], priceRange[moderate], area[city centre], familyFriendly[no], near[Raja Indian Cuisine]'	'The Punter is moderately priced and a chinese restaurant, it is in city centre near Raja Indian Cuisine, it is a pub and it is n 't kid friendly.'
'name[The Punter], eatType[pub], food[Chinese], priceRange[moderate], area[city centre], familyFriendly[yes], near[Raja Indian Cuisine]'	'The Punter is moderately priced, kid friendly and a chinese restaurant, it is near Raja Indian Cuisine in city centre and it is a pub.'
'name[The Punter], eatType[pub], food[Chinese], priceRange[moderate], area[riverside], familyFriendly[no], near[Raja Indian Cuisine]'	'The Punter is a chinese restaurant and moderately priced, it is in riverside near Raja Indian Cuisine, it is a pub and it is n 't kid friendly.'
'name[The Punter], eatType[pub], food[Chinese], priceRange[moderate], area[riverside], familyFriendly[yes], near[Raja Indian Cuisine]'	'The Punter is moderately priced, a chinese restaurant and kid friendly, it is in riverside near Raja Indian Cuisine and it is a pub.'
'name[The Punter], eatType[pub], food[Chinese], priceRange[more than £30], area[riverside], familyFriendly[yes], near[Raja Indian Cuisine]'	'The Punter is a chinese restaurant and kid friendly, it is in riverside near Raja Indian Cuisine, it is a pub and it costs more than £30.'
'name[The Punter], eatType[pub], food[English], priceRange[£20-25], area[riverside], familyFriendly[yes], near[Raja Indian Cuisine]'	'The Punter is in riverside near Raja Indian Cuisine with a price range of £20-25, it is an english restaurant and kid friendly and it is a pub.'
'name[The Punter], eatType[pub], food[English], priceRange[cheap], area[riverside], familyFriendly[yes], near[Raja Indian Cuisine]'	'The Punter is cheap, an english restaurant and kid friendly, it is near Raja Indian Cuisine in riverside and it is a pub.'
'name[The Punter], eatType[pub], food[English], priceRange[high], area[city centre], familyFriendly[no], near[Raja Indian Cuisine]'	'The Punter is an english restaurant and expensive, it is in city centre near Raja Indian Cuisine, it is a pub and it is n 't kid friendly.'
'name[The Punter], eatType[pub], food[English], priceRange[high], area[city centre], familyFriendly[yes], near[Raja Indian Cuisine]'	'The Punter is a pub, it is in city centre near Raja Indian Cuisine and it is an english restaurant, kid friendly and expensive.'
'name[The Punter], eatType[pub], food[English], priceRange[high], area[riverside], familyFriendly[no], near[Raja Indian Cuisine]'	'The Punter is an english restaurant and expensive, it is in riverside near Raja Indian Cuisine, it is a pub and it is n 't kid friendly.'
'name[The Punter], eatType[pub], food[English], priceRange[high], area[riverside], familyFriendly[yes], near[Raja Indian Cuisine]'	'The Punter is expensive, an english restaurant and kid friendly, it is in riverside near Raja Indian Cuisine and it is a pub.'
'name[The Punter], eatType[pub], food[Italian], priceRange[high], customer rating[average], area[city centre], familyFriendly[no], near[Rainbow Vegetarian Café]'	'The Punter is an italian restaurant and expensive with an average rating, it is in city centre near Rainbow Vegetarian Café, it is a pub and it is n 't kid friendly.'
'name[The Punter], eatType[restaurant], food[Chinese], priceRange[less than £20], area[city centre], familyFriendly[yes], near[Raja Indian Cuisine]'	'The Punter is in city centre near Raja Indian Cuisine, it is a chinese restaurant and family friendly and it costs less than £20.'
'name[The Punter], eatType[restaurant], food[Chinese], priceRange[less than £20], area[riverside], familyFriendly[no], near[Raja Indian Cuisine]'	'The Punter costs less than £20, it 's near Raja Indian Cuisine in riverside, it is a chinese restaurant and it is n 't kid friendly.'
'name[The Punter], eatType[restaurant], food[Chinese], priceRange[less than £20], area[riverside], familyFriendly[yes], near[Raja Indian Cuisine]'	'The Punter is in riverside near Raja Indian Cuisine, it is a chinese restaurant and family friendly and it costs less than £20.'
'name[The Punter], eatType[restaurant], food[Chinese], priceRange[moderate], area[city centre], familyFriendly[no], near[Raja Indian Cuisine]'	'The Punter is near Raja Indian Cuisine in city centre, it is a chinese restaurant and moderately priced and it is n 't kid friendly.'
'name[The Punter], eatType[restaurant], food[Chinese], priceRange[moderate], area[city centre], familyFriendly[yes], near[Raja Indian Cuisine]'	'The Punter is in city centre near Raja Indian Cuisine, it is a chinese restaurant and kid friendly and it is moderately priced.'
'name[The Punter], eatType[restaurant], food[Chinese], priceRange[moderate], area[riverside], familyFriendly[no], near[Raja Indian Cuisine]'	'The Punter is near Raja Indian Cuisine in riverside, it is a chinese restaurant and moderately priced and it is n 't kid friendly.'
'name[The Punter], eatType[restaurant], food[Chinese], priceRange[moderate], area[riverside], familyFriendly[yes], near[Raja Indian Cuisine]'	'The Punter is in riverside near Raja Indian Cuisine, it is a chinese restaurant and kid friendly and it is moderately priced.'
'name[The Punter], eatType[restaurant], food[Chinese], priceRange[more than £30], area[riverside], familyFriendly[yes], near[Raja Indian Cuisine]'	'The Punter is in riverside near Raja Indian Cuisine, it is a chinese restaurant and kid friendly and it costs more than £30.'
'name[The Punter], eatType[restaurant], food[English], priceRange[£20-25], area[riverside], familyFriendly[yes], near[Raja Indian Cuisine]'	'The Punter is in riverside near Raja Indian Cuisine with a price range of £20-25 and it is an english restaurant and kid friendly.'
'name[The Punter], eatType[restaurant], food[English], priceRange[cheap], area[riverside], familyFriendly[yes], near[Raja Indian Cuisine]'	'The Punter is in riverside near Raja Indian Cuisine, it is cheap and an english restaurant and it is kid friendly.'
'name[The Punter], eatType[restaurant], food[English], priceRange[high], area[city centre], familyFriendly[no], near[Raja Indian Cuisine]'	'The Punter is in city centre near Raja Indian Cuisine, it is an english restaurant and expensive and it is n 't family friendly.'
'name[The Punter], eatType[restaurant], food[English], priceRange[high], area[city centre], familyFriendly[yes], near[Raja Indian Cuisine]'	'The Punter is in city centre near Raja Indian Cuisine, it is an english restaurant and kid friendly and it is expensive.'
'name[The Punter], eatType[restaurant], food[English], priceRange[high], area[riverside], familyFriendly[no], near[Raja Indian Cuisine]'	'The Punter is in riverside near Raja Indian Cuisine, it is an english restaurant and expensive and it is n 't kid friendly.'
'name[The Punter], eatType[restaurant], food[English], priceRange[high], area[riverside], familyFriendly[yes], near[Raja Indian Cuisine]'	'The Punter is in riverside near Raja Indian Cuisine, it is an english restaurant and kid friendly and it is expensive.'
'name[The Punter], eatType[restaurant], food[Indian], priceRange[cheap], customer rating[average], area[city centre], familyFriendly[yes], near[Express by Holiday Inn]'	'The Punter is cheap, an indian restaurant and family friendly with an average rating, it is near Express by Holiday Inn in city centre and it is a restaurant.'
'name[The Punter], eatType[restaurant], food[Indian], priceRange[cheap], customer rating[average], area[riverside], familyFriendly[no], near[Express by Holiday Inn]'	'The Punter is an indian restaurant and cheap with an average rating, it is near Express by Holiday Inn in riverside and it is n 't kid friendly.'
'name[The Punter], eatType[restaurant], food[Indian], priceRange[cheap], customer rating[average], area[riverside], familyFriendly[yes], near[Express by Holiday Inn]'	'The Punter is cheap, an indian restaurant and family friendly with an average rating, it is near Express by Holiday Inn in riverside and it is a restaurant.'
'name[The Punter], eatType[restaurant], food[Indian], priceRange[high], customer rating[1 out of 5], area[city centre], familyFriendly[no], near[Express by Holiday Inn]'	'The Punter is in city centre near Express by Holiday Inn with a 1 out of 5 rating, it is an indian restaurant and expensive and it is n 't family friendly.'
'name[The Punter], eatType[restaurant], food[Indian], priceRange[high], customer rating[1 out of 5], area[city centre], familyFriendly[yes], near[Express by Holiday Inn]'	'The Punter is expensive, an indian restaurant and kid friendly with a 1 out of 5 rating, it is in city centre near Express by Holiday Inn and it is a restaurant.'
'name[The Punter], eatType[restaurant], food[Indian], priceRange[high], customer rating[1 out of 5], area[riverside], familyFriendly[no], near[Express by Holiday Inn]'	'The Punter is in riverside near Express by Holiday Inn with a 1 out of 5 rating, it is an indian restaurant and expensive and it is n 't kid friendly.'
'name[The Punter], eatType[restaurant], food[Indian], priceRange[high], customer rating[1 out of 5], area[riverside], familyFriendly[yes], near[Express by Holiday Inn]'	'The Punter is in riverside near Express by Holiday Inn with a 1 out of 5 rating, it is an indian restaurant and expensive and it is kid friendly.'
'name[The Punter], eatType[restaurant], food[Indian], priceRange[high], customer rating[average], area[city centre], familyFriendly[no], near[Express by Holiday Inn]'	'The Punter is in city centre near Express by Holiday Inn with an average rating, it is an indian restaurant and expensive and it is n 't family friendly.'
'name[The Punter], eatType[restaurant], food[Indian], priceRange[high], customer rating[average], area[city centre], familyFriendly[yes], near[Express by Holiday Inn]'	'The Punter is in city centre near Express by Holiday Inn with an average rating, it is an indian restaurant and kid friendly and it is expensive.'
'name[The Punter], eatType[restaurant], food[Indian], priceRange[high], customer rating[average], area[riverside], familyFriendly[no], near[Express by Holiday Inn]'	'The Punter is in riverside near Express by Holiday Inn with an average rating, it is an indian restaurant and expensive and it is n 't kid friendly.'
'name[The Punter], eatType[restaurant], food[Indian], priceRange[high], customer rating[average], area[riverside], familyFriendly[yes], near[Express by Holiday Inn]'	'The Punter is in riverside near Express by Holiday Inn with an average rating, it is an indian restaurant and kid friendly and it is expensive.'
'name[The Punter], eatType[restaurant], food[Indian], priceRange[less than £20], customer rating[low], area[city centre], familyFriendly[no], near[Express by Holiday Inn]'	'The Punter costs less than £20 with a low rating, it is near Express by Holiday Inn in city centre, it is an indian restaurant and it is n 't family friendly.'
'name[The Punter], eatType[restaurant], food[Indian], priceRange[less than £20], customer rating[low], area[city centre], familyFriendly[yes], near[Express by Holiday Inn]'	'The Punter costs less than £20 with a low rating, it is near Express by Holiday Inn in city centre and it is an indian restaurant and family friendly.'
'name[The Punter], eatType[restaurant], food[Indian], priceRange[less than £20], customer rating[low], area[riverside], familyFriendly[no], near[Express by Holiday Inn]'	'The Punter costs less than £20 with a low rating, it is near Express by Holiday Inn in riverside, it is an indian restaurant and it is n 't kid friendly.'
'name[The Punter], eatType[restaurant], food[Indian], priceRange[less than £20], customer rating[low], area[riverside], familyFriendly[yes], near[Express by Holiday Inn]'	'The Punter costs less than £20 with a low rating, it is near Express by Holiday Inn in riverside, it is an indian restaurant and family friendly and it is a restaurant.'
'name[The Punter], eatType[restaurant], food[Indian], priceRange[moderate], customer rating[1 out of 5], area[city centre], familyFriendly[no], near[Express by Holiday Inn]'	'The Punter is in city centre near Express by Holiday Inn with a 1 out of 5 rating, it is an indian restaurant and moderately priced and it is n 't kid friendly.'
'name[The Punter], eatType[restaurant], food[Indian], priceRange[moderate], customer rating[1 out of 5], area[city centre], familyFriendly[yes], near[Express by Holiday Inn]'	'The Punter is moderately priced, an indian restaurant and kid friendly with a 1 out of 5 rating, it is in city centre near Express by Holiday Inn and it is a restaurant.'
'name[The Punter], eatType[restaurant], food[Indian], priceRange[moderate], customer rating[1 out of 5], area[riverside], familyFriendly[no], near[Express by Holiday Inn]'	'The Punter is in riverside near Express by Holiday Inn with a 1 out of 5 rating, it is an indian restaurant and moderately priced and it is n 't kid friendly.'
'name[The Punter], eatType[restaurant], food[Indian], priceRange[moderate], customer rating[1 out of 5], area[riverside], familyFriendly[yes], near[Express by Holiday Inn]'	'The Punter is in riverside near Express by Holiday Inn with a 1 out of 5 rating, it is moderately priced and an indian restaurant and it is kid friendly.'
'name[The Punter], eatType[restaurant], food[Indian], priceRange[moderate], customer rating[3 out of 5], area[city centre], familyFriendly[no], near[Express by Holiday Inn]'	'The Punter is in city centre near Express by Holiday Inn with a 3 out of 5 rating, it is an indian restaurant and moderately priced and it is n 't kid friendly.'
'name[The Punter], eatType[restaurant], food[Indian], priceRange[moderate], customer rating[3 out of 5], area[city centre], familyFriendly[yes], near[Express by Holiday Inn]'	'The Punter is moderately priced, an indian restaurant and kid friendly with a 3 out of 5 rating, it is in city centre near Express by Holiday Inn and it is a restaurant.'
'name[The Punter], eatType[restaurant], food[Indian], priceRange[moderate], customer rating[3 out of 5], area[riverside], familyFriendly[no], near[Express by Holiday Inn]'	'The Punter is an indian restaurant and moderately priced with a 3 out of 5 rating, it is near Express by Holiday Inn in riverside and it is n 't kid friendly.'
'name[The Punter], eatType[restaurant], food[Indian], priceRange[moderate], customer rating[3 out of 5], area[riverside], familyFriendly[yes], near[Express by Holiday Inn]'	'The Punter is in riverside near Express by Holiday Inn with a 3 out of 5 rating, it is moderately priced and an indian restaurant and it is kid friendly.'
'name[The Punter], eatType[restaurant], food[Indian], priceRange[more than £30], customer rating[high], area[city centre], familyFriendly[no], near[Express by Holiday Inn]'	'The Punter costs more than £30 with a high rating, it is in city centre near Express by Holiday Inn, it is an indian restaurant and it is n 't family friendly.'
'name[The Punter], eatType[restaurant], food[Indian], priceRange[more than £30], customer rating[high], area[city centre], familyFriendly[yes], near[Express by Holiday Inn]'	'The Punter costs more than £30 with a high rating, it is near Express by Holiday Inn in city centre and it is an indian restaurant and family friendly.'
'name[The Punter], eatType[restaurant], food[Indian], priceRange[more than £30], customer rating[high], area[riverside], familyFriendly[no], near[Express by Holiday Inn]'	'The Punter costs more than £30 with a high rating, it is near Express by Holiday Inn in riverside, it is an indian restaurant and it is n 't kid friendly.'
'name[The Punter], eatType[restaurant], food[Indian], priceRange[more than £30], customer rating[high], area[riverside], familyFriendly[yes], near[Express by Holiday Inn]'	'The Punter costs more than £30 with a high rating, it is near Express by Holiday Inn in riverside, it is an indian restaurant and it is kid friendly.'
'name[The Punter], eatType[restaurant], food[Italian], priceRange[£20-25], customer rating[high], area[city centre], familyFriendly[no], near[Express by Holiday Inn]'	'The Punter is an italian restaurant with a price range of £20-25 with a high rating, it is near Express by Holiday Inn in city centre and it is n 't kid friendly.'
'name[The Punter], eatType[restaurant], food[Italian], priceRange[£20-25], customer rating[high], area[city centre], familyFriendly[yes], near[Express by Holiday Inn]'	'The Punter is in city centre near Express by Holiday Inn with a high rating with a price range of £20-25, it is an italian restaurant and family friendly.'
'name[The Punter], eatType[restaurant], food[Italian], priceRange[£20-25], customer rating[high], area[riverside], familyFriendly[no], near[Express by Holiday Inn]'	'The Punter is an italian restaurant with a price range of £20-25 with a high rating, it is near Express by Holiday Inn in riverside and it is n 't kid friendly.'
'name[The Punter], eatType[restaurant], food[Italian], priceRange[£20-25], customer rating[high], area[riverside], familyFriendly[yes], near[Express by Holiday Inn]'	'The Punter is in riverside near Express by Holiday Inn with a high rating with a price range of £20-25, it is an italian restaurant and kid friendly.'
'name[The Punter], eatType[restaurant], food[Italian], priceRange[cheap], customer rating[5 out of 5], area[city centre], familyFriendly[no], near[Express by Holiday Inn]'	'The Punter is in city centre near Express by Holiday Inn with a 5 out of 5 rating, it is an italian restaurant and cheap and it is n 't family friendly.'
'name[The Punter], eatType[restaurant], food[Italian], priceRange[cheap], customer rating[5 out of 5], area[city centre], familyFriendly[no], near[Rainbow Vegetarian Café]'	'The Punter is in city centre near Rainbow Vegetarian Café with a 5 out of 5 rating, it is an italian restaurant and cheap and it is n 't family friendly.'
'name[The Punter], eatType[restaurant], food[Italian], priceRange[cheap], customer rating[5 out of 5], area[city centre], familyFriendly[yes], near[Rainbow Vegetarian Café]'	'The Punter is in city centre near Rainbow Vegetarian Café with a 5 out of 5 rating, it is an italian restaurant and family friendly and it is cheap.'
'name[The Punter], eatType[restaurant], food[Italian], priceRange[cheap], customer rating[5 out of 5], area[riverside], familyFriendly[no], near[Rainbow Vegetarian Café]'	'The Punter is in riverside near Rainbow Vegetarian Café with a 5 out of 5 rating, it is an italian restaurant and cheap and it is n 't family friendly.'
'name[The Punter], eatType[restaurant], food[Italian], priceRange[cheap], customer rating[5 out of 5], area[riverside], familyFriendly[yes], near[Rainbow Vegetarian Café]'	'The Punter is in riverside near Rainbow Vegetarian Café with a 5 out of 5 rating, it is cheap and an italian restaurant and it is kid friendly.'
'name[The Punter], eatType[restaurant], food[Italian], priceRange[cheap], customer rating[average], area[city centre], familyFriendly[no], near[Rainbow Vegetarian Café]'	'The Punter is an italian restaurant and cheap with an average rating, it is near Rainbow Vegetarian Café in city centre and it is n 't family friendly.'
'name[The Punter], eatType[restaurant], food[Italian], priceRange[cheap], customer rating[average], area[city centre], familyFriendly[yes], near[Rainbow Vegetarian Café]'	'The Punter is in city centre near Rainbow Vegetarian Café with an average rating, it is cheap and an italian restaurant and it is kid friendly.'
'name[The Punter], eatType[restaurant], food[Italian], priceRange[cheap], customer rating[average], area[riverside], familyFriendly[no], near[Rainbow Vegetarian Café]'	'The Punter is in riverside near Rainbow Vegetarian Café with an average rating, it is an italian restaurant and cheap and it is n 't family friendly.'
'name[The Punter], eatType[restaurant], food[Italian], priceRange[cheap], customer rating[average], area[riverside], familyFriendly[yes], near[Rainbow Vegetarian Café]'	'The Punter is in riverside near Rainbow Vegetarian Café with an average rating, it is cheap and an italian restaurant and it is kid friendly.'
'name[The Punter], eatType[restaurant], food[Italian], priceRange[high], customer rating[1 out of 5], area[city centre], familyFriendly[no], near[Rainbow Vegetarian Café]'	'The Punter is in city centre near Rainbow Vegetarian Café with a 1 out of 5 rating, it is an italian restaurant and expensive and it is n 't family friendly.'
'name[The Punter], eatType[restaurant], food[Italian], priceRange[high], customer rating[1 out of 5], area[city centre], familyFriendly[yes], near[Rainbow Vegetarian Café]'	'The Punter is in city centre near Rainbow Vegetarian Café with a 1 out of 5 rating, it is an italian restaurant and expensive and it is kid friendly.'
'name[The Punter], eatType[restaurant], food[Italian], priceRange[high], customer rating[1 out of 5], area[riverside], familyFriendly[no], near[Rainbow Vegetarian Café]'	'The Punter is in riverside near Rainbow Vegetarian Café with a 1 out of 5 rating, it is an italian restaurant and expensive and it is n 't kid friendly.'
'name[The Punter], eatType[restaurant], food[Italian], priceRange[high], customer rating[1 out of 5], area[riverside], familyFriendly[yes], near[Rainbow Vegetarian Café]'	'The Punter is in riverside near Rainbow Vegetarian Café with a 1 out of 5 rating, it is an italian restaurant and expensive and it is kid friendly.'
'name[The Vaults], eatType[pub], food[French], priceRange[high], area[riverside], familyFriendly[yes], near[Raja Indian Cuisine]'	'The Vaults is a french restaurant, expensive and kid friendly, it is in riverside near Raja Indian Cuisine and it is a pub.'
'name[The Vaults], eatType[pub], food[French], priceRange[less than £20], area[city centre], familyFriendly[no], near[Raja Indian Cuisine]'	'The Vaults is a pub, it costs less than £20, it 's in city centre near Raja Indian Cuisine, it is a french restaurant and it is n 't kid friendly.'
'name[The Vaults], eatType[pub], food[French], priceRange[less than £20], area[city centre], familyFriendly[yes], near[Raja Indian Cuisine]'	'The Vaults costs less than £20, it 's near Raja Indian Cuisine in city centre, it is a pub and it is family friendly and a french restaurant.'
'name[The Vaults], eatType[pub], food[French], priceRange[less than £20], area[riverside], familyFriendly[no], near[Raja Indian Cuisine]'	'The Vaults is a pub, it costs less than £20, it 's near Raja Indian Cuisine in riverside, it is a french restaurant and it is n 't kid friendly.'
'name[The Vaults], eatType[pub], food[French], priceRange[less than £20], area[riverside], familyFriendly[yes], near[Raja Indian Cuisine]'	'The Vaults costs less than £20, it 's near Raja Indian Cuisine in riverside, it is a pub and it is family friendly and a french restaurant.'
'name[The Vaults], eatType[pub], food[French], priceRange[moderate], area[city centre], familyFriendly[no], near[Raja Indian Cuisine]'	'The Vaults is a french restaurant and moderately priced, it is in city centre near Raja Indian Cuisine, it is a pub and it is n 't kid friendly.'
'name[The Vaults], eatType[pub], food[French], priceRange[moderate], area[city centre], familyFriendly[yes], near[Raja Indian Cuisine]'	'The Vaults is a french restaurant, kid friendly and moderately priced, it is near Raja Indian Cuisine in city centre and it is a pub.'
'name[The Vaults], eatType[pub], food[French], priceRange[moderate], area[riverside], familyFriendly[no], near[Raja Indian Cuisine]'	'The Vaults is a french restaurant and moderately priced, it is in riverside near Raja Indian Cuisine, it is a pub and it is n 't kid friendly.'
'name[The Vaults], eatType[pub], food[French], priceRange[moderate], area[riverside], familyFriendly[yes], near[Raja Indian Cuisine]'	'The Vaults is a french restaurant, kid friendly and moderately priced, it is in riverside near Raja Indian Cuisine and it is a pub.'
'name[The Vaults], eatType[pub], food[French], priceRange[more than £30], area[city centre], familyFriendly[no], near[Raja Indian Cuisine]'	'The Vaults costs more than £30, it 's a french restaurant, it is in city centre near Raja Indian Cuisine, it is a pub and it is n 't kid friendly.'
'name[The Vaults], eatType[pub], food[French], priceRange[more than £30], area[city centre], familyFriendly[yes], near[Raja Indian Cuisine]'	'The Vaults costs more than £30, it 's in city centre near Raja Indian Cuisine, it is a french restaurant and family friendly and it is a pub.'
'name[The Vaults], eatType[pub], food[French], priceRange[more than £30], area[riverside], familyFriendly[no], near[Raja Indian Cuisine]'	'The Vaults costs more than £30, it 's a french restaurant, it is in riverside near Raja Indian Cuisine, it is a pub and it is n 't kid friendly.'
'name[The Vaults], eatType[pub], food[French], priceRange[more than £30], area[riverside], familyFriendly[yes], near[Raja Indian Cuisine]'	'The Vaults costs more than £30, it 's near Raja Indian Cuisine in riverside, it is a french restaurant and kid friendly and it is a pub.'
'name[The Vaults], eatType[pub], food[Indian], priceRange[£20-25], area[riverside], familyFriendly[yes], near[Raja Indian Cuisine]'	'The Vaults is in riverside near Raja Indian Cuisine with a price range of £20-25, it is an indian restaurant and kid friendly and it is a pub.'
'name[The Vaults], eatType[pub], food[Indian], priceRange[cheap], area[riverside], familyFriendly[yes], near[Raja Indian Cuisine]'	'The Vaults is cheap, an indian restaurant and kid friendly, it is near Raja Indian Cuisine in riverside and it is a pub.'
'name[The Vaults], eatType[pub], food[Indian], priceRange[high], area[city centre], familyFriendly[no], near[Raja Indian Cuisine]'	'The Vaults is an indian restaurant and expensive, it is in city centre near Raja Indian Cuisine, it is a pub and it is n 't kid friendly.'
'name[The Vaults], eatType[pub], food[Indian], priceRange[high], area[city centre], familyFriendly[yes], near[Raja Indian Cuisine]'	'The Vaults is in city centre near Raja Indian Cuisine, it is a pub, it is an indian restaurant and kid friendly and it is expensive.'
'name[The Vaults], eatType[pub], food[Italian], priceRange[high], customer rating[average], area[city centre], familyFriendly[no], near[Rainbow Vegetarian Café]'	'The Vaults is an italian restaurant and expensive with an average rating, it is in city centre near Rainbow Vegetarian Café, it is a pub and it is n 't kid friendly.'
'name[The Vaults], eatType[pub], food[Italian], priceRange[high], customer rating[average], area[city centre], familyFriendly[yes], near[Rainbow Vegetarian Café]'	'The Vaults is in city centre near Rainbow Vegetarian Café with an average rating, it is an italian restaurant, kid friendly and expensive and it is a pub.'
'name[The Vaults], eatType[pub], food[Italian], priceRange[high], customer rating[average], area[riverside], familyFriendly[no], near[Rainbow Vegetarian Café]'	'The Vaults is an italian restaurant and expensive with an average rating, it is in riverside near Rainbow Vegetarian Café, it is a pub and it is n 't kid friendly.'
'name[The Vaults], eatType[pub], food[Italian], priceRange[high], customer rating[average], area[riverside], familyFriendly[yes], near[Rainbow Vegetarian Café]'	'The Vaults is in riverside near Rainbow Vegetarian Café with an average rating, it is an italian restaurant, expensive and kid friendly and it is a pub.'
'name[The Vaults], eatType[pub], food[Italian], priceRange[less than £20], customer rating[low], area[city centre], familyFriendly[no], near[Rainbow Vegetarian Café]'	'The Vaults is an italian restaurant with a low rating, it is in city centre near Rainbow Vegetarian Café, it is a pub, it is n 't family friendly and it costs less than £20.'
'name[The Vaults], eatType[pub], food[Italian], priceRange[less than £20], customer rating[low], area[city centre], familyFriendly[yes], near[Rainbow Vegetarian Café]'	'The Vaults costs less than £20 with a low rating, it is near Rainbow Vegetarian Café in city centre, it is a pub and it is family friendly and an italian restaurant.'
'name[The Vaults], eatType[pub], food[Italian], priceRange[less than £20], customer rating[low], area[riverside], familyFriendly[no], near[Rainbow Vegetarian Café]'	'The Vaults is an italian restaurant with a low rating, it is in riverside near Rainbow Vegetarian Café, it is a pub, it is n 't family friendly and it costs less than £20.'
'name[The Vaults], eatType[pub], food[Italian], priceRange[less than £20], customer rating[low], area[riverside], familyFriendly[yes], near[Rainbow Vegetarian Café]'	'The Vaults costs less than £20 with a low rating, it is near Rainbow Vegetarian Café in riverside, it is a pub and it is family friendly and an italian restaurant.'
'name[The Vaults], eatType[pub], food[Italian], priceRange[moderate], customer rating[1 out of 5], area[city centre], familyFriendly[no], near[Rainbow Vegetarian Café]'	'The Vaults is in city centre near Rainbow Vegetarian Café with a 1 out of 5 rating, it is a pub, it is an italian restaurant and moderately priced and it is n 't kid friendly.'
'name[The Vaults], eatType[pub], food[Italian], priceRange[moderate], customer rating[1 out of 5], area[city centre], familyFriendly[yes], near[Rainbow Vegetarian Café]'	'The Vaults is in city centre near Rainbow Vegetarian Café with a 1 out of 5 rating, it is kid friendly, an italian restaurant and moderately priced and it is a pub.'
'name[The Vaults], eatType[pub], food[Italian], priceRange[moderate], customer rating[1 out of 5], area[riverside], familyFriendly[no], near[Rainbow Vegetarian Café]'	'The Vaults is in riverside near Rainbow Vegetarian Café with a 1 out of 5 rating, it is moderately priced and an italian restaurant, it is a pub and it is n 't kid friendly.'
'name[The Vaults], eatType[pub], food[Italian], priceRange[moderate], customer rating[1 out of 5], area[riverside], familyFriendly[yes], near[Rainbow Vegetarian Café]'	'The Vaults is in riverside near Rainbow Vegetarian Café with a 1 out of 5 rating, it is kid friendly, an italian restaurant and moderately priced and it is a pub.'
'name[The Vaults], eatType[pub], food[Italian], priceRange[moderate], customer rating[3 out of 5], area[city centre], familyFriendly[no], near[Rainbow Vegetarian Café]'	'The Vaults is in city centre near Rainbow Vegetarian Café with a 3 out of 5 rating, it is a pub, it is an italian restaurant and moderately priced and it is n 't kid friendly.'
'name[The Vaults], eatType[pub], food[Italian], priceRange[moderate], customer rating[3 out of 5], area[city centre], familyFriendly[yes], near[Rainbow Vegetarian Café]'	'The Vaults is in city centre near Rainbow Vegetarian Café with a 3 out of 5 rating, it is a pub, it is kid friendly and an italian restaurant and it is moderately priced.'
'name[The Vaults], eatType[pub], food[Italian], priceRange[moderate], customer rating[3 out of 5], area[riverside], familyFriendly[no], near[Rainbow Vegetarian Café]'	'The Vaults is moderately priced and an italian restaurant with a 3 out of 5 rating, it is in riverside near Rainbow Vegetarian Café, it is a pub and it is n 't kid friendly.'
'name[The Vaults], eatType[pub], food[Italian], priceRange[moderate], customer rating[3 out of 5], area[riverside], familyFriendly[yes], near[Rainbow Vegetarian Café]'	'The Vaults is in riverside near Rainbow Vegetarian Café with a 3 out of 5 rating, it is a pub and it is moderately priced, an italian restaurant and kid friendly.'
'name[The Vaults], eatType[pub], food[Italian], priceRange[more than £30], customer rating[high], area[city centre], familyFriendly[no], near[Rainbow Vegetarian Café]'	'The Vaults is an italian restaurant with a high rating, it is in city centre near Rainbow Vegetarian Café, it is a pub, it is n 't kid friendly and it costs more than £30.'
'name[The Vaults], eatType[pub], food[Italian], priceRange[more than £30], customer rating[high], area[city centre], familyFriendly[yes], near[Rainbow Vegetarian Café]'	'The Vaults is in city centre near Rainbow Vegetarian Café with a high rating, it is a pub, it is an italian restaurant and family friendly and it costs more than £30.'
'name[The Vaults], eatType[pub], food[Italian], priceRange[more than £30], customer rating[high], area[riverside], familyFriendly[no], near[Rainbow Vegetarian Café]'	'The Vaults is an italian restaurant with a high rating, it is in riverside near Rainbow Vegetarian Café, it is a pub, it is n 't kid friendly and it costs more than £30.'
'name[The Vaults], eatType[pub], food[Italian], priceRange[more than £30], customer rating[high], area[riverside], familyFriendly[yes], near[Rainbow Vegetarian Café]'	'The Vaults costs more than £30 with a high rating, it is in riverside near Rainbow Vegetarian Café, it is an italian restaurant and kid friendly and it is a pub.'
'name[The Vaults], eatType[pub], food[Japanese], priceRange[£20-25], customer rating[3 out of 5], area[city centre], familyFriendly[no], near[Rainbow Vegetarian Café]'	'The Vaults is a japanese restaurant with a 3 out of 5 rating with a price range of £20-25, it is in city centre near Rainbow Vegetarian Café, it is a pub and it is n 't kid friendly.'
'name[The Vaults], eatType[pub], food[Japanese], priceRange[£20-25], customer rating[3 out of 5], area[city centre], familyFriendly[yes], near[Rainbow Vegetarian Café]'	'The Vaults is a japanese place and kid friendly with a 3 out of 5 rating with a price range of £20-25, it is in city centre near Rainbow Vegetarian Café and it is a pub.'
'name[The Vaults], eatType[pub], food[Japanese], priceRange[£20-25], customer rating[3 out of 5], area[riverside], familyFriendly[no], near[Rainbow Vegetarian Café]'	'The Vaults is a japanese restaurant with a 3 out of 5 rating with a price range of £20-25, it is in riverside near Rainbow Vegetarian Café, it is a pub and it is n 't kid friendly.'
'name[The Vaults], eatType[pub], food[Japanese], priceRange[£20-25], customer rating[3 out of 5], area[riverside], familyFriendly[yes], near[Rainbow Vegetarian Café]'	'The Vaults is a japanese place and kid friendly with a 3 out of 5 rating with a price range of £20-25, it is in riverside near Rainbow Vegetarian Café and it is a pub.'
'name[The Vaults], eatType[pub], food[Japanese], priceRange[£20-25], customer rating[high], area[city centre], familyFriendly[no], near[Rainbow Vegetarian Café]'	'The Vaults is a japanese restaurant with a high rating with a price range of £20-25, it is in city centre near Rainbow Vegetarian Café, it is a pub and it is n 't kid friendly.'
'name[The Vaults], eatType[pub], food[Japanese], priceRange[£20-25], customer rating[high], area[city centre], familyFriendly[yes], near[Rainbow Vegetarian Café]'	'The Vaults is a japanese place and kid friendly with a high rating with a price range of £20-25, it is in city centre near Rainbow Vegetarian Café and it is a pub.'
'name[The Vaults], eatType[pub], food[Japanese], priceRange[£20-25], customer rating[high], area[riverside], familyFriendly[no], near[Rainbow Vegetarian Café]'	'The Vaults is a japanese restaurant with a high rating with a price range of £20-25, it is in riverside near Rainbow Vegetarian Café, it is a pub and it is n 't kid friendly.'
'name[The Vaults], eatType[pub], food[Japanese], priceRange[£20-25], customer rating[high], area[riverside], familyFriendly[no], near[Raja Indian Cuisine]'	'The Vaults is a japanese restaurant with a high rating with a price range of £20-25, it is in riverside near Raja Indian Cuisine, it is a pub and it is n 't kid friendly.'
'name[The Vaults], eatType[pub], food[Japanese], priceRange[£20-25], customer rating[high], area[riverside], familyFriendly[yes], near[Raja Indian Cuisine]'	'The Vaults is a japanese place and kid friendly with a high rating with a price range of £20-25, it is in riverside near Raja Indian Cuisine and it is a pub.'
'name[The Vaults], eatType[pub], food[Japanese], priceRange[cheap], customer rating[5 out of 5], area[city centre], familyFriendly[no], near[Raja Indian Cuisine]'	'The Vaults is a japanese restaurant and cheap with a 5 out of 5 rating, it is in city centre near Raja Indian Cuisine, it is a pub and it is n 't kid friendly.'
'name[The Vaults], eatType[pub], food[Japanese], priceRange[cheap], customer rating[5 out of 5], area[city centre], familyFriendly[yes], near[Raja Indian Cuisine]'	'The Vaults is in city centre near Raja Indian Cuisine with a 5 out of 5 rating, it is a japanese restaurant, kid friendly and cheap and it is a pub.'
'name[The Vaults], eatType[pub], food[Japanese], priceRange[cheap], customer rating[5 out of 5], area[riverside], familyFriendly[no], near[Raja Indian Cuisine]'	'The Vaults is a japanese restaurant and cheap with a 5 out of 5 rating, it is a pub, it is near Raja Indian Cuisine in riverside and it is n 't kid friendly.'
'name[The Vaults], eatType[pub], food[Japanese], priceRange[cheap], customer rating[5 out of 5], area[riverside], familyFriendly[yes], near[Raja Indian Cuisine]'	'The Vaults is in riverside near Raja Indian Cuisine with a 5 out of 5 rating, it is a japanese restaurant, kid friendly and cheap and it is a pub.'
'name[The Vaults], eatType[pub], food[Japanese], priceRange[high], customer rating[3 out of 5], area[city centre], familyFriendly[no], near[Raja Indian Cuisine]'	'The Vaults is in city centre near Raja Indian Cuisine with a 3 out of 5 rating, it is a pub, it is a japanese restaurant and expensive and it is n 't kid friendly.'
'name[The Vaults], eatType[pub], food[Japanese], priceRange[high], customer rating[3 out of 5], area[city centre], familyFriendly[yes], near[Raja Indian Cuisine]'	'The Vaults is in city centre near Raja Indian Cuisine with a 3 out of 5 rating, it is a japanese restaurant, kid friendly and expensive and it is a pub.'
'name[The Vaults], eatType[pub], food[Japanese], priceRange[high], customer rating[3 out of 5], area[riverside], familyFriendly[no], near[Raja Indian Cuisine]'	'The Vaults is a japanese restaurant and expensive with a 3 out of 5 rating, it is in riverside near Raja Indian Cuisine, it is a pub and it is n 't kid friendly.'
'name[The Vaults], eatType[pub], food[Japanese], priceRange[high], customer rating[3 out of 5], area[riverside], familyFriendly[yes], near[Raja Indian Cuisine]'	'The Vaults is a japanese restaurant, kid friendly and expensive with a 3 out of 5 rating, it is in riverside near Raja Indian Cuisine and it is a pub.'
'name[The Vaults], eatType[pub], food[Japanese], priceRange[less than £20], customer rating[average], area[city centre], familyFriendly[no], near[Raja Indian Cuisine]'	'The Vaults is a japanese restaurant with an average rating, it is in city centre near Raja Indian Cuisine, it is a pub, it is n 't family friendly and it costs less than £20.'
'name[The Vaults], eatType[pub], food[Japanese], priceRange[less than £20], customer rating[average], area[city centre], familyFriendly[yes], near[Raja Indian Cuisine]'	'The Vaults is in city centre near Raja Indian Cuisine with an average rating, it is a pub, it costs less than £20 and it 's kid friendly and a japanese restaurant.'
'name[The Vaults], eatType[pub], food[Japanese], priceRange[less than £20], customer rating[average], area[riverside], familyFriendly[no], near[Raja Indian Cuisine]'	'The Vaults costs less than £20 with an average rating, it is near Raja Indian Cuisine in riverside, it is a pub, it is a japanese restaurant and it is n 't kid friendly.'
'name[The Vaults], eatType[pub], food[Japanese], priceRange[less than £20], customer rating[average], area[riverside], familyFriendly[yes], near[Raja Indian Cuisine]'	'The Vaults is in riverside near Raja Indian Cuisine with an average rating, it is a pub, it costs less than £20 and it 's kid friendly and a japanese restaurant.'
'name[The Vaults], eatType[pub], food[Japanese], priceRange[less than £20], customer rating[low], area[city centre], familyFriendly[no], near[Raja Indian Cuisine]'	'The Vaults is a japanese restaurant with a low rating, it is in city centre near Raja Indian Cuisine, it is a pub, it is n 't family friendly and it costs less than £20.'
'name[The Vaults], eatType[pub], food[Japanese], priceRange[less than £20], customer rating[low], area[city centre], familyFriendly[yes], near[Raja Indian Cuisine]'	'The Vaults costs less than £20 with a low rating, it is near Raja Indian Cuisine in city centre, it is a pub and it is family friendly and a japanese restaurant.'
'name[The Vaults], eatType[pub], food[Japanese], priceRange[less than £20], customer rating[low], area[riverside], familyFriendly[no], near[Raja Indian Cuisine]'	'The Vaults is a japanese restaurant with a low rating, it costs less than £20, it 's in riverside near Raja Indian Cuisine, it is a pub and it is n 't kid friendly.'
'name[The Vaults], eatType[pub], food[Japanese], priceRange[less than £20], customer rating[low], area[riverside], familyFriendly[yes], near[Raja Indian Cuisine]'	'The Vaults costs less than £20 with a low rating, it is near Raja Indian Cuisine in riverside, it is a pub and it is kid friendly and a japanese restaurant.'
'name[The Vaults], eatType[pub], food[Japanese], priceRange[moderate], customer rating[1 out of 5], area[city centre], familyFriendly[no], near[Raja Indian Cuisine]'	'The Vaults is a japanese restaurant and moderately priced with a 1 out of 5 rating, it is in city centre near Raja Indian Cuisine, it is a pub and it is n 't kid friendly.'
'name[The Vaults], eatType[pub], food[Japanese], priceRange[moderate], customer rating[1 out of 5], area[city centre], familyFriendly[yes], near[Raja Indian Cuisine]'	'The Vaults is in city centre near Raja Indian Cuisine with a 1 out of 5 rating, it is a japanese restaurant, kid friendly and moderately priced and it is a pub.'
'name[The Vaults], eatType[restaurant], food[French], priceRange[high], area[riverside], familyFriendly[yes], near[Raja Indian Cuisine]'	'The Vaults is in riverside near Raja Indian Cuisine, it is a french restaurant and kid friendly and it is expensive.'
'name[The Vaults], eatType[restaurant], food[French], priceRange[less than £20], area[city centre], familyFriendly[no], near[Raja Indian Cuisine]'	'The Vaults costs less than £20, it 's near Raja Indian Cuisine in city centre, it is a french restaurant and it is n 't family friendly.'
'name[The Vaults], eatType[restaurant], food[French], priceRange[less than £20], area[city centre], familyFriendly[yes], near[Raja Indian Cuisine]'	'The Vaults costs less than £20, it 's near Raja Indian Cuisine in city centre and it is a french restaurant and family friendly.'
'name[The Vaults], eatType[restaurant], food[French], priceRange[less than £20], area[riverside], familyFriendly[no], near[Raja Indian Cuisine]'	'The Vaults costs less than £20, it 's near Raja Indian Cuisine in riverside, it is a french restaurant and it is n 't kid friendly.'
'name[The Vaults], eatType[restaurant], food[French], priceRange[less than £20], area[riverside], familyFriendly[yes], near[Raja Indian Cuisine]'	'The Vaults is in riverside near Raja Indian Cuisine, it is a french restaurant and family friendly and it costs less than £20.'
'name[The Vaults], eatType[restaurant], food[French], priceRange[moderate], area[city centre], familyFriendly[no], near[Raja Indian Cuisine]'	'The Vaults is moderately priced and a french restaurant, it is near Raja Indian Cuisine in city centre and it is n 't kid friendly.'
'name[The Vaults], eatType[restaurant], food[French], priceRange[moderate], area[city centre], familyFriendly[yes], near[Raja Indian Cuisine]'	'The Vaults is in city centre near Raja Indian Cuisine, it is a french restaurant and kid friendly and it is moderately priced.'
'name[The Vaults], eatType[restaurant], food[French], priceRange[moderate], area[riverside], familyFriendly[no], near[Raja Indian Cuisine]'	'The Vaults is near Raja Indian Cuisine in riverside, it is a french restaurant and moderately priced and it is n 't kid friendly.'
'name[The Vaults], eatType[restaurant], food[French], priceRange[moderate], area[riverside], familyFriendly[yes], near[Raja Indian Cuisine]'	'The Vaults is in riverside near Raja Indian Cuisine, it is a french restaurant and kid friendly and it is moderately priced.'
'name[The Vaults], eatType[restaurant], food[French], priceRange[more than £30], area[city centre], familyFriendly[no], near[Raja Indian Cuisine]'	'The Vaults costs more than £30, it 's near Raja Indian Cuisine in city centre, it is a french restaurant and it is n 't family friendly.'
'name[The Vaults], eatType[restaurant], food[French], priceRange[more than £30], area[city centre], familyFriendly[yes], near[Raja Indian Cuisine]'	'The Vaults costs more than £30, it 's near Raja Indian Cuisine in city centre and it is a french restaurant and family friendly.'
'name[The Vaults], eatType[restaurant], food[French], priceRange[more than £30], area[riverside], familyFriendly[no], near[Raja Indian Cuisine]'	'The Vaults costs more than £30, it 's near Raja Indian Cuisine in riverside, it is a french restaurant and it is n 't kid friendly.'
'name[The Vaults], eatType[restaurant], food[French], priceRange[more than £30], area[riverside], familyFriendly[yes], near[Raja Indian Cuisine]'	'The Vaults costs more than £30, it 's near Raja Indian Cuisine in riverside, it is a french restaurant and it is kid friendly.'
'name[The Vaults], eatType[restaurant], food[Indian], priceRange[£20-25], area[riverside], familyFriendly[yes], near[Raja Indian Cuisine]'	'The Vaults is an indian restaurant and kid friendly with a price range of £20-25, it is near Raja Indian Cuisine in riverside and it is a restaurant.'
'name[The Vaults], eatType[restaurant], food[Indian], priceRange[cheap], area[riverside], familyFriendly[yes], near[Raja Indian Cuisine]'	'The Vaults is in riverside near Raja Indian Cuisine, it is cheap and an indian restaurant and it is kid friendly.'
'name[The Vaults], eatType[restaurant], food[Indian], priceRange[high], area[city centre], familyFriendly[no], near[Raja Indian Cuisine]'	'The Vaults is in city centre near Raja Indian Cuisine, it is an indian restaurant and expensive and it is n 't family friendly.'
'name[The Vaults], eatType[restaurant], food[Indian], priceRange[high], area[city centre], familyFriendly[yes], near[Raja Indian Cuisine]'	'The Vaults is in city centre near Raja Indian Cuisine, it is an indian restaurant and kid friendly and it is expensive.'
'name[The Waterman], eatType[pub], food[Indian], priceRange[high], area[city centre], familyFriendly[yes], near[Raja Indian Cuisine]'	'The Waterman is in city centre near Raja Indian Cuisine, it is a pub, it is an indian restaurant and kid friendly and it is expensive.'
'name[The Waterman], eatType[pub], food[Indian], priceRange[high], area[riverside], familyFriendly[no], near[Raja Indian Cuisine]'	'The Waterman is an indian restaurant and expensive, it is in riverside near Raja Indian Cuisine, it is a pub and it is n 't kid friendly.'
'name[The Waterman], eatType[pub], food[Indian], priceRange[high], area[riverside], familyFriendly[yes], near[Raja Indian Cuisine]'	'The Waterman is a pub, it is in riverside near Raja Indian Cuisine and it is an indian restaurant, expensive and kid friendly.'
'name[The Waterman], eatType[pub], food[Indian], priceRange[less than £20], area[city centre], familyFriendly[no], near[Raja Indian Cuisine]'	'The Waterman costs less than £20, it 's in city centre near Raja Indian Cuisine, it is a pub, it is an indian restaurant and it is n 't kid friendly.'
'name[The Waterman], eatType[pub], food[Indian], priceRange[less than £20], area[city centre], familyFriendly[yes], near[Raja Indian Cuisine]'	'The Waterman costs less than £20, it 's in city centre near Raja Indian Cuisine, it is an indian restaurant and family friendly and it is a pub.'
'name[The Waterman], eatType[pub], food[Indian], priceRange[less than £20], area[riverside], familyFriendly[no], near[Raja Indian Cuisine]'	'The Waterman is a pub, it costs less than £20, it 's in riverside near Raja Indian Cuisine, it is an indian restaurant and it is n 't kid friendly.'
'name[The Waterman], eatType[pub], food[Indian], priceRange[less than £20], area[riverside], familyFriendly[yes], near[Raja Indian Cuisine]'	'The Waterman costs less than £20, it 's near Raja Indian Cuisine in riverside, it is an indian restaurant and family friendly and it is a pub.'
'name[The Waterman], eatType[pub], food[Indian], priceRange[moderate], area[city centre], familyFriendly[no], near[Raja Indian Cuisine]'	'The Waterman is an indian restaurant and moderately priced, it is in city centre near Raja Indian Cuisine, it is a pub and it is n 't kid friendly.'
'name[The Waterman], eatType[pub], food[Indian], priceRange[moderate], area[city centre], familyFriendly[yes], near[Raja Indian Cuisine]'	'The Waterman is moderately priced, an indian restaurant and kid friendly, it is near Raja Indian Cuisine in city centre and it is a pub.'
'name[The Waterman], eatType[pub], food[Indian], priceRange[moderate], area[riverside], familyFriendly[no], near[Raja Indian Cuisine]'	'The Waterman is an indian restaurant and moderately priced, it is in riverside near Raja Indian Cuisine, it is a pub and it is n 't kid friendly.'
'name[The Waterman], eatType[pub], food[Indian], priceRange[moderate], area[riverside], familyFriendly[yes], near[Raja Indian Cuisine]'	'The Waterman is moderately priced, an indian restaurant and kid friendly, it is near Raja Indian Cuisine in riverside and it is a pub.'
'name[The Waterman], eatType[pub], food[Indian], priceRange[more than £30], area[riverside], familyFriendly[yes], near[Raja Indian Cuisine]'	'The Waterman costs more than £30, it 's in riverside near Raja Indian Cuisine, it is an indian restaurant and family friendly and it is a pub.'
'name[The Waterman], eatType[pub], food[Italian], priceRange[£20-25], area[riverside], familyFriendly[yes], near[Raja Indian Cuisine]'	'The Waterman is in riverside near Raja Indian Cuisine with a price range of £20-25, it is kid friendly and an italian restaurant and it is a pub.'
'name[The Waterman], eatType[pub], food[Italian], priceRange[cheap], area[riverside], familyFriendly[yes], near[Raja Indian Cuisine]'	'The Waterman is cheap, an italian restaurant and kid friendly, it is near Raja Indian Cuisine in riverside and it is a pub.'
'name[The Waterman], eatType[pub], food[Italian], priceRange[high], area[city centre], familyFriendly[no], near[Raja Indian Cuisine]'	'The Waterman is an italian restaurant and expensive, it is in city centre near Raja Indian Cuisine, it is a pub and it is n 't kid friendly.'
'name[The Waterman], eatType[pub], food[Italian], priceRange[high], area[city centre], familyFriendly[yes], near[Raja Indian Cuisine]'	'The Waterman is an italian restaurant, expensive and kid friendly, it is near Raja Indian Cuisine in city centre and it is a pub.'
'name[The Waterman], eatType[pub], food[Italian], priceRange[high], area[riverside], familyFriendly[no], near[Raja Indian Cuisine]'	'The Waterman is an italian restaurant and expensive, it is in riverside near Raja Indian Cuisine, it is a pub and it is n 't kid friendly.'
'name[The Waterman], eatType[pub], food[Italian], priceRange[high], area[riverside], familyFriendly[yes], near[Raja Indian Cuisine]'	'The Waterman is expensive, an italian restaurant and kid friendly, it is in riverside near Raja Indian Cuisine and it is a pub.'
'name[The Waterman], eatType[pub], food[Italian], priceRange[less than £20], area[city centre], familyFriendly[no], near[Raja Indian Cuisine]'	'The Waterman is a pub, it is in city centre near Raja Indian Cuisine, it is an italian restaurant, it is n 't family friendly and it costs less than £20.'
'name[The Waterman], eatType[pub], food[Italian], priceRange[less than £20], area[city centre], familyFriendly[yes], near[Raja Indian Cuisine]'	'The Waterman costs less than £20, it 's near Raja Indian Cuisine in city centre, it is a pub and it is family friendly and an italian restaurant.'
'name[The Waterman], eatType[pub], food[Italian], priceRange[less than £20], area[riverside], familyFriendly[no], near[Raja Indian Cuisine]'	'The Waterman is in riverside near Raja Indian Cuisine, it is an italian restaurant, it is a pub, it is n 't family friendly and it costs less than £20.'
'name[The Waterman], eatType[restaurant], food[Indian], priceRange[high], area[city centre], familyFriendly[yes], near[Raja Indian Cuisine]'	'The Waterman is in city centre near Raja Indian Cuisine, it is an indian restaurant and kid friendly and it is expensive.'
'name[The Waterman], eatType[restaurant], food[Indian], priceRange[high], area[riverside], familyFriendly[no], near[Raja Indian Cuisine]'	'The Waterman is in riverside near Raja Indian Cuisine, it is an indian restaurant and expensive and it is n 't kid friendly.'
'name[The Waterman], eatType[restaurant], food[Indian], priceRange[high], area[riverside], familyFriendly[yes], near[Raja Indian Cuisine]'	'The Waterman is in riverside near Raja Indian Cuisine, it is an indian restaurant and kid friendly and it is expensive.'
'name[The Waterman], eatType[restaurant], food[Indian], priceRange[less than £20], area[city centre], familyFriendly[no], near[Raja Indian Cuisine]'	'The Waterman is an indian restaurant, it is near Raja Indian Cuisine in city centre, it is n 't family friendly and it costs less than £20.'
'name[The Waterman], eatType[restaurant], food[Indian], priceRange[less than £20], area[city centre], familyFriendly[yes], near[Raja Indian Cuisine]'	'The Waterman is an indian restaurant and family friendly, it costs less than £20, it 's in city centre near Raja Indian Cuisine and it is a restaurant.'
'name[The Waterman], eatType[restaurant], food[Indian], priceRange[less than £20], area[riverside], familyFriendly[no], near[Raja Indian Cuisine]'	'The Waterman costs less than £20, it 's near Raja Indian Cuisine in riverside, it is an indian restaurant and it is n 't kid friendly.'
'name[The Waterman], eatType[restaurant], food[Indian], priceRange[less than £20], area[riverside], familyFriendly[yes], near[Raja Indian Cuisine]'	'The Waterman is an indian restaurant and family friendly, it costs less than £20, it 's in riverside near Raja Indian Cuisine and it is a restaurant.'
'name[The Waterman], eatType[restaurant], food[Indian], priceRange[moderate], area[city centre], familyFriendly[no], near[Raja Indian Cuisine]'	'The Waterman is moderately priced and an indian restaurant, it is near Raja Indian Cuisine in city centre and it is n 't kid friendly.'
'name[The Waterman], eatType[restaurant], food[Indian], priceRange[moderate], area[city centre], familyFriendly[yes], near[Raja Indian Cuisine]'	'The Waterman is in city centre near Raja Indian Cuisine, it is moderately priced and an indian restaurant and it is kid friendly.'
'name[The Waterman], eatType[restaurant], food[Indian], priceRange[moderate], area[riverside], familyFriendly[no], near[Raja Indian Cuisine]'	'The Waterman is moderately priced and an indian restaurant, it is near Raja Indian Cuisine in riverside and it is n 't kid friendly.'
'name[The Waterman], eatType[restaurant], food[Indian], priceRange[moderate], area[riverside], familyFriendly[yes], near[Raja Indian Cuisine]'	'The Waterman is in riverside near Raja Indian Cuisine, it is moderately priced and an indian restaurant and it is kid friendly.'
'name[The Waterman], eatType[restaurant], food[Indian], priceRange[more than £30], area[riverside], familyFriendly[yes], near[Raja Indian Cuisine]'	'The Waterman is an indian restaurant and kid friendly, it costs more than £30, it 's in riverside near Raja Indian Cuisine and it is a restaurant.'
'name[The Waterman], eatType[restaurant], food[Italian], priceRange[£20-25], area[riverside], familyFriendly[yes], near[Raja Indian Cuisine]'	'The Waterman is an italian restaurant and kid friendly with a price range of £20-25, it is in riverside near Raja Indian Cuisine and it is a restaurant.'
'name[The Waterman], eatType[restaurant], food[Italian], priceRange[cheap], area[riverside], familyFriendly[yes], near[Raja Indian Cuisine]'	'The Waterman is in riverside near Raja Indian Cuisine, it is cheap and an italian restaurant and it is kid friendly.'
'name[The Waterman], eatType[restaurant], food[Italian], priceRange[high], area[city centre], familyFriendly[no], near[Raja Indian Cuisine]'	'The Waterman is in city centre near Raja Indian Cuisine, it is an italian restaurant and expensive and it is n 't family friendly.'
'name[The Waterman], eatType[restaurant], food[Italian], priceRange[high], area[city centre], familyFriendly[yes], near[Raja Indian Cuisine]'	'The Waterman is in city centre near Raja Indian Cuisine, it is an italian restaurant and kid friendly and it is expensive.'
'name[The Waterman], eatType[restaurant], food[Italian], priceRange[high], area[riverside], familyFriendly[no], near[Raja Indian Cuisine]'	'The Waterman is in riverside near Raja Indian Cuisine, it is an italian restaurant and expensive and it is n 't kid friendly.'
'name[The Waterman], eatType[restaurant], food[Italian], priceRange[high], area[riverside], familyFriendly[yes], near[Raja Indian Cuisine]'	'The Waterman is in riverside near Raja Indian Cuisine, it is an italian restaurant and kid friendly and it is expensive.'
'name[The Waterman], eatType[restaurant], food[Italian], priceRange[less than £20], area[city centre], familyFriendly[no], near[Raja Indian Cuisine]'	'The Waterman is an italian restaurant, it is near Raja Indian Cuisine in city centre, it is n 't family friendly and it costs less than £20.'
'name[The Waterman], eatType[restaurant], food[Italian], priceRange[less than £20], area[city centre], familyFriendly[yes], near[Raja Indian Cuisine]'	'The Waterman is family friendly and an italian restaurant, it is near Raja Indian Cuisine in city centre and it costs less than £20.'
'name[The Waterman], eatType[restaurant], food[Italian], priceRange[less than £20], area[riverside], familyFriendly[no], near[Raja Indian Cuisine]'	'The Waterman costs less than £20, it 's near Raja Indian Cuisine in riverside, it is an italian restaurant and it is n 't kid friendly.'
'name[The Wrestlers], eatType[pub], food[Italian], priceRange[less than £20], area[riverside], familyFriendly[no], near[Raja Indian Cuisine]'	'The Wrestlers is in riverside near Raja Indian Cuisine, it is an italian restaurant, it is a pub, it is n 't family friendly and it costs less than £20.'
'name[The Wrestlers], eatType[pub], food[Italian], priceRange[less than £20], area[riverside], familyFriendly[yes], near[Raja Indian Cuisine]'	'The Wrestlers costs less than £20, it 's near Raja Indian Cuisine in riverside, it is a pub and it is family friendly and an italian restaurant.'
'name[The Wrestlers], eatType[pub], food[Italian], priceRange[moderate], area[city centre], familyFriendly[no], near[Raja Indian Cuisine]'	'The Wrestlers is an italian restaurant and moderately priced, it is in city centre near Raja Indian Cuisine, it is a pub and it is n 't kid friendly.'
'name[The Wrestlers], eatType[pub], food[Italian], priceRange[moderate], area[city centre], familyFriendly[yes], near[Raja Indian Cuisine]'	'The Wrestlers is moderately priced, an italian restaurant and kid friendly, it is near Raja Indian Cuisine in city centre and it is a pub.'
'name[The Wrestlers], eatType[pub], food[Italian], priceRange[moderate], area[riverside], familyFriendly[no], near[Raja Indian Cuisine]'	'The Wrestlers is an italian restaurant and moderately priced, it is in riverside near Raja Indian Cuisine, it is a pub and it is n 't kid friendly.'
'name[The Wrestlers], eatType[pub], food[Italian], priceRange[moderate], area[riverside], familyFriendly[yes], near[Raja Indian Cuisine]'	'The Wrestlers is moderately priced, an italian restaurant and kid friendly, it is in riverside near Raja Indian Cuisine and it is a pub.'
'name[The Wrestlers], eatType[pub], food[Italian], priceRange[more than £30], area[riverside], familyFriendly[yes], near[Raja Indian Cuisine]'	'The Wrestlers costs more than £30, it 's in riverside near Raja Indian Cuisine, it is an italian restaurant and kid friendly and it is a pub.'
'name[The Wrestlers], eatType[pub], food[Japanese], priceRange[£20-25], area[riverside], familyFriendly[yes], near[Raja Indian Cuisine]'	'The Wrestlers is in riverside near Raja Indian Cuisine with a price range of £20-25, it is a pub and it is kid friendly and a japanese restaurant.'
'name[The Wrestlers], eatType[pub], food[Japanese], priceRange[cheap], area[riverside], familyFriendly[yes], near[Raja Indian Cuisine]'	'The Wrestlers is cheap, kid friendly and a japanese restaurant, it is near Raja Indian Cuisine in riverside and it is a pub.'
'name[The Wrestlers], eatType[pub], food[Japanese], priceRange[high], area[riverside], familyFriendly[yes], near[Raja Indian Cuisine]'	'The Wrestlers is in riverside near Raja Indian Cuisine, it is a japanese restaurant, kid friendly and expensive and it is a pub.'
'name[The Wrestlers], eatType[pub], food[Japanese], priceRange[less than £20], area[city centre], familyFriendly[no], near[Raja Indian Cuisine]'	'The Wrestlers costs less than £20, it 's in city centre near Raja Indian Cuisine, it is a pub, it is n 't family friendly and it 's a japanese restaurant.'
'name[The Wrestlers], eatType[pub], food[Japanese], priceRange[less than £20], area[city centre], familyFriendly[yes], near[Raja Indian Cuisine]'	'The Wrestlers costs less than £20, it 's near Raja Indian Cuisine in city centre, it is a pub and it is family friendly and a japanese restaurant.'
'name[The Wrestlers], eatType[pub], food[Japanese], priceRange[less than £20], area[riverside], familyFriendly[no], near[Raja Indian Cuisine]'	'The Wrestlers costs less than £20, it 's near Raja Indian Cuisine in riverside, it is a pub, it is a japanese restaurant and it is n 't kid friendly.'
'name[The Wrestlers], eatType[pub], food[Japanese], priceRange[less than £20], area[riverside], familyFriendly[yes], near[Raja Indian Cuisine]'	'The Wrestlers costs less than £20, it 's near Raja Indian Cuisine in riverside, it is a pub and it is kid friendly and a japanese restaurant.'
'name[The Wrestlers], eatType[pub], food[Japanese], priceRange[moderate], area[city centre], familyFriendly[no], near[Raja Indian Cuisine]'	'The Wrestlers is a japanese restaurant and moderately priced, it is in city centre near Raja Indian Cuisine, it is a pub and it is n 't kid friendly.'
'name[The Wrestlers], eatType[pub], food[Japanese], priceRange[moderate], area[city centre], familyFriendly[yes], near[Raja Indian Cuisine]'	'The Wrestlers is a japanese restaurant, kid friendly and moderately priced, it is near Raja Indian Cuisine in city centre and it is a pub.'
'name[The Wrestlers], eatType[pub], food[Japanese], priceRange[moderate], area[riverside], familyFriendly[no], near[Raja Indian Cuisine]'	'The Wrestlers is a japanese restaurant and moderately priced, it is in riverside near Raja Indian Cuisine, it is a pub and it is n 't kid friendly.'
'name[The Wrestlers], eatType[pub], food[Japanese], priceRange[moderate], area[riverside], familyFriendly[yes], near[Raja Indian Cuisine]'	'The Wrestlers is a japanese restaurant, kid friendly and moderately priced, it is in riverside near Raja Indian Cuisine and it is a pub.'
'name[The Wrestlers], eatType[pub], food[Japanese], priceRange[moderate], customer rating[1 out of 5], area[city centre], familyFriendly[yes], near[Raja Indian Cuisine]'	'The Wrestlers is in city centre near Raja Indian Cuisine with a 1 out of 5 rating, it is a japanese restaurant, kid friendly and moderately priced and it is a pub.'
'name[The Wrestlers], eatType[pub], food[Japanese], priceRange[moderate], customer rating[1 out of 5], area[riverside], familyFriendly[no], near[Raja Indian Cuisine]'	'The Wrestlers is a japanese restaurant and moderately priced with a 1 out of 5 rating, it is in riverside near Raja Indian Cuisine, it is a pub and it is n 't kid friendly.'
'name[The Wrestlers], eatType[pub], food[Japanese], priceRange[moderate], customer rating[1 out of 5], area[riverside], familyFriendly[yes], near[Raja Indian Cuisine]'	'The Wrestlers is in riverside near Raja Indian Cuisine with a 1 out of 5 rating, it is a japanese restaurant, kid friendly and moderately priced and it is a pub.'
'name[The Wrestlers], eatType[pub], food[Japanese], priceRange[more than £30], area[city centre], familyFriendly[no], near[Raja Indian Cuisine]'	'The Wrestlers costs more than £30, it 's in city centre near Raja Indian Cuisine, it is a pub, it is a japanese restaurant and it is n 't kid friendly.'
'name[The Wrestlers], eatType[pub], food[Japanese], priceRange[more than £30], area[city centre], familyFriendly[yes], near[Raja Indian Cuisine]'	'The Wrestlers costs more than £30, it 's a pub, it is in city centre near Raja Indian Cuisine and it is a japanese restaurant and family friendly.'
'name[The Wrestlers], eatType[pub], food[Japanese], priceRange[more than £30], area[riverside], familyFriendly[no], near[Raja Indian Cuisine]'	'The Wrestlers costs more than £30, it 's a japanese restaurant, it is in riverside near Raja Indian Cuisine, it is a pub and it is n 't kid friendly.'
'name[The Wrestlers], eatType[pub], food[Japanese], priceRange[more than £30], area[riverside], familyFriendly[yes], near[Raja Indian Cuisine]'	'The Wrestlers costs more than £30, it 's near Raja Indian Cuisine in riverside, it is a japanese restaurant and kid friendly and it is a pub.'
'name[The Wrestlers], eatType[pub], food[Japanese], priceRange[more than £30], customer rating[5 out of 5], area[city centre], familyFriendly[no], near[Raja Indian Cuisine]'	'The Wrestlers is a japanese restaurant with a 5 out of 5 rating, it is in city centre near Raja Indian Cuisine, it is a pub, it is n 't kid friendly and it costs more than £30.'
'name[The Wrestlers], eatType[pub], food[Japanese], priceRange[more than £30], customer rating[5 out of 5], area[city centre], familyFriendly[yes], near[Raja Indian Cuisine]'	'The Wrestlers costs more than £30 with a 5 out of 5 rating, it is in city centre near Raja Indian Cuisine, it is a pub and it is family friendly and a japanese restaurant.'
'name[The Wrestlers], eatType[pub], food[Japanese], priceRange[more than £30], customer rating[5 out of 5], area[riverside], familyFriendly[no], near[Raja Indian Cuisine]'	'The Wrestlers costs more than £30 with a 5 out of 5 rating, it is in riverside near Raja Indian Cuisine, it is a pub, it is a japanese restaurant and it is n 't kid friendly.'
'name[The Wrestlers], eatType[pub], food[Japanese], priceRange[more than £30], customer rating[5 out of 5], area[riverside], familyFriendly[yes], near[Raja Indian Cuisine]'	'The Wrestlers is in riverside near Raja Indian Cuisine with a 5 out of 5 rating, it is a pub, it costs more than £30 and it 's kid friendly and a japanese restaurant.'
'name[The Wrestlers], eatType[pub], food[Japanese], priceRange[more than £30], customer rating[low], area[city centre], familyFriendly[no], near[Raja Indian Cuisine]'	'The Wrestlers is a japanese restaurant with a low rating, it is in city centre near Raja Indian Cuisine, it is a pub, it is n 't kid friendly and it costs more than £30.'
'name[The Wrestlers], eatType[pub], food[Japanese], priceRange[more than £30], customer rating[low], area[city centre], familyFriendly[yes], near[Raja Indian Cuisine]'	'The Wrestlers costs more than £30 with a low rating, it is in city centre near Raja Indian Cuisine, it is a pub and it is family friendly and a japanese restaurant.'
'name[The Wrestlers], eatType[pub], food[Japanese], priceRange[more than £30], customer rating[low], area[riverside], familyFriendly[no], near[Raja Indian Cuisine]'	'The Wrestlers is a japanese restaurant with a low rating, it is in riverside near Raja Indian Cuisine, it is a pub, it is n 't kid friendly and it costs more than £30.'
'name[The Wrestlers], eatType[pub], food[Japanese], priceRange[more than £30], customer rating[low], area[riverside], familyFriendly[yes], near[Raja Indian Cuisine]'	'The Wrestlers costs more than £30 with a low rating, it is near Raja Indian Cuisine in riverside, it is a pub and it is kid friendly and a japanese restaurant.'
'name[The Wrestlers], eatType[restaurant], food[Italian], priceRange[less than £20], area[riverside], familyFriendly[no], near[Raja Indian Cuisine]'	'The Wrestlers costs less than £20, it 's near Raja Indian Cuisine in riverside, it is an italian restaurant and it is n 't kid friendly.'
'name[The Wrestlers], eatType[restaurant], food[Italian], priceRange[less than £20], area[riverside], familyFriendly[yes], near[Raja Indian Cuisine]'	'The Wrestlers is an italian restaurant and family friendly, it costs less than £20, it 's in riverside near Raja Indian Cuisine and it is a restaurant.'
'name[The Wrestlers], eatType[restaurant], food[Italian], priceRange[moderate], area[city centre], familyFriendly[no], near[Raja Indian Cuisine]'	'The Wrestlers is moderately priced and an italian restaurant, it is near Raja Indian Cuisine in city centre and it is n 't kid friendly.'
'name[The Wrestlers], eatType[restaurant], food[Italian], priceRange[moderate], area[city centre], familyFriendly[yes], near[Raja Indian Cuisine]'	'The Wrestlers is in city centre near Raja Indian Cuisine, it is moderately priced and an italian restaurant and it is kid friendly.'
'name[The Wrestlers], eatType[restaurant], food[Italian], priceRange[moderate], area[riverside], familyFriendly[no], near[Raja Indian Cuisine]'	'The Wrestlers is moderately priced and an italian restaurant, it is near Raja Indian Cuisine in riverside and it is n 't kid friendly.'
'name[The Wrestlers], eatType[restaurant], food[Italian], priceRange[moderate], area[riverside], familyFriendly[yes], near[Raja Indian Cuisine]'	'The Wrestlers is in riverside near Raja Indian Cuisine, it is moderately priced and an italian restaurant and it is kid friendly.'
'name[The Wrestlers], eatType[restaurant], food[Italian], priceRange[more than £30], area[riverside], familyFriendly[yes], near[Raja Indian Cuisine]'	'The Wrestlers costs more than £30, it 's near Raja Indian Cuisine in riverside, it is an italian restaurant and it is kid friendly.'
'name[The Wrestlers], eatType[restaurant], food[Japanese], priceRange[£20-25], area[riverside], familyFriendly[yes], near[Raja Indian Cuisine]'	'The Wrestlers is near Raja Indian Cuisine in riverside with a price range of £20-25, it is a japanese restaurant and kid friendly.'
'name[The Wrestlers], eatType[restaurant], food[Japanese], priceRange[cheap], area[riverside], familyFriendly[yes], near[Raja Indian Cuisine]'	'The Wrestlers is in riverside near Raja Indian Cuisine, it is a japanese restaurant and family friendly and it is cheap.'
'name[The Wrestlers], eatType[restaurant], food[Japanese], priceRange[high], area[riverside], familyFriendly[yes], near[Raja Indian Cuisine]'	'The Wrestlers is in riverside near Raja Indian Cuisine, it is a japanese restaurant and kid friendly and it is expensive.'
'name[The Wrestlers], eatType[restaurant], food[Japanese], priceRange[less than £20], area[city centre], familyFriendly[no], near[Raja Indian Cuisine]'	'The Wrestlers costs less than £20, it 's near Raja Indian Cuisine in city centre, it is a japanese restaurant and it is n 't family friendly.'
'name[The Wrestlers], eatType[restaurant], food[Japanese], priceRange[less than £20], area[city centre], familyFriendly[yes], near[Raja Indian Cuisine]'	'The Wrestlers costs less than £20, it 's near Raja Indian Cuisine in city centre and it is a japanese restaurant and family friendly.'
'name[The Wrestlers], eatType[restaurant], food[Japanese], priceRange[less than £20], area[riverside], familyFriendly[no], near[Raja Indian Cuisine]'	'The Wrestlers costs less than £20, it 's near Raja Indian Cuisine in riverside, it is a japanese restaurant and it is n 't kid friendly.'
'name[The Wrestlers], eatType[restaurant], food[Japanese], priceRange[less than £20], area[riverside], familyFriendly[yes], near[Raja Indian Cuisine]'	'The Wrestlers costs less than £20, it 's near Raja Indian Cuisine in riverside, it is a japanese restaurant and family friendly.'
'name[The Wrestlers], eatType[restaurant], food[Japanese], priceRange[moderate], area[city centre], familyFriendly[no], near[Raja Indian Cuisine]'	'The Wrestlers is near Raja Indian Cuisine in city centre, it is a japanese restaurant and moderately priced and it is n 't kid friendly.'
'name[The Wrestlers], eatType[restaurant], food[Japanese], priceRange[moderate], area[city centre], familyFriendly[yes], near[Raja Indian Cuisine]'	'The Wrestlers is in city centre near Raja Indian Cuisine, it is a japanese restaurant and kid friendly and it is moderately priced.'
'name[The Wrestlers], eatType[restaurant], food[Japanese], priceRange[moderate], area[riverside], familyFriendly[no], near[Raja Indian Cuisine]'	'The Wrestlers is near Raja Indian Cuisine in riverside, it is a japanese restaurant and moderately priced and it is n 't kid friendly.'
'name[The Wrestlers], eatType[restaurant], food[Japanese], priceRange[moderate], area[riverside], familyFriendly[yes], near[Raja Indian Cuisine]'	'The Wrestlers is in riverside near Raja Indian Cuisine, it is a japanese restaurant and kid friendly and it is moderately priced.'
'name[The Wrestlers], eatType[restaurant], food[Japanese], priceRange[more than £30], area[city centre], familyFriendly[no], near[Raja Indian Cuisine]'	'The Wrestlers costs more than £30, it 's near Raja Indian Cuisine in city centre, it is a japanese restaurant and it is n 't family friendly.'
'name[The Wrestlers], eatType[restaurant], food[Japanese], priceRange[more than £30], area[city centre], familyFriendly[yes], near[Raja Indian Cuisine]'	'The Wrestlers costs more than £30, it 's near Raja Indian Cuisine in city centre and it is a japanese restaurant and family friendly.'
'name[The Wrestlers], eatType[restaurant], food[Japanese], priceRange[more than £30], area[riverside], familyFriendly[no], near[Raja Indian Cuisine]'	'The Wrestlers costs more than £30, it 's near Raja Indian Cuisine in riverside, it is a japanese restaurant and it is n 't kid friendly.'
'name[The Wrestlers], eatType[restaurant], food[Japanese], priceRange[more than £30], area[riverside], familyFriendly[yes], near[Raja Indian Cuisine]'	'The Wrestlers costs more than £30, it 's near Raja Indian Cuisine in riverside, it is a japanese restaurant and it is kid friendly.'
'name[Wildwood], eatType[coffee shop], area[riverside]'	'Wildwood is in riverside and it is a coffee shop.'
'name[Wildwood], eatType[pub], area[riverside]'	'Wildwood is in riverside and it is a pub.'
'name[Wildwood], eatType[pub], food[French], area[riverside], familyFriendly[yes], near[Raja Indian Cuisine]'	'Wildwood is in riverside near Raja Indian Cuisine, it is a pub and it is kid friendly and a french restaurant.'
'name[Wildwood], eatType[pub], food[Indian], area[city centre], familyFriendly[no], near[Raja Indian Cuisine]'	'Wildwood is a pub, it is in city centre near Raja Indian Cuisine, it is an indian restaurant and it is n 't kid friendly.'
'name[Wildwood], eatType[pub], food[Indian], area[city centre], familyFriendly[yes], near[Raja Indian Cuisine]'	'Wildwood is in city centre near Raja Indian Cuisine, it is an indian restaurant and family friendly and it is a pub.'
'name[Wildwood], eatType[pub], food[Indian], area[riverside], familyFriendly[no], near[Raja Indian Cuisine]'	'Wildwood is in riverside near Raja Indian Cuisine, it is a pub, it is an indian restaurant and it is n 't kid friendly.'
'name[Wildwood], eatType[pub], food[Indian], area[riverside], familyFriendly[yes], near[Raja Indian Cuisine]'	'Wildwood is in riverside near Raja Indian Cuisine, it is an indian restaurant and family friendly and it is a pub.'
'name[Wildwood], eatType[pub], food[Italian], area[city centre], familyFriendly[no], near[Raja Indian Cuisine]'	'Wildwood is a pub, it is in city centre near Raja Indian Cuisine, it is an italian restaurant and it is n 't kid friendly.'
'name[Wildwood], eatType[pub], food[Italian], area[city centre], familyFriendly[yes], near[Raja Indian Cuisine]'	'Wildwood is in city centre near Raja Indian Cuisine, it is an italian restaurant and family friendly and it is a pub.'
'name[Wildwood], eatType[pub], food[Italian], area[riverside], familyFriendly[no], near[Raja Indian Cuisine]'	'Wildwood is in riverside near Raja Indian Cuisine, it is an italian restaurant, it is a pub and it is n 't kid friendly.'
'name[Wildwood], eatType[pub], food[Italian], area[riverside], familyFriendly[yes], near[Raja Indian Cuisine]'	'Wildwood is in riverside near Raja Indian Cuisine, it is an italian restaurant and family friendly and it is a pub.'
'name[Wildwood], eatType[restaurant], food[French], area[riverside], familyFriendly[yes], near[Raja Indian Cuisine]'	'Wildwood is a french restaurant and kid friendly, it is in riverside near Raja Indian Cuisine and it is a restaurant.'
'name[Wildwood], eatType[restaurant], food[Indian], area[city centre], familyFriendly[no], near[Raja Indian Cuisine]'	'Wildwood is near Raja Indian Cuisine in city centre, it is an indian restaurant and it is n 't family friendly.'
'name[Wildwood], eatType[restaurant], food[Indian], area[city centre], familyFriendly[yes], near[Raja Indian Cuisine]'	'Wildwood is in city centre near Raja Indian Cuisine, it is an indian restaurant and family friendly and it is a restaurant.'
'name[Wildwood], eatType[restaurant], food[Indian], area[riverside], familyFriendly[no], near[Raja Indian Cuisine]'	'Wildwood is in riverside near Raja Indian Cuisine, it is an indian restaurant and it is n 't kid friendly.'
'name[Wildwood], eatType[restaurant], food[Indian], area[riverside], familyFriendly[yes], near[Raja Indian Cuisine]'	'Wildwood is an indian restaurant and kid friendly, it is in riverside near Raja Indian Cuisine and it is a restaurant.'
'name[Wildwood], eatType[restaurant], food[Italian], area[city centre], familyFriendly[no], near[Raja Indian Cuisine]'	'Wildwood is near Raja Indian Cuisine in city centre, it is an italian restaurant and it is n 't family friendly.'
'name[Wildwood], eatType[restaurant], food[Italian], area[city centre], familyFriendly[yes], near[Raja Indian Cuisine]'	'Wildwood is an italian restaurant and kid friendly, it is in city centre near Raja Indian Cuisine and it is a restaurant.'
'name[Wildwood], eatType[restaurant], food[Italian], area[riverside], familyFriendly[no], near[Raja Indian Cuisine]'	'Wildwood is in riverside near Raja Indian Cuisine, it is an italian restaurant and it is n 't kid friendly.'
'name[Wildwood], eatType[restaurant], food[Italian], area[riverside], familyFriendly[yes], near[Raja Indian Cuisine]'	'Wildwood is in riverside near Raja Indian Cuisine, it is an italian restaurant and kid friendly and it is a restaurant.'
'name[Zizzi], eatType[coffee shop], area[riverside]'	'Zizzi is in riverside and it is a coffee shop.'
'name[Zizzi], eatType[coffee shop], customer rating[average], near[Burger King]'	'Zizzi is near Burger King with an average rating and it is a coffee shop.'
'name[Zizzi], eatType[coffee shop], customer rating[high], near[Burger King]'	'Zizzi is near Burger King with a high rating and it is a coffee shop.'
'name[Zizzi], eatType[coffee shop], near[The Sorrento]'	'Well, Zizzi is near The Sorrento, it is a coffee shop.'
'name[Zizzi], eatType[pub], area[riverside]'	'Zizzi is in riverside and it is a pub.'
'name[Zizzi], eatType[pub], customer rating[average], near[Burger King]'	'Zizzi is near Burger King with an average rating and it is a pub.'
'name[Zizzi], eatType[pub], customer rating[high], near[Burger King]'	'Zizzi is a pub with a high rating and it is near Burger King.'
'name[Zizzi], eatType[pub], near[The Sorrento]'	'Zizzi is near The Sorrento and it is a pub.'
