"name[Blue Spice], eatType[coffee shop], area[city centre]"	Blue spice is a coffee shop in city centre.
"name[Blue Spice], eatType[coffee shop], area[riverside]"	Blue spice is a coffee shop on the riverside.
"name[Blue Spice], eatType[coffee shop], customer rating[5 out of 5], near[Crowne Plaza Hotel]"	Blue spice is a coffee shop near crowne plaza hotel with a customer rating of 5 out of 5.
"name[Blue Spice], eatType[coffee shop], customer rating[average], near[Burger King]"	Blue spice is an average rated coffee shop near burger king.
"name[Blue Spice], eatType[coffee shop], customer rating[average], near[Crowne Plaza Hotel]"	Blue spice is an average rated coffee shop near crowne plaza hotel.
"name[Blue Spice], eatType[pub], area[city centre]"	In the city centre there is a pub called blue spice.
"name[Blue Spice], eatType[pub], area[riverside]"	Blue spice is a pub by the riverside.
"name[Blue Spice], eatType[pub], customer rating[5 out of 5], near[Crowne Plaza Hotel]"	Blue spice is a pub near crowne plaza hotel with a 5 out of 5 customer rating.
"name[Blue Spice], eatType[pub], customer rating[average], near[Burger King]"	Blue spice is an average rated pub near burger king.
"name[Blue Spice], eatType[pub], customer rating[average], near[Crowne Plaza Hotel]"	Blue spice is an average rated pub near crowne plaza hotel.
"name[Blue Spice], eatType[pub], food[Chinese], area[city centre], familyFriendly[no], near[Rainbow Vegetarian Café]"	Blue spice is a pub that provides chinese food in the city centre. it is located near rainbow vegetarian café.
"name[Blue Spice], eatType[pub], food[Chinese], area[city centre], familyFriendly[yes], near[Rainbow Vegetarian Café]"	Blue spice is a family friendly chinese pub located in the city centre near rainbow vegetarian café.
"name[Blue Spice], eatType[pub], food[Chinese], area[riverside], familyFriendly[no], near[Rainbow Vegetarian Café]"	Blue spice is a chinese pub located near rainbow vegetarian café in the riverside area. it is not family friendly.
"name[Blue Spice], eatType[pub], food[Chinese], area[riverside], familyFriendly[yes], near[Rainbow Vegetarian Café]"	Blue spice is a family friendly pub serving chinese food. it is located in the riverside area near rainbow vegetarian café.
"name[Blue Spice], eatType[pub], food[English], area[city centre], familyFriendly[no], near[Rainbow Vegetarian Café]"	Blue spice is a family-friendly pub located in the city centre near rainbow vegetarian café. it serves english food.
"name[Blue Spice], eatType[pub], food[English], area[city centre], familyFriendly[yes], near[Rainbow Vegetarian Café]"	Blue spice is a family-friendly pub serving english food near rainbow vegetarian café in the city centre.
"name[Blue Spice], eatType[pub], food[English], area[riverside], familyFriendly[no], near[Rainbow Vegetarian Café]"	Blue spice is an english pub located near rainbow vegetarian café in the riverside area. it is not family-friendly.
"name[Blue Spice], eatType[pub], food[English], area[riverside], familyFriendly[yes], near[Rainbow Vegetarian Café]"	Blue spice is a family friendly pub that serves english food. it is located in the riverside area near rainbow vegetarian café.
"name[Blue Spice], eatType[restaurant], food[Chinese], area[city centre], familyFriendly[no], near[Rainbow Vegetarian Café]"	Blue spice is a chinese restaurant located near rainbow vegetarian café in the city centre. it is not family friendly.
"name[Blue Spice], eatType[restaurant], food[Chinese], area[city centre], familyFriendly[yes], near[Rainbow Vegetarian Café]"	Blue spice is a family friendly chinese restaurant located in the city centre near the rainbow vegetarian café.
"name[Blue Spice], eatType[restaurant], food[Chinese], area[riverside], familyFriendly[no], near[Rainbow Vegetarian Café]"	Blue spice is a chinese restaurant located in the riverside area. it is near rainbow vegetarian café.
"name[Blue Spice], eatType[restaurant], food[Chinese], area[riverside], familyFriendly[yes], near[Rainbow Vegetarian Café]"	Blue spice is a kid friendly chinese restaurant in the riverside area. it is near rainbow vegetarian café.
"name[Blue Spice], eatType[restaurant], food[English], area[city centre], familyFriendly[no], near[Rainbow Vegetarian Café]"	Blue spice is a non family-friendly english restaurant located near rainbow vegetarian café.
"name[Blue Spice], eatType[restaurant], food[English], area[city centre], familyFriendly[yes], near[Rainbow Vegetarian Café]"	Blue spice is a family-friendly english restaurant near rainbow vegetarian café in the city centre.
"name[Blue Spice], eatType[restaurant], food[English], area[riverside], familyFriendly[no], near[Rainbow Vegetarian Café]"	Blue spice is a non family-friendly english restaurant located near rainbow vegetarian café.
"name[Blue Spice], eatType[restaurant], food[English], area[riverside], familyFriendly[yes], near[Rainbow Vegetarian Café]"	Blue spice is a family friendly english restaurant near rainbow vegetarian café.
"name[Clowns], eatType[coffee shop], customer rating[3 out of 5], near[All Bar One]"	Clowns is a coffee shop located near all bar one.
"name[Clowns], eatType[coffee shop], customer rating[5 out of 5], near[Crowne Plaza Hotel]"	Clowns is a coffee shop near crowne plaza hotel with a customer rating of 5 out of 5.
"name[Clowns], eatType[coffee shop], near[The Sorrento]"	Clowns is a coffee shop near the sorrento
"name[Clowns], eatType[pub], customer rating[3 out of 5], near[All Bar One]"	Clowns is a pub located near all bar one.
"name[Clowns], eatType[pub], customer rating[5 out of 5], near[Crowne Plaza Hotel]"	Clowns is a pub near crowne plaza hotel with a 5 out of 5 customer rating.
"name[Clowns], eatType[pub], near[The Sorrento]"	Near the sorrento is a pub called clowns.
"name[Cocum], eatType[coffee shop], customer rating[high], near[Burger King]"	Cocum is a coffee shop near burger king with a high customer rating.
"name[Cocum], eatType[coffee shop], customer rating[high], near[Café Sicilia]"	Cocum is a coffee shop near café sicilia with a high customer rating.
"name[Cocum], eatType[coffee shop], customer rating[low], near[Café Sicilia]"	Cocum is a coffee shop near café sicilia. it has a low customer rating.
"name[Cocum], eatType[coffee shop], customer rating[low], near[Express by Holiday Inn]"	Cocum is a coffee shop near express by holiday inn. it has a low customer rating.
"name[Cocum], eatType[coffee shop], near[The Rice Boat]"	Cocum is a coffee shop near the rice boat
"name[Cocum], eatType[coffee shop], near[The Sorrento]"	Cocum is a coffee shop near the sorrento
"name[Cocum], eatType[pub], customer rating[high], near[Burger King]"	Cocum is a pub near burger king with a high customer rating.
"name[Cocum], eatType[pub], customer rating[high], near[Café Sicilia]"	Cocum is a pub near café sicilia with a high customer rating.
"name[Cocum], eatType[pub], customer rating[low], near[Café Sicilia]"	Cocum is a low rated pub located near café sicilia.
"name[Cocum], eatType[pub], customer rating[low], near[Express by Holiday Inn]"	Cocum is a low rated pub located near express by holiday inn.
"name[Cocum], eatType[pub], near[The Rice Boat]"	Near the rice boat is a pub called cocum.
"name[Cocum], eatType[pub], near[The Sorrento]"	Near the sorrento is a pub called cocum.
"name[Cotto], eatType[coffee shop], near[The Bakers]"	Cotto is a coffee shop near the bakers
"name[Cotto], eatType[pub], near[The Bakers]"	Near the bakers is a pub called cotto.
"name[Giraffe], eatType[coffee shop], near[The Bakers]"	Giraffe is a coffee shop near the bakers
"name[Giraffe], eatType[coffee shop], near[The Rice Boat]"	Giraffe is a coffee shop near the rice boat
"name[Giraffe], eatType[pub], food[English], area[riverside], familyFriendly[yes], near[Rainbow Vegetarian Café]"	Giraffe is a family friendly pub that serves english food. it is located in the riverside area near rainbow vegetarian café.
"name[Giraffe], eatType[pub], food[Fast food], area[city centre], familyFriendly[no], near[Rainbow Vegetarian Café]"	Giraffe is a fast food pub located near rainbow vegetarian café in the city centre. it is not family-friendly.
"name[Giraffe], eatType[pub], food[Fast food], area[city centre], familyFriendly[yes], near[Rainbow Vegetarian Café]"	Giraffe is a family-friendly fast food pub in the city centre near the rainbow vegetarian café.
"name[Giraffe], eatType[pub], food[Fast food], area[riverside], familyFriendly[no], near[Rainbow Vegetarian Café]"	Giraffe is a fast food pub located near rainbow vegetarian café in the riverside area. it is not family-friendly.
"name[Giraffe], eatType[pub], food[Fast food], area[riverside], familyFriendly[yes], near[Rainbow Vegetarian Café]"	Giraffe is a family friendly fast food pub in the riverside area near rainbow vegetarian café.
"name[Giraffe], eatType[pub], food[Fast food], area[riverside], familyFriendly[yes], near[Raja Indian Cuisine]"	Giraffe is a family friendly fast food pub in the riverside area near raja indian cuisine.
"name[Giraffe], eatType[pub], food[French], area[city centre], familyFriendly[no], near[Raja Indian Cuisine]"	Giraffe is a non family-friendly french pub in the city centre near raja indian cuisine.
"name[Giraffe], eatType[pub], food[French], area[city centre], familyFriendly[yes], near[Raja Indian Cuisine]"	Giraffe is a family-friendly pub serving french food. it is located in the city centre near raja indian cuisine.
"name[Giraffe], eatType[pub], food[French], area[riverside], familyFriendly[no], near[Raja Indian Cuisine]"	Giraffe is a french pub located near raja indian cuisine in the riverside area. it is not family-friendly.
"name[Giraffe], eatType[pub], food[French], area[riverside], familyFriendly[yes], near[Raja Indian Cuisine]"	Giraffe is a family friendly french pub in riverside.
"name[Giraffe], eatType[pub], near[The Bakers]"	Near the bakers is a pub called giraffe.
"name[Giraffe], eatType[pub], near[The Rice Boat]"	Near the rice boat is a pub called giraffe.
"name[Giraffe], eatType[restaurant], food[English], area[riverside], familyFriendly[yes], near[Rainbow Vegetarian Café]"	Giraffe is a family friendly english restaurant near rainbow vegetarian café.
"name[Giraffe], eatType[restaurant], food[Fast food], area[city centre], familyFriendly[no], near[Rainbow Vegetarian Café]"	Giraffe is a fast food restaurant near rainbow vegetarian café in the city centre. it is not family-friendly.
"name[Giraffe], eatType[restaurant], food[Fast food], area[city centre], familyFriendly[yes], near[Rainbow Vegetarian Café]"	Giraffe is a family-friendly fast food restaurant located near rainbow vegetarian café in the city centre.
"name[Giraffe], eatType[restaurant], food[Fast food], area[riverside], familyFriendly[no], near[Rainbow Vegetarian Café]"	Giraffe is a fast food restaurant located in the riverside area near rainbow vegetarian café. it is not family-friendly.
"name[Giraffe], eatType[restaurant], food[Fast food], area[riverside], familyFriendly[yes], near[Rainbow Vegetarian Café]"	Giraffe is a fast food restaurant located near rainbow vegetarian café.
"name[Giraffe], eatType[restaurant], food[Fast food], area[riverside], familyFriendly[yes], near[Raja Indian Cuisine]"	Giraffe is a fast food restaurant located near raja indian cuisine.
"name[Giraffe], eatType[restaurant], food[French], area[city centre], familyFriendly[no], near[Raja Indian Cuisine]"	Giraffe is a non family-friendly french restaurant located near raja indian cuisine.
"name[Giraffe], eatType[restaurant], food[French], area[city centre], familyFriendly[yes], near[Raja Indian Cuisine]"	Giraffe is a family-friendly french restaurant in the city centre near raja indian cuisine
"name[Giraffe], eatType[restaurant], food[French], area[riverside], familyFriendly[no], near[Raja Indian Cuisine]"	Giraffe is a french restaurant near raja indian cuisine in the riverside area. it is not family-friendly.
"name[Giraffe], eatType[restaurant], food[French], area[riverside], familyFriendly[yes], near[Raja Indian Cuisine]"	Giraffe is a family friendly french restaurant located near raja indian cuisine.
"name[Green Man], eatType[coffee shop], customer rating[1 out of 5], near[All Bar One]"	Green man is a coffee shop located near all bar one.
"name[Green Man], eatType[coffee shop], customer rating[3 out of 5], near[All Bar One]"	Green man is a coffee shop located near all bar one.
"name[Green Man], eatType[pub], customer rating[1 out of 5], near[All Bar One]"	Green man is a pub near all bar one. it has a customer rating of 1 out of 5.
"name[Green Man], eatType[pub], customer rating[3 out of 5], near[All Bar One]"	Green man is a pub located near all bar one.
"name[Green Man], eatType[pub], food[Italian], area[riverside], familyFriendly[yes], near[Express by Holiday Inn]"	Green man is a family friendly italian pub near express by holiday inn in the riverside area.
"name[Green Man], eatType[pub], food[Italian], area[riverside], familyFriendly[yes], near[Raja Indian Cuisine]"	Green man is a family friendly italian pub near raja indian cuisine in the riverside area.
"name[Green Man], eatType[pub], food[Japanese], area[city centre], familyFriendly[no], near[Express by Holiday Inn]"	Green man is a non family-friendly japanese pub in the city centre near express by holiday inn.
"name[Green Man], eatType[pub], food[Japanese], area[city centre], familyFriendly[yes], near[Express by Holiday Inn]"	Green man is a family-friendly pub serving japanese food. it is located in the city centre near express by holiday inn.
"name[Green Man], eatType[pub], food[Japanese], area[riverside], familyFriendly[no], near[Express by Holiday Inn]"	Green man is a japanese pub near express by holiday inn in the riverside area.
"name[Green Man], eatType[pub], food[Japanese], area[riverside], familyFriendly[yes], near[Express by Holiday Inn]"	Green man is a family friendly japanese pub in the riverside area near express by holiday inn.
"name[Green Man], eatType[restaurant], food[Italian], area[riverside], familyFriendly[yes], near[Express by Holiday Inn]"	Green man is a family friendly italian restaurant located near express by holiday inn.
"name[Green Man], eatType[restaurant], food[Italian], area[riverside], familyFriendly[yes], near[Raja Indian Cuisine]"	Green man is a family friendly italian restaurant located near raja indian cuisine.
"name[Green Man], eatType[restaurant], food[Japanese], area[city centre], familyFriendly[no], near[Express by Holiday Inn]"	In the city centre near express by holiday inn is a japanese restaurant called green man.
"name[Green Man], eatType[restaurant], food[Japanese], area[city centre], familyFriendly[yes], near[Express by Holiday Inn]"	Green man is a family-friendly japanese restaurant in the city centre near express by holiday inn
"name[Green Man], eatType[restaurant], food[Japanese], area[riverside], familyFriendly[no], near[Express by Holiday Inn]"	Green man is a japanese restaurant located near express by holiday inn in the riverside area.
"name[Green Man], eatType[restaurant], food[Japanese], area[riverside], familyFriendly[yes], near[Express by Holiday Inn]"	Green man is a family friendly japanese restaurant near express by holiday inn in the riverside area.
"name[Loch Fyne], eatType[coffee shop], area[riverside]"	Loch fyne is a coffee shop on the riverside.
"name[Loch Fyne], eatType[pub], area[riverside]"	Loch fyne is a pub by the riverside.
"name[Strada], eatType[coffee shop], area[city centre]"	Strada is a coffee shop in city centre.
"name[Strada], eatType[coffee shop], customer rating[1 out of 5], near[All Bar One]"	Strada is a coffee shop located near all bar one.
"name[Strada], eatType[coffee shop], customer rating[1 out of 5], near[Rainbow Vegetarian Café]"	Strada is a coffee shop located near rainbow vegetarian café.
"name[Strada], eatType[coffee shop], customer rating[low], near[Express by Holiday Inn]"	Strada is a coffee shop near express by holiday inn. it has a low customer rating.
"name[Strada], eatType[pub], area[city centre]"	In the city centre there is a pub called strada.
"name[Strada], eatType[pub], customer rating[1 out of 5], near[All Bar One]"	Strada is a pub near all bar one. it has a customer rating of 1 out of 5.
"name[Strada], eatType[pub], customer rating[1 out of 5], near[Rainbow Vegetarian Café]"	Strada is a pub near rainbow vegetarian café. it has a customer rating of 1 out of 5.
"name[Strada], eatType[pub], customer rating[low], near[Express by Holiday Inn]"	Strada is a low rated pub located near express by holiday inn.
"name[The Cricketers], eatType[coffee shop], customer rating[1 out of 5], familyFriendly[yes], near[Avalon]"	The cricketers is a children friendly coffee shop near avalon. it has a customer rating of 1 out of 5.
"name[The Cricketers], eatType[coffee shop], customer rating[3 out of 5], familyFriendly[yes], near[Avalon]"	The cricketers is a child friendly coffee shop near avalon. it has a customer rating of 3 out of 5.
"name[The Cricketers], eatType[coffee shop], customer rating[3 out of 5], familyFriendly[yes], near[Crowne Plaza Hotel]"	The cricketers is a child friendly coffee shop near crowne plaza hotel. it has a customer rating of 3 out of 5.
"name[The Cricketers], eatType[coffee shop], customer rating[5 out of 5], familyFriendly[no], near[Crowne Plaza Hotel]"	The cricketers is a coffee shop near crowne plaza hotel. it is not family-friendly and has a customer rating of 5 out of 5.
"name[The Cricketers], eatType[coffee shop], customer rating[5 out of 5], familyFriendly[yes], near[Crowne Plaza Hotel]"	The cricketers is a family friendly coffee shop near crowne plaza hotel with a customer rating of 5 out of 5.
"name[The Cricketers], eatType[coffee shop], customer rating[average], familyFriendly[no], near[Café Sicilia]"	The cricketers is a family-friendly coffee shop near café sicilia.
"name[The Cricketers], eatType[coffee shop], customer rating[average], familyFriendly[no], near[Crowne Plaza Hotel]"	The cricketers is a family-friendly coffee shop near crowne plaza hotel.
"name[The Cricketers], eatType[coffee shop], customer rating[average], familyFriendly[yes], near[Café Sicilia]"	The cricketers is a family-friendly coffee shop near café sicilia.
"name[The Cricketers], eatType[coffee shop], customer rating[high], familyFriendly[yes], near[Café Sicilia]"	The cricketers is a child friendly coffee shop near café sicilia. it has a high customer rating.
"name[The Cricketers], eatType[coffee shop], customer rating[high], familyFriendly[yes], near[Express by Holiday Inn]"	The cricketers is a child friendly coffee shop near express by holiday inn. it has a high customer rating.
"name[The Cricketers], eatType[coffee shop], customer rating[low], familyFriendly[no], near[Express by Holiday Inn]"	The cricketers is a non-family-friendly coffee shop near express by holiday inn.
"name[The Cricketers], eatType[coffee shop], customer rating[low], familyFriendly[no], near[Ranch]"	The cricketers is a non-family-friendly coffee shop near ranch.
"name[The Cricketers], eatType[coffee shop], customer rating[low], familyFriendly[yes], near[Ranch]"	The cricketers is a family friendly coffee shop near ranch with a low customer rating.
"name[The Cricketers], eatType[restaurant], customer rating[1 out of 5], familyFriendly[yes], near[Avalon]"	The cricketers is a child friendly restaurant located near avalon.
"name[The Cricketers], eatType[restaurant], customer rating[3 out of 5], familyFriendly[yes], near[Avalon]"	The cricketers is a family friendly restaurant near avalon. it has a customer rating of 3 out of 5.
"name[The Cricketers], eatType[restaurant], customer rating[3 out of 5], familyFriendly[yes], near[Crowne Plaza Hotel]"	The cricketers is a family friendly restaurant near crowne plaza hotel. it has a customer rating of 3 out of 5.
"name[The Cricketers], eatType[restaurant], customer rating[5 out of 5], familyFriendly[no], near[Crowne Plaza Hotel]"	The cricketers is a non-family-friendly restaurant near crowne plaza hotel. it has a customer rating of 5 out of 5.
"name[The Cricketers], eatType[restaurant], customer rating[5 out of 5], familyFriendly[yes], near[Crowne Plaza Hotel]"	The cricketers is a family friendly restaurant near crowne plaza hotel with a customer rating of 5 out of 5.
"name[The Cricketers], eatType[restaurant], customer rating[average], familyFriendly[no], near[Café Sicilia]"	The cricketers is a family-friendly restaurant near café sicilia.
"name[The Cricketers], eatType[restaurant], customer rating[average], familyFriendly[no], near[Crowne Plaza Hotel]"	The cricketers is a family-friendly restaurant near crowne plaza hotel.
"name[The Cricketers], eatType[restaurant], customer rating[average], familyFriendly[yes], near[Café Sicilia]"	The cricketers is a family friendly restaurant located near café sicilia. it has an average customer rating.
"name[The Cricketers], eatType[restaurant], customer rating[high], familyFriendly[yes], near[Café Sicilia]"	The cricketers is a child friendly restaurant near café sicilia with a high customer rating.
"name[The Cricketers], eatType[restaurant], customer rating[high], familyFriendly[yes], near[Express by Holiday Inn]"	The cricketers is a child friendly restaurant near express by holiday inn with a high customer rating.
"name[The Cricketers], eatType[restaurant], customer rating[low], familyFriendly[no], near[Express by Holiday Inn]"	The cricketers is a low rated restaurant near express by holiday inn. it is not family-friendly.
"name[The Cricketers], eatType[restaurant], customer rating[low], familyFriendly[no], near[Ranch]"	The cricketers is a low rated restaurant near ranch. it is not family-friendly.
"name[The Cricketers], eatType[restaurant], customer rating[low], familyFriendly[yes], near[Ranch]"	The cricketers is a family friendly restaurant near ranch with a low customer rating.
"name[The Cricketers], eatType[restaurant], food[Chinese], priceRange[£20-25], customer rating[high], area[city centre], familyFriendly[no], near[All Bar One]"	The cricketers is a restaurant providing chinese food in the £20-25 price range. it is located in the city center. it is near all bar one.
"name[The Cricketers], eatType[restaurant], food[Chinese], priceRange[£20-25], customer rating[high], area[city centre], familyFriendly[yes], near[All Bar One]"	The cricketers is a kid friendly chinese restaurant located in the city centre near all bar one. it has a high customer rating and is kid friendly.
"name[The Cricketers], eatType[restaurant], food[Chinese], priceRange[£20-25], customer rating[high], area[riverside], familyFriendly[no], near[All Bar One]"	The cricketers is a moderately priced chinese restaurant located in the riverside area near all bar one.
"name[The Cricketers], eatType[restaurant], food[Chinese], priceRange[£20-25], customer rating[high], area[riverside], familyFriendly[yes], near[All Bar One]"	The cricketers is a restaurant providing chinese food in the £20-25 price range. it is located in riverside. it is near all bar one.
"name[The Cricketers], eatType[restaurant], food[Chinese], priceRange[cheap], customer rating[5 out of 5], area[city centre], familyFriendly[no], near[All Bar One]"	The cricketers is a cheap chinese restaurant in the city centre near all bar one. it has a customer rating of 5 out of 5.
"name[The Cricketers], eatType[restaurant], food[Chinese], priceRange[cheap], customer rating[5 out of 5], area[city centre], familyFriendly[yes], near[All Bar One]"	The cricketers is a cheap chinese restaurant located in the city centre near all bar one. it has a customer rating of 5 out of 5.
"name[The Cricketers], eatType[restaurant], food[Chinese], priceRange[cheap], customer rating[5 out of 5], area[riverside], familyFriendly[no], near[All Bar One]"	The cricketers is a cheap chinese restaurant located in the riverside area near all bar one. it has a customer rating of 5 out of 5.
"name[The Cricketers], eatType[restaurant], food[Chinese], priceRange[cheap], customer rating[5 out of 5], area[riverside], familyFriendly[yes], near[All Bar One]"	The cricketers is a cheap family friendly chinese restaurant with a customer rating of 5 out of 5. it is located near all bar one in the riverside area.
"name[The Cricketers], eatType[restaurant], food[Chinese], priceRange[cheap], customer rating[average], area[city centre], familyFriendly[no], near[All Bar One]"	The cricketers is a cheap chinese restaurant located in city centre near all bar one. it is not family friendly.
"name[The Cricketers], eatType[restaurant], food[Chinese], priceRange[cheap], customer rating[average], area[city centre], familyFriendly[yes], near[All Bar One]"	The cricketers is a cheap chinese restaurant located in the city centre near all bar one.
"name[The Cricketers], eatType[restaurant], food[Chinese], priceRange[cheap], customer rating[average], area[riverside], familyFriendly[no], near[All Bar One]"	The cricketers is a cheap chinese restaurant located in riverside near all bar one. it is not family friendly.
"name[The Cricketers], eatType[restaurant], food[Chinese], priceRange[cheap], customer rating[average], area[riverside], familyFriendly[yes], near[All Bar One]"	The cricketers is a family friendly chinese restaurant in the cheap price range. it is located in the riverside area near all bar one.
"name[The Cricketers], eatType[restaurant], food[Chinese], priceRange[high], customer rating[1 out of 5], area[city centre], familyFriendly[no], near[All Bar One]"	The cricketers is a chinese restaurant in the high price range. it is located in the city centre near all bar one.
"name[The Cricketers], eatType[restaurant], food[Chinese], priceRange[high], customer rating[1 out of 5], area[city centre], familyFriendly[yes], near[All Bar One]"	The cricketers is a child friendly chinese restaurant in the city centre. it is located near all bar one.
"name[The Cricketers], eatType[restaurant], food[Chinese], priceRange[high], customer rating[1 out of 5], area[riverside], familyFriendly[no], near[All Bar One]"	The cricketers is a high priced chinese restaurant located in the riverside area near all bar one.
"name[The Cricketers], eatType[restaurant], food[Chinese], priceRange[high], customer rating[1 out of 5], area[riverside], familyFriendly[yes], near[All Bar One]"	The cricketers is a child friendly chinese restaurant in the high price range. it is located in the riverside area near the all bar one.
"name[The Cricketers], eatType[restaurant], food[Chinese], priceRange[high], customer rating[average], area[city centre], familyFriendly[no], near[All Bar One]"	The cricketers is a chinese restaurant located in the city centre near all bar one. it has an average customer rating and is not child friendly.
"name[The Cricketers], eatType[restaurant], food[Chinese], priceRange[high], customer rating[average], area[city centre], familyFriendly[yes], near[All Bar One]"	The cricketers is a children friendly chinese restaurant in the high price range. it is located in the city centre near all bar one.
"name[The Cricketers], eatType[restaurant], food[Chinese], priceRange[high], customer rating[average], area[riverside], familyFriendly[no], near[All Bar One]"	The cricketers is a high priced chinese restaurant located in riverside near all bar one. it has an average customer rating and is not child friendly.
"name[The Cricketers], eatType[restaurant], food[Chinese], priceRange[high], customer rating[average], area[riverside], familyFriendly[yes], near[All Bar One]"	The cricketers is a family friendly chinese restaurant in the high price range. it is located in riverside near all bar one.
"name[The Cricketers], eatType[restaurant], food[Chinese], priceRange[less than £20], customer rating[low], area[city centre], familyFriendly[no], near[All Bar One]"	The cricketers is a restaurant providing chinese food in the less than £20 price range. it is located in the city centre. it is near all bar one.
"name[The Cricketers], eatType[restaurant], food[Chinese], priceRange[less than £20], customer rating[low], area[city centre], familyFriendly[yes], near[All Bar One]"	The cricketers is a family friendly chinese restaurant in the less than £20 price range. it is located near all bar one in the city centre.
"name[The Cricketers], eatType[restaurant], food[Chinese], priceRange[less than £20], customer rating[low], area[riverside], familyFriendly[no], near[All Bar One]"	The cricketers is a chinese restaurant in the less than £20 price range. it is located in the riverside area near all bar one.
"name[The Cricketers], eatType[restaurant], food[Chinese], priceRange[less than £20], customer rating[low], area[riverside], familyFriendly[yes], near[All Bar One]"	The cricketers is a family friendly chinese restaurant in the less than £20 price range. it is located near all bar one in the riverside area.
"name[The Cricketers], eatType[restaurant], food[Chinese], priceRange[moderate], customer rating[1 out of 5], area[city centre], familyFriendly[no], near[All Bar One]"	The cricketers is a moderately priced chinese restaurant located in the city centre near all bar one. it has a customer rating of 1 out of 5.
"name[The Cricketers], eatType[restaurant], food[Chinese], priceRange[moderate], customer rating[1 out of 5], area[city centre], familyFriendly[yes], near[All Bar One]"	The cricketers is a chinese restaurant in the moderate price range. it is located in the city centre. it is near all bar one.
"name[The Cricketers], eatType[restaurant], food[Chinese], priceRange[moderate], customer rating[1 out of 5], area[riverside], familyFriendly[no], near[All Bar One]"	The cricketers is a restaurant providing chinese food in the moderate price range. it is located in the riverside. it is near all bar one.
"name[The Cricketers], eatType[restaurant], food[Chinese], priceRange[moderate], customer rating[1 out of 5], area[riverside], familyFriendly[yes], near[All Bar One]"	The cricketers is a moderately priced chinese restaurant with a customer rating of 1 out of 5. it is located in the riverside area near all bar one.
"name[The Cricketers], eatType[restaurant], food[Chinese], priceRange[moderate], customer rating[3 out of 5], area[city centre], familyFriendly[no], near[All Bar One]"	The cricketers is a restaurant providing chinese food in the moderate price range. it is located in the city centre. it is near all bar one. its customer rating is 3 out of 5.
"name[The Cricketers], eatType[restaurant], food[Chinese], priceRange[moderate], customer rating[3 out of 5], area[city centre], familyFriendly[yes], near[All Bar One]"	The cricketers is a moderately priced chinese restaurant in the city centre near all bar one.
"name[The Cricketers], eatType[restaurant], food[Chinese], priceRange[moderate], customer rating[3 out of 5], area[riverside], familyFriendly[no], near[All Bar One]"	The cricketers is a moderately priced chinese restaurant in the riverside area near all bar one.
"name[The Cricketers], eatType[restaurant], food[Chinese], priceRange[moderate], customer rating[3 out of 5], area[riverside], familyFriendly[yes], near[All Bar One]"	The cricketers is a restaurant providing chinese food in the moderate price range. it is near all bar one.
"name[The Cricketers], eatType[restaurant], food[Chinese], priceRange[more than £30], customer rating[high], area[city centre], familyFriendly[no], near[All Bar One]"	The cricketers is a restaurant providing chinese food in the more than £30 price range. it is located in the city centre and is near all bar one.
"name[The Cricketers], eatType[restaurant], food[Chinese], priceRange[more than £30], customer rating[high], area[city centre], familyFriendly[yes], near[All Bar One]"	The cricketers is a chinese restaurant in the more than £30 price range. it is located in the city centre, near all bar one.
"name[The Cricketers], eatType[restaurant], food[Chinese], priceRange[more than £30], customer rating[high], area[riverside], familyFriendly[no], near[All Bar One]"	The cricketers is a restaurant providing chinese food in the more than £30 price range. it is located in riverside near all bar one.
"name[The Cricketers], eatType[restaurant], food[Chinese], priceRange[more than £30], customer rating[high], area[riverside], familyFriendly[yes], near[All Bar One]"	The cricketers is a children friendly chinese restaurant in the more than £30 price range. it is located in the riverside area near all bar one.
"name[The Cricketers], eatType[restaurant], food[English], priceRange[£20-25], customer rating[high], area[city centre], familyFriendly[no], near[All Bar One]"	The cricketers is a restaurant providing english food in the £20-25 price range. it is located in the city centre. it is near all bar one.
"name[The Cricketers], eatType[restaurant], food[English], priceRange[£20-25], customer rating[high], area[city centre], familyFriendly[yes], near[All Bar One]"	The cricketers is a family-friendly english restaurant located in the city centre near all bar one. it has a high customer rating and a price range of £20-25.
"name[The Cricketers], eatType[restaurant], food[English], priceRange[£20-25], customer rating[high], area[riverside], familyFriendly[no], near[All Bar One]"	The cricketers is a moderately priced english restaurant near all bar one.
"name[The Cricketers], eatType[restaurant], food[English], priceRange[£20-25], customer rating[high], area[riverside], familyFriendly[yes], near[All Bar One]"	The cricketers is a family friendly english restaurant located near all bar one.
"name[The Cricketers], eatType[restaurant], food[English], priceRange[cheap], customer rating[5 out of 5], area[city centre], familyFriendly[no], near[Café Rouge]"	The cricketers is a cheap english restaurant near café rouge in the city centre. it has a customer rating of 5 out of 5.
"name[The Cricketers], eatType[restaurant], food[English], priceRange[cheap], customer rating[5 out of 5], area[city centre], familyFriendly[yes], near[Café Rouge]"	The cricketers is a cheap family-friendly english restaurant located in the city centre near café rouge.
"name[The Cricketers], eatType[restaurant], food[English], priceRange[cheap], customer rating[5 out of 5], area[riverside], familyFriendly[no], near[Café Rouge]"	The cricketers is a cheap english restaurant located in riverside near café rouge. it has a customer rating of 5 out of 5.
"name[The Cricketers], eatType[restaurant], food[English], priceRange[cheap], customer rating[5 out of 5], area[riverside], familyFriendly[yes], near[Café Rouge]"	The cricketers is a cheap, family friendly restaurant located near café rouge.
"name[The Cricketers], eatType[restaurant], food[English], priceRange[cheap], customer rating[average], area[city centre], familyFriendly[no], near[Café Rouge]"	The cricketers is a cheap english restaurant located in the city centre near café rouge. it has an average customer rating.
"name[The Cricketers], eatType[restaurant], food[English], priceRange[cheap], customer rating[average], area[city centre], familyFriendly[yes], near[Café Rouge]"	The cricketers is a cheap family-friendly english restaurant located in the city centre near café rouge.
"name[The Cricketers], eatType[restaurant], food[English], priceRange[cheap], customer rating[average], area[riverside], familyFriendly[no], near[Café Rouge]"	The cricketers is a cheap english restaurant near café rouge in the riverside area. it is not family-friendly.
"name[The Cricketers], eatType[restaurant], food[English], priceRange[cheap], customer rating[average], area[riverside], familyFriendly[yes], near[Café Rouge]"	The cricketers is a cheap, family friendly restaurant near café rouge.
"name[The Cricketers], eatType[restaurant], food[English], priceRange[high], customer rating[1 out of 5], area[city centre], familyFriendly[no], near[Café Rouge]"	The cricketers is a high priced english restaurant located in the city centre near café rouge. it has a customer rating of 1 out of 5.
"name[The Cricketers], eatType[restaurant], food[English], priceRange[high], customer rating[1 out of 5], area[city centre], familyFriendly[yes], near[Café Rouge]"	The cricketers is a children friendly english restaurant in the high price range. it is located in the city centre near the café rouge.
"name[The Cricketers], eatType[restaurant], food[English], priceRange[high], customer rating[1 out of 5], area[riverside], familyFriendly[no], near[Café Rouge]"	The cricketers is a high priced english restaurant located near café rouge.
"name[The Cricketers], eatType[restaurant], food[English], priceRange[high], customer rating[1 out of 5], area[riverside], familyFriendly[yes], near[Café Rouge]"	The cricketers is an expensive english restaurant located near café rouge.
"name[The Cricketers], eatType[restaurant], food[English], priceRange[high], customer rating[average], area[city centre], familyFriendly[no], near[Café Rouge]"	The cricketers is an expensive english restaurant located in the city centre near café rouge. it has an average customer rating and is not child friendly.
"name[The Cricketers], eatType[restaurant], food[English], priceRange[high], customer rating[average], area[city centre], familyFriendly[yes], near[Café Rouge]"	The cricketers is an english restaurant located in the city centre near café rouge. it is children friendly and has an average customer rating.
"name[The Cricketers], eatType[restaurant], food[English], priceRange[high], customer rating[average], area[riverside], familyFriendly[no], near[Café Rouge]"	The cricketers is a high priced english restaurant located in the riverside area near café rouge.
"name[The Mill], eatType[pub], food[English], priceRange[high], area[riverside], familyFriendly[yes], near[Raja Indian Cuisine]"	The mill is a child friendly pub located in the riverside area near raja indian cuisine. it serves english food in the high price range.
"name[The Mill], eatType[pub], food[English], priceRange[less than £20], area[city centre], familyFriendly[no], near[Raja Indian Cuisine]"	The mill is a family-friendly pub located in the city centre near raja indian cuisine. it serves english food for less than £20.
"name[The Mill], eatType[pub], food[English], priceRange[less than £20], area[city centre], familyFriendly[yes], near[Raja Indian Cuisine]"	The mill is a family-friendly pub located in the city centre near raja indian cuisine. it serves english food for less than £20.
"name[The Mill], eatType[pub], food[English], priceRange[less than £20], area[riverside], familyFriendly[no], near[Raja Indian Cuisine]"	The mill is a low-priced pub located near raja indian cuisine.
"name[The Mill], eatType[pub], food[English], priceRange[less than £20], area[riverside], familyFriendly[yes], near[Raja Indian Cuisine]"	The mill is a family-friendly pub located near raja indian cuisine.
"name[The Mill], eatType[pub], food[English], priceRange[moderate], area[city centre], familyFriendly[no], near[Raja Indian Cuisine]"	The mill is a moderately priced english pub located in the city centre near raja indian cuisine.
"name[The Mill], eatType[pub], food[English], priceRange[moderate], area[city centre], familyFriendly[yes], near[Raja Indian Cuisine]"	The mill is a moderately priced english pub in the city centre near raja indian cuisine. it is kids friendly.
"name[The Mill], eatType[pub], food[English], priceRange[moderate], area[riverside], familyFriendly[no], near[Raja Indian Cuisine]"	The mill is a moderately priced english pub located near raja indian cuisine.
"name[The Mill], eatType[pub], food[English], priceRange[moderate], area[riverside], familyFriendly[yes], near[Raja Indian Cuisine]"	The mill is a moderately priced, kid friendly pub near raja indian cuisine.
"name[The Mill], eatType[pub], food[English], priceRange[more than £30], area[riverside], familyFriendly[yes], near[Raja Indian Cuisine]"	The mill is a children friendly pub near raja indian cuisine.
"name[The Mill], eatType[pub], food[Fast food], priceRange[£20-25], area[riverside], familyFriendly[yes], near[Raja Indian Cuisine]"	The mill is a kid friendly fast food pub located near raja indian cuisine in the riverside area.
"name[The Mill], eatType[pub], food[Fast food], priceRange[£20-25], customer rating[high], area[city centre], familyFriendly[no], near[Café Rouge]"	The mill is a fast food pub located in the city centre near café rouge. it has a high customer rating and a price range of £20-25.
"name[The Mill], eatType[pub], food[Fast food], priceRange[£20-25], customer rating[high], area[city centre], familyFriendly[yes], near[Café Rouge]"	The mill is a fast food pub in the city centre near café rouge. it has a high customer rating and is kid friendly.
"name[The Mill], eatType[pub], food[Fast food], priceRange[£20-25], customer rating[high], area[riverside], familyFriendly[no], near[Café Rouge]"	The mill is a fast food pub near café rouge.
"name[The Mill], eatType[pub], food[Fast food], priceRange[£20-25], customer rating[high], area[riverside], familyFriendly[yes], near[Café Rouge]"	The mill is a kid friendly fast food pub near café rouge.
"name[The Mill], eatType[pub], food[Fast food], priceRange[£20-25], customer rating[high], area[riverside], familyFriendly[yes], near[Café Sicilia]"	The mill is a kid friendly fast food pub near café sicilia.
"name[The Mill], eatType[pub], food[Fast food], priceRange[cheap], area[riverside], familyFriendly[yes], near[Raja Indian Cuisine]"	The mill is a cheap fast food pub near raja indian cuisine in the riverside area. it is family friendly.
"name[The Mill], eatType[pub], food[Fast food], priceRange[cheap], customer rating[5 out of 5], area[city centre], familyFriendly[no], near[Café Sicilia]"	The mill is a cheap fast food pub located in the city centre near café sicilia. it has a customer rating of 5 out of 5.
"name[The Mill], eatType[pub], food[Fast food], priceRange[cheap], customer rating[5 out of 5], area[city centre], familyFriendly[yes], near[Café Sicilia]"	The mill is a cheap, family-friendly fast food pub in the city centre near café sicilia with a customer rating of 5 out of 5.
"name[The Mill], eatType[pub], food[Fast food], priceRange[cheap], customer rating[5 out of 5], area[riverside], familyFriendly[no], near[Café Sicilia]"	The mill is a cheap fast food pub located in the riverside area near café sicilia. it has a customer rating of 5 out of 5.
"name[The Mill], eatType[pub], food[Fast food], priceRange[cheap], customer rating[5 out of 5], area[riverside], familyFriendly[yes], near[Café Sicilia]"	The mill is a cheap, family friendly pub located near the café sicilia.
"name[The Mill], eatType[pub], food[Fast food], priceRange[cheap], customer rating[average], area[city centre], familyFriendly[no], near[Café Sicilia]"	The mill is a cheap fast food pub in the city centre near café sicilia. it is not family-friendly and has an average customer rating.
"name[The Mill], eatType[pub], food[Fast food], priceRange[cheap], customer rating[average], area[city centre], familyFriendly[yes], near[Café Sicilia]"	The mill is a cheap family-friendly fast food pub in the city centre near café sicilia.
"name[The Mill], eatType[pub], food[Fast food], priceRange[cheap], customer rating[average], area[riverside], familyFriendly[no], near[Café Sicilia]"	The mill is a cheap fast food pub near café sicilia in the riverside area. it is not family-friendly.
"name[The Mill], eatType[pub], food[Fast food], priceRange[cheap], customer rating[average], area[riverside], familyFriendly[yes], near[Café Sicilia]"	The mill is a cheap, family friendly pub near café sicilia.
"name[The Mill], eatType[pub], food[Fast food], priceRange[high], customer rating[1 out of 5], area[city centre], familyFriendly[no], near[Café Sicilia]"	The mill is a high priced fast food pub in the city centre near café sicilia. it has a customer rating of 1 out of 5 and is not child friendly.
"name[The Mill], eatType[pub], food[Fast food], priceRange[high], customer rating[1 out of 5], area[city centre], familyFriendly[yes], near[Café Sicilia]"	The mill is a child friendly fast food pub in the city centre. it is located near café sicilia.
"name[The Mill], eatType[pub], food[Fast food], priceRange[high], customer rating[1 out of 5], area[riverside], familyFriendly[no], near[Café Sicilia]"	The mill is a high priced fast food pub located near café sicilia.
"name[The Mill], eatType[pub], food[Fast food], priceRange[high], customer rating[1 out of 5], area[riverside], familyFriendly[yes], near[Café Sicilia]"	The mill is a children friendly pub located near café sicilia.
"name[The Mill], eatType[pub], food[Fast food], priceRange[high], customer rating[average], area[city centre], familyFriendly[no], near[Café Sicilia]"	The mill is a high priced fast food pub located in the city centre near café sicilia. it has an average customer rating and is not family-friendly.
"name[The Mill], eatType[pub], food[Fast food], priceRange[high], customer rating[average], area[city centre], familyFriendly[yes], near[Café Sicilia]"	The mill is a family-friendly fast food pub in the city centre near café sicilia. it has an average customer rating and a high price range.
"name[The Mill], eatType[pub], food[Fast food], priceRange[high], customer rating[average], area[riverside], familyFriendly[no], near[Café Sicilia]"	The mill is a high priced fast food pub located near café sicilia.
"name[The Mill], eatType[pub], food[Fast food], priceRange[high], customer rating[average], area[riverside], familyFriendly[yes], near[Café Sicilia]"	The mill is a child friendly fast food pub near café sicilia in the riverside area.
"name[The Mill], eatType[pub], food[Fast food], priceRange[less than £20], customer rating[low], area[city centre], familyFriendly[no], near[Café Sicilia]"	The mill is a fast food pub near café sicilia in the city centre. it is not family-friendly and has a low customer rating.
"name[The Mill], eatType[pub], food[Fast food], priceRange[less than £20], customer rating[low], area[city centre], familyFriendly[yes], near[Café Sicilia]"	The mill is a family-friendly fast food pub in the city centre near café sicilia. it has a low customer rating and a price range of less than £20.
"name[The Mill], eatType[pub], food[Fast food], priceRange[less than £20], customer rating[low], area[riverside], familyFriendly[no], near[Café Sicilia]"	The mill is a low-priced pub located near café sicilia.
"name[The Mill], eatType[pub], food[Fast food], priceRange[less than £20], customer rating[low], area[riverside], familyFriendly[yes], near[Café Sicilia]"	The mill is a family-friendly pub located near café sicilia.
"name[The Mill], eatType[pub], food[Fast food], priceRange[moderate], customer rating[1 out of 5], area[city centre], familyFriendly[no], near[Café Sicilia]"	The mill is a moderately priced fast food pub in the city centre near café sicilia. it has a customer rating of 1 out of 5.
"name[The Mill], eatType[pub], food[Fast food], priceRange[moderate], customer rating[1 out of 5], area[city centre], familyFriendly[yes], near[Café Sicilia]"	The mill is a kid friendly fast food pub near café sicilia in the city centre. it has a moderate price range and a customer rating of 1 out of 5.
"name[The Mill], eatType[pub], food[Fast food], priceRange[moderate], customer rating[1 out of 5], area[riverside], familyFriendly[no], near[Café Sicilia]"	The mill is a moderately priced fast food pub located near café sicilia.
"name[The Mill], eatType[pub], food[Fast food], priceRange[moderate], customer rating[1 out of 5], area[riverside], familyFriendly[yes], near[Café Sicilia]"	The mill is a moderately priced pub near café sicilia.
"name[The Mill], eatType[pub], food[Fast food], priceRange[moderate], customer rating[3 out of 5], area[city centre], familyFriendly[no], near[Café Sicilia]"	The mill is a moderately priced fast food pub located near café sicilia in the city centre. it has a customer rating of 3 out of 5.
"name[The Mill], eatType[pub], food[Fast food], priceRange[moderate], customer rating[3 out of 5], area[city centre], familyFriendly[yes], near[Café Sicilia]"	The mill is a kid friendly fast food pub in the city centre near café sicilia. it has a moderate price range and a customer rating of 3 out of 5.
"name[The Mill], eatType[pub], food[Fast food], priceRange[moderate], customer rating[3 out of 5], area[riverside], familyFriendly[no], near[Café Sicilia]"	The mill is a fast food pub located near café sicilia.
"name[The Mill], eatType[pub], food[Fast food], priceRange[moderate], customer rating[3 out of 5], area[riverside], familyFriendly[yes], near[Café Sicilia]"	The mill is a moderately priced fast food pub located near café sicilia.
"name[The Mill], eatType[restaurant], food[English], priceRange[high], area[riverside], familyFriendly[yes], near[Raja Indian Cuisine]"	The mill is a child friendly english restaurant in the high price range. it is located in the riverside area near raja indian cuisine.
"name[The Mill], eatType[restaurant], food[English], priceRange[high], customer rating[average], area[riverside], familyFriendly[yes], near[Café Rouge]"	The mill is a family friendly restaurant located near the café rouge.
"name[The Mill], eatType[restaurant], food[English], priceRange[less than £20], area[city centre], familyFriendly[no], near[Raja Indian Cuisine]"	The mill is a non family-friendly restaurant located in the city centre near raja indian cuisine.
"name[The Mill], eatType[restaurant], food[English], priceRange[less than £20], area[city centre], familyFriendly[yes], near[Raja Indian Cuisine]"	The mill is a family-friendly restaurant serving english food in the less than £20 price range. it is located in the city centre near raja indian cuisine.
"name[The Mill], eatType[restaurant], food[English], priceRange[less than £20], area[riverside], familyFriendly[no], near[Raja Indian Cuisine]"	The mill is a low-priced restaurant near raja indian cuisine.
"name[The Mill], eatType[restaurant], food[English], priceRange[less than £20], area[riverside], familyFriendly[yes], near[Raja Indian Cuisine]"	The mill is a family friendly english restaurant located near raja indian cuisine.
"name[The Mill], eatType[restaurant], food[English], priceRange[less than £20], customer rating[low], area[city centre], familyFriendly[no], near[Café Rouge]"	The mill is a cheap english restaurant located in the city centre near café rouge. it has a low customer rating.
"name[The Mill], eatType[restaurant], food[English], priceRange[less than £20], customer rating[low], area[city centre], familyFriendly[yes], near[Café Rouge]"	The mill is a family-friendly restaurant serving english food in the low price range. it is located in the city centre near café rouge.
"name[The Mill], eatType[restaurant], food[English], priceRange[less than £20], customer rating[low], area[riverside], familyFriendly[no], near[Café Rouge]"	The mill is a low priced restaurant located near café rouge.
"name[The Mill], eatType[restaurant], food[English], priceRange[less than £20], customer rating[low], area[riverside], familyFriendly[yes], near[Café Rouge]"	The mill is a family friendly restaurant located near the café rouge.
"name[The Mill], eatType[restaurant], food[English], priceRange[moderate], area[city centre], familyFriendly[no], near[Raja Indian Cuisine]"	The mill is a moderately priced english restaurant located near raja indian cuisine in the city centre.
"name[The Mill], eatType[restaurant], food[English], priceRange[moderate], area[city centre], familyFriendly[yes], near[Raja Indian Cuisine]"	The mill is a moderately priced english restaurant located in the city centre near raja indian cuisine.
"name[The Mill], eatType[restaurant], food[English], priceRange[moderate], area[riverside], familyFriendly[no], near[Raja Indian Cuisine]"	The mill is a moderately priced english restaurant near raja indian cuisine in the riverside area.
"name[The Mill], eatType[restaurant], food[English], priceRange[moderate], area[riverside], familyFriendly[yes], near[Raja Indian Cuisine]"	The mill is a moderately priced english restaurant located near raja indian cuisine.
"name[The Mill], eatType[restaurant], food[English], priceRange[moderate], customer rating[1 out of 5], area[city centre], familyFriendly[no], near[Café Rouge]"	The mill is a moderately priced english restaurant located in the city centre near café rouge. it has a customer rating of 1 out of 5.
"name[The Mill], eatType[restaurant], food[English], priceRange[moderate], customer rating[1 out of 5], area[city centre], familyFriendly[yes], near[Café Rouge]"	The mill is a moderately priced english restaurant in the city centre near café rouge.
"name[The Mill], eatType[restaurant], food[English], priceRange[moderate], customer rating[1 out of 5], area[riverside], familyFriendly[no], near[Café Rouge]"	The mill is a moderately priced restaurant located near the café rouge.
"name[The Mill], eatType[restaurant], food[English], priceRange[moderate], customer rating[1 out of 5], area[riverside], familyFriendly[yes], near[Café Rouge]"	The mill is a moderately priced restaurant located near café rouge.
"name[The Mill], eatType[restaurant], food[English], priceRange[moderate], customer rating[3 out of 5], area[city centre], familyFriendly[no], near[Café Rouge]"	The mill is a moderately priced english restaurant located in the city centre near café rouge.
"name[The Mill], eatType[restaurant], food[English], priceRange[moderate], customer rating[3 out of 5], area[city centre], familyFriendly[yes], near[Café Rouge]"	The mill is a moderately priced english restaurant in the city centre near café rouge.
"name[The Mill], eatType[restaurant], food[English], priceRange[moderate], customer rating[3 out of 5], area[riverside], familyFriendly[no], near[Café Rouge]"	The mill is a moderately priced restaurant located near the café rouge.
"name[The Mill], eatType[restaurant], food[English], priceRange[moderate], customer rating[3 out of 5], area[riverside], familyFriendly[yes], near[Café Rouge]"	The mill is a moderately priced english restaurant located near café rouge.
"name[The Mill], eatType[restaurant], food[English], priceRange[more than £30], area[riverside], familyFriendly[yes], near[Raja Indian Cuisine]"	The mill is a children friendly english restaurant near raja indian cuisine in the riverside area. the price range is more than £30.
"name[The Mill], eatType[restaurant], food[English], priceRange[more than £30], customer rating[high], area[city centre], familyFriendly[no], near[Café Rouge]"	The mill is an expensive english restaurant located near café rouge in the city centre. it is not child friendly.
"name[The Mill], eatType[restaurant], food[English], priceRange[more than £30], customer rating[high], area[city centre], familyFriendly[yes], near[Café Rouge]"	The mill is a child friendly english restaurant in the more than £30 price range. it is located near café rouge in the city centre.
"name[The Mill], eatType[restaurant], food[English], priceRange[more than £30], customer rating[high], area[riverside], familyFriendly[no], near[Café Rouge]"	The mill is a high-priced english restaurant located near café rouge.
"name[The Mill], eatType[restaurant], food[English], priceRange[more than £30], customer rating[high], area[riverside], familyFriendly[yes], near[Café Rouge]"	The mill is an expensive english restaurant located near café rouge.
"name[The Mill], eatType[restaurant], food[Fast food], priceRange[£20-25], area[riverside], familyFriendly[yes], near[Raja Indian Cuisine]"	The mill is a kid friendly fast food restaurant located near raja indian cuisine.
"name[The Mill], eatType[restaurant], food[Fast food], priceRange[cheap], area[riverside], familyFriendly[yes], near[Raja Indian Cuisine]"	The mill is a family friendly fast food restaurant in the cheap price range. it is located in the riverside area near raja indian cuisine.
"name[The Phoenix], eatType[pub], food[Fast food], priceRange[cheap], area[riverside], familyFriendly[yes], near[Raja Indian Cuisine]"	The phoenix is a cheap fast food pub near raja indian cuisine in the riverside area. it is family friendly.
"name[The Phoenix], eatType[pub], food[Fast food], priceRange[high], area[city centre], familyFriendly[no], near[Raja Indian Cuisine]"	The phoenix is a high priced fast food pub in the city centre near raja indian cuisine.
"name[The Phoenix], eatType[pub], food[Fast food], priceRange[high], area[city centre], familyFriendly[yes], near[Raja Indian Cuisine]"	The phoenix is a family-friendly fast food pub in the city centre near raja indian cuisine.
"name[The Phoenix], eatType[pub], food[Fast food], priceRange[high], area[riverside], familyFriendly[no], near[Raja Indian Cuisine]"	The phoenix is a high priced fast food pub near raja indian cuisine in the riverside area. it is not child friendly.
"name[The Phoenix], eatType[pub], food[Fast food], priceRange[high], area[riverside], familyFriendly[yes], near[Raja Indian Cuisine]"	The phoenix is a children friendly fast food pub in the riverside area near raja indian cuisine.
"name[The Phoenix], eatType[pub], food[Fast food], priceRange[less than £20], area[city centre], familyFriendly[no], near[Raja Indian Cuisine]"	The phoenix is a fast food pub located near raja indian cuisine in the city centre. it is not family-friendly and has a price range of less than £20.
"name[The Phoenix], eatType[pub], food[Fast food], priceRange[less than £20], area[city centre], familyFriendly[yes], near[Raja Indian Cuisine]"	The phoenix is a family-friendly fast food pub in the city centre near raja indian cuisine. it has a price range of less than £20.
"name[The Phoenix], eatType[pub], food[Fast food], priceRange[less than £20], area[riverside], familyFriendly[no], near[Raja Indian Cuisine]"	The phoenix is a cheap fast food pub near raja indian cuisine in the riverside area.
"name[The Phoenix], eatType[pub], food[Fast food], priceRange[less than £20], area[riverside], familyFriendly[yes], near[Raja Indian Cuisine]"	The phoenix is a family friendly fast food pub near raja indian cuisine.
"name[The Phoenix], eatType[pub], food[Fast food], priceRange[moderate], area[city centre], familyFriendly[no], near[Raja Indian Cuisine]"	The phoenix is a moderately priced fast food pub located near raja indian cuisine in the city centre.
"name[The Phoenix], eatType[pub], food[Fast food], priceRange[moderate], area[city centre], familyFriendly[yes], near[Raja Indian Cuisine]"	The phoenix is a moderately priced fast food pub in the city centre near raja indian cuisine. it is kid friendly.
"name[The Phoenix], eatType[pub], food[Fast food], priceRange[moderate], area[riverside], familyFriendly[no], near[Raja Indian Cuisine]"	The phoenix is a moderately priced fast food pub near raja indian cuisine in the riverside area.
"name[The Phoenix], eatType[pub], food[Fast food], priceRange[moderate], area[riverside], familyFriendly[yes], near[Raja Indian Cuisine]"	The phoenix is a kid friendly fast food pub in the riverside area near raja indian cuisine.
"name[The Phoenix], eatType[pub], food[Fast food], priceRange[moderate], customer rating[3 out of 5], area[riverside], familyFriendly[yes], near[Café Sicilia]"	The phoenix is a moderately priced fast food pub located near café sicilia.
"name[The Phoenix], eatType[pub], food[Fast food], priceRange[more than £30], area[riverside], familyFriendly[yes], near[Raja Indian Cuisine]"	The phoenix is a child friendly fast food pub near raja indian cuisine in the riverside area. the price range is more than £30.
"name[The Phoenix], eatType[pub], food[Fast food], priceRange[more than £30], customer rating[high], area[city centre], familyFriendly[no], near[Café Sicilia]"	The phoenix is a fast food pub located in the city centre near café sicilia. it has a high customer rating and is not children friendly.
"name[The Phoenix], eatType[pub], food[Fast food], priceRange[more than £30], customer rating[high], area[city centre], familyFriendly[yes], near[Café Sicilia]"	The phoenix is a children friendly fast food pub near café sicilia in the city centre. it has a high customer rating and a price range of more than £30.
"name[The Phoenix], eatType[pub], food[Fast food], priceRange[more than £30], customer rating[high], area[riverside], familyFriendly[no], near[Café Sicilia]"	The phoenix is a fast food pub in the riverside area near café sicilia. it has a high customer rating and is not child friendly.
"name[The Phoenix], eatType[pub], food[Fast food], priceRange[more than £30], customer rating[high], area[riverside], familyFriendly[yes], near[Café Sicilia]"	The phoenix is a children friendly fast food pub near café sicilia in the riverside area. the price range is more than £30.
"name[The Phoenix], eatType[pub], food[French], priceRange[£20-25], area[riverside], familyFriendly[yes], near[Raja Indian Cuisine]"	The phoenix is a kid friendly french pub located near raja indian cuisine in the riverside area.
"name[The Phoenix], eatType[pub], food[French], priceRange[£20-25], customer rating[3 out of 5], area[city centre], familyFriendly[no], near[Café Sicilia]"	The phoenix is a french pub located in the city centre near café sicilia. it is not kid friendly and has a customer rating of 3 out of 5.
"name[The Phoenix], eatType[pub], food[French], priceRange[£20-25], customer rating[3 out of 5], area[city centre], familyFriendly[yes], near[Café Sicilia]"	The phoenix is a kid friendly french pub in the city centre near café sicilia. it has a customer rating of 3 out of 5.
"name[The Phoenix], eatType[pub], food[French], priceRange[£20-25], customer rating[3 out of 5], area[riverside], familyFriendly[no], near[Café Sicilia]"	The phoenix is a french pub near café sicilia in the riverside area. it has a customer rating of 3 out of 5 and is not kid friendly.
"name[The Phoenix], eatType[pub], food[French], priceRange[£20-25], customer rating[3 out of 5], area[riverside], familyFriendly[yes], near[Café Sicilia]"	The phoenix is a kid-friendly french pub near café sicilia.
"name[The Phoenix], eatType[pub], food[French], priceRange[£20-25], customer rating[3 out of 5], area[riverside], familyFriendly[yes], near[Crowne Plaza Hotel]"	The phoenix is a kid-friendly french pub near crowne plaza hotel.
"name[The Phoenix], eatType[pub], food[French], priceRange[£20-25], customer rating[high], area[city centre], familyFriendly[no], near[Crowne Plaza Hotel]"	The phoenix is a french pub near crowne plaza hotel in the city centre. it has a high customer rating and is not kid friendly.
"name[The Phoenix], eatType[pub], food[French], priceRange[£20-25], customer rating[high], area[city centre], familyFriendly[yes], near[Crowne Plaza Hotel]"	The phoenix is a kid friendly french pub in the city centre near crowne plaza hotel with a high customer rating and a price range of £20-25.
"name[The Phoenix], eatType[pub], food[French], priceRange[£20-25], customer rating[high], area[riverside], familyFriendly[no], near[Crowne Plaza Hotel]"	The phoenix is a french pub in the riverside area near crowne plaza hotel. it has a price range of £20-25 and is not kid friendly.
"name[The Phoenix], eatType[pub], food[French], priceRange[£20-25], customer rating[high], area[riverside], familyFriendly[yes], near[Crowne Plaza Hotel]"	The phoenix is a kid friendly french pub located near crowne plaza hotel.
"name[The Phoenix], eatType[pub], food[French], priceRange[cheap], area[riverside], familyFriendly[yes], near[Raja Indian Cuisine]"	The phoenix is a cheap, family friendly pub located near raja indian cuisine.
"name[The Phoenix], eatType[pub], food[French], priceRange[cheap], customer rating[5 out of 5], area[city centre], familyFriendly[no], near[Crowne Plaza Hotel]"	The phoenix is a cheap french pub located near crowne plaza hotel in the city centre. it has a customer rating of 5 out of 5.
"name[The Phoenix], eatType[pub], food[French], priceRange[cheap], customer rating[5 out of 5], area[city centre], familyFriendly[yes], near[Crowne Plaza Hotel]"	The phoenix is a cheap, family-friendly french pub in the city centre near crowne plaza hotel with a customer rating of 5 out of 5.
"name[The Phoenix], eatType[pub], food[French], priceRange[cheap], customer rating[5 out of 5], area[riverside], familyFriendly[no], near[Crowne Plaza Hotel]"	The phoenix is a cheap french pub near crowne plaza hotel in the riverside area. it has a customer rating of 5 out of 5.
"name[The Phoenix], eatType[pub], food[French], priceRange[cheap], customer rating[5 out of 5], area[riverside], familyFriendly[yes], near[Crowne Plaza Hotel]"	The phoenix is a cheap, family friendly pub near crowne plaza hotel.
"name[The Phoenix], eatType[pub], food[French], priceRange[high], area[riverside], familyFriendly[yes], near[Raja Indian Cuisine]"	The phoenix is a children friendly french pub near raja indian cuisine in the riverside area.
"name[The Phoenix], eatType[pub], food[French], priceRange[high], customer rating[3 out of 5], area[city centre], familyFriendly[no], near[Crowne Plaza Hotel]"	The phoenix is a high priced french pub in the city centre near crowne plaza hotel. it has a customer rating of 3 out of 5.
"name[The Phoenix], eatType[pub], food[French], priceRange[high], customer rating[3 out of 5], area[city centre], familyFriendly[yes], near[Crowne Plaza Hotel]"	The phoenix is a children friendly french pub in the city centre near crowne plaza hotel. it has a high price range and a customer rating of 3 out of 5.
"name[The Phoenix], eatType[pub], food[French], priceRange[high], customer rating[3 out of 5], area[riverside], familyFriendly[no], near[Crowne Plaza Hotel]"	The phoenix is a high priced french pub located near crowne plaza hotel in the riverside area.
"name[The Phoenix], eatType[pub], food[French], priceRange[high], customer rating[3 out of 5], area[riverside], familyFriendly[yes], near[Crowne Plaza Hotel]"	The phoenix is a family friendly pub located near crowne plaza hotel.
"name[The Phoenix], eatType[pub], food[French], priceRange[less than £20], customer rating[average], area[city centre], familyFriendly[no], near[Crowne Plaza Hotel]"	The phoenix is a french pub near crowne plaza hotel in the city centre. it is not family-friendly and has an average customer rating.
"name[The Phoenix], eatType[pub], food[French], priceRange[less than £20], customer rating[average], area[city centre], familyFriendly[yes], near[Crowne Plaza Hotel]"	The phoenix is a family-friendly pub located in the city centre near crowne plaza hotel. it serves french food for less than £20.
"name[The Phoenix], eatType[pub], food[French], priceRange[less than £20], customer rating[average], area[riverside], familyFriendly[no], near[Crowne Plaza Hotel]"	The phoenix is a low-priced pub near crowne plaza hotel.
"name[The Phoenix], eatType[pub], food[French], priceRange[less than £20], customer rating[average], area[riverside], familyFriendly[yes], near[Crowne Plaza Hotel]"	The phoenix is a family-friendly pub located near crowne plaza hotel.
"name[The Phoenix], eatType[pub], food[French], priceRange[less than £20], customer rating[low], area[city centre], familyFriendly[no], near[Crowne Plaza Hotel]"	The phoenix is a french pub located in the city centre near crowne plaza hotel. it has a low customer rating and is not family-friendly.
"name[The Phoenix], eatType[pub], food[French], priceRange[less than £20], customer rating[low], area[city centre], familyFriendly[yes], near[Crowne Plaza Hotel]"	The phoenix is a family-friendly pub located in the city centre near crowne plaza hotel. it serves french food for less than £20.
"name[The Phoenix], eatType[pub], food[French], priceRange[less than £20], customer rating[low], area[riverside], familyFriendly[no], near[Crowne Plaza Hotel]"	The phoenix is a low priced pub located near crowne plaza hotel.
"name[The Phoenix], eatType[pub], food[French], priceRange[less than £20], customer rating[low], area[riverside], familyFriendly[yes], near[Crowne Plaza Hotel]"	The phoenix is a family-friendly pub located near crowne plaza hotel.
"name[The Phoenix], eatType[pub], food[French], priceRange[moderate], customer rating[1 out of 5], area[city centre], familyFriendly[no], near[Crowne Plaza Hotel]"	The phoenix is a moderately priced french pub near crowne plaza hotel in the city centre. it has a customer rating of 1 out of 5.
"name[The Phoenix], eatType[pub], food[French], priceRange[moderate], customer rating[1 out of 5], area[city centre], familyFriendly[yes], near[Crowne Plaza Hotel]"	The phoenix is a kid friendly french pub located near crowne plaza hotel in the city centre. it has a moderate price range and a customer rating of 1 out of 5.
"name[The Phoenix], eatType[pub], food[French], priceRange[moderate], customer rating[1 out of 5], area[riverside], familyFriendly[no], near[Crowne Plaza Hotel]"	The phoenix is a french pub located near crowne plaza hotel in the riverside area.
"name[The Phoenix], eatType[pub], food[French], priceRange[moderate], customer rating[1 out of 5], area[riverside], familyFriendly[yes], near[Crowne Plaza Hotel]"	The phoenix is a kid friendly pub located near the crowne plaza hotel.
"name[The Phoenix], eatType[pub], food[French], priceRange[more than £30], customer rating[5 out of 5], area[city centre], familyFriendly[no], near[Crowne Plaza Hotel]"	The phoenix is a french pub located in the city centre near crowne plaza hotel. it has a customer rating of 5 out of 5 and is not child friendly.
"name[The Phoenix], eatType[pub], food[French], priceRange[more than £30], customer rating[5 out of 5], area[city centre], familyFriendly[yes], near[Crowne Plaza Hotel]"	The phoenix is a family-friendly french pub in the city centre near crowne plaza hotel. it has a customer rating of 5 out of 5.
"name[The Phoenix], eatType[pub], food[French], priceRange[more than £30], customer rating[5 out of 5], area[riverside], familyFriendly[no], near[Crowne Plaza Hotel]"	The phoenix is a french pub near crowne plaza hotel in the riverside area. it is not children friendly and has a price range of more than £30.
"name[The Phoenix], eatType[pub], food[French], priceRange[more than £30], customer rating[5 out of 5], area[riverside], familyFriendly[yes], near[Crowne Plaza Hotel]"	The phoenix is a family friendly pub located near crowne plaza hotel.
"name[The Phoenix], eatType[pub], food[French], priceRange[more than £30], customer rating[low], area[city centre], familyFriendly[no], near[Crowne Plaza Hotel]"	The phoenix is a french pub near crowne plaza hotel in the city centre. it has a low customer rating and is not family-friendly.
"name[The Phoenix], eatType[pub], food[French], priceRange[more than £30], customer rating[low], area[city centre], familyFriendly[yes], near[Crowne Plaza Hotel]"	The phoenix is a family-friendly french pub in the city centre near crowne plaza hotel. it has a low customer rating and a price range of more than £30.
"name[The Phoenix], eatType[pub], food[French], priceRange[more than £30], customer rating[low], area[riverside], familyFriendly[no], near[Crowne Plaza Hotel]"	The phoenix is a french pub near crowne plaza hotel in the riverside area. it has a low customer rating and is not child friendly.
"name[The Phoenix], eatType[pub], food[French], priceRange[more than £30], customer rating[low], area[riverside], familyFriendly[yes], near[Crowne Plaza Hotel]"	The phoenix is a children friendly pub located near crowne plaza hotel.
"name[The Phoenix], eatType[restaurant], food[Fast food], priceRange[cheap], area[riverside], familyFriendly[yes], near[Raja Indian Cuisine]"	The phoenix is a family friendly fast food restaurant in the cheap price range. it is located in the riverside area near raja indian cuisine.
"name[The Phoenix], eatType[restaurant], food[Fast food], priceRange[high], area[city centre], familyFriendly[no], near[Raja Indian Cuisine]"	The phoenix is an expensive fast food restaurant located in the city centre near raja indian cuisine. it is not child friendly.
"name[The Phoenix], eatType[restaurant], food[Fast food], priceRange[high], area[city centre], familyFriendly[yes], near[Raja Indian Cuisine]"	The phoenix is a child friendly fast food restaurant in the high price range. it is located in the city centre near raja indian cuisine.
"name[The Phoenix], eatType[restaurant], food[Fast food], priceRange[high], area[riverside], familyFriendly[no], near[Raja Indian Cuisine]"	The phoenix is a high-priced fast food restaurant located in the riverside area near raja indian cuisine.
"name[The Phoenix], eatType[restaurant], food[Fast food], priceRange[high], area[riverside], familyFriendly[yes], near[Raja Indian Cuisine]"	The phoenix is a child friendly fast food restaurant in the riverside area near raja indian cuisine.
"name[The Phoenix], eatType[restaurant], food[Fast food], priceRange[less than £20], area[city centre], familyFriendly[no], near[Raja Indian Cuisine]"	The phoenix is a cheap fast food restaurant located in the city centre near raja indian cuisine.
"name[The Phoenix], eatType[restaurant], food[Fast food], priceRange[less than £20], area[city centre], familyFriendly[yes], near[Raja Indian Cuisine]"	The phoenix is a family-friendly fast food restaurant located near raja indian cuisine in the city centre.
"name[The Phoenix], eatType[restaurant], food[Fast food], priceRange[less than £20], area[riverside], familyFriendly[no], near[Raja Indian Cuisine]"	The phoenix is a cheap fast food restaurant near raja indian cuisine in the riverside area.
"name[The Phoenix], eatType[restaurant], food[Fast food], priceRange[less than £20], area[riverside], familyFriendly[yes], near[Raja Indian Cuisine]"	The phoenix is a family friendly fast food restaurant near raja indian cuisine.
"name[The Phoenix], eatType[restaurant], food[Fast food], priceRange[moderate], area[city centre], familyFriendly[no], near[Raja Indian Cuisine]"	The phoenix is a moderately priced fast food restaurant located in the city centre near raja indian cuisine. it is not kid friendly.
"name[The Phoenix], eatType[restaurant], food[Fast food], priceRange[moderate], area[city centre], familyFriendly[yes], near[Raja Indian Cuisine]"	The phoenix is a moderately priced fast food restaurant located in the city centre near raja indian cuisine. it is kid friendly.
"name[The Phoenix], eatType[restaurant], food[Fast food], priceRange[moderate], area[riverside], familyFriendly[no], near[Raja Indian Cuisine]"	The phoenix is a moderately priced fast food restaurant located in the riverside area near raja indian cuisine.
"name[The Phoenix], eatType[restaurant], food[Fast food], priceRange[moderate], area[riverside], familyFriendly[yes], near[Raja Indian Cuisine]"	The phoenix is a moderately priced fast food restaurant near raja indian cuisine.
"name[The Phoenix], eatType[restaurant], food[Fast food], priceRange[more than £30], area[riverside], familyFriendly[yes], near[Raja Indian Cuisine]"	The phoenix is a children friendly fast food restaurant in the riverside area near raja indian cuisine. it has a price range of more than £30.
"name[The Phoenix], eatType[restaurant], food[French], priceRange[£20-25], area[riverside], familyFriendly[yes], near[Raja Indian Cuisine]"	The phoenix is a kid friendly french restaurant located near raja indian cuisine.
"name[The Phoenix], eatType[restaurant], food[French], priceRange[cheap], area[riverside], familyFriendly[yes], near[Raja Indian Cuisine]"	The phoenix is a cheap family friendly french restaurant located near raja indian cuisine.
"name[The Phoenix], eatType[restaurant], food[French], priceRange[high], area[riverside], familyFriendly[yes], near[Raja Indian Cuisine]"	The phoenix is a children friendly french restaurant near raja indian cuisine in the riverside area.
"name[The Phoenix], eatType[restaurant], food[Indian], priceRange[£20-25], customer rating[high], area[city centre], familyFriendly[no], near[Crowne Plaza Hotel]"	The phoenix is a restaurant providing indian food in the £20-25 price range. it is located in the city centre and is near crowne plaza hotel.
"name[The Phoenix], eatType[restaurant], food[Indian], priceRange[£20-25], customer rating[high], area[city centre], familyFriendly[yes], near[Crowne Plaza Hotel]"	The phoenix is a restaurant providing indian food in the £20-25 price range. it is located in the city centre near crowne plaza hotel.
"name[The Phoenix], eatType[restaurant], food[Indian], priceRange[£20-25], customer rating[high], area[riverside], familyFriendly[no], near[Crowne Plaza Hotel]"	The phoenix is a restaurant that provides indian food in the £20-25 price range. it is located in the riverside. it is near crowne plaza hotel.
"name[The Phoenix], eatType[restaurant], food[Indian], priceRange[£20-25], customer rating[high], area[riverside], familyFriendly[yes], near[Crowne Plaza Hotel]"	The phoenix is a restaurant providing indian food in the £20-25 price range. it is located in riverside. it is near crowne plaza hotel. its customer rating is high.
"name[The Phoenix], eatType[restaurant], food[Indian], priceRange[cheap], customer rating[5 out of 5], area[city centre], familyFriendly[no], near[Crowne Plaza Hotel]"	The phoenix is a cheap indian restaurant in the city centre near crowne plaza hotel. it has a customer rating of 5 out of 5.
"name[The Phoenix], eatType[restaurant], food[Indian], priceRange[cheap], customer rating[5 out of 5], area[city centre], familyFriendly[yes], near[Crowne Plaza Hotel]"	The phoenix is a cheap indian restaurant located in the city centre near crowne plaza hotel. it is family friendly and has a customer rating of 5 out of 5.
"name[The Phoenix], eatType[restaurant], food[Indian], priceRange[cheap], customer rating[5 out of 5], area[riverside], familyFriendly[no], near[Crowne Plaza Hotel]"	The phoenix is a cheap indian restaurant located in the riverside area near crowne plaza hotel. it is not family friendly.
"name[The Phoenix], eatType[restaurant], food[Indian], priceRange[cheap], customer rating[5 out of 5], area[riverside], familyFriendly[no], near[Express by Holiday Inn]"	The phoenix is a cheap indian restaurant located in the riverside area near express by holiday inn. it is not family friendly.
"name[The Phoenix], eatType[restaurant], food[Indian], priceRange[cheap], customer rating[5 out of 5], area[riverside], familyFriendly[yes], near[Express by Holiday Inn]"	The phoenix is a cheap indian restaurant with a customer rating of 5 out of 5. it is located in the riverside area near express by holiday inn.
"name[The Phoenix], eatType[restaurant], food[Indian], priceRange[cheap], customer rating[average], area[city centre], familyFriendly[no], near[Express by Holiday Inn]"	The phoenix is a cheap indian restaurant near express by holiday inn in the city centre. it is not family friendly.
"name[The Plough], eatType[pub], food[Chinese], priceRange[£20-25], area[riverside], familyFriendly[yes], near[Raja Indian Cuisine]"	The plough is a pub that serves chinese food in the £20-25 price range. it is located in the riverside. it is near raja indian cuisine.
"name[The Plough], eatType[pub], food[Chinese], priceRange[cheap], area[riverside], familyFriendly[yes], near[Raja Indian Cuisine]"	The plough is a cheap, family friendly pub that serves chinese food in the riverside area near raja indian cuisine.
"name[The Plough], eatType[pub], food[Chinese], priceRange[high], area[city centre], familyFriendly[no], near[Raja Indian Cuisine]"	The plough is a high priced chinese pub near raja indian cuisine in the city centre.
"name[The Plough], eatType[pub], food[Chinese], priceRange[high], area[city centre], familyFriendly[yes], near[Raja Indian Cuisine]"	The plough is a children friendly chinese pub in the high price range. it is located in the city centre near raja indian cuisine.
"name[The Plough], eatType[pub], food[Chinese], priceRange[high], area[riverside], familyFriendly[no], near[Raja Indian Cuisine]"	The plough is a high priced chinese pub near raja indian cuisine in riverside. it is not child friendly.
"name[The Plough], eatType[pub], food[Chinese], priceRange[high], area[riverside], familyFriendly[yes], near[Raja Indian Cuisine]"	The plough is a child friendly chinese pub in the high price range. it is located in the riverside area near raja indian cuisine.
"name[The Plough], eatType[pub], food[Chinese], priceRange[less than £20], area[city centre], familyFriendly[no], near[Raja Indian Cuisine]"	The plough is a cheap chinese pub located near raja indian cuisine in the city centre. it is not family friendly.
"name[The Plough], eatType[restaurant], food[Chinese], priceRange[£20-25], area[riverside], familyFriendly[yes], near[Raja Indian Cuisine]"	The plough is a restaurant providing chinese food in the £20-25 price range. it is located in the riverside. it is near raja indian cuisine.
"name[The Plough], eatType[restaurant], food[Chinese], priceRange[cheap], area[riverside], familyFriendly[yes], near[Raja Indian Cuisine]"	The plough is a cheap family friendly chinese restaurant located in the riverside area near raja indian cuisine.
"name[The Plough], eatType[restaurant], food[Chinese], priceRange[high], area[city centre], familyFriendly[no], near[Raja Indian Cuisine]"	The plough is a high priced chinese restaurant in the city centre near raja indian cuisine. it is not child friendly.
"name[The Plough], eatType[restaurant], food[Chinese], priceRange[high], area[city centre], familyFriendly[yes], near[Raja Indian Cuisine]"	The plough is a child friendly chinese restaurant in the high price range. it is located in the city centre. it is near raja indian cuisine.
"name[The Plough], eatType[restaurant], food[Chinese], priceRange[high], area[riverside], familyFriendly[no], near[Raja Indian Cuisine]"	The plough is a high priced chinese restaurant located in riverside near raja indian cuisine. it is not child friendly.
"name[The Plough], eatType[restaurant], food[Chinese], priceRange[high], area[riverside], familyFriendly[yes], near[Raja Indian Cuisine]"	The plough is a children friendly chinese restaurant in the high price range. it is located in riverside near raja indian cuisine.
"name[The Plough], eatType[restaurant], food[Chinese], priceRange[less than £20], area[city centre], familyFriendly[no], near[Raja Indian Cuisine]"	The plough is a low-priced chinese restaurant located in the city centre near raja indian cuisine.
"name[The Punter], eatType[pub], food[Chinese], priceRange[less than £20], area[city centre], familyFriendly[yes], near[Raja Indian Cuisine]"	The punter is a family friendly pub serving chinese food in the less than £20 price range. it is located in the city centre near raja indian cuisine.
"name[The Punter], eatType[pub], food[Chinese], priceRange[less than £20], area[riverside], familyFriendly[no], near[Raja Indian Cuisine]"	The punter is a pub providing chinese food in the less than £20 price range. it is located in the riverside. it is near raja indian cuisine.
"name[The Punter], eatType[pub], food[Chinese], priceRange[less than £20], area[riverside], familyFriendly[yes], near[Raja Indian Cuisine]"	The punter is a family friendly pub that serves chinese food for less than £20. it is located in the riverside area near raja indian cuisine.
"name[The Punter], eatType[pub], food[Chinese], priceRange[moderate], area[city centre], familyFriendly[no], near[Raja Indian Cuisine]"	The punter is a pub providing chinese food in the moderate price range. it is located in the city centre near raja indian cuisine.
"name[The Punter], eatType[pub], food[Chinese], priceRange[moderate], area[city centre], familyFriendly[yes], near[Raja Indian Cuisine]"	The punter is a pub that provides chinese food in the moderate price range. it is located in the city centre near raja indian cuisine.
"name[The Punter], eatType[pub], food[Chinese], priceRange[moderate], area[riverside], familyFriendly[no], near[Raja Indian Cuisine]"	The punter is a pub that provides chinese food in the moderate price range. it is located in the riverside area near raja indian cuisine.
"name[The Punter], eatType[pub], food[Chinese], priceRange[moderate], area[riverside], familyFriendly[yes], near[Raja Indian Cuisine]"	The punter is a pub that provides chinese food in the moderate price range. it is located in the riverside area near raja indian cuisine.
"name[The Punter], eatType[pub], food[Chinese], priceRange[more than £30], area[riverside], familyFriendly[yes], near[Raja Indian Cuisine]"	The punter is a pub that provides chinese food in the more than £30 price range. it is located in the riverside area near raja indian cuisine.
"name[The Punter], eatType[pub], food[English], priceRange[£20-25], area[riverside], familyFriendly[yes], near[Raja Indian Cuisine]"	The punter is a kid-friendly pub located near raja indian cuisine.
"name[The Punter], eatType[pub], food[English], priceRange[cheap], area[riverside], familyFriendly[yes], near[Raja Indian Cuisine]"	The punter is a cheap, family friendly pub located near raja indian cuisine.
"name[The Punter], eatType[pub], food[English], priceRange[high], area[city centre], familyFriendly[no], near[Raja Indian Cuisine]"	The punter is a high priced english pub located near raja indian cuisine in the city centre.
"name[The Punter], eatType[pub], food[English], priceRange[high], area[city centre], familyFriendly[yes], near[Raja Indian Cuisine]"	The punter is a child friendly pub located in the city centre near raja indian cuisine. it serves english food and has a high price range.
"name[The Punter], eatType[pub], food[English], priceRange[high], area[riverside], familyFriendly[no], near[Raja Indian Cuisine]"	The punter is a high priced english pub located near raja indian cuisine in riverside.
"name[The Punter], eatType[pub], food[English], priceRange[high], area[riverside], familyFriendly[yes], near[Raja Indian Cuisine]"	The punter is a child friendly pub located in the riverside area near raja indian cuisine. it serves english food in the high price range.
"name[The Punter], eatType[pub], food[Italian], priceRange[high], customer rating[average], area[city centre], familyFriendly[no], near[Rainbow Vegetarian Café]"	The punter is a high priced italian pub in the city centre near rainbow vegetarian café. it has an average customer rating and is not child friendly.
"name[The Punter], eatType[restaurant], food[Chinese], priceRange[less than £20], area[city centre], familyFriendly[yes], near[Raja Indian Cuisine]"	The punter is a family friendly chinese restaurant in the city centre. it is near raja indian cuisine.
"name[The Punter], eatType[restaurant], food[Chinese], priceRange[less than £20], area[riverside], familyFriendly[no], near[Raja Indian Cuisine]"	The punter is a chinese restaurant in the less than £20 price range. it is located in the riverside area near raja indian cuisine.
"name[The Punter], eatType[restaurant], food[Chinese], priceRange[less than £20], area[riverside], familyFriendly[yes], near[Raja Indian Cuisine]"	The punter is a family friendly chinese restaurant in the less than £20 price range. it is located in the riverside area near raja indian cuisine.
"name[The Punter], eatType[restaurant], food[Chinese], priceRange[moderate], area[city centre], familyFriendly[no], near[Raja Indian Cuisine]"	The punter is a moderately priced chinese restaurant near raja indian cuisine in the city centre.
"name[The Punter], eatType[restaurant], food[Chinese], priceRange[moderate], area[city centre], familyFriendly[yes], near[Raja Indian Cuisine]"	The punter is a moderately priced chinese restaurant located in the city centre near raja indian cuisine.
"name[The Punter], eatType[restaurant], food[Chinese], priceRange[moderate], area[riverside], familyFriendly[no], near[Raja Indian Cuisine]"	The punter is a moderately priced chinese restaurant located in riverside near raja indian cuisine.
"name[The Punter], eatType[restaurant], food[Chinese], priceRange[moderate], area[riverside], familyFriendly[yes], near[Raja Indian Cuisine]"	The punter is a kids friendly chinese restaurant in the moderate price range. it is located in the riverside area near raja indian cuisine.
"name[The Punter], eatType[restaurant], food[Chinese], priceRange[more than £30], area[riverside], familyFriendly[yes], near[Raja Indian Cuisine]"	The punter is a children friendly chinese restaurant in the riverside area. it is near raja indian cuisine.
"name[The Punter], eatType[restaurant], food[English], priceRange[£20-25], area[riverside], familyFriendly[yes], near[Raja Indian Cuisine]"	The punter is a kids friendly english restaurant located near raja indian cuisine.
"name[The Punter], eatType[restaurant], food[English], priceRange[cheap], area[riverside], familyFriendly[yes], near[Raja Indian Cuisine]"	The punter is a cheap family friendly english restaurant located near raja indian cuisine.
"name[The Punter], eatType[restaurant], food[English], priceRange[high], area[city centre], familyFriendly[no], near[Raja Indian Cuisine]"	The punter is a high priced english restaurant located in the city centre near raja indian cuisine. it is not child friendly.
"name[The Punter], eatType[restaurant], food[English], priceRange[high], area[city centre], familyFriendly[yes], near[Raja Indian Cuisine]"	The punter is a children friendly english restaurant in the city centre near raja indian cuisine. it has a high price range.
"name[The Punter], eatType[restaurant], food[English], priceRange[high], area[riverside], familyFriendly[no], near[Raja Indian Cuisine]"	The punter is a high priced english restaurant near raja indian cuisine in riverside. it is not child friendly.
"name[The Punter], eatType[restaurant], food[English], priceRange[high], area[riverside], familyFriendly[yes], near[Raja Indian Cuisine]"	The punter is a child friendly english restaurant in the high price range. it is located in the riverside area near raja indian cuisine.
"name[The Punter], eatType[restaurant], food[Indian], priceRange[cheap], customer rating[average], area[city centre], familyFriendly[yes], near[Express by Holiday Inn]"	The punter is a cheap indian restaurant located in the city centre near express by holiday inn.
"name[The Punter], eatType[restaurant], food[Indian], priceRange[cheap], customer rating[average], area[riverside], familyFriendly[no], near[Express by Holiday Inn]"	The punter is a cheap indian restaurant located in riverside near express by holiday inn. it is not family friendly.
"name[The Punter], eatType[restaurant], food[Indian], priceRange[cheap], customer rating[average], area[riverside], familyFriendly[yes], near[Express by Holiday Inn]"	The punter is a cheap indian restaurant located in the riverside area. it is family friendly and is near express by holiday inn.
"name[The Punter], eatType[restaurant], food[Indian], priceRange[high], customer rating[1 out of 5], area[city centre], familyFriendly[no], near[Express by Holiday Inn]"	The punter is a high priced indian restaurant located in the city centre near express by holiday inn. it has a customer rating of 1 out of 5.
"name[The Punter], eatType[restaurant], food[Indian], priceRange[high], customer rating[1 out of 5], area[city centre], familyFriendly[yes], near[Express by Holiday Inn]"	The punter is a high priced indian restaurant in the city centre near express by holiday inn.
"name[The Punter], eatType[restaurant], food[Indian], priceRange[high], customer rating[1 out of 5], area[riverside], familyFriendly[no], near[Express by Holiday Inn]"	The punter is a high priced indian restaurant located in riverside near express by holiday inn.
"name[The Punter], eatType[restaurant], food[Indian], priceRange[high], customer rating[1 out of 5], area[riverside], familyFriendly[yes], near[Express by Holiday Inn]"	The punter is a high priced indian restaurant located in the riverside area near express by holiday inn.
"name[The Punter], eatType[restaurant], food[Indian], priceRange[high], customer rating[average], area[city centre], familyFriendly[no], near[Express by Holiday Inn]"	The punter is a high priced indian restaurant located in the city centre. it is near express by holiday inn.
"name[The Punter], eatType[restaurant], food[Indian], priceRange[high], customer rating[average], area[city centre], familyFriendly[yes], near[Express by Holiday Inn]"	The punter is a restaurant providing indian food in the high price range. it is located in the city centre near express by holiday inn.
"name[The Punter], eatType[restaurant], food[Indian], priceRange[high], customer rating[average], area[riverside], familyFriendly[no], near[Express by Holiday Inn]"	The punter is a high priced indian restaurant near express by holiday inn. it has an average customer rating and is not child friendly.
"name[The Punter], eatType[restaurant], food[Indian], priceRange[high], customer rating[average], area[riverside], familyFriendly[yes], near[Express by Holiday Inn]"	The punter is a high priced indian restaurant located in riverside near express by holiday inn.
"name[The Punter], eatType[restaurant], food[Indian], priceRange[less than £20], customer rating[low], area[city centre], familyFriendly[no], near[Express by Holiday Inn]"	The punter is a restaurant providing indian food in the less than £20 price range. it is located in the city centre. it is near express by holiday inn. it has a low customer rating.
"name[The Punter], eatType[restaurant], food[Indian], priceRange[less than £20], customer rating[low], area[city centre], familyFriendly[yes], near[Express by Holiday Inn]"	The punter is a restaurant providing indian food in the less than £20 price range. it is located in the city centre. it is near express by holiday inn and has a low customer rating.
"name[The Punter], eatType[restaurant], food[Indian], priceRange[less than £20], customer rating[low], area[riverside], familyFriendly[no], near[Express by Holiday Inn]"	The punter is a restaurant providing indian food in the low price range. it is located in the riverside area near express by holiday inn.
"name[The Punter], eatType[restaurant], food[Indian], priceRange[less than £20], customer rating[low], area[riverside], familyFriendly[yes], near[Express by Holiday Inn]"	The punter is a restaurant providing indian food in the low price range. it is located in the riverside area near express by holiday inn.
"name[The Punter], eatType[restaurant], food[Indian], priceRange[moderate], customer rating[1 out of 5], area[city centre], familyFriendly[no], near[Express by Holiday Inn]"	The punter is a moderately priced indian restaurant located near express by holiday inn in the city centre.
"name[The Punter], eatType[restaurant], food[Indian], priceRange[moderate], customer rating[1 out of 5], area[city centre], familyFriendly[yes], near[Express by Holiday Inn]"	The punter is a moderately priced indian restaurant located in the city centre near express by holiday inn. it has a customer rating of 1 out of 5.
"name[The Punter], eatType[restaurant], food[Indian], priceRange[moderate], customer rating[1 out of 5], area[riverside], familyFriendly[no], near[Express by Holiday Inn]"	The punter is a moderately priced indian restaurant in the riverside area near express by holiday inn.
"name[The Punter], eatType[restaurant], food[Indian], priceRange[moderate], customer rating[1 out of 5], area[riverside], familyFriendly[yes], near[Express by Holiday Inn]"	The punter is a restaurant providing indian food in the moderate price range. it is located in riverside. it is near express by holiday inn.
"name[The Punter], eatType[restaurant], food[Indian], priceRange[moderate], customer rating[3 out of 5], area[city centre], familyFriendly[no], near[Express by Holiday Inn]"	The punter is a moderately priced indian restaurant located in the city centre near express by holiday inn.
"name[The Punter], eatType[restaurant], food[Indian], priceRange[moderate], customer rating[3 out of 5], area[city centre], familyFriendly[yes], near[Express by Holiday Inn]"	The punter is a restaurant providing indian food in the moderate price range. it is located in the city centre and is near express by holiday inn.
"name[The Punter], eatType[restaurant], food[Indian], priceRange[moderate], customer rating[3 out of 5], area[riverside], familyFriendly[no], near[Express by Holiday Inn]"	The punter is a moderately priced indian restaurant located in the riverside area near express by holiday inn.
"name[The Punter], eatType[restaurant], food[Indian], priceRange[moderate], customer rating[3 out of 5], area[riverside], familyFriendly[yes], near[Express by Holiday Inn]"	The punter is a restaurant providing indian food in the moderate price range. it is near express by holiday inn.
"name[The Punter], eatType[restaurant], food[Indian], priceRange[more than £30], customer rating[high], area[city centre], familyFriendly[no], near[Express by Holiday Inn]"	The punter is a restaurant providing indian food in the more than £30 price range. it is located in the city centre, near express by holiday inn.
"name[The Punter], eatType[restaurant], food[Indian], priceRange[more than £30], customer rating[high], area[city centre], familyFriendly[yes], near[Express by Holiday Inn]"	The punter is a children friendly indian restaurant in the more than £30 price range. it is located in the city centre. it is near express by holiday inn.
"name[The Punter], eatType[restaurant], food[Indian], priceRange[more than £30], customer rating[high], area[riverside], familyFriendly[no], near[Express by Holiday Inn]"	The punter is an indian restaurant in the more than £30 price range. it is located in the riverside. it is near express by holiday inn.
"name[The Punter], eatType[restaurant], food[Indian], priceRange[more than £30], customer rating[high], area[riverside], familyFriendly[yes], near[Express by Holiday Inn]"	The punter is a children friendly indian restaurant in the more than £30 price range. it is located in the riverside area near express by holiday inn.
"name[The Punter], eatType[restaurant], food[Italian], priceRange[£20-25], customer rating[high], area[city centre], familyFriendly[no], near[Express by Holiday Inn]"	The punter is a restaurant providing italian food in the £20-25 price range. it is located in the city centre. it is near express by holiday inn.
"name[The Punter], eatType[restaurant], food[Italian], priceRange[£20-25], customer rating[high], area[city centre], familyFriendly[yes], near[Express by Holiday Inn]"	The punter is an italian restaurant located in the city centre near express by holiday inn. it has a high customer rating and is kid friendly.
"name[The Punter], eatType[restaurant], food[Italian], priceRange[£20-25], customer rating[high], area[riverside], familyFriendly[no], near[Express by Holiday Inn]"	The punter is a moderately priced italian restaurant near express by holiday inn.
"name[The Punter], eatType[restaurant], food[Italian], priceRange[£20-25], customer rating[high], area[riverside], familyFriendly[yes], near[Express by Holiday Inn]"	The punter is a kid friendly italian restaurant located near express by holiday inn.
"name[The Punter], eatType[restaurant], food[Italian], priceRange[cheap], customer rating[5 out of 5], area[city centre], familyFriendly[no], near[Express by Holiday Inn]"	The punter is a cheap italian restaurant located in the city centre near express by holiday inn. it has a customer rating of 5 out of 5 and is not family-friendly.
"name[The Punter], eatType[restaurant], food[Italian], priceRange[cheap], customer rating[5 out of 5], area[city centre], familyFriendly[no], near[Rainbow Vegetarian Café]"	The punter is a cheap italian restaurant located in the city centre near rainbow vegetarian café. it has a customer rating of 5 out of 5 and is not family-friendly.
"name[The Punter], eatType[restaurant], food[Italian], priceRange[cheap], customer rating[5 out of 5], area[city centre], familyFriendly[yes], near[Rainbow Vegetarian Café]"	The punter is a cheap family-friendly italian restaurant in the city centre near rainbow vegetarian café. it has a customer rating of 5 out of 5.
"name[The Punter], eatType[restaurant], food[Italian], priceRange[cheap], customer rating[5 out of 5], area[riverside], familyFriendly[no], near[Rainbow Vegetarian Café]"	The punter is a cheap italian restaurant located in the riverside area near rainbow vegetarian café. it has a customer rating of 5 out of 5.
"name[The Punter], eatType[restaurant], food[Italian], priceRange[cheap], customer rating[5 out of 5], area[riverside], familyFriendly[yes], near[Rainbow Vegetarian Café]"	The punter is a family friendly restaurant located near rainbow vegetarian café.
"name[The Punter], eatType[restaurant], food[Italian], priceRange[cheap], customer rating[average], area[city centre], familyFriendly[no], near[Rainbow Vegetarian Café]"	The punter is a cheap italian restaurant located in the city centre near rainbow vegetarian café. it is not family-friendly and has an average customer rating.
"name[The Punter], eatType[restaurant], food[Italian], priceRange[cheap], customer rating[average], area[city centre], familyFriendly[yes], near[Rainbow Vegetarian Café]"	The punter is a cheap italian restaurant located in the city centre near rainbow vegetarian café.
"name[The Punter], eatType[restaurant], food[Italian], priceRange[cheap], customer rating[average], area[riverside], familyFriendly[no], near[Rainbow Vegetarian Café]"	The punter is a cheap italian restaurant near rainbow vegetarian café in riverside. it is not family-friendly.
"name[The Punter], eatType[restaurant], food[Italian], priceRange[cheap], customer rating[average], area[riverside], familyFriendly[yes], near[Rainbow Vegetarian Café]"	The punter is a cheap italian restaurant located near rainbow vegetarian café.
"name[The Punter], eatType[restaurant], food[Italian], priceRange[high], customer rating[1 out of 5], area[city centre], familyFriendly[no], near[Rainbow Vegetarian Café]"	The punter is an expensive italian restaurant located in the city centre near rainbow vegetarian café. it has a customer rating of 1 out of 5.
"name[The Punter], eatType[restaurant], food[Italian], priceRange[high], customer rating[1 out of 5], area[city centre], familyFriendly[yes], near[Rainbow Vegetarian Café]"	The punter is a child friendly italian restaurant located in the city centre near rainbow vegetarian café. it has a high price range and a customer rating of 1 out of 5.
"name[The Punter], eatType[restaurant], food[Italian], priceRange[high], customer rating[1 out of 5], area[riverside], familyFriendly[no], near[Rainbow Vegetarian Café]"	The punter is a high priced italian restaurant near rainbow vegetarian café.
"name[The Punter], eatType[restaurant], food[Italian], priceRange[high], customer rating[1 out of 5], area[riverside], familyFriendly[yes], near[Rainbow Vegetarian Café]"	The punter is a high priced italian restaurant located near rainbow vegetarian café.
"name[The Vaults], eatType[pub], food[French], priceRange[high], area[riverside], familyFriendly[yes], near[Raja Indian Cuisine]"	The vaults is a children friendly french pub near raja indian cuisine in the riverside area.
"name[The Vaults], eatType[pub], food[French], priceRange[less than £20], area[city centre], familyFriendly[no], near[Raja Indian Cuisine]"	The vaults is a french pub in the city centre near raja indian cuisine. it is not family-friendly and has a price range of less than £20.
"name[The Vaults], eatType[pub], food[French], priceRange[less than £20], area[city centre], familyFriendly[yes], near[Raja Indian Cuisine]"	The vaults is a family-friendly french pub in the city centre near raja indian cuisine. it has a price range of less than £20.
"name[The Vaults], eatType[pub], food[French], priceRange[less than £20], area[riverside], familyFriendly[no], near[Raja Indian Cuisine]"	The vaults is a low-priced pub near raja indian cuisine.
"name[The Vaults], eatType[pub], food[French], priceRange[less than £20], area[riverside], familyFriendly[yes], near[Raja Indian Cuisine]"	The vaults is a family friendly pub located near the raja indian cuisine.
"name[The Vaults], eatType[pub], food[French], priceRange[moderate], area[city centre], familyFriendly[no], near[Raja Indian Cuisine]"	The vaults is a moderately priced french pub located near raja indian cuisine in the city centre.
"name[The Vaults], eatType[pub], food[French], priceRange[moderate], area[city centre], familyFriendly[yes], near[Raja Indian Cuisine]"	The vaults is a kid friendly french pub in the city centre near raja indian cuisine with a moderate price range.
"name[The Vaults], eatType[pub], food[French], priceRange[moderate], area[riverside], familyFriendly[no], near[Raja Indian Cuisine]"	The vaults is a moderately priced french pub near raja indian cuisine in riverside.
"name[The Vaults], eatType[pub], food[French], priceRange[moderate], area[riverside], familyFriendly[yes], near[Raja Indian Cuisine]"	The vaults is a kid friendly pub in the moderate price range located near raja indian cuisine.
"name[The Vaults], eatType[pub], food[French], priceRange[more than £30], area[city centre], familyFriendly[no], near[Raja Indian Cuisine]"	The vaults is a french pub located in the city centre near raja indian cuisine. it has a price range of more than £30 and is not children friendly.
"name[The Vaults], eatType[pub], food[French], priceRange[more than £30], area[city centre], familyFriendly[yes], near[Raja Indian Cuisine]"	The vaults is a child friendly french pub in the city centre near raja indian cuisine. it has a price range of more than £30.
"name[The Vaults], eatType[pub], food[French], priceRange[more than £30], area[riverside], familyFriendly[no], near[Raja Indian Cuisine]"	The vaults is a french pub near raja indian cuisine in the riverside area. it is not children friendly and has a price range of more than £30.
"name[The Vaults], eatType[pub], food[French], priceRange[more than £30], area[riverside], familyFriendly[yes], near[Raja Indian Cuisine]"	The vaults is a children friendly pub that serves french food in the more than £30 price range. it is located in the riverside area near raja indian cuisine.
"name[The Vaults], eatType[pub], food[Indian], priceRange[£20-25], area[riverside], familyFriendly[yes], near[Raja Indian Cuisine]"	The vaults is a pub that serves indian food in the £20-25 price range. it is located in the riverside. it is near raja indian cuisine.
"name[The Vaults], eatType[pub], food[Indian], priceRange[cheap], area[riverside], familyFriendly[yes], near[Raja Indian Cuisine]"	The vaults is a cheap, family friendly pub that serves indian food. it is located in the riverside area near raja indian cuisine.
"name[The Vaults], eatType[pub], food[Indian], priceRange[high], area[city centre], familyFriendly[no], near[Raja Indian Cuisine]"	The vaults is a high priced indian pub located in the city centre near raja indian cuisine. it is not children friendly.
"name[The Vaults], eatType[pub], food[Indian], priceRange[high], area[city centre], familyFriendly[yes], near[Raja Indian Cuisine]"	The vaults is a high priced indian pub in the city centre near raja indian cuisine. it is children friendly.
"name[The Vaults], eatType[pub], food[Italian], priceRange[high], customer rating[average], area[city centre], familyFriendly[no], near[Rainbow Vegetarian Café]"	The vaults is a high priced italian pub in the city centre near rainbow vegetarian café. it has an average customer rating and is not child friendly.
"name[The Vaults], eatType[pub], food[Italian], priceRange[high], customer rating[average], area[city centre], familyFriendly[yes], near[Rainbow Vegetarian Café]"	The vaults is a children friendly italian pub in the city centre near rainbow vegetarian café. it has an average customer rating and a high price range.
"name[The Vaults], eatType[pub], food[Italian], priceRange[high], customer rating[average], area[riverside], familyFriendly[no], near[Rainbow Vegetarian Café]"	The vaults is an expensive italian pub near rainbow vegetarian café in the riverside area.
"name[The Vaults], eatType[pub], food[Italian], priceRange[high], customer rating[average], area[riverside], familyFriendly[yes], near[Rainbow Vegetarian Café]"	The vaults is a family friendly pub located near the rainbow vegetarian café.
"name[The Vaults], eatType[pub], food[Italian], priceRange[less than £20], customer rating[low], area[city centre], familyFriendly[no], near[Rainbow Vegetarian Café]"	The vaults is a pub located in the city centre near rainbow vegetarian café. it is not family-friendly and has a low customer rating.
"name[The Vaults], eatType[pub], food[Italian], priceRange[less than £20], customer rating[low], area[city centre], familyFriendly[yes], near[Rainbow Vegetarian Café]"	The vaults is a family-friendly italian pub in the city centre near rainbow vegetarian café. it has a low customer rating and a price range of less than £20.
"name[The Vaults], eatType[pub], food[Italian], priceRange[less than £20], customer rating[low], area[riverside], familyFriendly[no], near[Rainbow Vegetarian Café]"	The vaults is a low-priced pub near rainbow vegetarian café.
"name[The Vaults], eatType[pub], food[Italian], priceRange[less than £20], customer rating[low], area[riverside], familyFriendly[yes], near[Rainbow Vegetarian Café]"	The vaults is a family-friendly pub located near rainbow vegetarian café.
"name[The Vaults], eatType[pub], food[Italian], priceRange[moderate], customer rating[1 out of 5], area[city centre], familyFriendly[no], near[Rainbow Vegetarian Café]"	The vaults is a moderately priced italian pub near rainbow vegetarian café in the city centre. it has a customer rating of 1 out of 5.
"name[The Vaults], eatType[pub], food[Italian], priceRange[moderate], customer rating[1 out of 5], area[city centre], familyFriendly[yes], near[Rainbow Vegetarian Café]"	The vaults is a family-friendly italian pub located near rainbow vegetarian café in the city centre. it has a customer rating of 1 out of 5.
"name[The Vaults], eatType[pub], food[Italian], priceRange[moderate], customer rating[1 out of 5], area[riverside], familyFriendly[no], near[Rainbow Vegetarian Café]"	The vaults is a moderately priced italian pub located near rainbow vegetarian café.
"name[The Vaults], eatType[pub], food[Italian], priceRange[moderate], customer rating[1 out of 5], area[riverside], familyFriendly[yes], near[Rainbow Vegetarian Café]"	The vaults is a moderately priced italian pub located near rainbow vegetarian café.
"name[The Vaults], eatType[pub], food[Italian], priceRange[moderate], customer rating[3 out of 5], area[city centre], familyFriendly[no], near[Rainbow Vegetarian Café]"	The vaults is a moderately priced italian pub located in the city centre near rainbow vegetarian café. it has a customer rating of 3 out of 5.
"name[The Vaults], eatType[pub], food[Italian], priceRange[moderate], customer rating[3 out of 5], area[city centre], familyFriendly[yes], near[Rainbow Vegetarian Café]"	The vaults is a kid friendly italian pub in the city centre near rainbow vegetarian café. it has a customer rating of 3 out of 5.
"name[The Vaults], eatType[pub], food[Italian], priceRange[moderate], customer rating[3 out of 5], area[riverside], familyFriendly[no], near[Rainbow Vegetarian Café]"	The vaults is a moderately priced pub near rainbow vegetarian café.
"name[The Vaults], eatType[pub], food[Italian], priceRange[moderate], customer rating[3 out of 5], area[riverside], familyFriendly[yes], near[Rainbow Vegetarian Café]"	The vaults is a moderately priced, family friendly pub located near rainbow vegetarian café.
"name[The Vaults], eatType[pub], food[Italian], priceRange[more than £30], customer rating[high], area[city centre], familyFriendly[no], near[Rainbow Vegetarian Café]"	The vaults is an italian pub located in the city centre near rainbow vegetarian café. it has a high customer rating and is not child friendly.
"name[The Vaults], eatType[pub], food[Italian], priceRange[more than £30], customer rating[high], area[city centre], familyFriendly[yes], near[Rainbow Vegetarian Café]"	The vaults is a children friendly italian pub in the city centre near rainbow vegetarian café with a high customer rating and a price range of more than £30.
"name[The Vaults], eatType[pub], food[Italian], priceRange[more than £30], customer rating[high], area[riverside], familyFriendly[no], near[Rainbow Vegetarian Café]"	The vaults is an expensive italian pub near rainbow vegetarian café in riverside.
"name[The Vaults], eatType[pub], food[Italian], priceRange[more than £30], customer rating[high], area[riverside], familyFriendly[yes], near[Rainbow Vegetarian Café]"	The vaults is a children friendly italian pub located near rainbow vegetarian café.
"name[The Vaults], eatType[pub], food[Japanese], priceRange[£20-25], customer rating[3 out of 5], area[city centre], familyFriendly[no], near[Rainbow Vegetarian Café]"	The vaults is a japanese pub located near rainbow vegetarian café in the city centre. it has a customer rating of 3 out of 5 and is not kid friendly.
"name[The Vaults], eatType[pub], food[Japanese], priceRange[£20-25], customer rating[3 out of 5], area[city centre], familyFriendly[yes], near[Rainbow Vegetarian Café]"	The vaults is a kid friendly japanese pub in the city centre near rainbow vegetarian café. it has a customer rating of 3 out of 5.
"name[The Vaults], eatType[pub], food[Japanese], priceRange[£20-25], customer rating[3 out of 5], area[riverside], familyFriendly[no], near[Rainbow Vegetarian Café]"	The vaults is a japanese pub located near rainbow vegetarian café in the riverside area.
"name[The Vaults], eatType[pub], food[Japanese], priceRange[£20-25], customer rating[3 out of 5], area[riverside], familyFriendly[yes], near[Rainbow Vegetarian Café]"	The vaults is a kid friendly japanese pub near rainbow vegetarian café.
"name[The Vaults], eatType[pub], food[Japanese], priceRange[£20-25], customer rating[high], area[city centre], familyFriendly[no], near[Rainbow Vegetarian Café]"	The vaults is a japanese pub located in the city centre near rainbow vegetarian café. it has a high customer rating and a price range of £20-25.
"name[The Vaults], eatType[pub], food[Japanese], priceRange[£20-25], customer rating[high], area[city centre], familyFriendly[yes], near[Rainbow Vegetarian Café]"	The vaults is a japanese pub in the city centre near rainbow vegetarian café. it has a high customer rating and is kid friendly.
"name[The Vaults], eatType[pub], food[Japanese], priceRange[£20-25], customer rating[high], area[riverside], familyFriendly[no], near[Rainbow Vegetarian Café]"	The vaults is a japanese pub located in the riverside area near rainbow vegetarian café. it has a high customer rating and is not kid friendly.
"name[The Vaults], eatType[pub], food[Japanese], priceRange[£20-25], customer rating[high], area[riverside], familyFriendly[no], near[Raja Indian Cuisine]"	The vaults is a japanese pub located in the riverside area near raja indian cuisine. it has a high customer rating and is not kid friendly.
"name[The Vaults], eatType[pub], food[Japanese], priceRange[£20-25], customer rating[high], area[riverside], familyFriendly[yes], near[Raja Indian Cuisine]"	The vaults is a kid friendly japanese pub located near raja indian cuisine.
"name[The Vaults], eatType[pub], food[Japanese], priceRange[cheap], customer rating[5 out of 5], area[city centre], familyFriendly[no], near[Raja Indian Cuisine]"	The vaults is a cheap japanese pub located near raja indian cuisine in the city centre. it has a customer rating of 5 out of 5.
"name[The Vaults], eatType[pub], food[Japanese], priceRange[cheap], customer rating[5 out of 5], area[city centre], familyFriendly[yes], near[Raja Indian Cuisine]"	The vaults is a cheap, family-friendly japanese pub in the city centre near raja indian cuisine. it has a customer rating of 5 out of 5.
"name[The Vaults], eatType[pub], food[Japanese], priceRange[cheap], customer rating[5 out of 5], area[riverside], familyFriendly[no], near[Raja Indian Cuisine]"	The vaults is a cheap japanese pub in the riverside area near raja indian cuisine. it has a customer rating of 5 out of 5.
"name[The Vaults], eatType[pub], food[Japanese], priceRange[cheap], customer rating[5 out of 5], area[riverside], familyFriendly[yes], near[Raja Indian Cuisine]"	The vaults is a cheap, family friendly pub near raja indian cuisine.
"name[The Vaults], eatType[pub], food[Japanese], priceRange[high], customer rating[3 out of 5], area[city centre], familyFriendly[no], near[Raja Indian Cuisine]"	The vaults is a high priced japanese pub located in the city centre near raja indian cuisine. it has a customer rating of 3 out of 5.
"name[The Vaults], eatType[pub], food[Japanese], priceRange[high], customer rating[3 out of 5], area[city centre], familyFriendly[yes], near[Raja Indian Cuisine]"	The vaults is a children friendly japanese pub in the city centre near raja indian cuisine. it has a high price range and a customer rating of 3 out of 5.
"name[The Vaults], eatType[pub], food[Japanese], priceRange[high], customer rating[3 out of 5], area[riverside], familyFriendly[no], near[Raja Indian Cuisine]"	The vaults is a high priced japanese pub near raja indian cuisine in riverside.
"name[The Vaults], eatType[pub], food[Japanese], priceRange[high], customer rating[3 out of 5], area[riverside], familyFriendly[yes], near[Raja Indian Cuisine]"	The vaults is a children friendly pub located near raja indian cuisine.
"name[The Vaults], eatType[pub], food[Japanese], priceRange[less than £20], customer rating[average], area[city centre], familyFriendly[no], near[Raja Indian Cuisine]"	The vaults is a japanese pub near raja indian cuisine in the city centre. it has an average customer rating and is not family-friendly.
"name[The Vaults], eatType[pub], food[Japanese], priceRange[less than £20], customer rating[average], area[city centre], familyFriendly[yes], near[Raja Indian Cuisine]"	The vaults is a family-friendly japanese pub in the city centre near raja indian cuisine. it has an average customer rating and a price range of less than £20.
"name[The Vaults], eatType[pub], food[Japanese], priceRange[less than £20], customer rating[average], area[riverside], familyFriendly[no], near[Raja Indian Cuisine]"	The vaults is a cheap japanese pub near raja indian cuisine in the riverside area.
"name[The Vaults], eatType[pub], food[Japanese], priceRange[less than £20], customer rating[average], area[riverside], familyFriendly[yes], near[Raja Indian Cuisine]"	The vaults is a family-friendly pub located near raja indian cuisine.
"name[The Vaults], eatType[pub], food[Japanese], priceRange[less than £20], customer rating[low], area[city centre], familyFriendly[no], near[Raja Indian Cuisine]"	The vaults is a japanese pub near raja indian cuisine in the city centre. it is not family-friendly and has a low customer rating.
"name[The Vaults], eatType[pub], food[Japanese], priceRange[less than £20], customer rating[low], area[city centre], familyFriendly[yes], near[Raja Indian Cuisine]"	The vaults is a family-friendly japanese pub in the city centre near raja indian cuisine with a low customer rating and a price range of less than £20.
"name[The Vaults], eatType[pub], food[Japanese], priceRange[less than £20], customer rating[low], area[riverside], familyFriendly[no], near[Raja Indian Cuisine]"	The vaults is a cheap japanese pub located near raja indian cuisine.
"name[The Vaults], eatType[pub], food[Japanese], priceRange[less than £20], customer rating[low], area[riverside], familyFriendly[yes], near[Raja Indian Cuisine]"	The vaults is a low-priced family friendly pub located near raja indian cuisine.
"name[The Vaults], eatType[pub], food[Japanese], priceRange[moderate], customer rating[1 out of 5], area[city centre], familyFriendly[no], near[Raja Indian Cuisine]"	The vaults is a moderately priced japanese pub near raja indian cuisine in the city centre. it has a customer rating of 1 out of 5.
"name[The Vaults], eatType[pub], food[Japanese], priceRange[moderate], customer rating[1 out of 5], area[city centre], familyFriendly[yes], near[Raja Indian Cuisine]"	The vaults is a kid friendly japanese pub in the city centre near raja indian cuisine. it has a moderate price range and a customer rating of 1 out of 5.
"name[The Vaults], eatType[restaurant], food[French], priceRange[high], area[riverside], familyFriendly[yes], near[Raja Indian Cuisine]"	The vaults is a children friendly french restaurant near raja indian cuisine in the riverside area.
"name[The Vaults], eatType[restaurant], food[French], priceRange[less than £20], area[city centre], familyFriendly[no], near[Raja Indian Cuisine]"	The vaults is a french restaurant located in the city centre near raja indian cuisine. it has a price range of less than £20 and is not family-friendly.
"name[The Vaults], eatType[restaurant], food[French], priceRange[less than £20], area[city centre], familyFriendly[yes], near[Raja Indian Cuisine]"	The vaults is a family-friendly french restaurant in the city centre. it is near raja indian cuisine.
"name[The Vaults], eatType[restaurant], food[French], priceRange[less than £20], area[riverside], familyFriendly[no], near[Raja Indian Cuisine]"	The vaults is a cheap french restaurant located near raja indian cuisine in the riverside area.
"name[The Vaults], eatType[restaurant], food[French], priceRange[less than £20], area[riverside], familyFriendly[yes], near[Raja Indian Cuisine]"	The vaults is a family friendly restaurant located near the raja indian cuisine.
"name[The Vaults], eatType[restaurant], food[French], priceRange[moderate], area[city centre], familyFriendly[no], near[Raja Indian Cuisine]"	The vaults is a moderately priced french restaurant located near raja indian cuisine in the city centre.
"name[The Vaults], eatType[restaurant], food[French], priceRange[moderate], area[city centre], familyFriendly[yes], near[Raja Indian Cuisine]"	The vaults is a moderately priced french restaurant located in the city centre near raja indian cuisine.
"name[The Vaults], eatType[restaurant], food[French], priceRange[moderate], area[riverside], familyFriendly[no], near[Raja Indian Cuisine]"	The vaults is a moderately priced french restaurant located near raja indian cuisine in the riverside area.
"name[The Vaults], eatType[restaurant], food[French], priceRange[moderate], area[riverside], familyFriendly[yes], near[Raja Indian Cuisine]"	The vaults is a kid friendly french restaurant located near raja indian cuisine.
"name[The Vaults], eatType[restaurant], food[French], priceRange[more than £30], area[city centre], familyFriendly[no], near[Raja Indian Cuisine]"	The vaults is a french restaurant located in the city centre near raja indian cuisine. it has a price range of more than £30 and is not children friendly.
"name[The Vaults], eatType[restaurant], food[French], priceRange[more than £30], area[city centre], familyFriendly[yes], near[Raja Indian Cuisine]"	The vaults is a child friendly french restaurant in the city centre near raja indian cuisine. the price range is more than £30.
"name[The Vaults], eatType[restaurant], food[French], priceRange[more than £30], area[riverside], familyFriendly[no], near[Raja Indian Cuisine]"	The vaults is a french restaurant near raja indian cuisine in the riverside area. it is not child friendly and has a price range of more than £30.
"name[The Vaults], eatType[restaurant], food[French], priceRange[more than £30], area[riverside], familyFriendly[yes], near[Raja Indian Cuisine]"	The vaults is a child friendly french restaurant in the riverside area near raja indian cuisine.
"name[The Vaults], eatType[restaurant], food[Indian], priceRange[£20-25], area[riverside], familyFriendly[yes], near[Raja Indian Cuisine]"	The vaults is a restaurant that provides indian food in the £20-25 price range. it is located in the riverside. it is near raja indian cuisine.
"name[The Vaults], eatType[restaurant], food[Indian], priceRange[cheap], area[riverside], familyFriendly[yes], near[Raja Indian Cuisine]"	The vaults is a cheap indian restaurant near raja indian cuisine in the riverside area. it is family friendly.
"name[The Vaults], eatType[restaurant], food[Indian], priceRange[high], area[city centre], familyFriendly[no], near[Raja Indian Cuisine]"	The vaults is a high priced indian restaurant located in the city centre near raja indian cuisine.
"name[The Vaults], eatType[restaurant], food[Indian], priceRange[high], area[city centre], familyFriendly[yes], near[Raja Indian Cuisine]"	The vaults is a child friendly indian restaurant in the high price range. it is located in the city centre. it is near raja indian cuisine.
"name[The Waterman], eatType[pub], food[Indian], priceRange[high], area[city centre], familyFriendly[yes], near[Raja Indian Cuisine]"	The waterman is a high priced indian pub in the city centre near raja indian cuisine. it is children friendly.
"name[The Waterman], eatType[pub], food[Indian], priceRange[high], area[riverside], familyFriendly[no], near[Raja Indian Cuisine]"	The waterman is a high priced indian pub located in the riverside area near raja indian cuisine.
"name[The Waterman], eatType[pub], food[Indian], priceRange[high], area[riverside], familyFriendly[yes], near[Raja Indian Cuisine]"	The waterman is a child friendly pub that serves indian food in the high price range. it is located in riverside near raja indian cuisine.
"name[The Waterman], eatType[pub], food[Indian], priceRange[less than £20], area[city centre], familyFriendly[no], near[Raja Indian Cuisine]"	The waterman is a pub that serves indian food in the less than £20 price range. it is located in the city centre. it is near raja indian cuisine.
"name[The Waterman], eatType[pub], food[Indian], priceRange[less than £20], area[city centre], familyFriendly[yes], near[Raja Indian Cuisine]"	The waterman is a family friendly pub that serves indian food for less than £20. it is located in the city centre near raja indian cuisine.
"name[The Waterman], eatType[pub], food[Indian], priceRange[less than £20], area[riverside], familyFriendly[no], near[Raja Indian Cuisine]"	The waterman is a pub that provides indian food in the less than £20 price range. it is located in the riverside area near raja indian cuisine.
"name[The Waterman], eatType[pub], food[Indian], priceRange[less than £20], area[riverside], familyFriendly[yes], near[Raja Indian Cuisine]"	The waterman is a pub that provides indian food in the less than £20 price range. it is located in the riverside. it is near raja indian cuisine.
"name[The Waterman], eatType[pub], food[Indian], priceRange[moderate], area[city centre], familyFriendly[no], near[Raja Indian Cuisine]"	The waterman is a pub serving indian food in the moderate price range. it is located in the city centre. it is near raja indian cuisine.
"name[The Waterman], eatType[pub], food[Indian], priceRange[moderate], area[city centre], familyFriendly[yes], near[Raja Indian Cuisine]"	The waterman is a pub serving indian food in the moderate price range. it is located in the city centre. it is near raja indian cuisine.
"name[The Waterman], eatType[pub], food[Indian], priceRange[moderate], area[riverside], familyFriendly[no], near[Raja Indian Cuisine]"	The waterman is a pub serving indian food in the moderate price range. it is located in the riverside area near raja indian cuisine.
"name[The Waterman], eatType[pub], food[Indian], priceRange[moderate], area[riverside], familyFriendly[yes], near[Raja Indian Cuisine]"	The waterman is a pub that provides indian food in the moderate price range. it is located in the riverside area near raja indian cuisine.
"name[The Waterman], eatType[pub], food[Indian], priceRange[more than £30], area[riverside], familyFriendly[yes], near[Raja Indian Cuisine]"	The waterman is a pub that serves indian food in the more than £30 price range. it is located in the riverside. it is near raja indian cuisine.
"name[The Waterman], eatType[pub], food[Italian], priceRange[£20-25], area[riverside], familyFriendly[yes], near[Raja Indian Cuisine]"	The waterman is a kid friendly italian pub located near raja indian cuisine.
"name[The Waterman], eatType[pub], food[Italian], priceRange[cheap], area[riverside], familyFriendly[yes], near[Raja Indian Cuisine]"	The waterman is a cheap, family friendly pub located near raja indian cuisine.
"name[The Waterman], eatType[pub], food[Italian], priceRange[high], area[city centre], familyFriendly[no], near[Raja Indian Cuisine]"	The waterman is a high priced italian pub near raja indian cuisine in the city centre.
"name[The Waterman], eatType[pub], food[Italian], priceRange[high], area[city centre], familyFriendly[yes], near[Raja Indian Cuisine]"	The waterman is a child friendly italian pub in the city centre near raja indian cuisine. it has a high price range.
"name[The Waterman], eatType[pub], food[Italian], priceRange[high], area[riverside], familyFriendly[no], near[Raja Indian Cuisine]"	The waterman is a high-priced italian pub near raja indian cuisine in the riverside area.
"name[The Waterman], eatType[pub], food[Italian], priceRange[high], area[riverside], familyFriendly[yes], near[Raja Indian Cuisine]"	The waterman is a children friendly pub in the high price range. it is located near raja indian cuisine.
"name[The Waterman], eatType[pub], food[Italian], priceRange[less than £20], area[city centre], familyFriendly[no], near[Raja Indian Cuisine]"	The waterman is a pub located near raja indian cuisine in the city centre. it serves italian food for less than £20.
"name[The Waterman], eatType[pub], food[Italian], priceRange[less than £20], area[city centre], familyFriendly[yes], near[Raja Indian Cuisine]"	The waterman is a family-friendly italian pub in the city centre near raja indian cuisine. it has a price range of less than £20.
"name[The Waterman], eatType[pub], food[Italian], priceRange[less than £20], area[riverside], familyFriendly[no], near[Raja Indian Cuisine]"	The waterman is a low-priced pub near raja indian cuisine.
"name[The Waterman], eatType[restaurant], food[Indian], priceRange[high], area[city centre], familyFriendly[yes], near[Raja Indian Cuisine]"	The waterman is a child friendly indian restaurant in the high price range. it is located in the city centre. it is near raja indian cuisine.
"name[The Waterman], eatType[restaurant], food[Indian], priceRange[high], area[riverside], familyFriendly[no], near[Raja Indian Cuisine]"	The waterman is a high priced indian restaurant near raja indian cuisine in the riverside area.
"name[The Waterman], eatType[restaurant], food[Indian], priceRange[high], area[riverside], familyFriendly[yes], near[Raja Indian Cuisine]"	The waterman is a high priced indian restaurant located in the riverside area. it is near raja indian cuisine.
"name[The Waterman], eatType[restaurant], food[Indian], priceRange[less than £20], area[city centre], familyFriendly[no], near[Raja Indian Cuisine]"	The waterman is an indian restaurant in the less than £20 price range. it is located in the city centre near raja indian cuisine.
"name[The Waterman], eatType[restaurant], food[Indian], priceRange[less than £20], area[city centre], familyFriendly[yes], near[Raja Indian Cuisine]"	The waterman is a family friendly restaurant providing indian food in the less than £20 price range. it is located in the city centre. it is near raja indian cuisine.
"name[The Waterman], eatType[restaurant], food[Indian], priceRange[less than £20], area[riverside], familyFriendly[no], near[Raja Indian Cuisine]"	The waterman is a restaurant providing indian food in the low price range. it is located in the riverside area near raja indian cuisine.
"name[The Waterman], eatType[restaurant], food[Indian], priceRange[less than £20], area[riverside], familyFriendly[yes], near[Raja Indian Cuisine]"	The waterman is a restaurant providing indian food in the less than £20 price range. it is located in riverside. it is near raja indian cuisine.
"name[The Waterman], eatType[restaurant], food[Indian], priceRange[moderate], area[city centre], familyFriendly[no], near[Raja Indian Cuisine]"	The waterman is a moderately priced indian restaurant near raja indian cuisine in the city centre.
"name[The Waterman], eatType[restaurant], food[Indian], priceRange[moderate], area[city centre], familyFriendly[yes], near[Raja Indian Cuisine]"	The waterman is a moderately priced indian restaurant in the city centre near raja indian cuisine.
"name[The Waterman], eatType[restaurant], food[Indian], priceRange[moderate], area[riverside], familyFriendly[no], near[Raja Indian Cuisine]"	The waterman is a moderately priced indian restaurant near raja indian cuisine in the riverside area.
"name[The Waterman], eatType[restaurant], food[Indian], priceRange[moderate], area[riverside], familyFriendly[yes], near[Raja Indian Cuisine]"	The waterman is a kid friendly indian restaurant in the moderate price range. it is located in the riverside area near raja indian cuisine.
"name[The Waterman], eatType[restaurant], food[Indian], priceRange[more than £30], area[riverside], familyFriendly[yes], near[Raja Indian Cuisine]"	The waterman is a restaurant providing indian food in the more than £30 price range. it is located in riverside near raja indian cuisine.
"name[The Waterman], eatType[restaurant], food[Italian], priceRange[£20-25], area[riverside], familyFriendly[yes], near[Raja Indian Cuisine]"	The waterman is a kid friendly italian restaurant located near raja indian cuisine in the riverside area.
"name[The Waterman], eatType[restaurant], food[Italian], priceRange[cheap], area[riverside], familyFriendly[yes], near[Raja Indian Cuisine]"	The waterman is a cheap family friendly italian restaurant located near raja indian cuisine.
"name[The Waterman], eatType[restaurant], food[Italian], priceRange[high], area[city centre], familyFriendly[no], near[Raja Indian Cuisine]"	The waterman is a high priced italian restaurant in the city centre near raja indian cuisine. it is not children friendly.
"name[The Waterman], eatType[restaurant], food[Italian], priceRange[high], area[city centre], familyFriendly[yes], near[Raja Indian Cuisine]"	The waterman is a child friendly italian restaurant located in the city centre near raja indian cuisine. it has a high price range.
"name[The Waterman], eatType[restaurant], food[Italian], priceRange[high], area[riverside], familyFriendly[no], near[Raja Indian Cuisine]"	The waterman is a high priced italian restaurant near raja indian cuisine in the riverside area. it is not children friendly.
"name[The Waterman], eatType[restaurant], food[Italian], priceRange[high], area[riverside], familyFriendly[yes], near[Raja Indian Cuisine]"	The waterman is a child friendly italian restaurant in the riverside area near raja indian cuisine.
"name[The Waterman], eatType[restaurant], food[Italian], priceRange[less than £20], area[city centre], familyFriendly[no], near[Raja Indian Cuisine]"	The waterman is a low priced italian restaurant located in the city centre near raja indian cuisine. it is not family-friendly.
"name[The Waterman], eatType[restaurant], food[Italian], priceRange[less than £20], area[city centre], familyFriendly[yes], near[Raja Indian Cuisine]"	The waterman is a family-friendly italian restaurant in the city centre. it is near raja indian cuisine.
"name[The Waterman], eatType[restaurant], food[Italian], priceRange[less than £20], area[riverside], familyFriendly[no], near[Raja Indian Cuisine]"	The waterman is a low-priced restaurant located near raja indian cuisine.
"name[The Wrestlers], eatType[pub], food[Italian], priceRange[less than £20], area[riverside], familyFriendly[no], near[Raja Indian Cuisine]"	The wrestlers is a low-priced pub near raja indian cuisine.
"name[The Wrestlers], eatType[pub], food[Italian], priceRange[less than £20], area[riverside], familyFriendly[yes], near[Raja Indian Cuisine]"	The wrestlers is a family friendly italian pub near raja indian cuisine in the riverside area. the price range is less than £20.
"name[The Wrestlers], eatType[pub], food[Italian], priceRange[moderate], area[city centre], familyFriendly[no], near[Raja Indian Cuisine]"	The wrestlers is a moderately priced italian pub located near raja indian cuisine in the city centre.
"name[The Wrestlers], eatType[pub], food[Italian], priceRange[moderate], area[city centre], familyFriendly[yes], near[Raja Indian Cuisine]"	The wrestlers is a moderately priced italian pub located near raja indian cuisine in the city centre.
"name[The Wrestlers], eatType[pub], food[Italian], priceRange[moderate], area[riverside], familyFriendly[no], near[Raja Indian Cuisine]"	The wrestlers is a moderately priced italian pub located near raja indian cuisine.
"name[The Wrestlers], eatType[pub], food[Italian], priceRange[moderate], area[riverside], familyFriendly[yes], near[Raja Indian Cuisine]"	The wrestlers is a kid friendly italian pub in the moderate price range. it is located in the riverside area near raja indian cuisine.
"name[The Wrestlers], eatType[pub], food[Italian], priceRange[more than £30], area[riverside], familyFriendly[yes], near[Raja Indian Cuisine]"	The wrestlers is a children friendly italian pub near raja indian cuisine in the riverside area. the price range is more than £30.
"name[The Wrestlers], eatType[pub], food[Japanese], priceRange[£20-25], area[riverside], familyFriendly[yes], near[Raja Indian Cuisine]"	The wrestlers is a kid friendly japanese pub located near raja indian cuisine.
"name[The Wrestlers], eatType[pub], food[Japanese], priceRange[cheap], area[riverside], familyFriendly[yes], near[Raja Indian Cuisine]"	The wrestlers is a cheap, family friendly pub located near raja indian cuisine.
"name[The Wrestlers], eatType[pub], food[Japanese], priceRange[high], area[riverside], familyFriendly[yes], near[Raja Indian Cuisine]"	The wrestlers is a children friendly japanese pub in the high price range. it is located in the riverside area near raja indian cuisine.
"name[The Wrestlers], eatType[pub], food[Japanese], priceRange[less than £20], area[city centre], familyFriendly[no], near[Raja Indian Cuisine]"	The wrestlers is a japanese pub located near raja indian cuisine in the city centre. it is not family-friendly and has a price range of less than £20.
"name[The Wrestlers], eatType[pub], food[Japanese], priceRange[less than £20], area[city centre], familyFriendly[yes], near[Raja Indian Cuisine]"	The wrestlers is a family-friendly pub that serves japanese food for less than £20. it is located in the city centre near raja indian cuisine.
"name[The Wrestlers], eatType[pub], food[Japanese], priceRange[less than £20], area[riverside], familyFriendly[no], near[Raja Indian Cuisine]"	The wrestlers is a low-priced pub near raja indian cuisine.
"name[The Wrestlers], eatType[pub], food[Japanese], priceRange[less than £20], area[riverside], familyFriendly[yes], near[Raja Indian Cuisine]"	The wrestlers is a family friendly japanese pub near raja indian cuisine in the riverside area.
"name[The Wrestlers], eatType[pub], food[Japanese], priceRange[moderate], area[city centre], familyFriendly[no], near[Raja Indian Cuisine]"	The wrestlers is a moderately priced japanese pub located in the city centre near raja indian cuisine. it is not kid friendly.
"name[The Wrestlers], eatType[pub], food[Japanese], priceRange[moderate], area[city centre], familyFriendly[yes], near[Raja Indian Cuisine]"	The wrestlers is a kid friendly japanese pub in the city centre near raja indian cuisine. it has a moderate price range.
"name[The Wrestlers], eatType[pub], food[Japanese], priceRange[moderate], area[riverside], familyFriendly[no], near[Raja Indian Cuisine]"	The wrestlers is a moderately priced japanese pub near raja indian cuisine in the riverside area.
"name[The Wrestlers], eatType[pub], food[Japanese], priceRange[moderate], area[riverside], familyFriendly[yes], near[Raja Indian Cuisine]"	The wrestlers is a kid friendly japanese pub near raja indian cuisine in the riverside area with a moderate price range.
"name[The Wrestlers], eatType[pub], food[Japanese], priceRange[moderate], customer rating[1 out of 5], area[city centre], familyFriendly[yes], near[Raja Indian Cuisine]"	The wrestlers is a kid friendly japanese pub in the city centre near raja indian cuisine. it has a moderate price range and a customer rating of 1 out of 5.
"name[The Wrestlers], eatType[pub], food[Japanese], priceRange[moderate], customer rating[1 out of 5], area[riverside], familyFriendly[no], near[Raja Indian Cuisine]"	The wrestlers is a japanese pub near raja indian cuisine in the riverside area.
"name[The Wrestlers], eatType[pub], food[Japanese], priceRange[moderate], customer rating[1 out of 5], area[riverside], familyFriendly[yes], near[Raja Indian Cuisine]"	The wrestlers is a moderately priced japanese pub located near raja indian cuisine.
"name[The Wrestlers], eatType[pub], food[Japanese], priceRange[more than £30], area[city centre], familyFriendly[no], near[Raja Indian Cuisine]"	The wrestlers is a japanese pub near raja indian cuisine in the city centre. it has a price range of more than £30 and is not child friendly.
"name[The Wrestlers], eatType[pub], food[Japanese], priceRange[more than £30], area[city centre], familyFriendly[yes], near[Raja Indian Cuisine]"	The wrestlers is a child friendly japanese pub in the city centre near raja indian cuisine. it has a price range of more than £30.
"name[The Wrestlers], eatType[pub], food[Japanese], priceRange[more than £30], area[riverside], familyFriendly[no], near[Raja Indian Cuisine]"	The wrestlers is a japanese pub near raja indian cuisine in the riverside area. it is not children friendly and has a price range of more than £30.
"name[The Wrestlers], eatType[pub], food[Japanese], priceRange[more than £30], area[riverside], familyFriendly[yes], near[Raja Indian Cuisine]"	The wrestlers is a children friendly japanese pub near raja indian cuisine in the riverside area. the price range is more than £30.
"name[The Wrestlers], eatType[pub], food[Japanese], priceRange[more than £30], customer rating[5 out of 5], area[city centre], familyFriendly[no], near[Raja Indian Cuisine]"	The wrestlers is a japanese pub located near raja indian cuisine in the city centre. it has a customer rating of 5 out of 5 and is not child friendly.
"name[The Wrestlers], eatType[pub], food[Japanese], priceRange[more than £30], customer rating[5 out of 5], area[city centre], familyFriendly[yes], near[Raja Indian Cuisine]"	The wrestlers is a children friendly japanese pub in the city centre near raja indian cuisine. it has a customer rating of 5 out of 5 and a price range of more than £30.
"name[The Wrestlers], eatType[pub], food[Japanese], priceRange[more than £30], customer rating[5 out of 5], area[riverside], familyFriendly[no], near[Raja Indian Cuisine]"	The wrestlers is a japanese pub near raja indian cuisine in the riverside area. it is not child friendly and has a price range of more than £30.
"name[The Wrestlers], eatType[pub], food[Japanese], priceRange[more than £30], customer rating[5 out of 5], area[riverside], familyFriendly[yes], near[Raja Indian Cuisine]"	The wrestlers is a children friendly japanese pub near raja indian cuisine in the riverside area with a customer rating of 5 out of 5.
"name[The Wrestlers], eatType[pub], food[Japanese], priceRange[more than £30], customer rating[low], area[city centre], familyFriendly[no], near[Raja Indian Cuisine]"	The wrestlers is a japanese pub near raja indian cuisine in the city centre. it has a low customer rating and is not child friendly.
"name[The Wrestlers], eatType[pub], food[Japanese], priceRange[more than £30], customer rating[low], area[city centre], familyFriendly[yes], near[Raja Indian Cuisine]"	The wrestlers is a children friendly japanese pub in the city centre near raja indian cuisine. it has a price range of more than £30 and has a low customer rating.
"name[The Wrestlers], eatType[pub], food[Japanese], priceRange[more than £30], customer rating[low], area[riverside], familyFriendly[no], near[Raja Indian Cuisine]"	The wrestlers is a japanese pub near raja indian cuisine in the riverside area. it has a low customer rating and is not child friendly.
"name[The Wrestlers], eatType[pub], food[Japanese], priceRange[more than £30], customer rating[low], area[riverside], familyFriendly[yes], near[Raja Indian Cuisine]"	The wrestlers is a family friendly pub located near the raja indian cuisine.
"name[The Wrestlers], eatType[restaurant], food[Italian], priceRange[less than £20], area[riverside], familyFriendly[no], near[Raja Indian Cuisine]"	The wrestlers is a low-priced restaurant located near raja indian cuisine.
"name[The Wrestlers], eatType[restaurant], food[Italian], priceRange[less than £20], area[riverside], familyFriendly[yes], near[Raja Indian Cuisine]"	The wrestlers is a family friendly restaurant located near the raja indian cuisine.
"name[The Wrestlers], eatType[restaurant], food[Italian], priceRange[moderate], area[city centre], familyFriendly[no], near[Raja Indian Cuisine]"	The wrestlers is a moderately priced italian restaurant located near raja indian cuisine in the city centre.
"name[The Wrestlers], eatType[restaurant], food[Italian], priceRange[moderate], area[city centre], familyFriendly[yes], near[Raja Indian Cuisine]"	The wrestlers is a kid friendly italian restaurant in the moderate price range. it is located near raja indian cuisine in the city centre.
"name[The Wrestlers], eatType[restaurant], food[Italian], priceRange[moderate], area[riverside], familyFriendly[no], near[Raja Indian Cuisine]"	The wrestlers is a moderately priced italian restaurant near raja indian cuisine in the riverside area.
"name[The Wrestlers], eatType[restaurant], food[Italian], priceRange[moderate], area[riverside], familyFriendly[yes], near[Raja Indian Cuisine]"	The wrestlers is a moderately priced family friendly italian restaurant located near raja indian cuisine.
"name[The Wrestlers], eatType[restaurant], food[Italian], priceRange[more than £30], area[riverside], familyFriendly[yes], near[Raja Indian Cuisine]"	The wrestlers is a children friendly italian restaurant in the riverside area near raja indian cuisine. the price range is more than £30.
"name[The Wrestlers], eatType[restaurant], food[Japanese], priceRange[£20-25], area[riverside], familyFriendly[yes], near[Raja Indian Cuisine]"	The wrestlers is a kid-friendly japanese restaurant located near raja indian cuisine.
"name[The Wrestlers], eatType[restaurant], food[Japanese], priceRange[cheap], area[riverside], familyFriendly[yes], near[Raja Indian Cuisine]"	The wrestlers is a cheap japanese restaurant near raja indian cuisine. it is family friendly.
"name[The Wrestlers], eatType[restaurant], food[Japanese], priceRange[high], area[riverside], familyFriendly[yes], near[Raja Indian Cuisine]"	The wrestlers is a children friendly japanese restaurant near raja indian cuisine in the riverside area.
"name[The Wrestlers], eatType[restaurant], food[Japanese], priceRange[less than £20], area[city centre], familyFriendly[no], near[Raja Indian Cuisine]"	The wrestlers is a cheap japanese restaurant located in the city centre near the raja indian cuisine. it is not family-friendly.
"name[The Wrestlers], eatType[restaurant], food[Japanese], priceRange[less than £20], area[city centre], familyFriendly[yes], near[Raja Indian Cuisine]"	The wrestlers is a cheap family-friendly japanese restaurant located in the city centre near raja indian cuisine.
"name[The Wrestlers], eatType[restaurant], food[Japanese], priceRange[less than £20], area[riverside], familyFriendly[no], near[Raja Indian Cuisine]"	The wrestlers is a cheap japanese restaurant near raja indian cuisine in the riverside area.
"name[The Wrestlers], eatType[restaurant], food[Japanese], priceRange[less than £20], area[riverside], familyFriendly[yes], near[Raja Indian Cuisine]"	The wrestlers is a family friendly japanese restaurant located near raja indian cuisine.
"name[The Wrestlers], eatType[restaurant], food[Japanese], priceRange[moderate], area[city centre], familyFriendly[no], near[Raja Indian Cuisine]"	The wrestlers is a moderately priced japanese restaurant located in the city centre near raja indian cuisine.
"name[The Wrestlers], eatType[restaurant], food[Japanese], priceRange[moderate], area[city centre], familyFriendly[yes], near[Raja Indian Cuisine]"	The wrestlers is a kid friendly japanese restaurant located near raja indian cuisine in the city centre.
"name[The Wrestlers], eatType[restaurant], food[Japanese], priceRange[moderate], area[riverside], familyFriendly[no], near[Raja Indian Cuisine]"	The wrestlers is a moderately priced japanese restaurant located in riverside near raja indian cuisine.
"name[The Wrestlers], eatType[restaurant], food[Japanese], priceRange[moderate], area[riverside], familyFriendly[yes], near[Raja Indian Cuisine]"	The wrestlers is a kid friendly japanese restaurant located near raja indian cuisine in the riverside area.
"name[The Wrestlers], eatType[restaurant], food[Japanese], priceRange[more than £30], area[city centre], familyFriendly[no], near[Raja Indian Cuisine]"	The wrestlers is an expensive japanese restaurant located in the city centre near raja indian cuisine. it is not children friendly.
"name[The Wrestlers], eatType[restaurant], food[Japanese], priceRange[more than £30], area[city centre], familyFriendly[yes], near[Raja Indian Cuisine]"	The wrestlers is a family-friendly japanese restaurant located in the city centre near raja indian cuisine.
"name[The Wrestlers], eatType[restaurant], food[Japanese], priceRange[more than £30], area[riverside], familyFriendly[no], near[Raja Indian Cuisine]"	The wrestlers is a japanese restaurant in the riverside area near raja indian cuisine. it is not child friendly and has a price range of more than £30.
"name[The Wrestlers], eatType[restaurant], food[Japanese], priceRange[more than £30], area[riverside], familyFriendly[yes], near[Raja Indian Cuisine]"	The wrestlers is a children friendly japanese restaurant near raja indian cuisine in the riverside area.
"name[Wildwood], eatType[coffee shop], area[riverside]"	Wildwood is a coffee shop on the riverside.
"name[Wildwood], eatType[pub], area[riverside]"	Wildwood is a pub by the riverside.
"name[Wildwood], eatType[pub], food[French], area[riverside], familyFriendly[yes], near[Raja Indian Cuisine]"	Wildwood is a family friendly french pub in riverside.
"name[Wildwood], eatType[pub], food[Indian], area[city centre], familyFriendly[no], near[Raja Indian Cuisine]"	Wildwood is a pub that provides indian food in the city centre. it is located near raja indian cuisine.
"name[Wildwood], eatType[pub], food[Indian], area[city centre], familyFriendly[yes], near[Raja Indian Cuisine]"	Wildwood is a family friendly pub located near raja indian cuisine in the city centre.
"name[Wildwood], eatType[pub], food[Indian], area[riverside], familyFriendly[no], near[Raja Indian Cuisine]"	Wildwood is an indian pub located near raja indian cuisine in the riverside area. it is not family friendly.
"name[Wildwood], eatType[pub], food[Indian], area[riverside], familyFriendly[yes], near[Raja Indian Cuisine]"	Wildwood is a family friendly pub that serves indian food in the riverside area near raja indian cuisine.
"name[Wildwood], eatType[pub], food[Italian], area[city centre], familyFriendly[no], near[Raja Indian Cuisine]"	Wildwood is a non family-friendly italian pub in the city centre near raja indian cuisine.
"name[Wildwood], eatType[pub], food[Italian], area[city centre], familyFriendly[yes], near[Raja Indian Cuisine]"	Wildwood is a family-friendly pub that serves italian food. it is located in the city centre near raja indian cuisine.
"name[Wildwood], eatType[pub], food[Italian], area[riverside], familyFriendly[no], near[Raja Indian Cuisine]"	Wildwood is an italian pub near raja indian cuisine in riverside. it is not family-friendly.
"name[Wildwood], eatType[pub], food[Italian], area[riverside], familyFriendly[yes], near[Raja Indian Cuisine]"	Wildwood is a family friendly italian pub near raja indian cuisine in the riverside area.
"name[Wildwood], eatType[restaurant], food[French], area[riverside], familyFriendly[yes], near[Raja Indian Cuisine]"	Wildwood is a family friendly french restaurant located near raja indian cuisine.
"name[Wildwood], eatType[restaurant], food[Indian], area[city centre], familyFriendly[no], near[Raja Indian Cuisine]"	Wildwood is a restaurant providing indian food in the city centre. it is near raja indian cuisine.
"name[Wildwood], eatType[restaurant], food[Indian], area[city centre], familyFriendly[yes], near[Raja Indian Cuisine]"	Wildwood is a restaurant providing indian food it is located in the city centre. it is located near raja indian cuisine.
"name[Wildwood], eatType[restaurant], food[Indian], area[riverside], familyFriendly[no], near[Raja Indian Cuisine]"	Wildwood is an indian restaurant located in the riverside area near raja indian cuisine. it is not family friendly.
"name[Wildwood], eatType[restaurant], food[Indian], area[riverside], familyFriendly[yes], near[Raja Indian Cuisine]"	Wildwood is a restaurant providing indian food it is located in the riverside. it is located near raja indian cuisine.
"name[Wildwood], eatType[restaurant], food[Italian], area[city centre], familyFriendly[no], near[Raja Indian Cuisine]"	Wildwood is a family-friendly italian restaurant located near raja indian cuisine.
"name[Wildwood], eatType[restaurant], food[Italian], area[city centre], familyFriendly[yes], near[Raja Indian Cuisine]"	Wildwood is a family-friendly italian restaurant in the city centre near raja indian cuisine
"name[Wildwood], eatType[restaurant], food[Italian], area[riverside], familyFriendly[no], near[Raja Indian Cuisine]"	Wildwood is a italian restaurant near raja indian cuisine. it is not family-friendly.
"name[Wildwood], eatType[restaurant], food[Italian], area[riverside], familyFriendly[yes], near[Raja Indian Cuisine]"	Wildwood is a family friendly italian restaurant located near raja indian cuisine.
"name[Zizzi], eatType[coffee shop], area[riverside]"	Zizzi is a coffee shop on the riverside.
"name[Zizzi], eatType[coffee shop], customer rating[average], near[Burger King]"	Zizzi is an average rated coffee shop near burger king.
"name[Zizzi], eatType[coffee shop], customer rating[high], near[Burger King]"	Zizzi is a coffee shop near burger king with a high customer rating.
"name[Zizzi], eatType[coffee shop], near[The Sorrento]"	Zizzi is a coffee shop near the sorrento
"name[Zizzi], eatType[pub], area[riverside]"	Zizzi is a pub by the riverside.
"name[Zizzi], eatType[pub], customer rating[average], near[Burger King]"	Zizzi is an average rated pub near burger king.
"name[Zizzi], eatType[pub], customer rating[high], near[Burger King]"	Zizzi is a pub near burger king with a high customer rating.
"name[Zizzi], eatType[pub], near[The Sorrento]"	Near the sorrento is a pub called zizzi.
