"name[Blue Spice], eatType[coffee shop], area[city centre]"	Blue spice is a coffee shop located in the city centre.
"name[Blue Spice], eatType[coffee shop], area[riverside]"	Blue spice is a coffee shop in riverside.
"name[Blue Spice], eatType[coffee shop], customer rating[5 out of 5], near[Crowne Plaza Hotel]"	Blue spice is a coffee shop near the crowne plaza hotel with a customer rating of 5 out of 5.
"name[Blue Spice], eatType[coffee shop], customer rating[average], near[Burger King]"	Blue spice is a coffee shop near burger king with an average customer rating.
"name[Blue Spice], eatType[coffee shop], customer rating[average], near[Crowne Plaza Hotel]"	Near the crowne plaza hotel, blue spice is a coffee shop with an average customer rating.
"name[Blue Spice], eatType[pub], area[city centre]"	Blue spice is a pub located in the city centre.
"name[Blue Spice], eatType[pub], area[riverside]"	Blue spice is a pub in riverside.
"name[Blue Spice], eatType[pub], customer rating[5 out of 5], near[Crowne Plaza Hotel]"	Blue spice is a pub near crowne plaza hotel with a customer rating of 5 out of 5.
"name[Blue Spice], eatType[pub], customer rating[average], near[Burger King]"	Blue spice is a pub near burger king and has an average customer rating.
"name[Blue Spice], eatType[pub], customer rating[average], near[Crowne Plaza Hotel]"	Blue spice is a pub near crowne plaza hotel with an average customer rating.
"name[Blue Spice], eatType[pub], food[Chinese], area[city centre], familyFriendly[no], near[Rainbow Vegetarian Café]"	Blue spice is a pub located in the city centre near rainbow vegetarian café that serves chinese food.
"name[Blue Spice], eatType[pub], food[Chinese], area[city centre], familyFriendly[yes], near[Rainbow Vegetarian Café]"	Blue spice is a pub near rainbow vegetarian café in the city centre that serves chinese food.
"name[Blue Spice], eatType[pub], food[Chinese], area[riverside], familyFriendly[no], near[Rainbow Vegetarian Café]"	Blue spice is a pub that serves chinese food. it is located in the riverside. it is near rainbow vegetarian café.
"name[Blue Spice], eatType[pub], food[Chinese], area[riverside], familyFriendly[yes], near[Rainbow Vegetarian Café]"	Blue spice is a pub providing chinese food in the riverside area near rainbow vegetarian café.
"name[Blue Spice], eatType[pub], food[English], area[city centre], familyFriendly[no], near[Rainbow Vegetarian Café]"	Blue spice is a pub located in the city centre near rainbow vegetarian café. it serves english food and is not family-friendly.
"name[Blue Spice], eatType[pub], food[English], area[city centre], familyFriendly[yes], near[Rainbow Vegetarian Café]"	Blue spice is a family-friendly english pub located near rainbow vegetarian café.
"name[Blue Spice], eatType[pub], food[English], area[riverside], familyFriendly[no], near[Rainbow Vegetarian Café]"	Blue spice is a pub near rainbow vegetarian café in the riverside area. it is not family-friendly.
"name[Blue Spice], eatType[pub], food[English], area[riverside], familyFriendly[yes], near[Rainbow Vegetarian Café]"	Blue spice is a family friendly pub near rainbow vegetarian café.
"name[Blue Spice], eatType[restaurant], food[Chinese], area[city centre], familyFriendly[no], near[Rainbow Vegetarian Café]"	Blue spice is a chinese restaurant in the city centre near rainbow vegetarian café.
"name[Blue Spice], eatType[restaurant], food[Chinese], area[city centre], familyFriendly[yes], near[Rainbow Vegetarian Café]"	Blue spice is a chinese restaurant in the city centre near rainbow vegetarian café.
"name[Blue Spice], eatType[restaurant], food[Chinese], area[riverside], familyFriendly[no], near[Rainbow Vegetarian Café]"	Blue spice is a chinese restaurant in the riverside area near rainbow vegetarian café.
"name[Blue Spice], eatType[restaurant], food[Chinese], area[riverside], familyFriendly[yes], near[Rainbow Vegetarian Café]"	Blue spice is a chinese restaurant near rainbow vegetarian café in the riverside area.
"name[Blue Spice], eatType[restaurant], food[English], area[city centre], familyFriendly[no], near[Rainbow Vegetarian Café]"	Blue spice is a english restaurant located in the city centre near rainbow vegetarian café. it is not family-friendly.
"name[Blue Spice], eatType[restaurant], food[English], area[city centre], familyFriendly[yes], near[Rainbow Vegetarian Café]"	Blue spice is a family-friendly restaurant located in the city centre near rainbow vegetarian café.
"name[Blue Spice], eatType[restaurant], food[English], area[riverside], familyFriendly[no], near[Rainbow Vegetarian Café]"	Blue spice is a restaurant that serves english food. it is located in the riverside area near rainbow vegetarian café.
"name[Blue Spice], eatType[restaurant], food[English], area[riverside], familyFriendly[yes], near[Rainbow Vegetarian Café]"	Blue spice is a family friendly restaurant in the riverside area near rainbow vegetarian café.
"name[Clowns], eatType[coffee shop], customer rating[3 out of 5], near[All Bar One]"	Clowns is a coffee shop with a customer rating of 3 out of 5. it is located near all bar one.
"name[Clowns], eatType[coffee shop], customer rating[5 out of 5], near[Crowne Plaza Hotel]"	Clowns is a coffee shop near the crowne plaza hotel with a customer rating of 5 out of 5.
"name[Clowns], eatType[coffee shop], near[The Sorrento]"	Clowns is a coffee shop located near the sorrento.
"name[Clowns], eatType[pub], customer rating[3 out of 5], near[All Bar One]"	Clowns is a pub near all bar one with a 3 out of 5 customer rating.
"name[Clowns], eatType[pub], customer rating[5 out of 5], near[Crowne Plaza Hotel]"	Clowns is a pub near crowne plaza hotel with a customer rating of 5 out of 5.
"name[Clowns], eatType[pub], near[The Sorrento]"	Clowns is a pub located near the sorrento.
"name[Cocum], eatType[coffee shop], customer rating[high], near[Burger King]"	Cocum is a coffee shop located near burger king.
"name[Cocum], eatType[coffee shop], customer rating[high], near[Café Sicilia]"	Cocum is a coffee shop near café sicilia with high customer rating.
"name[Cocum], eatType[coffee shop], customer rating[low], near[Café Sicilia]"	Cocum is a coffee shop near café sicilia.
"name[Cocum], eatType[coffee shop], customer rating[low], near[Express by Holiday Inn]"	Cocum is a coffee shop near express by holiday inn with a low customer rating.
"name[Cocum], eatType[coffee shop], near[The Rice Boat]"	Cocum is a coffee shop located near the rice boat.
"name[Cocum], eatType[coffee shop], near[The Sorrento]"	Cocum is a coffee shop located near the sorrento.
"name[Cocum], eatType[pub], customer rating[high], near[Burger King]"	Cocum is a pub located near burger king.
"name[Cocum], eatType[pub], customer rating[high], near[Café Sicilia]"	Cocum is a pub near café sicilia.
"name[Cocum], eatType[pub], customer rating[low], near[Café Sicilia]"	Cocum is a pub located near café sicilia with a low customer rating.
"name[Cocum], eatType[pub], customer rating[low], near[Express by Holiday Inn]"	Cocum is a pub near the express by holiday inn with a low customer rating.
"name[Cocum], eatType[pub], near[The Rice Boat]"	Cocum is a pub located near the rice boat.
"name[Cocum], eatType[pub], near[The Sorrento]"	Cocum is a pub located near the sorrento.
"name[Cotto], eatType[coffee shop], near[The Bakers]"	Cotto is a coffee shop located near the bakers.
"name[Cotto], eatType[pub], near[The Bakers]"	Cotto is a pub located near the bakers.
"name[Giraffe], eatType[coffee shop], near[The Bakers]"	Giraffe is a coffee shop located near the bakers.
"name[Giraffe], eatType[coffee shop], near[The Rice Boat]"	Giraffe is a coffee shop located near the rice boat.
"name[Giraffe], eatType[pub], food[English], area[riverside], familyFriendly[yes], near[Rainbow Vegetarian Café]"	Giraffe is a family friendly pub located near rainbow vegetarian café.
"name[Giraffe], eatType[pub], food[Fast food], area[city centre], familyFriendly[no], near[Rainbow Vegetarian Café]"	Giraffe is a fast food pub in the city centre near rainbow vegetarian café. it is not family-friendly.
"name[Giraffe], eatType[pub], food[Fast food], area[city centre], familyFriendly[yes], near[Rainbow Vegetarian Café]"	Giraffe is a fast food pub located in the city centre near rainbow vegetarian café.
"name[Giraffe], eatType[pub], food[Fast food], area[riverside], familyFriendly[no], near[Rainbow Vegetarian Café]"	Giraffe is a fast food pub in the riverside area near rainbow vegetarian vegetarian. it is not family-friendly.
"name[Giraffe], eatType[pub], food[Fast food], area[riverside], familyFriendly[yes], near[Rainbow Vegetarian Café]"	Giraffe is a family friendly pub located near the rainbow vegetarian café.
"name[Giraffe], eatType[pub], food[Fast food], area[riverside], familyFriendly[yes], near[Raja Indian Cuisine]"	Giraffe is a family friendly pub located near raja indian cuisine in the riverside area.
"name[Giraffe], eatType[pub], food[French], area[city centre], familyFriendly[no], near[Raja Indian Cuisine]"	Giraffe is a pub located in the city centre near raja indian cuisine.
"name[Giraffe], eatType[pub], food[French], area[city centre], familyFriendly[yes], near[Raja Indian Cuisine]"	Giraffe is a french pub in the city centre near raja indian cuisine in the city centre.
"name[Giraffe], eatType[pub], food[French], area[riverside], familyFriendly[no], near[Raja Indian Cuisine]"	Giraffe is a pub near raja indian cuisine in riverside. it is not family-friendly.
"name[Giraffe], eatType[pub], food[French], area[riverside], familyFriendly[yes], near[Raja Indian Cuisine]"	Giraffe is a family friendly pub that serves french food. it is located near raja indian cuisine.
"name[Giraffe], eatType[pub], near[The Bakers]"	Giraffe is a pub located near the bakers.
"name[Giraffe], eatType[pub], near[The Rice Boat]"	Giraffe is a pub located near the rice boat.
"name[Giraffe], eatType[restaurant], food[English], area[riverside], familyFriendly[yes], near[Rainbow Vegetarian Café]"	Giraffe is a family friendly restaurant located in the riverside area near rainbow vegetarian café.
"name[Giraffe], eatType[restaurant], food[Fast food], area[city centre], familyFriendly[no], near[Rainbow Vegetarian Café]"	Giraffe is a fast food restaurant located in the city centre near rainbow vegetarian café.
"name[Giraffe], eatType[restaurant], food[Fast food], area[city centre], familyFriendly[yes], near[Rainbow Vegetarian Café]"	Giraffe is a family-friendly fast food restaurant in the city centre near rainbow vegetarian café.
"name[Giraffe], eatType[restaurant], food[Fast food], area[riverside], familyFriendly[no], near[Rainbow Vegetarian Café]"	Giraffe is a fast food restaurant in the riverside area near rainbow vegetarian café. it is not family-friendly.
"name[Giraffe], eatType[restaurant], food[Fast food], area[riverside], familyFriendly[yes], near[Rainbow Vegetarian Café]"	Giraffe is a fast food restaurant near rainbow vegetarian café in the riverside area.
"name[Giraffe], eatType[restaurant], food[Fast food], area[riverside], familyFriendly[yes], near[Raja Indian Cuisine]"	Giraffe is a fast food restaurant near raja indian cuisine in the riverside area.
"name[Giraffe], eatType[restaurant], food[French], area[city centre], familyFriendly[no], near[Raja Indian Cuisine]"	Giraffe is a french restaurant in the city centre near raja indian cuisine.
"name[Giraffe], eatType[restaurant], food[French], area[city centre], familyFriendly[yes], near[Raja Indian Cuisine]"	Giraffe is a french restaurant located in the city centre near raja indian cuisine.
"name[Giraffe], eatType[restaurant], food[French], area[riverside], familyFriendly[no], near[Raja Indian Cuisine]"	Giraffe is a french restaurant near raja indian cuisine in the riverside area.
"name[Giraffe], eatType[restaurant], food[French], area[riverside], familyFriendly[yes], near[Raja Indian Cuisine]"	Giraffe is a family friendly french restaurant in the riverside area.
"name[Green Man], eatType[coffee shop], customer rating[1 out of 5], near[All Bar One]"	Green man is a coffee shop near all bar one with a customer rating of 1 out of 5.
"name[Green Man], eatType[coffee shop], customer rating[3 out of 5], near[All Bar One]"	Green man is a coffee shop near all bar one and has a customer rating of 3 out of 5.
"name[Green Man], eatType[pub], customer rating[1 out of 5], near[All Bar One]"	Green man is a pub near all bar one with a 1 out of 5 customer rating.
"name[Green Man], eatType[pub], customer rating[3 out of 5], near[All Bar One]"	Green man is a pub near all bar one with a 3 out of 5 customer rating.
"name[Green Man], eatType[pub], food[Italian], area[riverside], familyFriendly[yes], near[Express by Holiday Inn]"	Green man is a family friendly pub located near express by holiday inn.
"name[Green Man], eatType[pub], food[Italian], area[riverside], familyFriendly[yes], near[Raja Indian Cuisine]"	Green man is a family friendly pub located near raja indian cuisine in riverside.
"name[Green Man], eatType[pub], food[Japanese], area[city centre], familyFriendly[no], near[Express by Holiday Inn]"	Green man is a pub located in the city centre near express by holiday inn. it serves japanese food and is not family-friendly.
"name[Green Man], eatType[pub], food[Japanese], area[city centre], familyFriendly[yes], near[Express by Holiday Inn]"	Green man is a family-friendly pub located near express by holiday inn in the city centre.
"name[Green Man], eatType[pub], food[Japanese], area[riverside], familyFriendly[no], near[Express by Holiday Inn]"	Green man is a pub near express by holiday inn in the riverside area. it serves japanese food and is not family-friendly.
"name[Green Man], eatType[pub], food[Japanese], area[riverside], familyFriendly[yes], near[Express by Holiday Inn]"	Green man is a pub near express by holiday inn in riverside. it serves japanese food and is child friendly.
"name[Green Man], eatType[restaurant], food[Italian], area[riverside], familyFriendly[yes], near[Express by Holiday Inn]"	Green man is a family friendly restaurant located near express by holiday inn in the riverside area.
"name[Green Man], eatType[restaurant], food[Italian], area[riverside], familyFriendly[yes], near[Raja Indian Cuisine]"	Green man is a family friendly restaurant in the riverside area near raja indian cuisine.
"name[Green Man], eatType[restaurant], food[Japanese], area[city centre], familyFriendly[no], near[Express by Holiday Inn]"	Green man is a japanese restaurant located in the city centre near express by holiday inn.
"name[Green Man], eatType[restaurant], food[Japanese], area[city centre], familyFriendly[yes], near[Express by Holiday Inn]"	Green man is a japanese restaurant in the city centre near express by holiday inn.
"name[Green Man], eatType[restaurant], food[Japanese], area[riverside], familyFriendly[no], near[Express by Holiday Inn]"	Green man is a japanese restaurant located in the riverside area near express by holiday inn.
"name[Green Man], eatType[restaurant], food[Japanese], area[riverside], familyFriendly[yes], near[Express by Holiday Inn]"	Green man is a japanese restaurant located near express by holiday inn in riverside.
"name[Loch Fyne], eatType[coffee shop], area[riverside]"	Loch fyne is a coffee shop in riverside.
"name[Loch Fyne], eatType[pub], area[riverside]"	Loch fyne is a pub in riverside.
"name[Strada], eatType[coffee shop], area[city centre]"	Strada is a coffee shop located in the city centre.
"name[Strada], eatType[coffee shop], customer rating[1 out of 5], near[All Bar One]"	Strada is a coffee shop with a customer rating of 1 out of 5 and is located near all bar one.
"name[Strada], eatType[coffee shop], customer rating[1 out of 5], near[Rainbow Vegetarian Café]"	Strada is a coffee shop with a customer rating of 1 out of 5 and is near rainbow vegetarian café.
"name[Strada], eatType[coffee shop], customer rating[low], near[Express by Holiday Inn]"	Strada is a coffee shop near the express by holiday inn.
"name[Strada], eatType[pub], area[city centre]"	Strada is a pub located in the city centre.
"name[Strada], eatType[pub], customer rating[1 out of 5], near[All Bar One]"	Strada is a pub near all bar one with a 1 out of 5 customer rating.
"name[Strada], eatType[pub], customer rating[1 out of 5], near[Rainbow Vegetarian Café]"	Strada is a pub near the rainbow vegetarian café with a customer rating of 1 out of 5.
"name[Strada], eatType[pub], customer rating[low], near[Express by Holiday Inn]"	Strada is a pub near the express by holiday inn with a low customer rating.
"name[The Cricketers], eatType[coffee shop], customer rating[1 out of 5], familyFriendly[yes], near[Avalon]"	The cricketers is a family friendly coffee shop near avalon. it has a customer rating of 1 out of 5.
"name[The Cricketers], eatType[coffee shop], customer rating[3 out of 5], familyFriendly[yes], near[Avalon]"	The cricketers is a kid friendly coffee shop near avalon.
"name[The Cricketers], eatType[coffee shop], customer rating[3 out of 5], familyFriendly[yes], near[Crowne Plaza Hotel]"	The cricketers is a family friendly coffee shop near crowne plaza hotel. it has a customer rating of 3 out of 5.
"name[The Cricketers], eatType[coffee shop], customer rating[5 out of 5], familyFriendly[no], near[Crowne Plaza Hotel]"	The cricketers is a coffee shop near crowne plaza hotel. it has a customer rating of 5 out of 5 and is not family-friendly.
"name[The Cricketers], eatType[coffee shop], customer rating[5 out of 5], familyFriendly[yes], near[Crowne Plaza Hotel]"	The cricketers is a family friendly coffee shop near the crowne plaza hotel with a customer rating of 5 out of 5.
"name[The Cricketers], eatType[coffee shop], customer rating[average], familyFriendly[no], near[Café Sicilia]"	The cricketers is a coffee shop located near café sicilia. it is not family-friendly and has an average customer rating.
"name[The Cricketers], eatType[coffee shop], customer rating[average], familyFriendly[no], near[Crowne Plaza Hotel]"	The cricketers is a coffee shop near crowne plaza hotel. it has an average customer rating and is not family-friendly.
"name[The Cricketers], eatType[coffee shop], customer rating[average], familyFriendly[yes], near[Café Sicilia]"	The cricketers is a family friendly coffee shop near café sicilia. it has an average customer rating.
"name[The Cricketers], eatType[coffee shop], customer rating[high], familyFriendly[yes], near[Café Sicilia]"	The cricketers is a family friendly coffee shop near café sicilia with a high customer rating.
"name[The Cricketers], eatType[coffee shop], customer rating[high], familyFriendly[yes], near[Express by Holiday Inn]"	The cricketers is a child friendly coffee shop near express by holiday inn.
"name[The Cricketers], eatType[coffee shop], customer rating[low], familyFriendly[no], near[Express by Holiday Inn]"	The cricketers is a coffee shop near express by holiday inn. it has a low customer rating and is not family-friendly.
"name[The Cricketers], eatType[coffee shop], customer rating[low], familyFriendly[no], near[Ranch]"	The cricketers is a coffee shop near ranch. it is not family-friendly and has a low customer rating.
"name[The Cricketers], eatType[coffee shop], customer rating[low], familyFriendly[yes], near[Ranch]"	The cricketers is a family friendly coffee shop near ranch. it has a low customer rating.
"name[The Cricketers], eatType[restaurant], customer rating[1 out of 5], familyFriendly[yes], near[Avalon]"	The cricketers is a kid friendly restaurant with a customer rating of 1 out of 5.
"name[The Cricketers], eatType[restaurant], customer rating[3 out of 5], familyFriendly[yes], near[Avalon]"	The cricketers is a kid friendly restaurant with a customer rating of 3 out of 5.
"name[The Cricketers], eatType[restaurant], customer rating[3 out of 5], familyFriendly[yes], near[Crowne Plaza Hotel]"	The cricketers is a family friendly restaurant located near the crowne plaza hotel.
"name[The Cricketers], eatType[restaurant], customer rating[5 out of 5], familyFriendly[no], near[Crowne Plaza Hotel]"	The cricketers is a restaurant near the crowne plaza hotel. it is not family-friendly.
"name[The Cricketers], eatType[restaurant], customer rating[5 out of 5], familyFriendly[yes], near[Crowne Plaza Hotel]"	The cricketers is a family friendly restaurant located near the crowne plaza hotel.
"name[The Cricketers], eatType[restaurant], customer rating[average], familyFriendly[no], near[Café Sicilia]"	The cricketers is a restaurant near café sicilia that is not family-friendly.
"name[The Cricketers], eatType[restaurant], customer rating[average], familyFriendly[no], near[Crowne Plaza Hotel]"	The cricketers is a restaurant near the crowne plaza hotel. it has an average customer rating and is not family-friendly.
"name[The Cricketers], eatType[restaurant], customer rating[average], familyFriendly[yes], near[Café Sicilia]"	The cricketers is a family friendly restaurant located near café sicilia.
"name[The Cricketers], eatType[restaurant], customer rating[high], familyFriendly[yes], near[Café Sicilia]"	The cricketers is a children friendly restaurant near café sicilia.
"name[The Cricketers], eatType[restaurant], customer rating[high], familyFriendly[yes], near[Express by Holiday Inn]"	The cricketers is a child friendly restaurant located near express by holiday inn.
"name[The Cricketers], eatType[restaurant], customer rating[low], familyFriendly[no], near[Express by Holiday Inn]"	The cricketers is a restaurant near express by holiday inn. it is not family-friendly and has a low customer rating.
"name[The Cricketers], eatType[restaurant], customer rating[low], familyFriendly[no], near[Ranch]"	The cricketers is a low rated restaurant located near ranch.
"name[The Cricketers], eatType[restaurant], customer rating[low], familyFriendly[yes], near[Ranch]"	The cricketers is a family friendly restaurant located near ranch.
"name[The Cricketers], eatType[restaurant], food[Chinese], priceRange[£20-25], customer rating[high], area[city centre], familyFriendly[no], near[All Bar One]"	The cricketers is a high rated chinese restaurant located in the city centre near all bar one.
"name[The Cricketers], eatType[restaurant], food[Chinese], priceRange[£20-25], customer rating[high], area[city centre], familyFriendly[yes], near[All Bar One]"	The cricketers is a kid friendly chinese restaurant located in the city centre near all bar one.
"name[The Cricketers], eatType[restaurant], food[Chinese], priceRange[£20-25], customer rating[high], area[riverside], familyFriendly[no], near[All Bar One]"	The cricketers is a restaurant providing chinese food in the £20-25 price range. it is located in the riverside. its customer rating is high.
"name[The Cricketers], eatType[restaurant], food[Chinese], priceRange[£20-25], customer rating[high], area[riverside], familyFriendly[yes], near[All Bar One]"	The cricketers is a kid friendly chinese restaurant located near all bar one.
"name[The Cricketers], eatType[restaurant], food[Chinese], priceRange[cheap], customer rating[5 out of 5], area[city centre], familyFriendly[no], near[All Bar One]"	The cricketers is a restaurant providing chinese food in the cheap price range. it is located in the city centre. it is near all bar one.
"name[The Cricketers], eatType[restaurant], food[Chinese], priceRange[cheap], customer rating[5 out of 5], area[city centre], familyFriendly[yes], near[All Bar One]"	The cricketers is a family friendly chinese restaurant located in the city centre near all bar one.
"name[The Cricketers], eatType[restaurant], food[Chinese], priceRange[cheap], customer rating[5 out of 5], area[riverside], familyFriendly[no], near[All Bar One]"	The cricketers is a restaurant providing chinese food in the cheap price range. it is located near all bar one. its customer rating is 5 out of 5.
"name[The Cricketers], eatType[restaurant], food[Chinese], priceRange[cheap], customer rating[5 out of 5], area[riverside], familyFriendly[yes], near[All Bar One]"	The cricketers is a cheap, family friendly chinese restaurant near all bar one.
"name[The Cricketers], eatType[restaurant], food[Chinese], priceRange[cheap], customer rating[average], area[city centre], familyFriendly[no], near[All Bar One]"	The cricketers is a cheap chinese restaurant located near all bar one in the city centre.
"name[The Cricketers], eatType[restaurant], food[Chinese], priceRange[cheap], customer rating[average], area[city centre], familyFriendly[yes], near[All Bar One]"	The cricketers is a cheap chinese restaurant located in the city centre near all bar one.
"name[The Cricketers], eatType[restaurant], food[Chinese], priceRange[cheap], customer rating[average], area[riverside], familyFriendly[no], near[All Bar One]"	The cricketers is a cheap chinese restaurant located in riverside near all bar one.
"name[The Cricketers], eatType[restaurant], food[Chinese], priceRange[cheap], customer rating[average], area[riverside], familyFriendly[yes], near[All Bar One]"	The cricketers is a family friendly chinese restaurant located near all bar one.
"name[The Cricketers], eatType[restaurant], food[Chinese], priceRange[high], customer rating[1 out of 5], area[city centre], familyFriendly[no], near[All Bar One]"	The cricketers is a restaurant providing chinese food in the high price range. it is located in the city centre. its customer rating is 1 out of 5.
"name[The Cricketers], eatType[restaurant], food[Chinese], priceRange[high], customer rating[1 out of 5], area[city centre], familyFriendly[yes], near[All Bar One]"	The cricketers is a restaurant providing chinese food in the high price range. it is near all bar one. its customer rating is 1 out of 5.
"name[The Cricketers], eatType[restaurant], food[Chinese], priceRange[high], customer rating[1 out of 5], area[riverside], familyFriendly[no], near[All Bar One]"	The cricketers is a restaurant providing chinese food in the high price range. it is located in the riverside. it is near all bar one. its customer rating is 1 out of 5.
"name[The Cricketers], eatType[restaurant], food[Chinese], priceRange[high], customer rating[1 out of 5], area[riverside], familyFriendly[yes], near[All Bar One]"	The cricketers is a restaurant providing chinese food in the high price range. it is located in the riverside. it is near all bar one. its customer rating is 1 out of 5.
"name[The Cricketers], eatType[restaurant], food[Chinese], priceRange[high], customer rating[average], area[city centre], familyFriendly[no], near[All Bar One]"	The cricketers is a restaurant providing chinese food in the high price range. it is located in the city centre. it is near all bar one.
"name[The Cricketers], eatType[restaurant], food[Chinese], priceRange[high], customer rating[average], area[city centre], familyFriendly[yes], near[All Bar One]"	The cricketers is a restaurant providing chinese food in the high price range. it is located in the city centre. it is near all bar bar.
"name[The Cricketers], eatType[restaurant], food[Chinese], priceRange[high], customer rating[average], area[riverside], familyFriendly[no], near[All Bar One]"	The cricketers is a restaurant providing chinese food in the high price range. it is located in the riverside. it is near all bar one. its customer rating is average.
"name[The Cricketers], eatType[restaurant], food[Chinese], priceRange[high], customer rating[average], area[riverside], familyFriendly[yes], near[All Bar One]"	The cricketers is a restaurant providing chinese food in the high price range. it is located in the riverside. it is near all bar one.
"name[The Cricketers], eatType[restaurant], food[Chinese], priceRange[less than £20], customer rating[low], area[city centre], familyFriendly[no], near[All Bar One]"	The cricketers is a chinese restaurant located in the city centre near all bar one. it has a low customer rating.
"name[The Cricketers], eatType[restaurant], food[Chinese], priceRange[less than £20], customer rating[low], area[city centre], familyFriendly[yes], near[All Bar One]"	The cricketers is a family friendly chinese restaurant in the city centre near all bar one.
"name[The Cricketers], eatType[restaurant], food[Chinese], priceRange[less than £20], customer rating[low], area[riverside], familyFriendly[no], near[All Bar One]"	The cricketers is a chinese restaurant in the riverside area near all bar one. it has a low customer rating and is not family friendly.
"name[The Cricketers], eatType[restaurant], food[Chinese], priceRange[less than £20], customer rating[low], area[riverside], familyFriendly[yes], near[All Bar One]"	The cricketers is a family friendly chinese restaurant in the riverside area near all bar one.
"name[The Cricketers], eatType[restaurant], food[Chinese], priceRange[moderate], customer rating[1 out of 5], area[city centre], familyFriendly[no], near[All Bar One]"	The cricketers is a restaurant providing chinese food in the moderate price range. it is located in the city centre. it is near all bar one.
"name[The Cricketers], eatType[restaurant], food[Chinese], priceRange[moderate], customer rating[1 out of 5], area[city centre], familyFriendly[yes], near[All Bar One]"	The cricketers is a restaurant providing chinese food in the moderate price range. it is near all bar one in the city centre.
"name[The Cricketers], eatType[restaurant], food[Chinese], priceRange[moderate], customer rating[1 out of 5], area[riverside], familyFriendly[no], near[All Bar One]"	The cricketers is a restaurant providing chinese food in the moderate price range. it is located in the riverside. its customer rating is 1 out of 5.
"name[The Cricketers], eatType[restaurant], food[Chinese], priceRange[moderate], customer rating[1 out of 5], area[riverside], familyFriendly[yes], near[All Bar One]"	The cricketers is a restaurant providing chinese food in the moderate price range. it is located in the riverside. its customer rating is 1 out of 5.
"name[The Cricketers], eatType[restaurant], food[Chinese], priceRange[moderate], customer rating[3 out of 5], area[city centre], familyFriendly[no], near[All Bar One]"	The cricketers is a restaurant providing chinese food in the moderate price range. it is near all bar one. its customer rating is 3 out of 5.
"name[The Cricketers], eatType[restaurant], food[Chinese], priceRange[moderate], customer rating[3 out of 5], area[city centre], familyFriendly[yes], near[All Bar One]"	The cricketers is a restaurant providing chinese food in the moderate price range. it is located in the city centre. it is near all bar one. its customer rating is 3 out of 5.
"name[The Cricketers], eatType[restaurant], food[Chinese], priceRange[moderate], customer rating[3 out of 5], area[riverside], familyFriendly[no], near[All Bar One]"	The cricketers is a restaurant providing chinese food in the moderate price range. it is located in the riverside.
"name[The Cricketers], eatType[restaurant], food[Chinese], priceRange[moderate], customer rating[3 out of 5], area[riverside], familyFriendly[yes], near[All Bar One]"	The cricketers is a restaurant providing chinese food in the moderate price range. it is located in the riverside.
"name[The Cricketers], eatType[restaurant], food[Chinese], priceRange[more than £30], customer rating[high], area[city centre], familyFriendly[no], near[All Bar One]"	The cricketers is a restaurant providing chinese food in the more than £30 price range. it is located in the city centre. it is near all bar one.
"name[The Cricketers], eatType[restaurant], food[Chinese], priceRange[more than £30], customer rating[high], area[city centre], familyFriendly[yes], near[All Bar One]"	The cricketers is a child friendly chinese restaurant in the city centre near all bar one.
"name[The Cricketers], eatType[restaurant], food[Chinese], priceRange[more than £30], customer rating[high], area[riverside], familyFriendly[no], near[All Bar One]"	The cricketers is a restaurant providing chinese food in the more than £30 price range. it is near all bar one.
"name[The Cricketers], eatType[restaurant], food[Chinese], priceRange[more than £30], customer rating[high], area[riverside], familyFriendly[yes], near[All Bar One]"	The cricketers is a children friendly chinese restaurant in the riverside area near all bar one.
"name[The Cricketers], eatType[restaurant], food[English], priceRange[£20-25], customer rating[high], area[city centre], familyFriendly[no], near[All Bar One]"	The cricketers is a restaurant providing english food in the £20-25 price range. it is located in the city centre near all bar one.
"name[The Cricketers], eatType[restaurant], food[English], priceRange[£20-25], customer rating[high], area[city centre], familyFriendly[yes], near[All Bar One]"	The cricketers is a family-friendly restaurant located near all bar one.
"name[The Cricketers], eatType[restaurant], food[English], priceRange[£20-25], customer rating[high], area[riverside], familyFriendly[no], near[All Bar One]"	The cricketers is a restaurant providing english food in the £20-25 price range. it is near all bar one.
"name[The Cricketers], eatType[restaurant], food[English], priceRange[£20-25], customer rating[high], area[riverside], familyFriendly[yes], near[All Bar One]"	The cricketers is a kid friendly english restaurant located near all bar one.
"name[The Cricketers], eatType[restaurant], food[English], priceRange[cheap], customer rating[5 out of 5], area[city centre], familyFriendly[no], near[Café Rouge]"	The cricketers is a cheap english restaurant in the city centre near café rouge. it is not family-friendly.
"name[The Cricketers], eatType[restaurant], food[English], priceRange[cheap], customer rating[5 out of 5], area[city centre], familyFriendly[yes], near[Café Rouge]"	The cricketers is a cheap, family-friendly restaurant in the city centre near café rouge.
"name[The Cricketers], eatType[restaurant], food[English], priceRange[cheap], customer rating[5 out of 5], area[riverside], familyFriendly[no], near[Café Rouge]"	The cricketers is a cheap, family-friendly english restaurant located near café rouge.
"name[The Cricketers], eatType[restaurant], food[English], priceRange[cheap], customer rating[5 out of 5], area[riverside], familyFriendly[yes], near[Café Rouge]"	The cricketers is a cheap, family friendly restaurant located near café rouge.
"name[The Cricketers], eatType[restaurant], food[English], priceRange[cheap], customer rating[average], area[city centre], familyFriendly[no], near[Café Rouge]"	The cricketers is a cheap english restaurant located in the city centre near café rouge. it is not family-friendly.
"name[The Cricketers], eatType[restaurant], food[English], priceRange[cheap], customer rating[average], area[city centre], familyFriendly[yes], near[Café Rouge]"	The cricketers is a cheap family-friendly restaurant located in the city centre near café rouge.
"name[The Cricketers], eatType[restaurant], food[English], priceRange[cheap], customer rating[average], area[riverside], familyFriendly[no], near[Café Rouge]"	The cricketers is a cheap, family-friendly restaurant located near café rouge.
"name[The Cricketers], eatType[restaurant], food[English], priceRange[cheap], customer rating[average], area[riverside], familyFriendly[yes], near[Café Rouge]"	The cricketers is a cheap, family friendly restaurant located near café rouge.
"name[The Cricketers], eatType[restaurant], food[English], priceRange[high], customer rating[1 out of 5], area[city centre], familyFriendly[no], near[Café Rouge]"	The cricketers is a high-priced english restaurant located in the city centre near café rouge.
"name[The Cricketers], eatType[restaurant], food[English], priceRange[high], customer rating[1 out of 5], area[city centre], familyFriendly[yes], near[Café Rouge]"	The cricketers is a high priced english restaurant in the city centre near café rouge.
"name[The Cricketers], eatType[restaurant], food[English], priceRange[high], customer rating[1 out of 5], area[riverside], familyFriendly[no], near[Café Rouge]"	The cricketers is a high priced english restaurant located near café rouge.
"name[The Cricketers], eatType[restaurant], food[English], priceRange[high], customer rating[1 out of 5], area[riverside], familyFriendly[yes], near[Café Rouge]"	The cricketers is a high priced, family friendly restaurant located near café rouge.
"name[The Cricketers], eatType[restaurant], food[English], priceRange[high], customer rating[average], area[city centre], familyFriendly[no], near[Café Rouge]"	The cricketers is a high-priced english restaurant located in the city centre near café rouge.
"name[The Cricketers], eatType[restaurant], food[English], priceRange[high], customer rating[average], area[city centre], familyFriendly[yes], near[Café Rouge]"	The cricketers is a high priced english restaurant in the city centre near café rouge.
"name[The Cricketers], eatType[restaurant], food[English], priceRange[high], customer rating[average], area[riverside], familyFriendly[no], near[Café Rouge]"	The cricketers is a high priced english restaurant located near café rouge.
"name[The Mill], eatType[pub], food[English], priceRange[high], area[riverside], familyFriendly[yes], near[Raja Indian Cuisine]"	The mill is a pub that serves english food in the high price range. it is located near raja indian cuisine in the riverside area.
"name[The Mill], eatType[pub], food[English], priceRange[less than £20], area[city centre], familyFriendly[no], near[Raja Indian Cuisine]"	The mill is a pub providing english food in the less than £20 price range. it is located in the city centre near raja indian cuisine.
"name[The Mill], eatType[pub], food[English], priceRange[less than £20], area[city centre], familyFriendly[yes], near[Raja Indian Cuisine]"	The mill is a family-friendly pub serving english food in the less than £20 price range. it is located in the city centre.
"name[The Mill], eatType[pub], food[English], priceRange[less than £20], area[riverside], familyFriendly[no], near[Raja Indian Cuisine]"	The mill is a pub that serves english food in the less than £20 price range. it is located near raja indian cuisine in the riverside area.
"name[The Mill], eatType[pub], food[English], priceRange[less than £20], area[riverside], familyFriendly[yes], near[Raja Indian Cuisine]"	The mill is a family friendly pub located near raja indian cuisine in riverside.
"name[The Mill], eatType[pub], food[English], priceRange[moderate], area[city centre], familyFriendly[no], near[Raja Indian Cuisine]"	The mill is a pub that serves english food in the moderate price range. it is located in the city centre near raja indian cuisine.
"name[The Mill], eatType[pub], food[English], priceRange[moderate], area[city centre], familyFriendly[yes], near[Raja Indian Cuisine]"	The mill is a moderately priced english pub located near raja raja indian cuisine in the city centre.
"name[The Mill], eatType[pub], food[English], priceRange[moderate], area[riverside], familyFriendly[no], near[Raja Indian Cuisine]"	The mill is a pub serving english food in the moderate price range. it is located near raja indian cuisine.
"name[The Mill], eatType[pub], food[English], priceRange[moderate], area[riverside], familyFriendly[yes], near[Raja Indian Cuisine]"	The mill is a kid friendly pub located near raja indian cuisine in riverside.
"name[The Mill], eatType[pub], food[English], priceRange[more than £30], area[riverside], familyFriendly[yes], near[Raja Indian Cuisine]"	The mill is a pub that serves english food in the more than £30 price range. it is located near raja indian cuisine.
"name[The Mill], eatType[pub], food[Fast food], priceRange[£20-25], area[riverside], familyFriendly[yes], near[Raja Indian Cuisine]"	The mill is a kid friendly pub located near raja indian cuisine in riverside.
"name[The Mill], eatType[pub], food[Fast food], priceRange[£20-25], customer rating[high], area[city centre], familyFriendly[no], near[Café Rouge]"	The mill is a pub providing fast food in the £20-25 price range. it is located near café rouge in the city centre.
"name[The Mill], eatType[pub], food[Fast food], priceRange[£20-25], customer rating[high], area[city centre], familyFriendly[yes], near[Café Rouge]"	The mill is a fast food pub in the city centre near café rouge. it has a high customer rating and a price range of £20-25.
"name[The Mill], eatType[pub], food[Fast food], priceRange[£20-25], customer rating[high], area[riverside], familyFriendly[no], near[Café Rouge]"	The mill is a fast food pub in the riverside area near café rouge with a price range of £20-25.
"name[The Mill], eatType[pub], food[Fast food], priceRange[£20-25], customer rating[high], area[riverside], familyFriendly[yes], near[Café Rouge]"	The mill is a fast food pub near café rouge in the riverside area. it has a high customer rating and a price range of £20-25.
"name[The Mill], eatType[pub], food[Fast food], priceRange[£20-25], customer rating[high], area[riverside], familyFriendly[yes], near[Café Sicilia]"	The mill is a fast food pub in the riverside area near café sicilia. it is kid friendly and has a high customer rating.
"name[The Mill], eatType[pub], food[Fast food], priceRange[cheap], area[riverside], familyFriendly[yes], near[Raja Indian Cuisine]"	The mill is a family friendly pub located near raja indian cuisine.
"name[The Mill], eatType[pub], food[Fast food], priceRange[cheap], customer rating[5 out of 5], area[city centre], familyFriendly[no], near[Café Sicilia]"	The mill is a cheap fast food pub located in the city centre near café sicilia. it has a customer rating of 5 out of 5.
"name[The Mill], eatType[pub], food[Fast food], priceRange[cheap], customer rating[5 out of 5], area[city centre], familyFriendly[yes], near[Café Sicilia]"	The mill is a cheap fast food pub in the city centre near café sicilia. its customer rating is 5 out of 5.
"name[The Mill], eatType[pub], food[Fast food], priceRange[cheap], customer rating[5 out of 5], area[riverside], familyFriendly[no], near[Café Sicilia]"	The mill is a cheap fast food pub located in the riverside area near café sicilia. it is not family-friendly.
"name[The Mill], eatType[pub], food[Fast food], priceRange[cheap], customer rating[5 out of 5], area[riverside], familyFriendly[yes], near[Café Sicilia]"	The mill is a cheap, family-friendly pub located near café sicilia.
"name[The Mill], eatType[pub], food[Fast food], priceRange[cheap], customer rating[average], area[city centre], familyFriendly[no], near[Café Sicilia]"	The mill is a cheap fast food pub located in the city centre near café sicilia. it has an average customer rating.
"name[The Mill], eatType[pub], food[Fast food], priceRange[cheap], customer rating[average], area[city centre], familyFriendly[yes], near[Café Sicilia]"	The mill is a cheap fast food pub in the city centre near café sicilia.
"name[The Mill], eatType[pub], food[Fast food], priceRange[cheap], customer rating[average], area[riverside], familyFriendly[no], near[Café Sicilia]"	The mill is a cheap fast food pub near café sicilia in the riverside area. it has an average customer rating.
"name[The Mill], eatType[pub], food[Fast food], priceRange[cheap], customer rating[average], area[riverside], familyFriendly[yes], near[Café Sicilia]"	The mill is a cheap, family friendly pub located near café sicilia.
"name[The Mill], eatType[pub], food[Fast food], priceRange[high], customer rating[1 out of 5], area[city centre], familyFriendly[no], near[Café Sicilia]"	The mill is a fast food pub in the high price range. it is located in the city centre near café sicilia. its customer rating is 1 out of 5.
"name[The Mill], eatType[pub], food[Fast food], priceRange[high], customer rating[1 out of 5], area[city centre], familyFriendly[yes], near[Café Sicilia]"	The mill is a fast food pub in the city centre near café sicilia. it has a customer rating of 1 out of 5.
"name[The Mill], eatType[pub], food[Fast food], priceRange[high], customer rating[1 out of 5], area[riverside], familyFriendly[no], near[Café Sicilia]"	The mill is a fast food pub in the riverside area near café sicilia. it is not child friendly and has a customer rating of 1 out of 5.
"name[The Mill], eatType[pub], food[Fast food], priceRange[high], customer rating[1 out of 5], area[riverside], familyFriendly[yes], near[Café Sicilia]"	The mill is a pub that serves fast food in the high price range. it is located near café sicilia.
"name[The Mill], eatType[pub], food[Fast food], priceRange[high], customer rating[average], area[city centre], familyFriendly[no], near[Café Sicilia]"	The mill is a high priced fast food pub located in the city centre near café sicilia. it is not child friendly.
"name[The Mill], eatType[pub], food[Fast food], priceRange[high], customer rating[average], area[city centre], familyFriendly[yes], near[Café Sicilia]"	The mill is a fast food pub in the city centre near café sicilia. it is children friendly and has an average customer rating.
"name[The Mill], eatType[pub], food[Fast food], priceRange[high], customer rating[average], area[riverside], familyFriendly[no], near[Café Sicilia]"	The mill is a fast food pub in the riverside area near café sicilia. it is not child friendly and has an average customer rating.
"name[The Mill], eatType[pub], food[Fast food], priceRange[high], customer rating[average], area[riverside], familyFriendly[yes], near[Café Sicilia]"	The mill is a fast food pub in the high price range. it is located in the riverside area near café sicilia.
"name[The Mill], eatType[pub], food[Fast food], priceRange[less than £20], customer rating[low], area[city centre], familyFriendly[no], near[Café Sicilia]"	The mill is a fast food pub located in the city centre near café sicilia. it has a low customer rating and is not family-friendly.
"name[The Mill], eatType[pub], food[Fast food], priceRange[less than £20], customer rating[low], area[city centre], familyFriendly[yes], near[Café Sicilia]"	The mill is a family-friendly fast food pub located in the city centre near café sicilia with a low customer rating.
"name[The Mill], eatType[pub], food[Fast food], priceRange[less than £20], customer rating[low], area[riverside], familyFriendly[no], near[Café Sicilia]"	The mill is a fast food pub near café sicilia in the riverside area. it is not family-friendly and has a low customer rating.
"name[The Mill], eatType[pub], food[Fast food], priceRange[less than £20], customer rating[low], area[riverside], familyFriendly[yes], near[Café Sicilia]"	The mill is a family-friendly pub located near café sicilia.
"name[The Mill], eatType[pub], food[Fast food], priceRange[moderate], customer rating[1 out of 5], area[city centre], familyFriendly[no], near[Café Sicilia]"	The mill is a fast food pub in the moderate price range. it is located near café sicilia in the city centre.
"name[The Mill], eatType[pub], food[Fast food], priceRange[moderate], customer rating[1 out of 5], area[city centre], familyFriendly[yes], near[Café Sicilia]"	The mill is a fast food pub located near café sicilia in the city centre. it is kid friendly and has a customer rating of 1 out of 5.
"name[The Mill], eatType[pub], food[Fast food], priceRange[moderate], customer rating[1 out of 5], area[riverside], familyFriendly[no], near[Café Sicilia]"	The mill is a moderately priced fast food pub in the riverside area near café sicilia. it has a customer rating of 1 out of 5.
"name[The Mill], eatType[pub], food[Fast food], priceRange[moderate], customer rating[1 out of 5], area[riverside], familyFriendly[yes], near[Café Sicilia]"	The mill is a fast food pub in the riverside area near café café sicilia. it is kid friendly and has a customer rating of 1 out of 5.
"name[The Mill], eatType[pub], food[Fast food], priceRange[moderate], customer rating[3 out of 5], area[city centre], familyFriendly[no], near[Café Sicilia]"	The mill is a moderately priced fast food pub located in the city centre near café sicilia. it is not kid friendly.
"name[The Mill], eatType[pub], food[Fast food], priceRange[moderate], customer rating[3 out of 5], area[city centre], familyFriendly[yes], near[Café Sicilia]"	The mill is a fast food pub located in the city centre near café sicilia. it is kid friendly and has a customer rating of 3 out of 5.
"name[The Mill], eatType[pub], food[Fast food], priceRange[moderate], customer rating[3 out of 5], area[riverside], familyFriendly[no], near[Café Sicilia]"	The mill is a fast food pub in the moderate price range. it is located near café sicilia.
"name[The Mill], eatType[pub], food[Fast food], priceRange[moderate], customer rating[3 out of 5], area[riverside], familyFriendly[yes], near[Café Sicilia]"	The mill is a kid friendly pub in the moderate price range. it is located near café sicilia.
"name[The Mill], eatType[restaurant], food[English], priceRange[high], area[riverside], familyFriendly[yes], near[Raja Indian Cuisine]"	The mill is a high priced english restaurant in riverside near raja indian cuisine.
"name[The Mill], eatType[restaurant], food[English], priceRange[high], customer rating[average], area[riverside], familyFriendly[yes], near[Café Rouge]"	The mill is a high priced english restaurant located near café rouge.
"name[The Mill], eatType[restaurant], food[English], priceRange[less than £20], area[city centre], familyFriendly[no], near[Raja Indian Cuisine]"	The mill is a english restaurant in the city centre near raja indian cuisine.
"name[The Mill], eatType[restaurant], food[English], priceRange[less than £20], area[city centre], familyFriendly[yes], near[Raja Indian Cuisine]"	The mill is a family-friendly restaurant located in the city centre near raja indian cuisine.
"name[The Mill], eatType[restaurant], food[English], priceRange[less than £20], area[riverside], familyFriendly[no], near[Raja Indian Cuisine]"	The mill is a english restaurant located in the riverside area near raja indian cuisine.
"name[The Mill], eatType[restaurant], food[English], priceRange[less than £20], area[riverside], familyFriendly[yes], near[Raja Indian Cuisine]"	The mill is a family friendly restaurant located near raja indian cuisine in the riverside area.
"name[The Mill], eatType[restaurant], food[English], priceRange[less than £20], customer rating[low], area[city centre], familyFriendly[no], near[Café Rouge]"	The mill is a cheap english restaurant located in the city centre near café rouge. it is not family-friendly.
"name[The Mill], eatType[restaurant], food[English], priceRange[less than £20], customer rating[low], area[city centre], familyFriendly[yes], near[Café Rouge]"	The mill is a family-friendly restaurant located in the city centre near café rouge.
"name[The Mill], eatType[restaurant], food[English], priceRange[less than £20], customer rating[low], area[riverside], familyFriendly[no], near[Café Rouge]"	The mill is a low priced restaurant located near café rouge.
"name[The Mill], eatType[restaurant], food[English], priceRange[less than £20], customer rating[low], area[riverside], familyFriendly[yes], near[Café Rouge]"	The mill is a low-priced restaurant located near café rouge.
"name[The Mill], eatType[restaurant], food[English], priceRange[moderate], area[city centre], familyFriendly[no], near[Raja Indian Cuisine]"	The mill is a moderately priced english restaurant in the city centre near raja indian cuisine.
"name[The Mill], eatType[restaurant], food[English], priceRange[moderate], area[city centre], familyFriendly[yes], near[Raja Indian Cuisine]"	The mill is a moderately priced english restaurant located in the city centre near raja indian cuisine.
"name[The Mill], eatType[restaurant], food[English], priceRange[moderate], area[riverside], familyFriendly[no], near[Raja Indian Cuisine]"	The mill is a moderately priced english restaurant located in riverside near raja indian cuisine.
"name[The Mill], eatType[restaurant], food[English], priceRange[moderate], area[riverside], familyFriendly[yes], near[Raja Indian Cuisine]"	The mill is a moderately priced english restaurant in riverside near raja indian cuisine.
"name[The Mill], eatType[restaurant], food[English], priceRange[moderate], customer rating[1 out of 5], area[city centre], familyFriendly[no], near[Café Rouge]"	The mill is a moderate priced english restaurant located in the city centre near café rouge.
"name[The Mill], eatType[restaurant], food[English], priceRange[moderate], customer rating[1 out of 5], area[city centre], familyFriendly[yes], near[Café Rouge]"	The mill is a moderately priced english restaurant in the city centre near café rouge.
"name[The Mill], eatType[restaurant], food[English], priceRange[moderate], customer rating[1 out of 5], area[riverside], familyFriendly[no], near[Café Rouge]"	The mill is a moderately priced english restaurant located in the riverside area near café rouge.
"name[The Mill], eatType[restaurant], food[English], priceRange[moderate], customer rating[1 out of 5], area[riverside], familyFriendly[yes], near[Café Rouge]"	The mill is a moderately priced restaurant located near café rouge.
"name[The Mill], eatType[restaurant], food[English], priceRange[moderate], customer rating[3 out of 5], area[city centre], familyFriendly[no], near[Café Rouge]"	The mill is a moderately priced english restaurant in the city centre near café rouge.
"name[The Mill], eatType[restaurant], food[English], priceRange[moderate], customer rating[3 out of 5], area[city centre], familyFriendly[yes], near[Café Rouge]"	The mill is a moderately priced english restaurant in the city centre near café rouge.
"name[The Mill], eatType[restaurant], food[English], priceRange[moderate], customer rating[3 out of 5], area[riverside], familyFriendly[no], near[Café Rouge]"	The mill is a moderately priced english restaurant located in riverside near café rouge.
"name[The Mill], eatType[restaurant], food[English], priceRange[moderate], customer rating[3 out of 5], area[riverside], familyFriendly[yes], near[Café Rouge]"	The mill is a moderately priced, family friendly restaurant located near café rouge.
"name[The Mill], eatType[restaurant], food[English], priceRange[more than £30], area[riverside], familyFriendly[yes], near[Raja Indian Cuisine]"	The mill is a family friendly restaurant located in the riverside area near raja indian cuisine.
"name[The Mill], eatType[restaurant], food[English], priceRange[more than £30], customer rating[high], area[city centre], familyFriendly[no], near[Café Rouge]"	The mill is a english restaurant in the more than £30 price range. it is located near café rouge in the city centre.
"name[The Mill], eatType[restaurant], food[English], priceRange[more than £30], customer rating[high], area[city centre], familyFriendly[yes], near[Café Rouge]"	The mill is a children friendly english restaurant located in the city centre near café rouge.
"name[The Mill], eatType[restaurant], food[English], priceRange[more than £30], customer rating[high], area[riverside], familyFriendly[no], near[Café Rouge]"	The mill is a high-priced restaurant located near café rouge.
"name[The Mill], eatType[restaurant], food[English], priceRange[more than £30], customer rating[high], area[riverside], familyFriendly[yes], near[Café Rouge]"	The mill is a high-priced restaurant located near café rouge.
"name[The Mill], eatType[restaurant], food[Fast food], priceRange[£20-25], area[riverside], familyFriendly[yes], near[Raja Indian Cuisine]"	The mill is a kid friendly fast food restaurant in the riverside area.
"name[The Mill], eatType[restaurant], food[Fast food], priceRange[cheap], area[riverside], familyFriendly[yes], near[Raja Indian Cuisine]"	The mill is a family friendly fast food restaurant in the riverside area.
"name[The Phoenix], eatType[pub], food[Fast food], priceRange[cheap], area[riverside], familyFriendly[yes], near[Raja Indian Cuisine]"	The phoenix is a cheap, family friendly fast food pub near raja indian cuisine.
"name[The Phoenix], eatType[pub], food[Fast food], priceRange[high], area[city centre], familyFriendly[no], near[Raja Indian Cuisine]"	The phoenix is a pub providing fast food in the high price range. it is located in the city centre near raja indian cuisine.
"name[The Phoenix], eatType[pub], food[Fast food], priceRange[high], area[city centre], familyFriendly[yes], near[Raja Indian Cuisine]"	The phoenix is a high priced fast food pub located in the city centre near raja indian cuisine.
"name[The Phoenix], eatType[pub], food[Fast food], priceRange[high], area[riverside], familyFriendly[no], near[Raja Indian Cuisine]"	The phoenix is a pub providing fast food in the high price range. it is located near raja indian cuisine.
"name[The Phoenix], eatType[pub], food[Fast food], priceRange[high], area[riverside], familyFriendly[yes], near[Raja Indian Cuisine]"	The phoenix is a fast food pub located near raja indian cuisine in the riverside area.
"name[The Phoenix], eatType[pub], food[Fast food], priceRange[less than £20], area[city centre], familyFriendly[no], near[Raja Indian Cuisine]"	The phoenix is a fast food pub located in the city centre near raja indian cuisine. it is not family-friendly.
"name[The Phoenix], eatType[pub], food[Fast food], priceRange[less than £20], area[city centre], familyFriendly[yes], near[Raja Indian Cuisine]"	The phoenix is a family-friendly fast food pub located near raja indian cuisine in the city centre.
"name[The Phoenix], eatType[pub], food[Fast food], priceRange[less than £20], area[riverside], familyFriendly[no], near[Raja Indian Cuisine]"	The phoenix is a fast food pub located near raja indian cuisine in the riverside area.
"name[The Phoenix], eatType[pub], food[Fast food], priceRange[less than £20], area[riverside], familyFriendly[yes], near[Raja Indian Cuisine]"	The phoenix is a family friendly fast food pub near raja indian cuisine in riverside.
"name[The Phoenix], eatType[pub], food[Fast food], priceRange[moderate], area[city centre], familyFriendly[no], near[Raja Indian Cuisine]"	The phoenix is a fast food pub in the moderate price range. it is located near raja indian cuisine in the city centre.
"name[The Phoenix], eatType[pub], food[Fast food], priceRange[moderate], area[city centre], familyFriendly[yes], near[Raja Indian Cuisine]"	The phoenix is a moderately priced fast food pub in the city centre near raja indian cuisine.
"name[The Phoenix], eatType[pub], food[Fast food], priceRange[moderate], area[riverside], familyFriendly[no], near[Raja Indian Cuisine]"	The phoenix is a fast food pub in the moderate price range. it is located near raja indian cuisine in the riverside area.
"name[The Phoenix], eatType[pub], food[Fast food], priceRange[moderate], area[riverside], familyFriendly[yes], near[Raja Indian Cuisine]"	The phoenix is a moderately priced fast food pub in the riverside area near raja indian cuisine.
"name[The Phoenix], eatType[pub], food[Fast food], priceRange[moderate], customer rating[3 out of 5], area[riverside], familyFriendly[yes], near[Café Sicilia]"	The phoenix is a moderately priced pub located near café café sicilia.
"name[The Phoenix], eatType[pub], food[Fast food], priceRange[more than £30], area[riverside], familyFriendly[yes], near[Raja Indian Cuisine]"	The phoenix is a fast food pub located near raja indian cuisine in the riverside area.
"name[The Phoenix], eatType[pub], food[Fast food], priceRange[more than £30], customer rating[high], area[city centre], familyFriendly[no], near[Café Sicilia]"	The phoenix is a fast food pub in the more than £30 price range. it is located in the city centre. it is near café sicilia.
"name[The Phoenix], eatType[pub], food[Fast food], priceRange[more than £30], customer rating[high], area[city centre], familyFriendly[yes], near[Café Sicilia]"	The phoenix is a pub located in the city centre near café sicilia. it serves fast food and is child friendly.
"name[The Phoenix], eatType[pub], food[Fast food], priceRange[more than £30], customer rating[high], area[riverside], familyFriendly[no], near[Café Sicilia]"	The phoenix is a fast food pub in the riverside area near café sicilia. it has a high customer rating and is not child friendly.
"name[The Phoenix], eatType[pub], food[Fast food], priceRange[more than £30], customer rating[high], area[riverside], familyFriendly[yes], near[Café Sicilia]"	The phoenix is a family friendly pub located near café sicilia.
"name[The Phoenix], eatType[pub], food[French], priceRange[£20-25], area[riverside], familyFriendly[yes], near[Raja Indian Cuisine]"	The phoenix is a family friendly pub located near raja indian cuisine.
"name[The Phoenix], eatType[pub], food[French], priceRange[£20-25], customer rating[3 out of 5], area[city centre], familyFriendly[no], near[Café Sicilia]"	The phoenix is a french pub located in the city centre near café sicilia with a customer rating of 3 out of 5.
"name[The Phoenix], eatType[pub], food[French], priceRange[£20-25], customer rating[3 out of 5], area[city centre], familyFriendly[yes], near[Café Sicilia]"	The phoenix is a french pub located in the city centre near café sicilia. it is kid friendly and has a customer rating of 3 out of 5.
"name[The Phoenix], eatType[pub], food[French], priceRange[£20-25], customer rating[3 out of 5], area[riverside], familyFriendly[no], near[Café Sicilia]"	The phoenix is a french pub located in the riverside area near café sicilia. it is not kid friendly and has a customer rating of 3 out of 5.
"name[The Phoenix], eatType[pub], food[French], priceRange[£20-25], customer rating[3 out of 5], area[riverside], familyFriendly[yes], near[Café Sicilia]"	The phoenix is a family friendly pub located in the riverside area near café sicilia.
"name[The Phoenix], eatType[pub], food[French], priceRange[£20-25], customer rating[3 out of 5], area[riverside], familyFriendly[yes], near[Crowne Plaza Hotel]"	The phoenix is a family friendly pub located near the crowne plaza hotel.
"name[The Phoenix], eatType[pub], food[French], priceRange[£20-25], customer rating[high], area[city centre], familyFriendly[no], near[Crowne Plaza Hotel]"	The phoenix is a pub providing french food in the £20-25 price range. it is located in the city centre near crowne plaza hotel.
"name[The Phoenix], eatType[pub], food[French], priceRange[£20-25], customer rating[high], area[city centre], familyFriendly[yes], near[Crowne Plaza Hotel]"	The phoenix is a family-friendly french pub located in the city centre near the crowne plaza hotel with a high customer rating.
"name[The Phoenix], eatType[pub], food[French], priceRange[£20-25], customer rating[high], area[riverside], familyFriendly[no], near[Crowne Plaza Hotel]"	The phoenix is a pub that serves french food in the £20-25 price range. it is located in the riverside. it is near crowne plaza hotel.
"name[The Phoenix], eatType[pub], food[French], priceRange[£20-25], customer rating[high], area[riverside], familyFriendly[yes], near[Crowne Plaza Hotel]"	The phoenix is a family friendly pub located near the crowne plaza plaza hotel.
"name[The Phoenix], eatType[pub], food[French], priceRange[cheap], area[riverside], familyFriendly[yes], near[Raja Indian Cuisine]"	The phoenix is a cheap, family-friendly pub located near raja indian cuisine.
"name[The Phoenix], eatType[pub], food[French], priceRange[cheap], customer rating[5 out of 5], area[city centre], familyFriendly[no], near[Crowne Plaza Hotel]"	The phoenix is a cheap french pub located in the city centre near crowne plaza hotel. it is not family-friendly.
"name[The Phoenix], eatType[pub], food[French], priceRange[cheap], customer rating[5 out of 5], area[city centre], familyFriendly[yes], near[Crowne Plaza Hotel]"	The phoenix is a cheap french pub in the city centre near crowne plaza hotel. it has a customer rating of 5 out of 5.
"name[The Phoenix], eatType[pub], food[French], priceRange[cheap], customer rating[5 out of 5], area[riverside], familyFriendly[no], near[Crowne Plaza Hotel]"	The phoenix is a cheap french pub located near the crowne plaza hotel in the riverside area. it is not family-friendly.
"name[The Phoenix], eatType[pub], food[French], priceRange[cheap], customer rating[5 out of 5], area[riverside], familyFriendly[yes], near[Crowne Plaza Hotel]"	The phoenix is a cheap, family friendly pub located near crowne plaza hotel in the riverside area.
"name[The Phoenix], eatType[pub], food[French], priceRange[high], area[riverside], familyFriendly[yes], near[Raja Indian Cuisine]"	The phoenix is a children friendly french pub near raja indian cuisine in riverside.
"name[The Phoenix], eatType[pub], food[French], priceRange[high], customer rating[3 out of 5], area[city centre], familyFriendly[no], near[Crowne Plaza Hotel]"	The phoenix is a french pub located in the city centre near the crowne plaza hotel. it is not children friendly and has a customer rating of 3 out of 5.
"name[The Phoenix], eatType[pub], food[French], priceRange[high], customer rating[3 out of 5], area[city centre], familyFriendly[yes], near[Crowne Plaza Hotel]"	The phoenix is a french pub in the city centre near the crowne plaza hotel. it is child friendly and has a customer rating of 3 out of 5.
"name[The Phoenix], eatType[pub], food[French], priceRange[high], customer rating[3 out of 5], area[riverside], familyFriendly[no], near[Crowne Plaza Hotel]"	The phoenix is a pub that serves french food in the high price range. it is located in the riverside area near the crowne plaza hotel.
"name[The Phoenix], eatType[pub], food[French], priceRange[high], customer rating[3 out of 5], area[riverside], familyFriendly[yes], near[Crowne Plaza Hotel]"	The phoenix is a children friendly pub located near the crowne plaza hotel.
"name[The Phoenix], eatType[pub], food[French], priceRange[less than £20], customer rating[average], area[city centre], familyFriendly[no], near[Crowne Plaza Hotel]"	The phoenix is a french pub in the city centre near the crowne plaza hotel. it is not family-friendly and has an average customer rating.
"name[The Phoenix], eatType[pub], food[French], priceRange[less than £20], customer rating[average], area[city centre], familyFriendly[yes], near[Crowne Plaza Hotel]"	The phoenix is a family-friendly french pub located in the city centre near the crowne plaza hotel.
"name[The Phoenix], eatType[pub], food[French], priceRange[less than £20], customer rating[average], area[riverside], familyFriendly[no], near[Crowne Plaza Hotel]"	The phoenix is a french pub located in the riverside area near the crowne plaza hotel. it is not family-friendly and has an average customer rating.
"name[The Phoenix], eatType[pub], food[French], priceRange[less than £20], customer rating[average], area[riverside], familyFriendly[yes], near[Crowne Plaza Hotel]"	The phoenix is a family friendly pub located near the crowne plaza hotel.
"name[The Phoenix], eatType[pub], food[French], priceRange[less than £20], customer rating[low], area[city centre], familyFriendly[no], near[Crowne Plaza Hotel]"	The phoenix is a french pub located in the city centre near the crowne plaza hotel. it has a low customer rating and is not family-friendly.
"name[The Phoenix], eatType[pub], food[French], priceRange[less than £20], customer rating[low], area[city centre], familyFriendly[yes], near[Crowne Plaza Hotel]"	The phoenix is a family-friendly pub located in the city centre near crowne plaza hotel. it serves french food and has a low customer rating.
"name[The Phoenix], eatType[pub], food[French], priceRange[less than £20], customer rating[low], area[riverside], familyFriendly[no], near[Crowne Plaza Hotel]"	The phoenix is a french pub near the crowne plaza hotel in the riverside area. it has a low customer rating and is not family-friendly.
"name[The Phoenix], eatType[pub], food[French], priceRange[less than £20], customer rating[low], area[riverside], familyFriendly[yes], near[Crowne Plaza Hotel]"	The phoenix is a family friendly pub located near the crowne plaza plaza hotel.
"name[The Phoenix], eatType[pub], food[French], priceRange[moderate], customer rating[1 out of 5], area[city centre], familyFriendly[no], near[Crowne Plaza Hotel]"	The phoenix is a pub that serves french food in the moderate price range. it is located in the city centre near the crowne plaza hotel.
"name[The Phoenix], eatType[pub], food[French], priceRange[moderate], customer rating[1 out of 5], area[city centre], familyFriendly[yes], near[Crowne Plaza Hotel]"	The phoenix is a family-friendly pub located near the crowne plaza hotel in the city centre. it serves french food and has a customer rating of 1 out of 5.
"name[The Phoenix], eatType[pub], food[French], priceRange[moderate], customer rating[1 out of 5], area[riverside], familyFriendly[no], near[Crowne Plaza Hotel]"	The phoenix is a pub near the crowne plaza hotel in the riverside area. it serves french food and is not kid friendly.
"name[The Phoenix], eatType[pub], food[French], priceRange[moderate], customer rating[1 out of 5], area[riverside], familyFriendly[yes], near[Crowne Plaza Hotel]"	The phoenix is a family friendly pub located near the crowne plaza hotel.
"name[The Phoenix], eatType[pub], food[French], priceRange[more than £30], customer rating[5 out of 5], area[city centre], familyFriendly[no], near[Crowne Plaza Hotel]"	The phoenix is a pub providing french food in the more than £30 price range. it is located in the city centre near crowne plaza hotel.
"name[The Phoenix], eatType[pub], food[French], priceRange[more than £30], customer rating[5 out of 5], area[city centre], familyFriendly[yes], near[Crowne Plaza Hotel]"	The phoenix is a family-friendly french pub located in the city centre near the crowne plaza hotel.
"name[The Phoenix], eatType[pub], food[French], priceRange[more than £30], customer rating[5 out of 5], area[riverside], familyFriendly[no], near[Crowne Plaza Hotel]"	The phoenix is a french pub in the more than £30 price range. it is located near crowne plaza hotel.
"name[The Phoenix], eatType[pub], food[French], priceRange[more than £30], customer rating[5 out of 5], area[riverside], familyFriendly[yes], near[Crowne Plaza Hotel]"	The phoenix is a children friendly pub located near the crowne crowne plaza hotel.
"name[The Phoenix], eatType[pub], food[French], priceRange[more than £30], customer rating[low], area[city centre], familyFriendly[no], near[Crowne Plaza Hotel]"	The phoenix is a pub providing french food in the more than £30 price range. it is located near the crowne plaza hotel in the city centre.
"name[The Phoenix], eatType[pub], food[French], priceRange[more than £30], customer rating[low], area[city centre], familyFriendly[yes], near[Crowne Plaza Hotel]"	The phoenix is a family-friendly french pub located in the city centre near the crowne plaza hotel. it has a low customer rating.
"name[The Phoenix], eatType[pub], food[French], priceRange[more than £30], customer rating[low], area[riverside], familyFriendly[no], near[Crowne Plaza Hotel]"	The phoenix is a french pub located in the riverside area near the crowne plaza hotel. it is not child friendly and has a low customer rating.
"name[The Phoenix], eatType[pub], food[French], priceRange[more than £30], customer rating[low], area[riverside], familyFriendly[yes], near[Crowne Plaza Hotel]"	The phoenix is a family-friendly pub located near the crowne plaza hotel.
"name[The Phoenix], eatType[restaurant], food[Fast food], priceRange[cheap], area[riverside], familyFriendly[yes], near[Raja Indian Cuisine]"	The phoenix is a cheap, family friendly fast food restaurant in the riverside area.
"name[The Phoenix], eatType[restaurant], food[Fast food], priceRange[high], area[city centre], familyFriendly[no], near[Raja Indian Cuisine]"	The phoenix is a high priced fast food restaurant in the city centre near raja indian cuisine.
"name[The Phoenix], eatType[restaurant], food[Fast food], priceRange[high], area[city centre], familyFriendly[yes], near[Raja Indian Cuisine]"	The phoenix is a fast food restaurant located in the city centre near raja indian cuisine.
"name[The Phoenix], eatType[restaurant], food[Fast food], priceRange[high], area[riverside], familyFriendly[no], near[Raja Indian Cuisine]"	The phoenix is a fast food restaurant located in the riverside area near raja indian cuisine.
"name[The Phoenix], eatType[restaurant], food[Fast food], priceRange[high], area[riverside], familyFriendly[yes], near[Raja Indian Cuisine]"	The phoenix is a fast food restaurant located near raja indian cuisine in riverside.
"name[The Phoenix], eatType[restaurant], food[Fast food], priceRange[less than £20], area[city centre], familyFriendly[no], near[Raja Indian Cuisine]"	The phoenix is a fast food restaurant near raja indian cuisine in the city centre.
"name[The Phoenix], eatType[restaurant], food[Fast food], priceRange[less than £20], area[city centre], familyFriendly[yes], near[Raja Indian Cuisine]"	The phoenix is a family-friendly fast food restaurant located in the city centre near raja indian cuisine.
"name[The Phoenix], eatType[restaurant], food[Fast food], priceRange[less than £20], area[riverside], familyFriendly[no], near[Raja Indian Cuisine]"	The phoenix is a fast food restaurant near raja indian cuisine in the riverside area.
"name[The Phoenix], eatType[restaurant], food[Fast food], priceRange[less than £20], area[riverside], familyFriendly[yes], near[Raja Indian Cuisine]"	The phoenix is a family friendly fast food restaurant in the riverside area.
"name[The Phoenix], eatType[restaurant], food[Fast food], priceRange[moderate], area[city centre], familyFriendly[no], near[Raja Indian Cuisine]"	The phoenix is a moderately priced fast food restaurant located in the city centre near raja indian cuisine.
"name[The Phoenix], eatType[restaurant], food[Fast food], priceRange[moderate], area[city centre], familyFriendly[yes], near[Raja Indian Cuisine]"	The phoenix is a fast food restaurant in the city centre near raja indian cuisine.
"name[The Phoenix], eatType[restaurant], food[Fast food], priceRange[moderate], area[riverside], familyFriendly[no], near[Raja Indian Cuisine]"	The phoenix is a moderately priced fast food restaurant located in the riverside area near raja indian cuisine.
"name[The Phoenix], eatType[restaurant], food[Fast food], priceRange[moderate], area[riverside], familyFriendly[yes], near[Raja Indian Cuisine]"	The phoenix is a fast food restaurant in the riverside area near raja indian cuisine.
"name[The Phoenix], eatType[restaurant], food[Fast food], priceRange[more than £30], area[riverside], familyFriendly[yes], near[Raja Indian Cuisine]"	The phoenix is a child friendly fast food restaurant in the riverside area near raja indian cuisine.
"name[The Phoenix], eatType[restaurant], food[French], priceRange[£20-25], area[riverside], familyFriendly[yes], near[Raja Indian Cuisine]"	The phoenix is a family friendly french restaurant in the riverside area.
"name[The Phoenix], eatType[restaurant], food[French], priceRange[cheap], area[riverside], familyFriendly[yes], near[Raja Indian Cuisine]"	The phoenix is a cheap, family friendly french restaurant near raja indian cuisine.
"name[The Phoenix], eatType[restaurant], food[French], priceRange[high], area[riverside], familyFriendly[yes], near[Raja Indian Cuisine]"	The phoenix is a high-priced french restaurant in the riverside area near raja indian cuisine.
"name[The Phoenix], eatType[restaurant], food[Indian], priceRange[£20-25], customer rating[high], area[city centre], familyFriendly[no], near[Crowne Plaza Hotel]"	The phoenix is a restaurant providing indian food in the £20-25 price range. it is located in the city centre. it is near crowne plaza hotel.
"name[The Phoenix], eatType[restaurant], food[Indian], priceRange[£20-25], customer rating[high], area[city centre], familyFriendly[yes], near[Crowne Plaza Hotel]"	The phoenix is a restaurant providing indian food in the £20-25 price range. it is located in the city centre. its customer rating is high.
"name[The Phoenix], eatType[restaurant], food[Indian], priceRange[£20-25], customer rating[high], area[riverside], familyFriendly[no], near[Crowne Plaza Hotel]"	The phoenix is a restaurant that serves indian food in the £20-25 price range. it is located in the riverside. it is near crowne plaza hotel.
"name[The Phoenix], eatType[restaurant], food[Indian], priceRange[£20-25], customer rating[high], area[riverside], familyFriendly[yes], near[Crowne Plaza Hotel]"	The phoenix is a restaurant providing indian food in the £20-25 price range. it is located in the riverside. it is near crowne plaza hotel. its customer rating is high.
"name[The Phoenix], eatType[restaurant], food[Indian], priceRange[cheap], customer rating[5 out of 5], area[city centre], familyFriendly[no], near[Crowne Plaza Hotel]"	The phoenix is a cheap indian restaurant located in the city centre near the crowne plaza hotel.
"name[The Phoenix], eatType[restaurant], food[Indian], priceRange[cheap], customer rating[5 out of 5], area[city centre], familyFriendly[yes], near[Crowne Plaza Hotel]"	The phoenix is a cheap, family friendly indian restaurant located in the city centre.
"name[The Phoenix], eatType[restaurant], food[Indian], priceRange[cheap], customer rating[5 out of 5], area[riverside], familyFriendly[no], near[Crowne Plaza Hotel]"	The phoenix is a restaurant providing indian food in the cheap price range. it is located in the riverside. its customer rating is 5 out of 5.
"name[The Phoenix], eatType[restaurant], food[Indian], priceRange[cheap], customer rating[5 out of 5], area[riverside], familyFriendly[no], near[Express by Holiday Inn]"	The phoenix is a cheap indian restaurant in the riverside area near express by holiday inn. its customer rating is 5 out of 5.
"name[The Phoenix], eatType[restaurant], food[Indian], priceRange[cheap], customer rating[5 out of 5], area[riverside], familyFriendly[yes], near[Express by Holiday Inn]"	The phoenix is a restaurant providing indian food in the cheap price range. it is located in the riverside. it is near express by holiday inn. its customer rating is 5 out of 5.
"name[The Phoenix], eatType[restaurant], food[Indian], priceRange[cheap], customer rating[average], area[city centre], familyFriendly[no], near[Express by Holiday Inn]"	The phoenix is a cheap indian restaurant in the city centre near express by holiday inn. it has an average customer rating.
"name[The Plough], eatType[pub], food[Chinese], priceRange[£20-25], area[riverside], familyFriendly[yes], near[Raja Indian Cuisine]"	The plough is a pub providing chinese food in the £20-25 price range. it is located in the riverside. it is near raja indian cuisine.
"name[The Plough], eatType[pub], food[Chinese], priceRange[cheap], area[riverside], familyFriendly[yes], near[Raja Indian Cuisine]"	The plough is a pub that serves chinese food in the cheap price range. it is located in the riverside. it is near raja indian cuisine.
"name[The Plough], eatType[pub], food[Chinese], priceRange[high], area[city centre], familyFriendly[no], near[Raja Indian Cuisine]"	The plough is a pub serving chinese food in the high price range. it is located in the city centre. it is near raja indian cuisine.
"name[The Plough], eatType[pub], food[Chinese], priceRange[high], area[city centre], familyFriendly[yes], near[Raja Indian Cuisine]"	The plough is a pub that serves chinese food in the high price range. it is located in the city centre. it is near raja indian cuisine.
"name[The Plough], eatType[pub], food[Chinese], priceRange[high], area[riverside], familyFriendly[no], near[Raja Indian Cuisine]"	The plough is a pub that serves chinese food in the high price range. it is located in the riverside. it is near raja indian cuisine.
"name[The Plough], eatType[pub], food[Chinese], priceRange[high], area[riverside], familyFriendly[yes], near[Raja Indian Cuisine]"	The plough is a pub that serves chinese food in the high price range. it is located in the riverside. it is near raja indian cuisine.
"name[The Plough], eatType[pub], food[Chinese], priceRange[less than £20], area[city centre], familyFriendly[no], near[Raja Indian Cuisine]"	The plough is a pub that serves chinese food in the less than £20 price range. it is located in the city centre and is not family friendly.
"name[The Plough], eatType[restaurant], food[Chinese], priceRange[£20-25], area[riverside], familyFriendly[yes], near[Raja Indian Cuisine]"	The plough is a chinese restaurant located in riverside near raja indian cuisine.
"name[The Plough], eatType[restaurant], food[Chinese], priceRange[cheap], area[riverside], familyFriendly[yes], near[Raja Indian Cuisine]"	The plough is a cheap chinese restaurant in riverside near raja indian cuisine.
"name[The Plough], eatType[restaurant], food[Chinese], priceRange[high], area[city centre], familyFriendly[no], near[Raja Indian Cuisine]"	The plough is a chinese restaurant located in the city centre near raja indian cuisine.
"name[The Plough], eatType[restaurant], food[Chinese], priceRange[high], area[city centre], familyFriendly[yes], near[Raja Indian Cuisine]"	The plough is a chinese restaurant in the city centre near raja indian cuisine.
"name[The Plough], eatType[restaurant], food[Chinese], priceRange[high], area[riverside], familyFriendly[no], near[Raja Indian Cuisine]"	The plough is a restaurant providing chinese food in the high price range. it is located in the riverside. it is near raja indian cuisine.
"name[The Plough], eatType[restaurant], food[Chinese], priceRange[high], area[riverside], familyFriendly[yes], near[Raja Indian Cuisine]"	The plough is a high priced chinese restaurant in the riverside area near raja indian cuisine.
"name[The Plough], eatType[restaurant], food[Chinese], priceRange[less than £20], area[city centre], familyFriendly[no], near[Raja Indian Cuisine]"	The plough is a chinese restaurant located in the city centre near raja indian cuisine.
"name[The Punter], eatType[pub], food[Chinese], priceRange[less than £20], area[city centre], familyFriendly[yes], near[Raja Indian Cuisine]"	The punter is a pub that serves chinese food in the less than £20 price range. it is located in the city centre.
"name[The Punter], eatType[pub], food[Chinese], priceRange[less than £20], area[riverside], familyFriendly[no], near[Raja Indian Cuisine]"	The punter is a pub that serves chinese food in the less than £20 price range. it is located in the riverside. it is near raja indian cuisine.
"name[The Punter], eatType[pub], food[Chinese], priceRange[less than £20], area[riverside], familyFriendly[yes], near[Raja Indian Cuisine]"	The punter is a pub providing chinese food in the less than £20 price range. it is located in the riverside. it is near raja indian cuisine.
"name[The Punter], eatType[pub], food[Chinese], priceRange[moderate], area[city centre], familyFriendly[no], near[Raja Indian Cuisine]"	The punter is a pub providing chinese food in the moderate price range. it is located in the city centre and is not kid friendly.
"name[The Punter], eatType[pub], food[Chinese], priceRange[moderate], area[city centre], familyFriendly[yes], near[Raja Indian Cuisine]"	The punter is a pub providing chinese food in the moderate price range. it is located in the city centre.
"name[The Punter], eatType[pub], food[Chinese], priceRange[moderate], area[riverside], familyFriendly[no], near[Raja Indian Cuisine]"	The punter is a pub providing chinese food in the moderate price range. it is located in the riverside. it is near raja indian cuisine.
"name[The Punter], eatType[pub], food[Chinese], priceRange[moderate], area[riverside], familyFriendly[yes], near[Raja Indian Cuisine]"	The punter is a pub that serves chinese food in the moderate price range. it is located in the riverside. it is near raja indian cuisine.
"name[The Punter], eatType[pub], food[Chinese], priceRange[more than £30], area[riverside], familyFriendly[yes], near[Raja Indian Cuisine]"	The punter is a pub that serves chinese food in the more than £30 price range. it is located in the riverside. it is near raja indian cuisine.
"name[The Punter], eatType[pub], food[English], priceRange[£20-25], area[riverside], familyFriendly[yes], near[Raja Indian Cuisine]"	The punter is a pub that serves english food in the £20-25 price range. it is located near raja indian cuisine.
"name[The Punter], eatType[pub], food[English], priceRange[cheap], area[riverside], familyFriendly[yes], near[Raja Indian Cuisine]"	The punter is a cheap, family friendly pub in the riverside area near raja indian cuisine.
"name[The Punter], eatType[pub], food[English], priceRange[high], area[city centre], familyFriendly[no], near[Raja Indian Cuisine]"	The punter is a pub providing english food in the high price range. it is located in the city centre near raja indian cuisine.
"name[The Punter], eatType[pub], food[English], priceRange[high], area[city centre], familyFriendly[yes], near[Raja Indian Cuisine]"	The punter is a pub that serves english food in the high price range. it is located in the city centre near raja indian cuisine.
"name[The Punter], eatType[pub], food[English], priceRange[high], area[riverside], familyFriendly[no], near[Raja Indian Cuisine]"	The punter is a pub providing english food in the high price range. it is located near raja indian cuisine.
"name[The Punter], eatType[pub], food[English], priceRange[high], area[riverside], familyFriendly[yes], near[Raja Indian Cuisine]"	The punter is a child friendly pub located near raja indian cuisine in the riverside area.
"name[The Punter], eatType[pub], food[Italian], priceRange[high], customer rating[average], area[city centre], familyFriendly[no], near[Rainbow Vegetarian Café]"	The punter is an italian pub located near rainbow vegetarian café in the city centre. it has an average customer rating and is not children friendly.
"name[The Punter], eatType[restaurant], food[Chinese], priceRange[less than £20], area[city centre], familyFriendly[yes], near[Raja Indian Cuisine]"	The punter is a family friendly chinese restaurant in the city centre.
"name[The Punter], eatType[restaurant], food[Chinese], priceRange[less than £20], area[riverside], familyFriendly[no], near[Raja Indian Cuisine]"	The punter is a chinese restaurant in the riverside area near raja indian cuisine. it is not family friendly.
"name[The Punter], eatType[restaurant], food[Chinese], priceRange[less than £20], area[riverside], familyFriendly[yes], near[Raja Indian Cuisine]"	The punter is a family friendly chinese restaurant located in the riverside area.
"name[The Punter], eatType[restaurant], food[Chinese], priceRange[moderate], area[city centre], familyFriendly[no], near[Raja Indian Cuisine]"	The punter is a moderate priced chinese restaurant located in the city centre near raja indian cuisine.
"name[The Punter], eatType[restaurant], food[Chinese], priceRange[moderate], area[city centre], familyFriendly[yes], near[Raja Indian Cuisine]"	The punter is a restaurant providing chinese food in the moderate price range. it is located in the city centre.
"name[The Punter], eatType[restaurant], food[Chinese], priceRange[moderate], area[riverside], familyFriendly[no], near[Raja Indian Cuisine]"	The punter is a moderately priced chinese restaurant in riverside near raja indian cuisine.
"name[The Punter], eatType[restaurant], food[Chinese], priceRange[moderate], area[riverside], familyFriendly[yes], near[Raja Indian Cuisine]"	The punter is a restaurant providing chinese food in the moderate price range. it is located in the riverside.
"name[The Punter], eatType[restaurant], food[Chinese], priceRange[more than £30], area[riverside], familyFriendly[yes], near[Raja Indian Cuisine]"	The punter is a restaurant providing chinese food in the more than £30 price range. it is located in the riverside.
"name[The Punter], eatType[restaurant], food[English], priceRange[£20-25], area[riverside], familyFriendly[yes], near[Raja Indian Cuisine]"	The punter is a family friendly restaurant located near raja indian cuisine in the riverside area.
"name[The Punter], eatType[restaurant], food[English], priceRange[cheap], area[riverside], familyFriendly[yes], near[Raja Indian Cuisine]"	The punter is a cheap, family friendly restaurant near raja indian cuisine.
"name[The Punter], eatType[restaurant], food[English], priceRange[high], area[city centre], familyFriendly[no], near[Raja Indian Cuisine]"	The punter is a high priced english restaurant in the city centre near raja indian cuisine.
"name[The Punter], eatType[restaurant], food[English], priceRange[high], area[city centre], familyFriendly[yes], near[Raja Indian Cuisine]"	The punter is a child friendly english restaurant located in the city centre near raja indian cuisine.
"name[The Punter], eatType[restaurant], food[English], priceRange[high], area[riverside], familyFriendly[no], near[Raja Indian Cuisine]"	The punter is a high priced english restaurant located in riverside near raja indian cuisine.
"name[The Punter], eatType[restaurant], food[English], priceRange[high], area[riverside], familyFriendly[yes], near[Raja Indian Cuisine]"	The punter is a children friendly restaurant located near raja indian cuisine.
"name[The Punter], eatType[restaurant], food[Indian], priceRange[cheap], customer rating[average], area[city centre], familyFriendly[yes], near[Express by Holiday Inn]"	The punter is a cheap indian restaurant located in the city centre near express by holiday inn.
"name[The Punter], eatType[restaurant], food[Indian], priceRange[cheap], customer rating[average], area[riverside], familyFriendly[no], near[Express by Holiday Inn]"	The punter is a cheap indian restaurant located in the riverside area near express by holiday inn.
"name[The Punter], eatType[restaurant], food[Indian], priceRange[cheap], customer rating[average], area[riverside], familyFriendly[yes], near[Express by Holiday Inn]"	The punter is a family friendly restaurant located near express by holiday inn.
"name[The Punter], eatType[restaurant], food[Indian], priceRange[high], customer rating[1 out of 5], area[city centre], familyFriendly[no], near[Express by Holiday Inn]"	The punter is a high priced indian restaurant in the city centre near express by holiday inn.
"name[The Punter], eatType[restaurant], food[Indian], priceRange[high], customer rating[1 out of 5], area[city centre], familyFriendly[yes], near[Express by Holiday Inn]"	The punter is a restaurant providing indian food in the high price range. it is located in the city centre and is near express by holiday inn.
"name[The Punter], eatType[restaurant], food[Indian], priceRange[high], customer rating[1 out of 5], area[riverside], familyFriendly[no], near[Express by Holiday Inn]"	The punter is a restaurant providing indian food in the high price range. it is located in the riverside. its customer rating is 1 out of 5.
"name[The Punter], eatType[restaurant], food[Indian], priceRange[high], customer rating[1 out of 5], area[riverside], familyFriendly[yes], near[Express by Holiday Inn]"	The punter is a restaurant providing indian food in the high price range. it is located in the riverside. its customer rating is 1 out of 5.
"name[The Punter], eatType[restaurant], food[Indian], priceRange[high], customer rating[average], area[city centre], familyFriendly[no], near[Express by Holiday Inn]"	The punter is a restaurant providing indian food in the high price range. it is located in the city centre. it is near express by holiday inn.
"name[The Punter], eatType[restaurant], food[Indian], priceRange[high], customer rating[average], area[city centre], familyFriendly[yes], near[Express by Holiday Inn]"	The punter is a restaurant providing indian food in the high price range. it is located in the city centre. it is near express by holiday inn.
"name[The Punter], eatType[restaurant], food[Indian], priceRange[high], customer rating[average], area[riverside], familyFriendly[no], near[Express by Holiday Inn]"	The punter is a high priced indian restaurant located in the riverside area near express by holiday inn.
"name[The Punter], eatType[restaurant], food[Indian], priceRange[high], customer rating[average], area[riverside], familyFriendly[yes], near[Express by Holiday Inn]"	The punter is a restaurant providing indian food in the high price range. it is near express by holiday inn.
"name[The Punter], eatType[restaurant], food[Indian], priceRange[less than £20], customer rating[low], area[city centre], familyFriendly[no], near[Express by Holiday Inn]"	The punter is a restaurant providing indian food in the less than £20 price range. it is located in the city centre. its customer rating is low.
"name[The Punter], eatType[restaurant], food[Indian], priceRange[less than £20], customer rating[low], area[city centre], familyFriendly[yes], near[Express by Holiday Inn]"	The punter is a family-friendly indian restaurant located in the city centre near express by holiday inn.
"name[The Punter], eatType[restaurant], food[Indian], priceRange[less than £20], customer rating[low], area[riverside], familyFriendly[no], near[Express by Holiday Inn]"	The punter is a restaurant providing indian food in the less than £20 price range. it is located in the riverside. it is near express by holiday inn.
"name[The Punter], eatType[restaurant], food[Indian], priceRange[less than £20], customer rating[low], area[riverside], familyFriendly[yes], near[Express by Holiday Inn]"	The punter is a restaurant providing indian food in the less than £20 price range. it is located in the riverside. its customer rating is low.
"name[The Punter], eatType[restaurant], food[Indian], priceRange[moderate], customer rating[1 out of 5], area[city centre], familyFriendly[no], near[Express by Holiday Inn]"	The punter is a moderately priced indian restaurant in the city centre near express by holiday inn.
"name[The Punter], eatType[restaurant], food[Indian], priceRange[moderate], customer rating[1 out of 5], area[city centre], familyFriendly[yes], near[Express by Holiday Inn]"	The punter is a moderately priced indian restaurant in the city centre near express by holiday inn.
"name[The Punter], eatType[restaurant], food[Indian], priceRange[moderate], customer rating[1 out of 5], area[riverside], familyFriendly[no], near[Express by Holiday Inn]"	The punter is a moderately priced indian restaurant located in the riverside area near express by holiday inn.
"name[The Punter], eatType[restaurant], food[Indian], priceRange[moderate], customer rating[1 out of 5], area[riverside], familyFriendly[yes], near[Express by Holiday Inn]"	The punter is a restaurant providing indian food in the moderate price range. it is located in the riverside. its customer rating is 1 out of 5.
"name[The Punter], eatType[restaurant], food[Indian], priceRange[moderate], customer rating[3 out of 5], area[city centre], familyFriendly[no], near[Express by Holiday Inn]"	The punter is a moderately priced indian restaurant in the city centre near express by holiday inn.
"name[The Punter], eatType[restaurant], food[Indian], priceRange[moderate], customer rating[3 out of 5], area[city centre], familyFriendly[yes], near[Express by Holiday Inn]"	The punter is a restaurant providing indian food in the moderate price range. it is located in the city centre. it is near express by holiday inn. its customer rating is 3 out of 5.
"name[The Punter], eatType[restaurant], food[Indian], priceRange[moderate], customer rating[3 out of 5], area[riverside], familyFriendly[no], near[Express by Holiday Inn]"	The punter is a restaurant providing indian food in the moderate price range. it is located in the riverside.
"name[The Punter], eatType[restaurant], food[Indian], priceRange[moderate], customer rating[3 out of 5], area[riverside], familyFriendly[yes], near[Express by Holiday Inn]"	The punter is a restaurant providing indian food in the moderate price range. it is near express by holiday inn in the riverside area.
"name[The Punter], eatType[restaurant], food[Indian], priceRange[more than £30], customer rating[high], area[city centre], familyFriendly[no], near[Express by Holiday Inn]"	The punter is an expensive indian restaurant located in the city centre near express by holiday inn.
"name[The Punter], eatType[restaurant], food[Indian], priceRange[more than £30], customer rating[high], area[city centre], familyFriendly[yes], near[Express by Holiday Inn]"	The punter is a restaurant providing indian food in the more than £30 price range. it is located in the city centre. it is near express by holiday inn.
"name[The Punter], eatType[restaurant], food[Indian], priceRange[more than £30], customer rating[high], area[riverside], familyFriendly[no], near[Express by Holiday Inn]"	The punter is a restaurant providing indian food in the more than £30 price range. it is located in the riverside. it is near express by holiday inn.
"name[The Punter], eatType[restaurant], food[Indian], priceRange[more than £30], customer rating[high], area[riverside], familyFriendly[yes], near[Express by Holiday Inn]"	The punter is a restaurant providing indian food in the more than £30 price range. it is located in the riverside. it is near express by holiday inn.
"name[The Punter], eatType[restaurant], food[Italian], priceRange[£20-25], customer rating[high], area[city centre], familyFriendly[no], near[Express by Holiday Inn]"	The punter is an italian restaurant located in the city centre near express by holiday inn. it is not kid friendly and has a price range of £20-25.
"name[The Punter], eatType[restaurant], food[Italian], priceRange[£20-25], customer rating[high], area[city centre], familyFriendly[yes], near[Express by Holiday Inn]"	The punter is an italian restaurant located in the city centre near express by holiday inn.
"name[The Punter], eatType[restaurant], food[Italian], priceRange[£20-25], customer rating[high], area[riverside], familyFriendly[no], near[Express by Holiday Inn]"	The punter is an italian restaurant located near express by holiday inn in the riverside area.
"name[The Punter], eatType[restaurant], food[Italian], priceRange[£20-25], customer rating[high], area[riverside], familyFriendly[yes], near[Express by Holiday Inn]"	The punter is a highly rated italian restaurant located near express by holiday inn in riverside.
"name[The Punter], eatType[restaurant], food[Italian], priceRange[cheap], customer rating[5 out of 5], area[city centre], familyFriendly[no], near[Express by Holiday Inn]"	The punter is a cheap italian restaurant located in the city centre near express by holiday inn
"name[The Punter], eatType[restaurant], food[Italian], priceRange[cheap], customer rating[5 out of 5], area[city centre], familyFriendly[no], near[Rainbow Vegetarian Café]"	The punter is a cheap italian restaurant located in the city centre near rainbow vegetarian café
"name[The Punter], eatType[restaurant], food[Italian], priceRange[cheap], customer rating[5 out of 5], area[city centre], familyFriendly[yes], near[Rainbow Vegetarian Café]"	The punter is a cheap, family-friendly italian restaurant in the city centre near rainbow vegetarian café.
"name[The Punter], eatType[restaurant], food[Italian], priceRange[cheap], customer rating[5 out of 5], area[riverside], familyFriendly[no], near[Rainbow Vegetarian Café]"	The punter is a cheap italian restaurant located in the riverside area near rainbow vegetarian café. it is not family-friendly.
"name[The Punter], eatType[restaurant], food[Italian], priceRange[cheap], customer rating[5 out of 5], area[riverside], familyFriendly[yes], near[Rainbow Vegetarian Café]"	The punter is a cheap, family friendly restaurant in the riverside area near rainbow vegetarian café.
"name[The Punter], eatType[restaurant], food[Italian], priceRange[cheap], customer rating[average], area[city centre], familyFriendly[no], near[Rainbow Vegetarian Café]"	The punter is a cheap italian restaurant in the city centre near rainbow vegetarian café. it is not family-friendly.
"name[The Punter], eatType[restaurant], food[Italian], priceRange[cheap], customer rating[average], area[city centre], familyFriendly[yes], near[Rainbow Vegetarian Café]"	The punter is a cheap, family-friendly italian restaurant located near rainbow vegetarian café.
"name[The Punter], eatType[restaurant], food[Italian], priceRange[cheap], customer rating[average], area[riverside], familyFriendly[no], near[Rainbow Vegetarian Café]"	The punter is a cheap italian restaurant located in the riverside area near rainbow vegetarian café.
"name[The Punter], eatType[restaurant], food[Italian], priceRange[cheap], customer rating[average], area[riverside], familyFriendly[yes], near[Rainbow Vegetarian Café]"	The punter is a cheap, family friendly restaurant located near rainbow vegetarian café.
"name[The Punter], eatType[restaurant], food[Italian], priceRange[high], customer rating[1 out of 5], area[city centre], familyFriendly[no], near[Rainbow Vegetarian Café]"	The punter is a restaurant providing italian food in the high price range. it is located in the city centre near rainbow vegetarian café.
"name[The Punter], eatType[restaurant], food[Italian], priceRange[high], customer rating[1 out of 5], area[city centre], familyFriendly[yes], near[Rainbow Vegetarian Café]"	The punter is a high priced italian restaurant located in the city centre near rainbow vegetarian café.
"name[The Punter], eatType[restaurant], food[Italian], priceRange[high], customer rating[1 out of 5], area[riverside], familyFriendly[no], near[Rainbow Vegetarian Café]"	The punter is a high priced italian restaurant in the riverside area near rainbow vegetarian café. it is not child friendly.
"name[The Punter], eatType[restaurant], food[Italian], priceRange[high], customer rating[1 out of 5], area[riverside], familyFriendly[yes], near[Rainbow Vegetarian Café]"	The punter is a high priced italian restaurant located in riverside near rainbow vegetarian café.
"name[The Vaults], eatType[pub], food[French], priceRange[high], area[riverside], familyFriendly[yes], near[Raja Indian Cuisine]"	The vaults is a children friendly pub located near raja indian cuisine in the riverside area.
"name[The Vaults], eatType[pub], food[French], priceRange[less than £20], area[city centre], familyFriendly[no], near[Raja Indian Cuisine]"	The vaults is a pub providing french food in the less than £20 price range. it is located in the city centre near raja indian cuisine.
"name[The Vaults], eatType[pub], food[French], priceRange[less than £20], area[city centre], familyFriendly[yes], near[Raja Indian Cuisine]"	The vaults is a family-friendly french pub in the less than £20 price range. it is located in the city centre.
"name[The Vaults], eatType[pub], food[French], priceRange[less than £20], area[riverside], familyFriendly[no], near[Raja Indian Cuisine]"	The vaults is a pub near raja indian cuisine in riverside. it is not family-friendly and has a price range of less than £20.
"name[The Vaults], eatType[pub], food[French], priceRange[less than £20], area[riverside], familyFriendly[yes], near[Raja Indian Cuisine]"	The vaults is a family friendly pub located near raja raja cuisine.
"name[The Vaults], eatType[pub], food[French], priceRange[moderate], area[city centre], familyFriendly[no], near[Raja Indian Cuisine]"	The vaults is a pub that serves french food in the moderate price range. it is located in the city centre near raja indian cuisine.
"name[The Vaults], eatType[pub], food[French], priceRange[moderate], area[city centre], familyFriendly[yes], near[Raja Indian Cuisine]"	The vaults is a moderate priced french pub in the city centre near raja raja indian cuisine.
"name[The Vaults], eatType[pub], food[French], priceRange[moderate], area[riverside], familyFriendly[no], near[Raja Indian Cuisine]"	The vaults is a pub that serves french food in the moderate price range. it is located near raja indian cuisine in the riverside area.
"name[The Vaults], eatType[pub], food[French], priceRange[moderate], area[riverside], familyFriendly[yes], near[Raja Indian Cuisine]"	The vaults is a kid friendly pub located near raja indian cuisine in riverside.
"name[The Vaults], eatType[pub], food[French], priceRange[more than £30], area[city centre], familyFriendly[no], near[Raja Indian Cuisine]"	The vaults is a pub serving french food in the more than £30 price range. it is located near raja indian cuisine in the city centre.
"name[The Vaults], eatType[pub], food[French], priceRange[more than £30], area[city centre], familyFriendly[yes], near[Raja Indian Cuisine]"	The vaults is a french pub in the more than £30 price range. it is located in the city centre and is child friendly.
"name[The Vaults], eatType[pub], food[French], priceRange[more than £30], area[riverside], familyFriendly[no], near[Raja Indian Cuisine]"	The vaults is a french pub in the more than £30 price range. it is located near raja indian cuisine.
"name[The Vaults], eatType[pub], food[French], priceRange[more than £30], area[riverside], familyFriendly[yes], near[Raja Indian Cuisine]"	The vaults is a child friendly pub located near raja indian cuisine.
"name[The Vaults], eatType[pub], food[Indian], priceRange[£20-25], area[riverside], familyFriendly[yes], near[Raja Indian Cuisine]"	The vaults is a pub providing indian food in the £20-25 price range. it is located in the riverside. it is near raja indian cuisine.
"name[The Vaults], eatType[pub], food[Indian], priceRange[cheap], area[riverside], familyFriendly[yes], near[Raja Indian Cuisine]"	The vaults is a pub that serves indian food in the cheap price range. it is located in the riverside. it is near raja indian cuisine.
"name[The Vaults], eatType[pub], food[Indian], priceRange[high], area[city centre], familyFriendly[no], near[Raja Indian Cuisine]"	The vaults is a pub serving indian food in the high price range. it is located in the city centre. it is near raja indian cuisine.
"name[The Vaults], eatType[pub], food[Indian], priceRange[high], area[city centre], familyFriendly[yes], near[Raja Indian Cuisine]"	The vaults is a pub providing indian food in the high price range. it is located in the city centre.
"name[The Vaults], eatType[pub], food[Italian], priceRange[high], customer rating[average], area[city centre], familyFriendly[no], near[Rainbow Vegetarian Café]"	The vaults is an italian pub located in the city centre near rainbow vegetarian café. it is not child friendly and has an average customer rating.
"name[The Vaults], eatType[pub], food[Italian], priceRange[high], customer rating[average], area[city centre], familyFriendly[yes], near[Rainbow Vegetarian Café]"	The vaults is a high priced italian pub in the high price range. it is located in the city centre near rainbow vegetarian café.
"name[The Vaults], eatType[pub], food[Italian], priceRange[high], customer rating[average], area[riverside], familyFriendly[no], near[Rainbow Vegetarian Café]"	The vaults is a pub that serves italian food in the high price range. it is located near the rainbow vegetarian café.
"name[The Vaults], eatType[pub], food[Italian], priceRange[high], customer rating[average], area[riverside], familyFriendly[yes], near[Rainbow Vegetarian Café]"	The vaults is a children friendly pub located near rainbow vegetarian café.
"name[The Vaults], eatType[pub], food[Italian], priceRange[less than £20], customer rating[low], area[city centre], familyFriendly[no], near[Rainbow Vegetarian Café]"	The vaults is a pub providing italian food in the less than £20 price range. it is located in the city centre and is not family-friendly.
"name[The Vaults], eatType[pub], food[Italian], priceRange[less than £20], customer rating[low], area[city centre], familyFriendly[yes], near[Rainbow Vegetarian Café]"	The vaults is a family-friendly italian pub located in the city centre near rainbow vegetarian café with a low customer rating.
"name[The Vaults], eatType[pub], food[Italian], priceRange[less than £20], customer rating[low], area[riverside], familyFriendly[no], near[Rainbow Vegetarian Café]"	The vaults is a pub that serves italian food. it is located near rainbow vegetarian café.
"name[The Vaults], eatType[pub], food[Italian], priceRange[less than £20], customer rating[low], area[riverside], familyFriendly[yes], near[Rainbow Vegetarian Café]"	The vaults is a family-friendly pub located near rainbow vegetarian café.
"name[The Vaults], eatType[pub], food[Italian], priceRange[moderate], customer rating[1 out of 5], area[city centre], familyFriendly[no], near[Rainbow Vegetarian Café]"	The vaults is a pub that serves italian food in the moderate price range. it is located in the city centre near rainbow vegetarian café. its customer rating is 1 out of 5.
"name[The Vaults], eatType[pub], food[Italian], priceRange[moderate], customer rating[1 out of 5], area[city centre], familyFriendly[yes], near[Rainbow Vegetarian Café]"	The vaults is a family-friendly pub in the moderate price range. it is located near rainbow vegetarian café.
"name[The Vaults], eatType[pub], food[Italian], priceRange[moderate], customer rating[1 out of 5], area[riverside], familyFriendly[no], near[Rainbow Vegetarian Café]"	The vaults is a pub that serves italian food. it is located near rainbow vegetarian café.
"name[The Vaults], eatType[pub], food[Italian], priceRange[moderate], customer rating[1 out of 5], area[riverside], familyFriendly[yes], near[Rainbow Vegetarian Café]"	The vaults is a pub that serves italian food in the moderate price range. it is located near rainbow vegetarian café.
"name[The Vaults], eatType[pub], food[Italian], priceRange[moderate], customer rating[3 out of 5], area[city centre], familyFriendly[no], near[Rainbow Vegetarian Café]"	The vaults is a moderately priced italian pub located in the city centre near rainbow vegetarian café. it has a customer rating of 3 out of 5.
"name[The Vaults], eatType[pub], food[Italian], priceRange[moderate], customer rating[3 out of 5], area[city centre], familyFriendly[yes], near[Rainbow Vegetarian Café]"	The vaults is a kid friendly pub located in the city centre near rainbow vegetarian café.
"name[The Vaults], eatType[pub], food[Italian], priceRange[moderate], customer rating[3 out of 5], area[riverside], familyFriendly[no], near[Rainbow Vegetarian Café]"	The vaults is a pub that serves italian food. it is located near rainbow vegetarian café.
"name[The Vaults], eatType[pub], food[Italian], priceRange[moderate], customer rating[3 out of 5], area[riverside], familyFriendly[yes], near[Rainbow Vegetarian Café]"	The vaults is a kid friendly pub in the moderate price range. it is located near the rainbow vegetarian café.
"name[The Vaults], eatType[pub], food[Italian], priceRange[more than £30], customer rating[high], area[city centre], familyFriendly[no], near[Rainbow Vegetarian Café]"	The vaults is a pub providing italian food in the more than £30 price range. it is located in the city centre near rainbow vegetarian café.
"name[The Vaults], eatType[pub], food[Italian], priceRange[more than £30], customer rating[high], area[city centre], familyFriendly[yes], near[Rainbow Vegetarian Café]"	The vaults is a pub that serves italian food in the more than £30 price range. it is located in the city centre near rainbow vegetarian café.
"name[The Vaults], eatType[pub], food[Italian], priceRange[more than £30], customer rating[high], area[riverside], familyFriendly[no], near[Rainbow Vegetarian Café]"	The vaults is an italian pub near rainbow vegetarian café in the riverside area. it has a high customer rating and is not child friendly.
"name[The Vaults], eatType[pub], food[Italian], priceRange[more than £30], customer rating[high], area[riverside], familyFriendly[yes], near[Rainbow Vegetarian Café]"	The vaults is a child friendly pub located near rainbow vegetarian café.
"name[The Vaults], eatType[pub], food[Japanese], priceRange[£20-25], customer rating[3 out of 5], area[city centre], familyFriendly[no], near[Rainbow Vegetarian Café]"	The vaults is a pub providing japanese food in the £20-25 price range. it is located in the city centre near rainbow vegetarian café.
"name[The Vaults], eatType[pub], food[Japanese], priceRange[£20-25], customer rating[3 out of 5], area[city centre], familyFriendly[yes], near[Rainbow Vegetarian Café]"	The vaults is a family-friendly japanese pub located in the city centre near rainbow vegetarian café. it has a customer rating of 3 out of 5.
"name[The Vaults], eatType[pub], food[Japanese], priceRange[£20-25], customer rating[3 out of 5], area[riverside], familyFriendly[no], near[Rainbow Vegetarian Café]"	The vaults is a pub in the riverside area near rainbow vegetarian café.
"name[The Vaults], eatType[pub], food[Japanese], priceRange[£20-25], customer rating[3 out of 5], area[riverside], familyFriendly[yes], near[Rainbow Vegetarian Café]"	The vaults is a family friendly pub located near rainbow vegetarian café.
"name[The Vaults], eatType[pub], food[Japanese], priceRange[£20-25], customer rating[high], area[city centre], familyFriendly[no], near[Rainbow Vegetarian Café]"	The vaults is a pub providing japanese food in the £20-25 price range. it is near rainbow vegetarian café in the city centre.
"name[The Vaults], eatType[pub], food[Japanese], priceRange[£20-25], customer rating[high], area[city centre], familyFriendly[yes], near[Rainbow Vegetarian Café]"	The vaults is a kid friendly japanese pub located in the city centre near rainbow vegetarian café. it has a high customer rating.
"name[The Vaults], eatType[pub], food[Japanese], priceRange[£20-25], customer rating[high], area[riverside], familyFriendly[no], near[Rainbow Vegetarian Café]"	The vaults is a pub that serves japanese food. it is located near rainbow vegetarian café.
"name[The Vaults], eatType[pub], food[Japanese], priceRange[£20-25], customer rating[high], area[riverside], familyFriendly[no], near[Raja Indian Cuisine]"	The vaults is a pub that serves japanese food in the £20-25 price range. it is located near raja indian cuisine.
"name[The Vaults], eatType[pub], food[Japanese], priceRange[£20-25], customer rating[high], area[riverside], familyFriendly[yes], near[Raja Indian Cuisine]"	The vaults is a pub that serves japanese food. it is located near raja indian cuisine.
"name[The Vaults], eatType[pub], food[Japanese], priceRange[cheap], customer rating[5 out of 5], area[city centre], familyFriendly[no], near[Raja Indian Cuisine]"	The vaults is a cheap japanese pub located in the city centre near raja indian cuisine.
"name[The Vaults], eatType[pub], food[Japanese], priceRange[cheap], customer rating[5 out of 5], area[city centre], familyFriendly[yes], near[Raja Indian Cuisine]"	The vaults is a cheap japanese pub located in the city centre near raja indian cuisine in the city centre.
"name[The Vaults], eatType[pub], food[Japanese], priceRange[cheap], customer rating[5 out of 5], area[riverside], familyFriendly[no], near[Raja Indian Cuisine]"	The vaults is a cheap japanese pub in the riverside area near raja indian cuisine. it is not family-friendly.
"name[The Vaults], eatType[pub], food[Japanese], priceRange[cheap], customer rating[5 out of 5], area[riverside], familyFriendly[yes], near[Raja Indian Cuisine]"	The vaults is a cheap, family friendly pub located near raja indian cuisine in the riverside area.
"name[The Vaults], eatType[pub], food[Japanese], priceRange[high], customer rating[3 out of 5], area[city centre], familyFriendly[no], near[Raja Indian Cuisine]"	The vaults is a pub serving japanese food in the high price range. it is located in the city centre and is not child friendly.
"name[The Vaults], eatType[pub], food[Japanese], priceRange[high], customer rating[3 out of 5], area[city centre], familyFriendly[yes], near[Raja Indian Cuisine]"	The vaults is a japanese pub in the high price range. it is located in the city centre. it is near raja indian cuisine.
"name[The Vaults], eatType[pub], food[Japanese], priceRange[high], customer rating[3 out of 5], area[riverside], familyFriendly[no], near[Raja Indian Cuisine]"	The vaults is a pub providing japanese food in the high price range. it is located in the riverside area near raja indian cuisine. its customer rating is 3 out of 5.
"name[The Vaults], eatType[pub], food[Japanese], priceRange[high], customer rating[3 out of 5], area[riverside], familyFriendly[yes], near[Raja Indian Cuisine]"	The vaults is a pub that serves japanese food in the high price range. it is located in the riverside. it is near raja indian cuisine.
"name[The Vaults], eatType[pub], food[Japanese], priceRange[less than £20], customer rating[average], area[city centre], familyFriendly[no], near[Raja Indian Cuisine]"	The vaults is a japanese pub located in the city centre near raja indian cuisine. it is not family-friendly.
"name[The Vaults], eatType[pub], food[Japanese], priceRange[less than £20], customer rating[average], area[city centre], familyFriendly[yes], near[Raja Indian Cuisine]"	The vaults is a family-friendly japanese pub located in the city centre near raja indian cuisine.
"name[The Vaults], eatType[pub], food[Japanese], priceRange[less than £20], customer rating[average], area[riverside], familyFriendly[no], near[Raja Indian Cuisine]"	The vaults is a japanese pub near raja indian cuisine in riverside. it has an average customer rating and is not family-friendly.
"name[The Vaults], eatType[pub], food[Japanese], priceRange[less than £20], customer rating[average], area[riverside], familyFriendly[yes], near[Raja Indian Cuisine]"	The vaults is a family friendly pub that serves japanese food. it is located near raja indian cuisine.
"name[The Vaults], eatType[pub], food[Japanese], priceRange[less than £20], customer rating[low], area[city centre], familyFriendly[no], near[Raja Indian Cuisine]"	The vaults is a pub providing japanese food in the less than £20 price range. it is located in the city centre and is not family-friendly.
"name[The Vaults], eatType[pub], food[Japanese], priceRange[less than £20], customer rating[low], area[city centre], familyFriendly[yes], near[Raja Indian Cuisine]"	The vaults is a family-friendly japanese pub located in the city centre near raja indian cuisine.
"name[The Vaults], eatType[pub], food[Japanese], priceRange[less than £20], customer rating[low], area[riverside], familyFriendly[no], near[Raja Indian Cuisine]"	The vaults is a pub providing japanese food in the less than £20 price range. it is located in the riverside. it is near raja indian cuisine.
"name[The Vaults], eatType[pub], food[Japanese], priceRange[less than £20], customer rating[low], area[riverside], familyFriendly[yes], near[Raja Indian Cuisine]"	The vaults is a family friendly japanese pub near raja indian cuisine in the riverside area with a low customer rating.
"name[The Vaults], eatType[pub], food[Japanese], priceRange[moderate], customer rating[1 out of 5], area[city centre], familyFriendly[no], near[Raja Indian Cuisine]"	The vaults is a pub providing japanese food in the moderate price range. it is located in the city centre and is not kid friendly.
"name[The Vaults], eatType[pub], food[Japanese], priceRange[moderate], customer rating[1 out of 5], area[city centre], familyFriendly[yes], near[Raja Indian Cuisine]"	The vaults is a pub that serves japanese food in the moderate price range. it is located in the city centre.
"name[The Vaults], eatType[restaurant], food[French], priceRange[high], area[riverside], familyFriendly[yes], near[Raja Indian Cuisine]"	The vaults is a french restaurant in the riverside area near raja indian cuisine.
"name[The Vaults], eatType[restaurant], food[French], priceRange[less than £20], area[city centre], familyFriendly[no], near[Raja Indian Cuisine]"	The vaults is a french restaurant in the city centre near raja indian cuisine.
"name[The Vaults], eatType[restaurant], food[French], priceRange[less than £20], area[city centre], familyFriendly[yes], near[Raja Indian Cuisine]"	The vaults is a family-friendly french restaurant located in the city centre near raja indian cuisine.
"name[The Vaults], eatType[restaurant], food[French], priceRange[less than £20], area[riverside], familyFriendly[no], near[Raja Indian Cuisine]"	The vaults is a french restaurant in the riverside area near raja indian cuisine.
"name[The Vaults], eatType[restaurant], food[French], priceRange[less than £20], area[riverside], familyFriendly[yes], near[Raja Indian Cuisine]"	The vaults is a family friendly french restaurant located in the riverside area.
"name[The Vaults], eatType[restaurant], food[French], priceRange[moderate], area[city centre], familyFriendly[no], near[Raja Indian Cuisine]"	The vaults is a moderately priced french restaurant in the city centre near raja indian cuisine.
"name[The Vaults], eatType[restaurant], food[French], priceRange[moderate], area[city centre], familyFriendly[yes], near[Raja Indian Cuisine]"	The vaults is a moderately priced french restaurant located in the city centre near raja indian cuisine.
"name[The Vaults], eatType[restaurant], food[French], priceRange[moderate], area[riverside], familyFriendly[no], near[Raja Indian Cuisine]"	The vaults is a moderately priced french restaurant in riverside near raja indian cuisine.
"name[The Vaults], eatType[restaurant], food[French], priceRange[moderate], area[riverside], familyFriendly[yes], near[Raja Indian Cuisine]"	The vaults is a moderately priced french restaurant in riverside near raja indian cuisine.
"name[The Vaults], eatType[restaurant], food[French], priceRange[more than £30], area[city centre], familyFriendly[no], near[Raja Indian Cuisine]"	The vaults is a french restaurant in the city centre near raja indian cuisine.
"name[The Vaults], eatType[restaurant], food[French], priceRange[more than £30], area[city centre], familyFriendly[yes], near[Raja Indian Cuisine]"	The vaults is a children friendly french restaurant located in the city centre.
"name[The Vaults], eatType[restaurant], food[French], priceRange[more than £30], area[riverside], familyFriendly[no], near[Raja Indian Cuisine]"	The vaults is a french restaurant near raja indian cuisine in the riverside area.
"name[The Vaults], eatType[restaurant], food[French], priceRange[more than £30], area[riverside], familyFriendly[yes], near[Raja Indian Cuisine]"	The vaults is a family friendly french restaurant in the riverside area.
"name[The Vaults], eatType[restaurant], food[Indian], priceRange[£20-25], area[riverside], familyFriendly[yes], near[Raja Indian Cuisine]"	The vaults is a restaurant providing indian food in the £20-25 price range. it is located in the riverside. it is near raja indian cuisine.
"name[The Vaults], eatType[restaurant], food[Indian], priceRange[cheap], area[riverside], familyFriendly[yes], near[Raja Indian Cuisine]"	The vaults is a cheap indian restaurant in the riverside area near raja indian cuisine.
"name[The Vaults], eatType[restaurant], food[Indian], priceRange[high], area[city centre], familyFriendly[no], near[Raja Indian Cuisine]"	The vaults is a restaurant providing indian food in the high price range. it is located in the city centre.
"name[The Vaults], eatType[restaurant], food[Indian], priceRange[high], area[city centre], familyFriendly[yes], near[Raja Indian Cuisine]"	The vaults is a high priced indian restaurant in the city centre near raja indian cuisine.
"name[The Waterman], eatType[pub], food[Indian], priceRange[high], area[city centre], familyFriendly[yes], near[Raja Indian Cuisine]"	The waterman is a pub providing indian food in the high price range. it is located in the city centre.
"name[The Waterman], eatType[pub], food[Indian], priceRange[high], area[riverside], familyFriendly[no], near[Raja Indian Cuisine]"	The waterman is a pub serving indian food in the high price range. it is located in the riverside. it is near raja indian cuisine.
"name[The Waterman], eatType[pub], food[Indian], priceRange[high], area[riverside], familyFriendly[yes], near[Raja Indian Cuisine]"	The waterman is a pub that serves indian food in the high price range. it is located in the riverside. it is near raja indian cuisine.
"name[The Waterman], eatType[pub], food[Indian], priceRange[less than £20], area[city centre], familyFriendly[no], near[Raja Indian Cuisine]"	The waterman is a pub providing indian food in the less than £20 price range. it is located in the city centre. it is near raja indian cuisine.
"name[The Waterman], eatType[pub], food[Indian], priceRange[less than £20], area[city centre], familyFriendly[yes], near[Raja Indian Cuisine]"	The waterman is a pub providing indian food in the less than £20 price range. it is located in the city centre and is family friendly.
"name[The Waterman], eatType[pub], food[Indian], priceRange[less than £20], area[riverside], familyFriendly[no], near[Raja Indian Cuisine]"	The waterman is a pub that serves indian food in the less than £20 price range. it is located in the riverside. it is near raja indian cuisine.
"name[The Waterman], eatType[pub], food[Indian], priceRange[less than £20], area[riverside], familyFriendly[yes], near[Raja Indian Cuisine]"	The waterman is a family friendly pub located near raja indian cuisine in the riverside area.
"name[The Waterman], eatType[pub], food[Indian], priceRange[moderate], area[city centre], familyFriendly[no], near[Raja Indian Cuisine]"	The waterman is a pub providing indian food in the moderate price range. it is located in the city centre and is not kid friendly.
"name[The Waterman], eatType[pub], food[Indian], priceRange[moderate], area[city centre], familyFriendly[yes], near[Raja Indian Cuisine]"	The waterman is a pub providing indian food in the moderate price range. it is located in the city centre and is kid friendly.
"name[The Waterman], eatType[pub], food[Indian], priceRange[moderate], area[riverside], familyFriendly[no], near[Raja Indian Cuisine]"	The waterman is a pub that serves indian food in the moderate price range. it is located in the riverside. it is near raja indian cuisine.
"name[The Waterman], eatType[pub], food[Indian], priceRange[moderate], area[riverside], familyFriendly[yes], near[Raja Indian Cuisine]"	The waterman is a pub that serves indian food in the moderate price range. it is located in the riverside. it is near raja indian cuisine.
"name[The Waterman], eatType[pub], food[Indian], priceRange[more than £30], area[riverside], familyFriendly[yes], near[Raja Indian Cuisine]"	The waterman is a pub providing indian food in the more than £30 price range. it is located in the riverside.
"name[The Waterman], eatType[pub], food[Italian], priceRange[£20-25], area[riverside], familyFriendly[yes], near[Raja Indian Cuisine]"	The waterman is a family friendly pub located near raja indian cuisine in the riverside area.
"name[The Waterman], eatType[pub], food[Italian], priceRange[cheap], area[riverside], familyFriendly[yes], near[Raja Indian Cuisine]"	The waterman is a cheap, family friendly pub near raja indian cuisine.
"name[The Waterman], eatType[pub], food[Italian], priceRange[high], area[city centre], familyFriendly[no], near[Raja Indian Cuisine]"	The waterman is a pub providing italian food in the high price range. it is located in the city centre near raja indian cuisine.
"name[The Waterman], eatType[pub], food[Italian], priceRange[high], area[city centre], familyFriendly[yes], near[Raja Indian Cuisine]"	The waterman is a high priced italian pub in the city centre near raja indian cuisine.
"name[The Waterman], eatType[pub], food[Italian], priceRange[high], area[riverside], familyFriendly[no], near[Raja Indian Cuisine]"	The waterman is a high-priced italian pub located near raja indian cuisine in riverside.
"name[The Waterman], eatType[pub], food[Italian], priceRange[high], area[riverside], familyFriendly[yes], near[Raja Indian Cuisine]"	The waterman is a children friendly pub located near raja indian cuisine in the riverside area.
"name[The Waterman], eatType[pub], food[Italian], priceRange[less than £20], area[city centre], familyFriendly[no], near[Raja Indian Cuisine]"	The waterman is a pub serving italian food in the less than £20 price range. it is located near raja indian cuisine in the city centre.
"name[The Waterman], eatType[pub], food[Italian], priceRange[less than £20], area[city centre], familyFriendly[yes], near[Raja Indian Cuisine]"	The waterman is a family-friendly italian pub in the city centre near raja indian cuisine.
"name[The Waterman], eatType[pub], food[Italian], priceRange[less than £20], area[riverside], familyFriendly[no], near[Raja Indian Cuisine]"	The waterman is an italian pub near raja indian cuisine in the riverside area. it is not family-friendly.
"name[The Waterman], eatType[restaurant], food[Indian], priceRange[high], area[city centre], familyFriendly[yes], near[Raja Indian Cuisine]"	The waterman is a high priced indian restaurant in the city centre near raja indian cuisine.
"name[The Waterman], eatType[restaurant], food[Indian], priceRange[high], area[riverside], familyFriendly[no], near[Raja Indian Cuisine]"	The waterman is a restaurant providing indian food in the high price range. it is located in the riverside. it is near raja indian cuisine.
"name[The Waterman], eatType[restaurant], food[Indian], priceRange[high], area[riverside], familyFriendly[yes], near[Raja Indian Cuisine]"	The waterman is a restaurant providing indian food in the high price range. it is located in the riverside.
"name[The Waterman], eatType[restaurant], food[Indian], priceRange[less than £20], area[city centre], familyFriendly[no], near[Raja Indian Cuisine]"	The waterman is a restaurant providing indian food in the less than £20 price range. it is located in the city centre and is not family friendly.
"name[The Waterman], eatType[restaurant], food[Indian], priceRange[less than £20], area[city centre], familyFriendly[yes], near[Raja Indian Cuisine]"	The waterman is a family friendly indian restaurant located in the city centre.
"name[The Waterman], eatType[restaurant], food[Indian], priceRange[less than £20], area[riverside], familyFriendly[no], near[Raja Indian Cuisine]"	The waterman is a restaurant providing indian food in the less than £20 price range. it is located in the riverside.
"name[The Waterman], eatType[restaurant], food[Indian], priceRange[less than £20], area[riverside], familyFriendly[yes], near[Raja Indian Cuisine]"	The waterman is a restaurant providing indian food in the less than £20 price range. it is located in the riverside. it is near raja indian cuisine.
"name[The Waterman], eatType[restaurant], food[Indian], priceRange[moderate], area[city centre], familyFriendly[no], near[Raja Indian Cuisine]"	The waterman is a restaurant providing indian food in the moderate price range. it is located in the city centre. it is near raja indian cuisine.
"name[The Waterman], eatType[restaurant], food[Indian], priceRange[moderate], area[city centre], familyFriendly[yes], near[Raja Indian Cuisine]"	The waterman is a moderately priced indian restaurant in the city centre near raja indian cuisine.
"name[The Waterman], eatType[restaurant], food[Indian], priceRange[moderate], area[riverside], familyFriendly[no], near[Raja Indian Cuisine]"	The waterman is a moderately priced indian restaurant in the riverside area near raja indian cuisine.
"name[The Waterman], eatType[restaurant], food[Indian], priceRange[moderate], area[riverside], familyFriendly[yes], near[Raja Indian Cuisine]"	The waterman is a moderately priced indian restaurant located near raja indian cuisine.
"name[The Waterman], eatType[restaurant], food[Indian], priceRange[more than £30], area[riverside], familyFriendly[yes], near[Raja Indian Cuisine]"	The waterman is a child friendly indian restaurant in the riverside area.
"name[The Waterman], eatType[restaurant], food[Italian], priceRange[£20-25], area[riverside], familyFriendly[yes], near[Raja Indian Cuisine]"	The waterman is a kid friendly italian restaurant located in the riverside area.
"name[The Waterman], eatType[restaurant], food[Italian], priceRange[cheap], area[riverside], familyFriendly[yes], near[Raja Indian Cuisine]"	The waterman is a cheap, family friendly italian restaurant in the riverside area.
"name[The Waterman], eatType[restaurant], food[Italian], priceRange[high], area[city centre], familyFriendly[no], near[Raja Indian Cuisine]"	The waterman is a high priced italian restaurant located in the city centre near raja indian cuisine.
"name[The Waterman], eatType[restaurant], food[Italian], priceRange[high], area[city centre], familyFriendly[yes], near[Raja Indian Cuisine]"	The waterman is a high-priced italian restaurant in the city centre near raja indian cuisine.
"name[The Waterman], eatType[restaurant], food[Italian], priceRange[high], area[riverside], familyFriendly[no], near[Raja Indian Cuisine]"	The waterman is an italian restaurant located near raja indian cuisine in riverside.
"name[The Waterman], eatType[restaurant], food[Italian], priceRange[high], area[riverside], familyFriendly[yes], near[Raja Indian Cuisine]"	The waterman is a high priced italian restaurant in the riverside area near raja indian cuisine.
"name[The Waterman], eatType[restaurant], food[Italian], priceRange[less than £20], area[city centre], familyFriendly[no], near[Raja Indian Cuisine]"	The waterman is an italian restaurant located in the city centre near raja indian cuisine. it is not family-friendly.
"name[The Waterman], eatType[restaurant], food[Italian], priceRange[less than £20], area[city centre], familyFriendly[yes], near[Raja Indian Cuisine]"	The waterman is a family-friendly italian restaurant in the city centre near raja indian cuisine.
"name[The Waterman], eatType[restaurant], food[Italian], priceRange[less than £20], area[riverside], familyFriendly[no], near[Raja Indian Cuisine]"	The waterman is an italian restaurant located in the riverside area near raja indian cuisine.
"name[The Wrestlers], eatType[pub], food[Italian], priceRange[less than £20], area[riverside], familyFriendly[no], near[Raja Indian Cuisine]"	The wrestlers is a pub that serves italian food in the less than £20 price range. it is located near raja indian cuisine.
"name[The Wrestlers], eatType[pub], food[Italian], priceRange[less than £20], area[riverside], familyFriendly[yes], near[Raja Indian Cuisine]"	The wrestlers is a family friendly italian pub located near raja indian cuisine in riverside.
"name[The Wrestlers], eatType[pub], food[Italian], priceRange[moderate], area[city centre], familyFriendly[no], near[Raja Indian Cuisine]"	The wrestlers is a pub that serves italian food in the moderate price range. it is located in the city centre near raja indian cuisine.
"name[The Wrestlers], eatType[pub], food[Italian], priceRange[moderate], area[city centre], familyFriendly[yes], near[Raja Indian Cuisine]"	The wrestlers is a pub located in the city centre near raja indian cuisine.
"name[The Wrestlers], eatType[pub], food[Italian], priceRange[moderate], area[riverside], familyFriendly[no], near[Raja Indian Cuisine]"	The wrestlers is a moderately priced italian pub in the riverside area near raja indian cuisine.
"name[The Wrestlers], eatType[pub], food[Italian], priceRange[moderate], area[riverside], familyFriendly[yes], near[Raja Indian Cuisine]"	The wrestlers is a family friendly pub located near raja indian cuisine in the riverside area.
"name[The Wrestlers], eatType[pub], food[Italian], priceRange[more than £30], area[riverside], familyFriendly[yes], near[Raja Indian Cuisine]"	The wrestlers is a pub that serves italian food. it is located near raja raja indian cuisine.
"name[The Wrestlers], eatType[pub], food[Japanese], priceRange[£20-25], area[riverside], familyFriendly[yes], near[Raja Indian Cuisine]"	The wrestlers is a family friendly pub located near raja indian cuisine.
"name[The Wrestlers], eatType[pub], food[Japanese], priceRange[cheap], area[riverside], familyFriendly[yes], near[Raja Indian Cuisine]"	The wrestlers is a family friendly pub located near raja indian cuisine in the riverside area.
"name[The Wrestlers], eatType[pub], food[Japanese], priceRange[high], area[riverside], familyFriendly[yes], near[Raja Indian Cuisine]"	The wrestlers is a children friendly japanese pub near raja raja cuisine cuisine in the riverside area.
"name[The Wrestlers], eatType[pub], food[Japanese], priceRange[less than £20], area[city centre], familyFriendly[no], near[Raja Indian Cuisine]"	The wrestlers is a japanese pub located in the city centre near raja indian cuisine. it is not family-friendly.
"name[The Wrestlers], eatType[pub], food[Japanese], priceRange[less than £20], area[city centre], familyFriendly[yes], near[Raja Indian Cuisine]"	The wrestlers is a family-friendly pub located in the city centre near raja indian cuisine.
"name[The Wrestlers], eatType[pub], food[Japanese], priceRange[less than £20], area[riverside], familyFriendly[no], near[Raja Indian Cuisine]"	The wrestlers is a pub that serves japanese food in the less than £20 price range. it is located near raja indian cuisine in the riverside area.
"name[The Wrestlers], eatType[pub], food[Japanese], priceRange[less than £20], area[riverside], familyFriendly[yes], near[Raja Indian Cuisine]"	The wrestlers is a family friendly japanese pub located near raja indian cuisine in the riverside area.
"name[The Wrestlers], eatType[pub], food[Japanese], priceRange[moderate], area[city centre], familyFriendly[no], near[Raja Indian Cuisine]"	The wrestlers is a pub that serves japanese food in the moderate price range. it is located near raja indian cuisine in the city centre.
"name[The Wrestlers], eatType[pub], food[Japanese], priceRange[moderate], area[city centre], familyFriendly[yes], near[Raja Indian Cuisine]"	The wrestlers is a moderately priced japanese pub located in the city centre near raja indian cuisine.
"name[The Wrestlers], eatType[pub], food[Japanese], priceRange[moderate], area[riverside], familyFriendly[no], near[Raja Indian Cuisine]"	The wrestlers is a pub providing japanese food in the moderate price range. it is located in the riverside area near raja indian cuisine.
"name[The Wrestlers], eatType[pub], food[Japanese], priceRange[moderate], area[riverside], familyFriendly[yes], near[Raja Indian Cuisine]"	The wrestlers is a moderately priced japanese pub located near raja indian cuisine in riverside.
"name[The Wrestlers], eatType[pub], food[Japanese], priceRange[moderate], customer rating[1 out of 5], area[city centre], familyFriendly[yes], near[Raja Indian Cuisine]"	The wrestlers is a pub that serves japanese food in the moderate price range. it is located in the city centre. it is near raja indian cuisine. its customer rating is 1 out of 5.
"name[The Wrestlers], eatType[pub], food[Japanese], priceRange[moderate], customer rating[1 out of 5], area[riverside], familyFriendly[no], near[Raja Indian Cuisine]"	The wrestlers is a pub providing japanese food in the moderate price range. it is located in the riverside area near raja indian cuisine. its customer rating is 1 out of 5.
"name[The Wrestlers], eatType[pub], food[Japanese], priceRange[moderate], customer rating[1 out of 5], area[riverside], familyFriendly[yes], near[Raja Indian Cuisine]"	The wrestlers is a pub that serves japanese food in the moderate price range. it is located near raja indian cuisine. its customer rating is 1 out of 5.
"name[The Wrestlers], eatType[pub], food[Japanese], priceRange[more than £30], area[city centre], familyFriendly[no], near[Raja Indian Cuisine]"	The wrestlers is a pub serving japanese food in the more than £30 price range. it is located in the city centre near raja indian cuisine.
"name[The Wrestlers], eatType[pub], food[Japanese], priceRange[more than £30], area[city centre], familyFriendly[yes], near[Raja Indian Cuisine]"	The wrestlers is a japanese pub in the more than £30 price range. it is located in the city centre near raja indian cuisine.
"name[The Wrestlers], eatType[pub], food[Japanese], priceRange[more than £30], area[riverside], familyFriendly[no], near[Raja Indian Cuisine]"	The wrestlers is a pub that serves japanese food. it is located near raja indian cuisine in riverside.
"name[The Wrestlers], eatType[pub], food[Japanese], priceRange[more than £30], area[riverside], familyFriendly[yes], near[Raja Indian Cuisine]"	The wrestlers is a family friendly pub located near raja indian cuisine in the riverside area.
"name[The Wrestlers], eatType[pub], food[Japanese], priceRange[more than £30], customer rating[5 out of 5], area[city centre], familyFriendly[no], near[Raja Indian Cuisine]"	The wrestlers is a pub providing japanese food in the more than £30 price range. it is located near raja indian cuisine in the city centre.
"name[The Wrestlers], eatType[pub], food[Japanese], priceRange[more than £30], customer rating[5 out of 5], area[city centre], familyFriendly[yes], near[Raja Indian Cuisine]"	The wrestlers is a japanese pub in the more than £30 price range. it is located in the city centre and is children friendly.
"name[The Wrestlers], eatType[pub], food[Japanese], priceRange[more than £30], customer rating[5 out of 5], area[riverside], familyFriendly[no], near[Raja Indian Cuisine]"	The wrestlers is a pub providing japanese food in the more than £30 price range. it is located in the riverside area near raja indian cuisine.
"name[The Wrestlers], eatType[pub], food[Japanese], priceRange[more than £30], customer rating[5 out of 5], area[riverside], familyFriendly[yes], near[Raja Indian Cuisine]"	The wrestlers is a pub that serves japanese food. it is located near raja raja indian cuisine.
"name[The Wrestlers], eatType[pub], food[Japanese], priceRange[more than £30], customer rating[low], area[city centre], familyFriendly[no], near[Raja Indian Cuisine]"	The wrestlers is a pub providing japanese food in the more than £30 price range. it is located in the city centre near raja indian cuisine.
"name[The Wrestlers], eatType[pub], food[Japanese], priceRange[more than £30], customer rating[low], area[city centre], familyFriendly[yes], near[Raja Indian Cuisine]"	The wrestlers is a japanese pub in the more than £30 price range. it is located in the city centre and is child friendly.
"name[The Wrestlers], eatType[pub], food[Japanese], priceRange[more than £30], customer rating[low], area[riverside], familyFriendly[no], near[Raja Indian Cuisine]"	The wrestlers is a pub providing japanese food in the more than £30 price range. it is near raja indian cuisine.
"name[The Wrestlers], eatType[pub], food[Japanese], priceRange[more than £30], customer rating[low], area[riverside], familyFriendly[yes], near[Raja Indian Cuisine]"	The wrestlers is a pub that serves japanese food. it is located near raja indian cuisine.
"name[The Wrestlers], eatType[restaurant], food[Italian], priceRange[less than £20], area[riverside], familyFriendly[no], near[Raja Indian Cuisine]"	The wrestlers is a cheap italian restaurant in the riverside area near raja indian cuisine.
"name[The Wrestlers], eatType[restaurant], food[Italian], priceRange[less than £20], area[riverside], familyFriendly[yes], near[Raja Indian Cuisine]"	The wrestlers is a family friendly italian restaurant located near raja indian cuisine.
"name[The Wrestlers], eatType[restaurant], food[Italian], priceRange[moderate], area[city centre], familyFriendly[no], near[Raja Indian Cuisine]"	The wrestlers is a moderately priced italian restaurant in the city centre near raja indian cuisine.
"name[The Wrestlers], eatType[restaurant], food[Italian], priceRange[moderate], area[city centre], familyFriendly[yes], near[Raja Indian Cuisine]"	The wrestlers is a moderately priced italian restaurant located in the city centre near raja indian cuisine.
"name[The Wrestlers], eatType[restaurant], food[Italian], priceRange[moderate], area[riverside], familyFriendly[no], near[Raja Indian Cuisine]"	The wrestlers is a moderately priced italian restaurant located in the riverside area near raja indian cuisine.
"name[The Wrestlers], eatType[restaurant], food[Italian], priceRange[moderate], area[riverside], familyFriendly[yes], near[Raja Indian Cuisine]"	The wrestlers is a moderately priced italian restaurant in riverside near raja raja indian cuisine.
"name[The Wrestlers], eatType[restaurant], food[Italian], priceRange[more than £30], area[riverside], familyFriendly[yes], near[Raja Indian Cuisine]"	The wrestlers is a family friendly italian restaurant located near raja indian cuisine.
"name[The Wrestlers], eatType[restaurant], food[Japanese], priceRange[£20-25], area[riverside], familyFriendly[yes], near[Raja Indian Cuisine]"	The wrestlers is a kid friendly japanese restaurant located in the riverside area.
"name[The Wrestlers], eatType[restaurant], food[Japanese], priceRange[cheap], area[riverside], familyFriendly[yes], near[Raja Indian Cuisine]"	The wrestlers is a cheap, family friendly japanese restaurant near raja indian cuisine.
"name[The Wrestlers], eatType[restaurant], food[Japanese], priceRange[high], area[riverside], familyFriendly[yes], near[Raja Indian Cuisine]"	The wrestlers is a child friendly japanese restaurant located in the riverside area near raja indian cuisine.
"name[The Wrestlers], eatType[restaurant], food[Japanese], priceRange[less than £20], area[city centre], familyFriendly[no], near[Raja Indian Cuisine]"	The wrestlers is a japanese restaurant located in the city centre near raja indian cuisine. it is not family-friendly.
"name[The Wrestlers], eatType[restaurant], food[Japanese], priceRange[less than £20], area[city centre], familyFriendly[yes], near[Raja Indian Cuisine]"	The wrestlers is a family-friendly japanese restaurant in the city centre near raja indian cuisine.
"name[The Wrestlers], eatType[restaurant], food[Japanese], priceRange[less than £20], area[riverside], familyFriendly[no], near[Raja Indian Cuisine]"	The wrestlers is a cheap japanese restaurant located in the riverside area near raja indian cuisine.
"name[The Wrestlers], eatType[restaurant], food[Japanese], priceRange[less than £20], area[riverside], familyFriendly[yes], near[Raja Indian Cuisine]"	The wrestlers is a family friendly japanese restaurant near raja indian cuisine in the riverside area.
"name[The Wrestlers], eatType[restaurant], food[Japanese], priceRange[moderate], area[city centre], familyFriendly[no], near[Raja Indian Cuisine]"	The wrestlers is a japanese restaurant located near raja indian cuisine in the city centre.
"name[The Wrestlers], eatType[restaurant], food[Japanese], priceRange[moderate], area[city centre], familyFriendly[yes], near[Raja Indian Cuisine]"	The wrestlers is a japanese restaurant located in the city centre near raja indian cuisine.
"name[The Wrestlers], eatType[restaurant], food[Japanese], priceRange[moderate], area[riverside], familyFriendly[no], near[Raja Indian Cuisine]"	The wrestlers is a moderately priced japanese restaurant in riverside near raja indian cuisine.
"name[The Wrestlers], eatType[restaurant], food[Japanese], priceRange[moderate], area[riverside], familyFriendly[yes], near[Raja Indian Cuisine]"	The wrestlers is a moderately priced japanese restaurant in riverside near raja indian cuisine.
"name[The Wrestlers], eatType[restaurant], food[Japanese], priceRange[more than £30], area[city centre], familyFriendly[no], near[Raja Indian Cuisine]"	The wrestlers is a japanese restaurant located in the city centre near raja indian cuisine.
"name[The Wrestlers], eatType[restaurant], food[Japanese], priceRange[more than £30], area[city centre], familyFriendly[yes], near[Raja Indian Cuisine]"	The wrestlers is a family-friendly japanese restaurant located in the city centre near raja indian cuisine.
"name[The Wrestlers], eatType[restaurant], food[Japanese], priceRange[more than £30], area[riverside], familyFriendly[no], near[Raja Indian Cuisine]"	The wrestlers is a japanese restaurant located in riverside near raja indian cuisine. it is not child friendly.
"name[The Wrestlers], eatType[restaurant], food[Japanese], priceRange[more than £30], area[riverside], familyFriendly[yes], near[Raja Indian Cuisine]"	The wrestlers is a child friendly japanese restaurant in the riverside area near raja indian cuisine.
"name[Wildwood], eatType[coffee shop], area[riverside]"	Wildwood is a coffee shop located in the riverside area.
"name[Wildwood], eatType[pub], area[riverside]"	Wildwood is a pub located in the riverside area.
"name[Wildwood], eatType[pub], food[French], area[riverside], familyFriendly[yes], near[Raja Indian Cuisine]"	Wildwood is a family friendly pub in the riverside area near raja indian cuisine.
"name[Wildwood], eatType[pub], food[Indian], area[city centre], familyFriendly[no], near[Raja Indian Cuisine]"	Wildwood is a pub that serves indian food in the city centre near raja indian cuisine.
"name[Wildwood], eatType[pub], food[Indian], area[city centre], familyFriendly[yes], near[Raja Indian Cuisine]"	Wildwood is a pub providing indian food in the city centre near raja indian cuisine in the city centre.
"name[Wildwood], eatType[pub], food[Indian], area[riverside], familyFriendly[no], near[Raja Indian Cuisine]"	Wildwood is a pub that serves indian food in the riverside area near raja indian cuisine.
"name[Wildwood], eatType[pub], food[Indian], area[riverside], familyFriendly[yes], near[Raja Indian Cuisine]"	Wildwood is a pub that serves indian food and is located near raja indian cuisine.
"name[Wildwood], eatType[pub], food[Italian], area[city centre], familyFriendly[no], near[Raja Indian Cuisine]"	Wildwood is an italian pub located in the city centre near raja indian cuisine. it is not family-friendly.
"name[Wildwood], eatType[pub], food[Italian], area[city centre], familyFriendly[yes], near[Raja Indian Cuisine]"	Wildwood is a family-friendly pub located in the city centre near raja indian cuisine.
"name[Wildwood], eatType[pub], food[Italian], area[riverside], familyFriendly[no], near[Raja Indian Cuisine]"	Wildwood is a pub near raja indian cuisine in the riverside area. it is not family-friendly.
"name[Wildwood], eatType[pub], food[Italian], area[riverside], familyFriendly[yes], near[Raja Indian Cuisine]"	Wildwood is a family friendly pub in the riverside area near raja indian cuisine.
"name[Wildwood], eatType[restaurant], food[French], area[riverside], familyFriendly[yes], near[Raja Indian Cuisine]"	Wildwood is a family friendly restaurant in the riverside area near raja indian cuisine.
"name[Wildwood], eatType[restaurant], food[Indian], area[city centre], familyFriendly[no], near[Raja Indian Cuisine]"	Wildwood is an indian restaurant located in the city centre near raja indian cuisine.
"name[Wildwood], eatType[restaurant], food[Indian], area[city centre], familyFriendly[yes], near[Raja Indian Cuisine]"	Wildwood is a family friendly indian restaurant in the city centre near raja indian cuisine.
"name[Wildwood], eatType[restaurant], food[Indian], area[riverside], familyFriendly[no], near[Raja Indian Cuisine]"	Wildwood is an indian restaurant in the riverside area near raja indian cuisine.
"name[Wildwood], eatType[restaurant], food[Indian], area[riverside], familyFriendly[yes], near[Raja Indian Cuisine]"	Wildwood is a family friendly restaurant in the riverside area near raja indian cuisine.
"name[Wildwood], eatType[restaurant], food[Italian], area[city centre], familyFriendly[no], near[Raja Indian Cuisine]"	Wildwood is an italian restaurant in the city centre near raja indian cuisine in the city centre.
"name[Wildwood], eatType[restaurant], food[Italian], area[city centre], familyFriendly[yes], near[Raja Indian Cuisine]"	Wildwood is a italian restaurant located in the city centre near raja indian cuisine.
"name[Wildwood], eatType[restaurant], food[Italian], area[riverside], familyFriendly[no], near[Raja Indian Cuisine]"	Wildwood is an italian restaurant located in the riverside area near raja indian cuisine.
"name[Wildwood], eatType[restaurant], food[Italian], area[riverside], familyFriendly[yes], near[Raja Indian Cuisine]"	Wildwood is a family friendly restaurant in riverside near raja indian cuisine.
"name[Zizzi], eatType[coffee shop], area[riverside]"	Zizzi is a coffee shop in the riverside area.
"name[Zizzi], eatType[coffee shop], customer rating[average], near[Burger King]"	Zizzi is a coffee shop near burger king with an average customer rating.
"name[Zizzi], eatType[coffee shop], customer rating[high], near[Burger King]"	Zizzi is a coffee shop located near burger king.
"name[Zizzi], eatType[coffee shop], near[The Sorrento]"	Zizzi is a coffee shop located near the sorrento.
"name[Zizzi], eatType[pub], area[riverside]"	Zizzi is a pub in riverside.
"name[Zizzi], eatType[pub], customer rating[average], near[Burger King]"	Zizzi is a pub located near burger king with an average customer rating.
"name[Zizzi], eatType[pub], customer rating[high], near[Burger King]"	Zizzi is a pub near burger king.
"name[Zizzi], eatType[pub], near[The Sorrento]"	Zizzi is a pub located near the sorrento.
