"name[Blue Spice], eatType[coffee shop], area[city centre]"	"blue spice is a coffee shop. it is located in the city centre."
"name[Blue Spice], eatType[coffee shop], area[riverside]"	"blue spice is a coffee shop. it is located in the riverside area."
"name[Blue Spice], eatType[coffee shop], customer rating[5 out of 5], near[Crowne Plaza Hotel]"	"blue spice is a coffee shop near crowne plaza hotel. it has a 5 out of 5 customer rating."
"name[Blue Spice], eatType[coffee shop], customer rating[average], near[Burger King]"	"blue spice is a coffee shop near burger king. it has an average customer rating."
"name[Blue Spice], eatType[coffee shop], customer rating[average], near[Crowne Plaza Hotel]"	"blue spice is a coffee shop near crowne plaza hotel. it has an average customer rating."
"name[Blue Spice], eatType[pub], area[city centre]"	"blue spice is a pub in the city centre."
"name[Blue Spice], eatType[pub], area[riverside]"	"blue spice is a pub that is located in the riverside area."
"name[Blue Spice], eatType[pub], customer rating[5 out of 5], near[Crowne Plaza Hotel]"	"blue spice is a pub near crowne plaza hotel. it has a 5 out of 5 customer rating."
"name[Blue Spice], eatType[pub], customer rating[average], near[Burger King]"	"blue spice is a pub near burger king. it has an average customer rating."
"name[Blue Spice], eatType[pub], customer rating[average], near[Crowne Plaza Hotel]"	"blue spice is a pub near crowne plaza hotel. it has an average customer rating."
"name[Blue Spice], eatType[pub], food[Chinese], area[city centre], familyFriendly[no], near[Rainbow Vegetarian Café]"	"blue spice is a pub that serves chinese food. it is located in the city centre near rainbow vegetarian café and is not family friendly."
"name[Blue Spice], eatType[pub], food[Chinese], area[city centre], familyFriendly[yes], near[Rainbow Vegetarian Café]"	"blue spice is a pub that serves chinese food. it is located in the city centre near rainbow vegetarian café and is family friendly."
"name[Blue Spice], eatType[pub], food[Chinese], area[riverside], familyFriendly[no], near[Rainbow Vegetarian Café]"	"blue spice is a pub that serves chinese food. it is located in riverside near rainbow vegetarian café and is not family friendly."
"name[Blue Spice], eatType[pub], food[Chinese], area[riverside], familyFriendly[yes], near[Rainbow Vegetarian Café]"	"blue spice is a pub that serves chinese food. it is located in the riverside area near rainbow vegetarian café and is family friendly."
"name[Blue Spice], eatType[pub], food[English], area[city centre], familyFriendly[no], near[Rainbow Vegetarian Café]"	"blue spice is a pub near rainbow vegetarian café in the city centre that serves english food. it is not family-friendly."
"name[Blue Spice], eatType[pub], food[English], area[city centre], familyFriendly[yes], near[Rainbow Vegetarian Café]"	"blue spice is a family-friendly pub serving english food. it is located in the city centre near rainbow vegetarian café."
"name[Blue Spice], eatType[pub], food[English], area[riverside], familyFriendly[no], near[Rainbow Vegetarian Café]"	"blue spice is a pub located near rainbow vegetarian café in the riverside area. it serves english food and is not family-friendly."
"name[Blue Spice], eatType[pub], food[English], area[riverside], familyFriendly[yes], near[Rainbow Vegetarian Café]"	"blue spice is a family friendly pub serving english food. it is located near rainbow vegetarian café in the riverside area."
"name[Blue Spice], eatType[restaurant], food[Chinese], area[city centre], familyFriendly[no], near[Rainbow Vegetarian Café]"	"blue spice is a chinese restaurant located in the city centre near rainbow vegetarian café. it is not family friendly."
"name[Blue Spice], eatType[restaurant], food[Chinese], area[city centre], familyFriendly[yes], near[Rainbow Vegetarian Café]"	"blue spice is a chinese restaurant located in the city centre near rainbow vegetarian café. it is family friendly."
"name[Blue Spice], eatType[restaurant], food[Chinese], area[riverside], familyFriendly[no], near[Rainbow Vegetarian Café]"	"blue spice is a chinese restaurant located near rainbow vegetarian café in riverside. it is not family friendly."
"name[Blue Spice], eatType[restaurant], food[Chinese], area[riverside], familyFriendly[yes], near[Rainbow Vegetarian Café]"	"blue spice is a chinese restaurant located near rainbow vegetarian café in riverside. it is family friendly."
"name[Blue Spice], eatType[restaurant], food[English], area[city centre], familyFriendly[no], near[Rainbow Vegetarian Café]"	"blue spice is a restaurant that serves english food. it is located in the city centre near rainbow vegetarian café. it is not family-friendly."
"name[Blue Spice], eatType[restaurant], food[English], area[city centre], familyFriendly[yes], near[Rainbow Vegetarian Café]"	"blue spice is a family-friendly english restaurant located in the city centre near rainbow vegetarian café."
"name[Blue Spice], eatType[restaurant], food[English], area[riverside], familyFriendly[no], near[Rainbow Vegetarian Café]"	"blue spice is a restaurant located near rainbow vegetarian café in the riverside area. it serves english food and is not family-friendly."
"name[Blue Spice], eatType[restaurant], food[English], area[riverside], familyFriendly[yes], near[Rainbow Vegetarian Café]"	"blue spice is a family friendly english restaurant in riverside near rainbow vegetarian café."
"name[Clowns], eatType[coffee shop], customer rating[3 out of 5], near[All Bar One]"	"clowns is a coffee shop near all bar one. it has a 3 out of 5 customer rating."
"name[Clowns], eatType[coffee shop], customer rating[5 out of 5], near[Crowne Plaza Hotel]"	"clowns is a coffee shop near crowne plaza hotel. it has a 5 out of 5 customer rating."
"name[Clowns], eatType[coffee shop], near[The Sorrento]"	"clowns is a coffee shop. it is located near the sorrento."
"name[Clowns], eatType[pub], customer rating[3 out of 5], near[All Bar One]"	"clowns is a pub near all bar one. it has a 3 out of 5 customer rating."
"name[Clowns], eatType[pub], customer rating[5 out of 5], near[Crowne Plaza Hotel]"	"clowns is a pub near crowne plaza hotel. it has a 5 out of 5 customer rating."
"name[Clowns], eatType[pub], near[The Sorrento]"	"clowns is a pub. it is located near the sorrento."
"name[Cocum], eatType[coffee shop], customer rating[high], near[Burger King]"	"cocum is a coffee shop near burger king. it has a high customer rating."
"name[Cocum], eatType[coffee shop], customer rating[high], near[Café Sicilia]"	"cocum is a coffee shop near café sicilia. it has a high customer rating."
"name[Cocum], eatType[coffee shop], customer rating[low], near[Café Sicilia]"	"cocum is a coffee shop near café sicilia. it has a low customer rating."
"name[Cocum], eatType[coffee shop], customer rating[low], near[Express by Holiday Inn]"	"cocum is a coffee shop near express by holiday inn. it has a low customer rating."
"name[Cocum], eatType[coffee shop], near[The Rice Boat]"	"cocum is a coffee shop. it is located near the rice boat."
"name[Cocum], eatType[coffee shop], near[The Sorrento]"	"cocum is a coffee shop. it is located near the sorrento."
"name[Cocum], eatType[pub], customer rating[high], near[Burger King]"	"cocum is a pub near burger king. it has a high customer rating."
"name[Cocum], eatType[pub], customer rating[high], near[Café Sicilia]"	"cocum is a pub near café sicilia. it has a high customer rating."
"name[Cocum], eatType[pub], customer rating[low], near[Café Sicilia]"	"cocum is a pub near café sicilia. it has a low customer rating."
"name[Cocum], eatType[pub], customer rating[low], near[Express by Holiday Inn]"	"cocum is a pub near express by holiday inn. it has a low customer rating."
"name[Cocum], eatType[pub], near[The Rice Boat]"	"cocum is a pub that serves japanese food. it is located near the rice boat."
"name[Cocum], eatType[pub], near[The Sorrento]"	"cocum is a pub that serves japanese food. it is located near the sorrento."
"name[Cotto], eatType[coffee shop], near[The Bakers]"	"cotto is a coffee shop. it is located near the bakers."
"name[Cotto], eatType[pub], near[The Bakers]"	"cotto is a pub that serves japanese food. it is located near the bakers."
"name[Giraffe], eatType[coffee shop], near[The Bakers]"	"giraffe is a coffee shop. it is located near the bakers."
"name[Giraffe], eatType[coffee shop], near[The Rice Boat]"	"giraffe is a coffee shop. it is located near the rice boat."
"name[Giraffe], eatType[pub], food[English], area[riverside], familyFriendly[yes], near[Rainbow Vegetarian Café]"	"giraffe is a family friendly pub serving english food. it is located near rainbow vegetarian café in the riverside area."
"name[Giraffe], eatType[pub], food[Fast food], area[city centre], familyFriendly[no], near[Rainbow Vegetarian Café]"	"giraffe is a pub that serves fast food. it is located in the city centre near rainbow vegetarian café. it is not family-friendly."
"name[Giraffe], eatType[pub], food[Fast food], area[city centre], familyFriendly[yes], near[Rainbow Vegetarian Café]"	"giraffe is a family-friendly pub serving fast food. it is located in the city centre near rainbow vegetarian café."
"name[Giraffe], eatType[pub], food[Fast food], area[riverside], familyFriendly[no], near[Rainbow Vegetarian Café]"	"giraffe is a pub located near rainbow vegetarian café. it is not family friendly."
"name[Giraffe], eatType[pub], food[Fast food], area[riverside], familyFriendly[yes], near[Rainbow Vegetarian Café]"	"giraffe is a family friendly pub serving fast food. it is located near rainbow vegetarian café in the riverside area."
"name[Giraffe], eatType[pub], food[Fast food], area[riverside], familyFriendly[yes], near[Raja Indian Cuisine]"	"giraffe is a family friendly pub serving fast food. it is located near raja indian cuisine in the riverside area."
"name[Giraffe], eatType[pub], food[French], area[city centre], familyFriendly[no], near[Raja Indian Cuisine]"	"giraffe is a pub located in the city centre near the raja indian cuisine. it serves french food and is not family-friendly."
"name[Giraffe], eatType[pub], food[French], area[city centre], familyFriendly[yes], near[Raja Indian Cuisine]"	"giraffe is a family-friendly pub serving french food. it is located in the city centre near raja indian cuisine."
"name[Giraffe], eatType[pub], food[French], area[riverside], familyFriendly[no], near[Raja Indian Cuisine]"	"giraffe is a pub located near raja indian cuisine. it is not family friendly."
"name[Giraffe], eatType[pub], food[French], area[riverside], familyFriendly[yes], near[Raja Indian Cuisine]"	"giraffe is a family friendly pub that serves french food. it is located near raja indian cuisine in the riverside area."
"name[Giraffe], eatType[pub], near[The Bakers]"	"giraffe is a pub that serves japanese food. it is located near the bakers."
"name[Giraffe], eatType[pub], near[The Rice Boat]"	"giraffe is a pub that serves japanese food. it is located near the rice boat."
"name[Giraffe], eatType[restaurant], food[English], area[riverside], familyFriendly[yes], near[Rainbow Vegetarian Café]"	"giraffe is a family friendly english restaurant in riverside near rainbow vegetarian café."
"name[Giraffe], eatType[restaurant], food[Fast food], area[city centre], familyFriendly[no], near[Rainbow Vegetarian Café]"	"giraffe is a fast food restaurant located in the city centre near rainbow vegetarian café. it is not family-friendly."
"name[Giraffe], eatType[restaurant], food[Fast food], area[city centre], familyFriendly[yes], near[Rainbow Vegetarian Café]"	"giraffe is a family-friendly fast food restaurant located in the city centre near rainbow vegetarian café."
"name[Giraffe], eatType[restaurant], food[Fast food], area[riverside], familyFriendly[no], near[Rainbow Vegetarian Café]"	"giraffe is a fast food restaurant near rainbow vegetarian café in riverside. it is not family-friendly."
"name[Giraffe], eatType[restaurant], food[Fast food], area[riverside], familyFriendly[yes], near[Rainbow Vegetarian Café]"	"giraffe is a family friendly fast food restaurant located near rainbow vegetarian café in the riverside area."
"name[Giraffe], eatType[restaurant], food[Fast food], area[riverside], familyFriendly[yes], near[Raja Indian Cuisine]"	"giraffe is a family friendly fast food restaurant located near raja indian cuisine in the riverside area."
"name[Giraffe], eatType[restaurant], food[French], area[city centre], familyFriendly[no], near[Raja Indian Cuisine]"	"giraffe is a restaurant that is not family-friendly. it is located in the city centre near raja indian cuisine. it serves french food."
"name[Giraffe], eatType[restaurant], food[French], area[city centre], familyFriendly[yes], near[Raja Indian Cuisine]"	"giraffe is a family-friendly restaurant that serves french food. it is located in the city centre near raja indian cuisine."
"name[Giraffe], eatType[restaurant], food[French], area[riverside], familyFriendly[no], near[Raja Indian Cuisine]"	"giraffe is a restaurant located near raja indian cuisine. it is not family friendly."
"name[Giraffe], eatType[restaurant], food[French], area[riverside], familyFriendly[yes], near[Raja Indian Cuisine]"	"giraffe is a family friendly restaurant that serves french food and is located near raja indian cuisine in the riverside area."
"name[Green Man], eatType[coffee shop], customer rating[1 out of 5], near[All Bar One]"	"green man is a coffee shop near all bar one. it has a 1 out of 5 customer rating."
"name[Green Man], eatType[coffee shop], customer rating[3 out of 5], near[All Bar One]"	"green man is a coffee shop near all bar one. it has a 3 out of 5 customer rating."
"name[Green Man], eatType[pub], customer rating[1 out of 5], near[All Bar One]"	"green man is a pub near all bar one. it has a 1 out of 5 customer rating."
"name[Green Man], eatType[pub], customer rating[3 out of 5], near[All Bar One]"	"green man is a pub near all bar one. it has a 3 out of 5 customer rating."
"name[Green Man], eatType[pub], food[Italian], area[riverside], familyFriendly[yes], near[Express by Holiday Inn]"	"green man is a family friendly pub serving italian food. it is located in the riverside area near express by holiday inn."
"name[Green Man], eatType[pub], food[Italian], area[riverside], familyFriendly[yes], near[Raja Indian Cuisine]"	"green man is a family friendly pub serving italian food. it is located in the riverside area near raja indian cuisine."
"name[Green Man], eatType[pub], food[Japanese], area[city centre], familyFriendly[no], near[Express by Holiday Inn]"	"green man is a pub that serves japanese food. it is located in the city centre near express by holiday inn. it is not family-friendly."
"name[Green Man], eatType[pub], food[Japanese], area[city centre], familyFriendly[yes], near[Express by Holiday Inn]"	"green man is a family-friendly pub serving japanese food. it is located in the city centre near express by holiday inn."
"name[Green Man], eatType[pub], food[Japanese], area[riverside], familyFriendly[no], near[Express by Holiday Inn]"	"green man is a pub located near express by holiday inn. it is not family friendly."
"name[Green Man], eatType[pub], food[Japanese], area[riverside], familyFriendly[yes], near[Express by Holiday Inn]"	"green man is a family friendly pub serving japanese food. it is located near express by holiday inn in the riverside area."
"name[Green Man], eatType[restaurant], food[Italian], area[riverside], familyFriendly[yes], near[Express by Holiday Inn]"	"green man is a family friendly italian restaurant in riverside near express by holiday inn."
"name[Green Man], eatType[restaurant], food[Italian], area[riverside], familyFriendly[yes], near[Raja Indian Cuisine]"	"green man is a family friendly italian restaurant in riverside near raja indian cuisine."
"name[Green Man], eatType[restaurant], food[Japanese], area[city centre], familyFriendly[no], near[Express by Holiday Inn]"	"green man is a japanese restaurant located in the city centre near express by holiday inn. it is not family-friendly."
"name[Green Man], eatType[restaurant], food[Japanese], area[city centre], familyFriendly[yes], near[Express by Holiday Inn]"	"green man is a family-friendly japanese restaurant located in the city centre near express by holiday inn."
"name[Green Man], eatType[restaurant], food[Japanese], area[riverside], familyFriendly[no], near[Express by Holiday Inn]"	"green man is a japanese restaurant located in riverside near express by holiday inn. it is not family-friendly."
"name[Green Man], eatType[restaurant], food[Japanese], area[riverside], familyFriendly[yes], near[Express by Holiday Inn]"	"green man is a family friendly japanese restaurant near express by holiday inn in the riverside area."
"name[Loch Fyne], eatType[coffee shop], area[riverside]"	"loch fyne is a coffee shop. it is located in the riverside area."
"name[Loch Fyne], eatType[pub], area[riverside]"	"loch fyne is a pub that is located in the riverside area."
"name[Strada], eatType[coffee shop], area[city centre]"	"strada is a coffee shop . it is located in the city centre."
"name[Strada], eatType[coffee shop], customer rating[1 out of 5], near[All Bar One]"	"strada is a coffee shop near all bar one. it has a 1 out of 5 customer rating."
"name[Strada], eatType[coffee shop], customer rating[1 out of 5], near[Rainbow Vegetarian Café]"	"strada is a coffee shop near rainbow vegetarian café. it has a 1 out of 5 customer rating."
"name[Strada], eatType[coffee shop], customer rating[low], near[Express by Holiday Inn]"	"strada is a coffee shop near express by holiday inn. it has a low customer rating."
"name[Strada], eatType[pub], area[city centre]"	"strada is a pub in the city centre that serves japanese food."
"name[Strada], eatType[pub], customer rating[1 out of 5], near[All Bar One]"	"strada is a pub near all bar one. it has a 1 out of 5 customer rating."
"name[Strada], eatType[pub], customer rating[1 out of 5], near[Rainbow Vegetarian Café]"	"strada is a pub near rainbow vegetarian café. it has a 1 out of 5 customer rating."
"name[Strada], eatType[pub], customer rating[low], near[Express by Holiday Inn]"	"strada is a pub near express by holiday inn. it has a low customer rating."
"name[The Cricketers], eatType[coffee shop], customer rating[1 out of 5], familyFriendly[yes], near[Avalon]"	"the cricketers is a coffee shop near avalon. it is children friendly and has a 1 out of 5 customer rating."
"name[The Cricketers], eatType[coffee shop], customer rating[3 out of 5], familyFriendly[yes], near[Avalon]"	"the cricketers is a coffee shop near avalon. it is children friendly and has a 3 out of 5 customer rating."
"name[The Cricketers], eatType[coffee shop], customer rating[3 out of 5], familyFriendly[yes], near[Crowne Plaza Hotel]"	"the cricketers is a coffee shop near crowne plaza hotel. it is children friendly and has a 3 out of 5 customer rating."
"name[The Cricketers], eatType[coffee shop], customer rating[5 out of 5], familyFriendly[no], near[Crowne Plaza Hotel]"	"the cricketers is a coffee shop near crowne plaza hotel. it is not family-friendly and has a 5 out of 5 customer rating."
"name[The Cricketers], eatType[coffee shop], customer rating[5 out of 5], familyFriendly[yes], near[Crowne Plaza Hotel]"	"the cricketers is a coffee shop near crowne plaza hotel. it is children friendly and has a 5 out of 5 customer rating."
"name[The Cricketers], eatType[coffee shop], customer rating[average], familyFriendly[no], near[Café Sicilia]"	"the cricketers is a coffee shop near café sicilia. it is not family-friendly and has an average customer rating."
"name[The Cricketers], eatType[coffee shop], customer rating[average], familyFriendly[no], near[Crowne Plaza Hotel]"	"the cricketers is a coffee shop near crowne plaza hotel. it is not family-friendly and has an average customer rating."
"name[The Cricketers], eatType[coffee shop], customer rating[average], familyFriendly[yes], near[Café Sicilia]"	"the cricketers is a coffee shop near café sicilia. it is children friendly and has an average customer rating."
"name[The Cricketers], eatType[coffee shop], customer rating[high], familyFriendly[yes], near[Café Sicilia]"	"the cricketers is a coffee shop near café sicilia. it is children friendly and has a high customer rating."
"name[The Cricketers], eatType[coffee shop], customer rating[high], familyFriendly[yes], near[Express by Holiday Inn]"	"the cricketers is a coffee shop near express by holiday inn. it is children friendly and has a high customer rating."
"name[The Cricketers], eatType[coffee shop], customer rating[low], familyFriendly[no], near[Express by Holiday Inn]"	"the cricketers is a coffee shop near express by holiday inn. it is not family-friendly and has a low customer rating."
"name[The Cricketers], eatType[coffee shop], customer rating[low], familyFriendly[no], near[Ranch]"	"the cricketers is a coffee shop near ranch. it is not family-friendly and has a low customer rating."
"name[The Cricketers], eatType[coffee shop], customer rating[low], familyFriendly[yes], near[Ranch]"	"the cricketers is a coffee shop near ranch. it is children friendly and has a low customer rating."
"name[The Cricketers], eatType[restaurant], customer rating[1 out of 5], familyFriendly[yes], near[Avalon]"	"the cricketers is a restaurant near avalon. it is children friendly and has a 1 out of 5 customer rating."
"name[The Cricketers], eatType[restaurant], customer rating[3 out of 5], familyFriendly[yes], near[Avalon]"	"the cricketers is a restaurant near avalon. it is children friendly and has a 3 out of 5 customer rating."
"name[The Cricketers], eatType[restaurant], customer rating[3 out of 5], familyFriendly[yes], near[Crowne Plaza Hotel]"	"the cricketers is a restaurant near crowne plaza hotel. it is children friendly and has a 3 out of 5 customer rating."
"name[The Cricketers], eatType[restaurant], customer rating[5 out of 5], familyFriendly[no], near[Crowne Plaza Hotel]"	"the cricketers is a restaurant near crowne plaza hotel. it is not family-friendly and has a 5 out of 5 customer rating."
"name[The Cricketers], eatType[restaurant], customer rating[5 out of 5], familyFriendly[yes], near[Crowne Plaza Hotel]"	"the cricketers is a restaurant near crowne plaza hotel. it is children friendly and has a 5 out of 5 customer rating."
"name[The Cricketers], eatType[restaurant], customer rating[average], familyFriendly[no], near[Café Sicilia]"	"the cricketers is a restaurant near café sicilia. it is not family-friendly and has an average customer rating."
"name[The Cricketers], eatType[restaurant], customer rating[average], familyFriendly[no], near[Crowne Plaza Hotel]"	"the cricketers is a restaurant near crowne plaza hotel. it is not family-friendly and has an average customer rating."
"name[The Cricketers], eatType[restaurant], customer rating[average], familyFriendly[yes], near[Café Sicilia]"	"the cricketers is a restaurant near café sicilia. it is children friendly and has an average customer rating."
"name[The Cricketers], eatType[restaurant], customer rating[high], familyFriendly[yes], near[Café Sicilia]"	"the cricketers is a restaurant near café sicilia. it is children friendly and has a high customer rating."
"name[The Cricketers], eatType[restaurant], customer rating[high], familyFriendly[yes], near[Express by Holiday Inn]"	"the cricketers is a restaurant near express by holiday inn. it is children friendly and has a high customer rating."
"name[The Cricketers], eatType[restaurant], customer rating[low], familyFriendly[no], near[Express by Holiday Inn]"	"the cricketers is a restaurant near express by holiday inn. it is not family-friendly and has a low customer rating."
"name[The Cricketers], eatType[restaurant], customer rating[low], familyFriendly[no], near[Ranch]"	"the cricketers is a restaurant near ranch. it is not family-friendly and has a low customer rating."
"name[The Cricketers], eatType[restaurant], customer rating[low], familyFriendly[yes], near[Ranch]"	"the cricketers is a restaurant near ranch. it is children friendly and has a low customer rating."
"name[The Cricketers], eatType[restaurant], food[Chinese], priceRange[£20-25], customer rating[high], area[city centre], familyFriendly[no], near[All Bar One]"	"the cricketers is a chinese restaurant with a £20-25 price range. it is located in the city centre near all bar one. it is not family friendly and has a customer rating of high."
"name[The Cricketers], eatType[restaurant], food[Chinese], priceRange[£20-25], customer rating[high], area[city centre], familyFriendly[yes], near[All Bar One]"	"the cricketers is a chinese restaurant with a £20-25 price range. it is located in the city centre near all bar one. it is family friendly and has a customer rating of high."
"name[The Cricketers], eatType[restaurant], food[Chinese], priceRange[£20-25], customer rating[high], area[riverside], familyFriendly[no], near[All Bar One]"	"the cricketers is a chinese restaurant with a high customer rating. it is located near all bar one in the riverside area. it is not family friendly and has a price range of £20-25."
"name[The Cricketers], eatType[restaurant], food[Chinese], priceRange[£20-25], customer rating[high], area[riverside], familyFriendly[yes], near[All Bar One]"	"the cricketers is a chinese restaurant with a £20-25 price range. it is located in the riverside area near all bar one. it is children friendly and has a customer rating of high."
"name[The Cricketers], eatType[restaurant], food[Chinese], priceRange[cheap], customer rating[5 out of 5], area[city centre], familyFriendly[no], near[All Bar One]"	"the cricketers is a chinese restaurant with a cheap price range. it is located in the city centre near all bar one. it is not family friendly and has a customer rating of 5 out of 5."
"name[The Cricketers], eatType[restaurant], food[Chinese], priceRange[cheap], customer rating[5 out of 5], area[city centre], familyFriendly[yes], near[All Bar One]"	"the cricketers is a chinese restaurant with a cheap price range. it is located in the city centre near all bar one. it is family friendly and has a customer rating of 5 out of 5."
"name[The Cricketers], eatType[restaurant], food[Chinese], priceRange[cheap], customer rating[5 out of 5], area[riverside], familyFriendly[no], near[All Bar One]"	"the cricketers is a chinese restaurant with a 5 out of 5 customer rating. it is located near all bar one in the riverside area. it is not family friendly and has a price range of cheap."
"name[The Cricketers], eatType[restaurant], food[Chinese], priceRange[cheap], customer rating[5 out of 5], area[riverside], familyFriendly[yes], near[All Bar One]"	"the cricketers is a chinese restaurant with a cheap price range. it is located in the riverside area near all bar one. it is children friendly and has a customer rating of 5 out of 5."
"name[The Cricketers], eatType[restaurant], food[Chinese], priceRange[cheap], customer rating[average], area[city centre], familyFriendly[no], near[All Bar One]"	"the cricketers is a chinese restaurant with a cheap price range. it is located in the city centre near all bar one. it is not family friendly and has a customer rating of average."
"name[The Cricketers], eatType[restaurant], food[Chinese], priceRange[cheap], customer rating[average], area[city centre], familyFriendly[yes], near[All Bar One]"	"the cricketers is a chinese restaurant with a cheap price range. it is located in the city centre near all bar one. it is family friendly and has a customer rating of average."
"name[The Cricketers], eatType[restaurant], food[Chinese], priceRange[cheap], customer rating[average], area[riverside], familyFriendly[no], near[All Bar One]"	"the cricketers is a chinese restaurant with an average customer rating. it is located near all bar one in the riverside area. it is not family friendly and has a price range of cheap."
"name[The Cricketers], eatType[restaurant], food[Chinese], priceRange[cheap], customer rating[average], area[riverside], familyFriendly[yes], near[All Bar One]"	"the cricketers is a chinese restaurant with a cheap price range. it is located in the riverside area near all bar one. it is children friendly and has a customer rating of average."
"name[The Cricketers], eatType[restaurant], food[Chinese], priceRange[high], customer rating[1 out of 5], area[city centre], familyFriendly[no], near[All Bar One]"	"the cricketers is a chinese restaurant with a high price range. it is located in the city centre near all bar one. it is not family friendly and has a customer rating of 1 out of 5."
"name[The Cricketers], eatType[restaurant], food[Chinese], priceRange[high], customer rating[1 out of 5], area[city centre], familyFriendly[yes], near[All Bar One]"	"the cricketers is a chinese restaurant with a high price range. it is located in the city centre near all bar one. it is family friendly and has a customer rating of 1 out of 5."
"name[The Cricketers], eatType[restaurant], food[Chinese], priceRange[high], customer rating[1 out of 5], area[riverside], familyFriendly[no], near[All Bar One]"	"the cricketers is a chinese restaurant with a 1 out of 5 customer rating. it is located near all bar one in the riverside area. it is not family friendly and has a price range of high."
"name[The Cricketers], eatType[restaurant], food[Chinese], priceRange[high], customer rating[1 out of 5], area[riverside], familyFriendly[yes], near[All Bar One]"	"the cricketers is a chinese restaurant with a high price range. it is located in the riverside area near all bar one. it is children friendly and has a customer rating of 1 out of 5."
"name[The Cricketers], eatType[restaurant], food[Chinese], priceRange[high], customer rating[average], area[city centre], familyFriendly[no], near[All Bar One]"	"the cricketers is a chinese restaurant with a high price range. it is located in the city centre near all bar one. it is not family friendly and has a customer rating of average."
"name[The Cricketers], eatType[restaurant], food[Chinese], priceRange[high], customer rating[average], area[city centre], familyFriendly[yes], near[All Bar One]"	"the cricketers is a chinese restaurant with a high price range. it is located in the city centre near all bar one. it is family friendly and has a customer rating of average."
"name[The Cricketers], eatType[restaurant], food[Chinese], priceRange[high], customer rating[average], area[riverside], familyFriendly[no], near[All Bar One]"	"the cricketers is a chinese restaurant with an average customer rating. it is located near all bar one in the riverside area. it is not family friendly and has a price range of high."
"name[The Cricketers], eatType[restaurant], food[Chinese], priceRange[high], customer rating[average], area[riverside], familyFriendly[yes], near[All Bar One]"	"the cricketers is a chinese restaurant with a high price range. it is located in the riverside area near all bar one. it is children friendly and has a customer rating of average."
"name[The Cricketers], eatType[restaurant], food[Chinese], priceRange[less than £20], customer rating[low], area[city centre], familyFriendly[no], near[All Bar One]"	"the cricketers is a chinese restaurant with a less than £20 price range. it is located in the city centre near all bar one. it is not family friendly and has a customer rating of low."
"name[The Cricketers], eatType[restaurant], food[Chinese], priceRange[less than £20], customer rating[low], area[city centre], familyFriendly[yes], near[All Bar One]"	"the cricketers is a chinese restaurant with a less than £20 price range. it is located in the city centre near all bar one. it is family friendly and has a customer rating of low."
"name[The Cricketers], eatType[restaurant], food[Chinese], priceRange[less than £20], customer rating[low], area[riverside], familyFriendly[no], near[All Bar One]"	"the cricketers is a chinese restaurant with a low customer rating. it is located near all bar one in the riverside area. it is not family friendly and has a price range of less than £20."
"name[The Cricketers], eatType[restaurant], food[Chinese], priceRange[less than £20], customer rating[low], area[riverside], familyFriendly[yes], near[All Bar One]"	"the cricketers is a chinese restaurant with a less than £20 price range. it is located in the riverside area near all bar one. it is children friendly and has a customer rating of low."
"name[The Cricketers], eatType[restaurant], food[Chinese], priceRange[moderate], customer rating[1 out of 5], area[city centre], familyFriendly[no], near[All Bar One]"	"the cricketers is a chinese restaurant with a moderate price range. it is located in the city centre near all bar one. it is not family friendly and has a customer rating of 1 out of 5."
"name[The Cricketers], eatType[restaurant], food[Chinese], priceRange[moderate], customer rating[1 out of 5], area[city centre], familyFriendly[yes], near[All Bar One]"	"the cricketers is a chinese restaurant with a moderate price range. it is located in the city centre near all bar one. it is family friendly and has a customer rating of 1 out of 5."
"name[The Cricketers], eatType[restaurant], food[Chinese], priceRange[moderate], customer rating[1 out of 5], area[riverside], familyFriendly[no], near[All Bar One]"	"the cricketers is a chinese restaurant with a 1 out of 5 customer rating. it is located near all bar one in the riverside area. it is not family friendly and has a price range of moderate."
"name[The Cricketers], eatType[restaurant], food[Chinese], priceRange[moderate], customer rating[1 out of 5], area[riverside], familyFriendly[yes], near[All Bar One]"	"the cricketers is a chinese restaurant with a moderate price range. it is located in the riverside area near all bar one. it is children friendly and has a customer rating of 1 out of 5."
"name[The Cricketers], eatType[restaurant], food[Chinese], priceRange[moderate], customer rating[3 out of 5], area[city centre], familyFriendly[no], near[All Bar One]"	"the cricketers is a chinese restaurant with a moderate price range. it is located in the city centre near all bar one. it is not family friendly and has a customer rating of 3 out of 5."
"name[The Cricketers], eatType[restaurant], food[Chinese], priceRange[moderate], customer rating[3 out of 5], area[city centre], familyFriendly[yes], near[All Bar One]"	"the cricketers is a chinese restaurant with a moderate price range. it is located in the city centre near all bar one. it is family friendly and has a customer rating of 3 out of 5."
"name[The Cricketers], eatType[restaurant], food[Chinese], priceRange[moderate], customer rating[3 out of 5], area[riverside], familyFriendly[no], near[All Bar One]"	"the cricketers is a chinese restaurant with a 3 out of 5 customer rating. it is located near all bar one in the riverside area. it is not family friendly and has a price range of moderate."
"name[The Cricketers], eatType[restaurant], food[Chinese], priceRange[moderate], customer rating[3 out of 5], area[riverside], familyFriendly[yes], near[All Bar One]"	"the cricketers is a chinese restaurant with a moderate price range. it is located in the riverside area near all bar one. it is children friendly and has a customer rating of 3 out of 5."
"name[The Cricketers], eatType[restaurant], food[Chinese], priceRange[more than £30], customer rating[high], area[city centre], familyFriendly[no], near[All Bar One]"	"the cricketers is a chinese restaurant with a more than £30 price range. it is located in the city centre near all bar one. it is not family friendly and has a customer rating of high."
"name[The Cricketers], eatType[restaurant], food[Chinese], priceRange[more than £30], customer rating[high], area[city centre], familyFriendly[yes], near[All Bar One]"	"the cricketers is a chinese restaurant with a more than £30 price range. it is located in the city centre near all bar one. it is family friendly and has a customer rating of high."
"name[The Cricketers], eatType[restaurant], food[Chinese], priceRange[more than £30], customer rating[high], area[riverside], familyFriendly[no], near[All Bar One]"	"the cricketers is a chinese restaurant with a high customer rating. it is located near all bar one in the riverside area. it is not family friendly and has a price range of more than £30."
"name[The Cricketers], eatType[restaurant], food[Chinese], priceRange[more than £30], customer rating[high], area[riverside], familyFriendly[yes], near[All Bar One]"	"the cricketers is a chinese restaurant with a more than £30 price range. it is located in the riverside area near all bar one. it is children friendly and has a customer rating of high."
"name[The Cricketers], eatType[restaurant], food[English], priceRange[£20-25], customer rating[high], area[city centre], familyFriendly[no], near[All Bar One]"	"the cricketers is a restaurant providing english food in the £20-25 price range. it is located in the city centre near all bar one. it is not child friendly and has a customer rating of high."
"name[The Cricketers], eatType[restaurant], food[English], priceRange[£20-25], customer rating[high], area[city centre], familyFriendly[yes], near[All Bar One]"	"the cricketers is a family-friendly restaurant that serves english food. it is located in the city centre near all bar one. it has a £20-25 price range and a customer rating of high."
"name[The Cricketers], eatType[restaurant], food[English], priceRange[£20-25], customer rating[high], area[riverside], familyFriendly[no], near[All Bar One]"	"the cricketers is a restaurant providing english food in the £20-25 price range. it is located in the riverside area near all bar one. it is not family-friendly and has a customer rating of high."
"name[The Cricketers], eatType[restaurant], food[English], priceRange[£20-25], customer rating[high], area[riverside], familyFriendly[yes], near[All Bar One]"	"the cricketers is a family friendly restaurant that serves english food. it is located near the all bar one in the riverside area. the price range is £20-25 and the customer rating is high."
"name[The Cricketers], eatType[restaurant], food[English], priceRange[cheap], customer rating[5 out of 5], area[city centre], familyFriendly[no], near[Café Rouge]"	"the cricketers is a restaurant providing english food in the cheap price range. it is located in the city centre near café rouge. it is not child friendly and has a customer rating of 5 out of 5."
"name[The Cricketers], eatType[restaurant], food[English], priceRange[cheap], customer rating[5 out of 5], area[city centre], familyFriendly[yes], near[Café Rouge]"	"the cricketers is a family-friendly restaurant that serves english food. it is located in the city centre near café rouge. it has a cheap price range and a customer rating of 5 out of 5."
"name[The Cricketers], eatType[restaurant], food[English], priceRange[cheap], customer rating[5 out of 5], area[riverside], familyFriendly[no], near[Café Rouge]"	"the cricketers is a restaurant providing english food in the cheap price range. it is located in the riverside area near café rouge. it is not family-friendly and has a customer rating of 5 out of 5."
"name[The Cricketers], eatType[restaurant], food[English], priceRange[cheap], customer rating[5 out of 5], area[riverside], familyFriendly[yes], near[Café Rouge]"	"the cricketers is a family friendly restaurant that serves english food. it is located near the café rouge in the riverside area. the price range is cheap and the customer rating is 5 out of 5."
"name[The Cricketers], eatType[restaurant], food[English], priceRange[cheap], customer rating[average], area[city centre], familyFriendly[no], near[Café Rouge]"	"the cricketers is a restaurant providing english food in the cheap price range. it is located in the city centre near café rouge. it is not child friendly and has a customer rating of average."
"name[The Cricketers], eatType[restaurant], food[English], priceRange[cheap], customer rating[average], area[city centre], familyFriendly[yes], near[Café Rouge]"	"the cricketers is a family-friendly restaurant that serves english food. it is located in the city centre near café rouge. it has a cheap price range and a customer rating of average."
"name[The Cricketers], eatType[restaurant], food[English], priceRange[cheap], customer rating[average], area[riverside], familyFriendly[no], near[Café Rouge]"	"the cricketers is a restaurant providing english food in the cheap price range. it is located in the riverside area near café rouge. it is not family-friendly and has a customer rating of average."
"name[The Cricketers], eatType[restaurant], food[English], priceRange[cheap], customer rating[average], area[riverside], familyFriendly[yes], near[Café Rouge]"	"the cricketers is a family friendly restaurant that serves english food. it is located near the café rouge in the riverside area. the price range is cheap and the customer rating is average."
"name[The Cricketers], eatType[restaurant], food[English], priceRange[high], customer rating[1 out of 5], area[city centre], familyFriendly[no], near[Café Rouge]"	"the cricketers is a restaurant providing english food in the high price range. it is located in the city centre near café rouge. it is not child friendly and has a customer rating of 1 out of 5."
"name[The Cricketers], eatType[restaurant], food[English], priceRange[high], customer rating[1 out of 5], area[city centre], familyFriendly[yes], near[Café Rouge]"	"the cricketers is a family-friendly restaurant that serves english food. it is located in the city centre near café rouge. it has a high price range and a customer rating of 1 out of 5."
"name[The Cricketers], eatType[restaurant], food[English], priceRange[high], customer rating[1 out of 5], area[riverside], familyFriendly[no], near[Café Rouge]"	"the cricketers is a restaurant providing english food in the high price range. it is located in the riverside area near café rouge. it is not family-friendly and has a customer rating of 1 out of 5."
"name[The Cricketers], eatType[restaurant], food[English], priceRange[high], customer rating[1 out of 5], area[riverside], familyFriendly[yes], near[Café Rouge]"	"the cricketers is a family friendly restaurant that serves english food. it is located near the café rouge in the riverside area. the price range is high and the customer rating is 1 out of 5."
"name[The Cricketers], eatType[restaurant], food[English], priceRange[high], customer rating[average], area[city centre], familyFriendly[no], near[Café Rouge]"	"the cricketers is a restaurant providing english food in the high price range. it is located in the city centre near café rouge. it is not child friendly and has a customer rating of average."
"name[The Cricketers], eatType[restaurant], food[English], priceRange[high], customer rating[average], area[city centre], familyFriendly[yes], near[Café Rouge]"	"the cricketers is a family-friendly restaurant that serves english food. it is located in the city centre near café rouge. it has a high price range and a customer rating of average."
"name[The Cricketers], eatType[restaurant], food[English], priceRange[high], customer rating[average], area[riverside], familyFriendly[no], near[Café Rouge]"	"the cricketers is a restaurant providing english food in the high price range. it is located in the riverside area near café rouge. it is not family-friendly and has a customer rating of average."
"name[The Mill], eatType[pub], food[English], priceRange[high], area[riverside], familyFriendly[yes], near[Raja Indian Cuisine]"	"the mill is a family friendly pub serving english food. it is located near raja indian cuisine in the riverside area."
"name[The Mill], eatType[pub], food[English], priceRange[less than £20], area[city centre], familyFriendly[no], near[Raja Indian Cuisine]"	"the mill is a pub that serves english food. it is located in the city centre near raja indian cuisine. it is not child friendly and has a price range of less than £20."
"name[The Mill], eatType[pub], food[English], priceRange[less than £20], area[city centre], familyFriendly[yes], near[Raja Indian Cuisine]"	"the mill is a pub that serves english food. it is located in the city centre near raja indian cuisine. it is family-friendly and has a less than £20 price range."
"name[The Mill], eatType[pub], food[English], priceRange[less than £20], area[riverside], familyFriendly[no], near[Raja Indian Cuisine]"	"the mill is a pub that serves english food. it is located near raja indian cuisine in the riverside area. it is not child friendly and has a price range of less than £20."
"name[The Mill], eatType[pub], food[English], priceRange[less than £20], area[riverside], familyFriendly[yes], near[Raja Indian Cuisine]"	"the mill is a family friendly pub serving english food. it is located near raja indian cuisine in the riverside area."
"name[The Mill], eatType[pub], food[English], priceRange[moderate], area[city centre], familyFriendly[no], near[Raja Indian Cuisine]"	"the mill is a pub that serves english food. it is located in the city centre near raja indian cuisine. it is not child friendly and has a price range of moderate."
"name[The Mill], eatType[pub], food[English], priceRange[moderate], area[city centre], familyFriendly[yes], near[Raja Indian Cuisine]"	"the mill is a pub that serves english food. it is located in the city centre near raja indian cuisine. it is family-friendly and has a moderate price range."
"name[The Mill], eatType[pub], food[English], priceRange[moderate], area[riverside], familyFriendly[no], near[Raja Indian Cuisine]"	"the mill is a pub that serves english food. it is located near raja indian cuisine in the riverside area. it is not child friendly and has a price range of moderate."
"name[The Mill], eatType[pub], food[English], priceRange[moderate], area[riverside], familyFriendly[yes], near[Raja Indian Cuisine]"	"the mill is a family friendly pub serving english food. it is located near raja indian cuisine in the riverside area."
"name[The Mill], eatType[pub], food[English], priceRange[more than £30], area[riverside], familyFriendly[yes], near[Raja Indian Cuisine]"	"the mill is a family friendly pub serving english food. it is located near raja indian cuisine in the riverside area."
"name[The Mill], eatType[pub], food[Fast food], priceRange[£20-25], area[riverside], familyFriendly[yes], near[Raja Indian Cuisine]"	"the mill is a family friendly pub serving fast food in the riverside area. it is near raja indian cuisine and has a price range of £20-25."
"name[The Mill], eatType[pub], food[Fast food], priceRange[£20-25], customer rating[high], area[city centre], familyFriendly[no], near[Café Rouge]"	"the mill is a pub that serves fast food in the city centre near café rouge. it is not child friendly and has a £20-25 price range and a customer rating of high."
"name[The Mill], eatType[pub], food[Fast food], priceRange[£20-25], customer rating[high], area[city centre], familyFriendly[yes], near[Café Rouge]"	"the mill is a family-friendly pub located near café rouge in the city centre. it serves fast food at a £20-25 price."
"name[The Mill], eatType[pub], food[Fast food], priceRange[£20-25], customer rating[high], area[riverside], familyFriendly[no], near[Café Rouge]"	"the mill is a fast food pub near café rouge. it is not family-friendly. it is in the riverside area. it has a high customer rating and a price range of £20-25."
"name[The Mill], eatType[pub], food[Fast food], priceRange[£20-25], customer rating[high], area[riverside], familyFriendly[yes], near[Café Rouge]"	"the mill is a family friendly pub located near café rouge. it is a £20-25 priced pub with a high customer rating."
"name[The Mill], eatType[pub], food[Fast food], priceRange[£20-25], customer rating[high], area[riverside], familyFriendly[yes], near[Café Sicilia]"	"the mill is a family friendly pub located near café sicilia. it is a £20-25 priced pub with a high customer rating."
"name[The Mill], eatType[pub], food[Fast food], priceRange[cheap], area[riverside], familyFriendly[yes], near[Raja Indian Cuisine]"	"the mill is a family friendly pub serving fast food in the riverside area. it is near raja indian cuisine and has a price range of cheap."
"name[The Mill], eatType[pub], food[Fast food], priceRange[cheap], customer rating[5 out of 5], area[city centre], familyFriendly[no], near[Café Sicilia]"	"the mill is a pub that serves fast food in the city centre near café sicilia. it is not child friendly and has a cheap price range and a customer rating of 5 out of 5."
"name[The Mill], eatType[pub], food[Fast food], priceRange[cheap], customer rating[5 out of 5], area[city centre], familyFriendly[yes], near[Café Sicilia]"	"the mill is a family-friendly pub located near café sicilia in the city centre. it serves fast food at a cheap price."
"name[The Mill], eatType[pub], food[Fast food], priceRange[cheap], customer rating[5 out of 5], area[riverside], familyFriendly[no], near[Café Sicilia]"	"the mill is a fast food pub near café sicilia. it is not family-friendly. it is in the riverside area. it has a 5 out of 5 customer rating and a price range of cheap."
"name[The Mill], eatType[pub], food[Fast food], priceRange[cheap], customer rating[5 out of 5], area[riverside], familyFriendly[yes], near[Café Sicilia]"	"the mill is a family friendly pub located near café sicilia. it is a cheap priced pub with a 5 out of 5 customer rating."
"name[The Mill], eatType[pub], food[Fast food], priceRange[cheap], customer rating[average], area[city centre], familyFriendly[no], near[Café Sicilia]"	"the mill is a pub that serves fast food in the city centre near café sicilia. it is not child friendly and has a cheap price range and a customer rating of average."
"name[The Mill], eatType[pub], food[Fast food], priceRange[cheap], customer rating[average], area[city centre], familyFriendly[yes], near[Café Sicilia]"	"the mill is a family-friendly pub located near café sicilia in the city centre. it serves fast food at a cheap price."
"name[The Mill], eatType[pub], food[Fast food], priceRange[cheap], customer rating[average], area[riverside], familyFriendly[no], near[Café Sicilia]"	"the mill is a fast food pub near café sicilia. it is not family-friendly. it is in the riverside area. it has an average customer rating and a price range of cheap."
"name[The Mill], eatType[pub], food[Fast food], priceRange[cheap], customer rating[average], area[riverside], familyFriendly[yes], near[Café Sicilia]"	"the mill is a family friendly pub located near café sicilia. it is a cheap priced pub with an average customer rating."
"name[The Mill], eatType[pub], food[Fast food], priceRange[high], customer rating[1 out of 5], area[city centre], familyFriendly[no], near[Café Sicilia]"	"the mill is a pub that serves fast food in the city centre near café sicilia. it is not child friendly and has a high price range and a customer rating of 1 out of 5."
"name[The Mill], eatType[pub], food[Fast food], priceRange[high], customer rating[1 out of 5], area[city centre], familyFriendly[yes], near[Café Sicilia]"	"the mill is a family-friendly pub located near café sicilia in the city centre. it serves fast food at a high price."
"name[The Mill], eatType[pub], food[Fast food], priceRange[high], customer rating[1 out of 5], area[riverside], familyFriendly[no], near[Café Sicilia]"	"the mill is a fast food pub near café sicilia. it is not family-friendly. it is in the riverside area. it has a 1 out of 5 customer rating and a price range of high."
"name[The Mill], eatType[pub], food[Fast food], priceRange[high], customer rating[1 out of 5], area[riverside], familyFriendly[yes], near[Café Sicilia]"	"the mill is a family friendly pub located near café sicilia. it is a high priced pub with a 1 out of 5 customer rating."
"name[The Mill], eatType[pub], food[Fast food], priceRange[high], customer rating[average], area[city centre], familyFriendly[no], near[Café Sicilia]"	"the mill is a pub that serves fast food in the city centre near café sicilia. it is not child friendly and has a high price range and a customer rating of average."
"name[The Mill], eatType[pub], food[Fast food], priceRange[high], customer rating[average], area[city centre], familyFriendly[yes], near[Café Sicilia]"	"the mill is a family-friendly pub located near café sicilia in the city centre. it serves fast food at a high price."
"name[The Mill], eatType[pub], food[Fast food], priceRange[high], customer rating[average], area[riverside], familyFriendly[no], near[Café Sicilia]"	"the mill is a fast food pub near café sicilia. it is not family-friendly. it is in the riverside area. it has an average customer rating and a price range of high."
"name[The Mill], eatType[pub], food[Fast food], priceRange[high], customer rating[average], area[riverside], familyFriendly[yes], near[Café Sicilia]"	"the mill is a family friendly pub located near café sicilia. it is a high priced pub with an average customer rating."
"name[The Mill], eatType[pub], food[Fast food], priceRange[less than £20], customer rating[low], area[city centre], familyFriendly[no], near[Café Sicilia]"	"the mill is a pub that serves fast food in the city centre near café sicilia. it is not child friendly and has a less than £20 price range and a customer rating of low."
"name[The Mill], eatType[pub], food[Fast food], priceRange[less than £20], customer rating[low], area[city centre], familyFriendly[yes], near[Café Sicilia]"	"the mill is a family-friendly pub located near café sicilia in the city centre. it serves fast food at a less than £20 price."
"name[The Mill], eatType[pub], food[Fast food], priceRange[less than £20], customer rating[low], area[riverside], familyFriendly[no], near[Café Sicilia]"	"the mill is a fast food pub near café sicilia. it is not family-friendly. it is in the riverside area. it has a low customer rating and a price range of less than £20."
"name[The Mill], eatType[pub], food[Fast food], priceRange[less than £20], customer rating[low], area[riverside], familyFriendly[yes], near[Café Sicilia]"	"the mill is a family friendly pub located near café sicilia. it is a less than £20 priced pub with a low customer rating."
"name[The Mill], eatType[pub], food[Fast food], priceRange[moderate], customer rating[1 out of 5], area[city centre], familyFriendly[no], near[Café Sicilia]"	"the mill is a pub that serves fast food in the city centre near café sicilia. it is not child friendly and has a moderate price range and a customer rating of 1 out of 5."
"name[The Mill], eatType[pub], food[Fast food], priceRange[moderate], customer rating[1 out of 5], area[city centre], familyFriendly[yes], near[Café Sicilia]"	"the mill is a family-friendly pub located near café sicilia in the city centre. it serves fast food at a moderate price."
"name[The Mill], eatType[pub], food[Fast food], priceRange[moderate], customer rating[1 out of 5], area[riverside], familyFriendly[no], near[Café Sicilia]"	"the mill is a fast food pub near café sicilia. it is not family-friendly. it is in the riverside area. it has a 1 out of 5 customer rating and a price range of moderate."
"name[The Mill], eatType[pub], food[Fast food], priceRange[moderate], customer rating[1 out of 5], area[riverside], familyFriendly[yes], near[Café Sicilia]"	"the mill is a family friendly pub located near café sicilia. it is a moderate priced pub with a 1 out of 5 customer rating."
"name[The Mill], eatType[pub], food[Fast food], priceRange[moderate], customer rating[3 out of 5], area[city centre], familyFriendly[no], near[Café Sicilia]"	"the mill is a pub that serves fast food in the city centre near café sicilia. it is not child friendly and has a moderate price range and a customer rating of 3 out of 5."
"name[The Mill], eatType[pub], food[Fast food], priceRange[moderate], customer rating[3 out of 5], area[city centre], familyFriendly[yes], near[Café Sicilia]"	"the mill is a family-friendly pub located near café sicilia in the city centre. it serves fast food at a moderate price."
"name[The Mill], eatType[pub], food[Fast food], priceRange[moderate], customer rating[3 out of 5], area[riverside], familyFriendly[no], near[Café Sicilia]"	"the mill is a fast food pub near café sicilia. it is not family-friendly. it is in the riverside area. it has a 3 out of 5 customer rating and a price range of moderate."
"name[The Mill], eatType[pub], food[Fast food], priceRange[moderate], customer rating[3 out of 5], area[riverside], familyFriendly[yes], near[Café Sicilia]"	"the mill is a family friendly pub located near café sicilia. it is a moderate priced pub with a 3 out of 5 customer rating."
"name[The Mill], eatType[restaurant], food[English], priceRange[high], area[riverside], familyFriendly[yes], near[Raja Indian Cuisine]"	"the mill is a family friendly restaurant serving english food. it is located near raja indian cuisine in the riverside area."
"name[The Mill], eatType[restaurant], food[English], priceRange[high], customer rating[average], area[riverside], familyFriendly[yes], near[Café Rouge]"	"the mill is a family friendly restaurant that serves english food. it is located near the café rouge in the riverside area. the price range is high and the customer rating is average."
"name[The Mill], eatType[restaurant], food[English], priceRange[less than £20], area[city centre], familyFriendly[no], near[Raja Indian Cuisine]"	"the mill is a restaurant that serves english food. it is located in the city centre near raja indian cuisine. it is not child friendly and has a less than £20 price range."
"name[The Mill], eatType[restaurant], food[English], priceRange[less than £20], area[city centre], familyFriendly[yes], near[Raja Indian Cuisine]"	"the mill is a family-friendly restaurant serving english food. it is located in the city centre near raja indian cuisine. the price range is less than £20."
"name[The Mill], eatType[restaurant], food[English], priceRange[less than £20], area[riverside], familyFriendly[no], near[Raja Indian Cuisine]"	"the mill is a restaurant providing english food in the less than £20 price range. it is located in the riverside area near raja indian cuisine."
"name[The Mill], eatType[restaurant], food[English], priceRange[less than £20], area[riverside], familyFriendly[yes], near[Raja Indian Cuisine]"	"the mill is a family friendly restaurant serving english food. it is located near raja indian cuisine in the riverside area."
"name[The Mill], eatType[restaurant], food[English], priceRange[less than £20], customer rating[low], area[city centre], familyFriendly[no], near[Café Rouge]"	"the mill is a restaurant providing english food in the less than £20 price range. it is located in the city centre near café rouge. it is not child friendly and has a customer rating of low."
"name[The Mill], eatType[restaurant], food[English], priceRange[less than £20], customer rating[low], area[city centre], familyFriendly[yes], near[Café Rouge]"	"the mill is a family-friendly restaurant that serves english food. it is located in the city centre near café rouge. it has a less than £20 price range and a customer rating of low."
"name[The Mill], eatType[restaurant], food[English], priceRange[less than £20], customer rating[low], area[riverside], familyFriendly[no], near[Café Rouge]"	"the mill is a restaurant providing english food in the less than £20 price range. it is located in the riverside area near café rouge. it is not family-friendly and has a customer rating of low."
"name[The Mill], eatType[restaurant], food[English], priceRange[less than £20], customer rating[low], area[riverside], familyFriendly[yes], near[Café Rouge]"	"the mill is a family friendly restaurant that serves english food. it is located near the café rouge in the riverside area. the price range is less than £20 and the customer rating is low."
"name[The Mill], eatType[restaurant], food[English], priceRange[moderate], area[city centre], familyFriendly[no], near[Raja Indian Cuisine]"	"the mill is a restaurant that serves english food. it is located in the city centre near raja indian cuisine. it is not child friendly and has a moderate price range."
"name[The Mill], eatType[restaurant], food[English], priceRange[moderate], area[city centre], familyFriendly[yes], near[Raja Indian Cuisine]"	"the mill is a family-friendly restaurant serving english food. it is located in the city centre near raja indian cuisine. the price range is moderate."
"name[The Mill], eatType[restaurant], food[English], priceRange[moderate], area[riverside], familyFriendly[no], near[Raja Indian Cuisine]"	"the mill is a restaurant providing english food in the moderate price range. it is located in the riverside area near raja indian cuisine."
"name[The Mill], eatType[restaurant], food[English], priceRange[moderate], area[riverside], familyFriendly[yes], near[Raja Indian Cuisine]"	"the mill is a family friendly restaurant serving english food. it is located near raja indian cuisine in the riverside area."
"name[The Mill], eatType[restaurant], food[English], priceRange[moderate], customer rating[1 out of 5], area[city centre], familyFriendly[no], near[Café Rouge]"	"the mill is a restaurant providing english food in the moderate price range. it is located in the city centre near café rouge. it is not child friendly and has a customer rating of 1 out of 5."
"name[The Mill], eatType[restaurant], food[English], priceRange[moderate], customer rating[1 out of 5], area[city centre], familyFriendly[yes], near[Café Rouge]"	"the mill is a family-friendly restaurant that serves english food. it is located in the city centre near café rouge. it has a moderate price range and a customer rating of 1 out of 5."
"name[The Mill], eatType[restaurant], food[English], priceRange[moderate], customer rating[1 out of 5], area[riverside], familyFriendly[no], near[Café Rouge]"	"the mill is a restaurant providing english food in the moderate price range. it is located in the riverside area near café rouge. it is not family-friendly and has a customer rating of 1 out of 5."
"name[The Mill], eatType[restaurant], food[English], priceRange[moderate], customer rating[1 out of 5], area[riverside], familyFriendly[yes], near[Café Rouge]"	"the mill is a family friendly restaurant that serves english food. it is located near the café rouge in the riverside area. the price range is moderate and the customer rating is 1 out of 5."
"name[The Mill], eatType[restaurant], food[English], priceRange[moderate], customer rating[3 out of 5], area[city centre], familyFriendly[no], near[Café Rouge]"	"the mill is a restaurant providing english food in the moderate price range. it is located in the city centre near café rouge. it is not child friendly and has a customer rating of 3 out of 5."
"name[The Mill], eatType[restaurant], food[English], priceRange[moderate], customer rating[3 out of 5], area[city centre], familyFriendly[yes], near[Café Rouge]"	"the mill is a family-friendly restaurant that serves english food. it is located in the city centre near café rouge. it has a moderate price range and a customer rating of 3 out of 5."
"name[The Mill], eatType[restaurant], food[English], priceRange[moderate], customer rating[3 out of 5], area[riverside], familyFriendly[no], near[Café Rouge]"	"the mill is a restaurant providing english food in the moderate price range. it is located in the riverside area near café rouge. it is not family-friendly and has a customer rating of 3 out of 5."
"name[The Mill], eatType[restaurant], food[English], priceRange[moderate], customer rating[3 out of 5], area[riverside], familyFriendly[yes], near[Café Rouge]"	"the mill is a family friendly restaurant that serves english food. it is located near the café rouge in the riverside area. the price range is moderate and the customer rating is 3 out of 5."
"name[The Mill], eatType[restaurant], food[English], priceRange[more than £30], area[riverside], familyFriendly[yes], near[Raja Indian Cuisine]"	"the mill is a family friendly restaurant serving english food. it is located near raja indian cuisine in the riverside area."
"name[The Mill], eatType[restaurant], food[English], priceRange[more than £30], customer rating[high], area[city centre], familyFriendly[no], near[Café Rouge]"	"the mill is a restaurant providing english food in the more than £30 price range. it is located in the city centre near café rouge. it is not child friendly and has a customer rating of high."
"name[The Mill], eatType[restaurant], food[English], priceRange[more than £30], customer rating[high], area[city centre], familyFriendly[yes], near[Café Rouge]"	"the mill is a family-friendly restaurant that serves english food. it is located in the city centre near café rouge. it has a more than £30 price range and a customer rating of high."
"name[The Mill], eatType[restaurant], food[English], priceRange[more than £30], customer rating[high], area[riverside], familyFriendly[no], near[Café Rouge]"	"the mill is a restaurant providing english food in the more than £30 price range. it is located in the riverside area near café rouge. it is not family-friendly and has a customer rating of high."
"name[The Mill], eatType[restaurant], food[English], priceRange[more than £30], customer rating[high], area[riverside], familyFriendly[yes], near[Café Rouge]"	"the mill is a family friendly restaurant that serves english food. it is located near the café rouge in the riverside area. the price range is more than £30 and the customer rating is high."
"name[The Mill], eatType[restaurant], food[Fast food], priceRange[£20-25], area[riverside], familyFriendly[yes], near[Raja Indian Cuisine]"	"the mill is a family friendly restaurant located near raja indian cuisine."
"name[The Mill], eatType[restaurant], food[Fast food], priceRange[cheap], area[riverside], familyFriendly[yes], near[Raja Indian Cuisine]"	"the mill is a family friendly restaurant located near raja indian cuisine."
"name[The Phoenix], eatType[pub], food[Fast food], priceRange[cheap], area[riverside], familyFriendly[yes], near[Raja Indian Cuisine]"	"the phoenix is a family friendly pub serving fast food in the riverside area. it is near raja indian cuisine and has a price range of cheap."
"name[The Phoenix], eatType[pub], food[Fast food], priceRange[high], area[city centre], familyFriendly[no], near[Raja Indian Cuisine]"	"the phoenix is a pub that serves fast food in the city centre near raja indian cuisine. it is not child friendly and has a price range of high."
"name[The Phoenix], eatType[pub], food[Fast food], priceRange[high], area[city centre], familyFriendly[yes], near[Raja Indian Cuisine]"	"the phoenix is a pub that serves fast food in the city centre near raja indian cuisine. it is kid friendly and has a price range of high."
"name[The Phoenix], eatType[pub], food[Fast food], priceRange[high], area[riverside], familyFriendly[no], near[Raja Indian Cuisine]"	"the phoenix is a pub near raja indian cuisine in the riverside area. it is not family-friendly and serves fast food at a high price range."
"name[The Phoenix], eatType[pub], food[Fast food], priceRange[high], area[riverside], familyFriendly[yes], near[Raja Indian Cuisine]"	"the phoenix is a family friendly pub serving fast food in the riverside area. it is near raja indian cuisine and has a price range of high."
"name[The Phoenix], eatType[pub], food[Fast food], priceRange[less than £20], area[city centre], familyFriendly[no], near[Raja Indian Cuisine]"	"the phoenix is a pub that serves fast food in the city centre near raja indian cuisine. it is not child friendly and has a price range of less than £20."
"name[The Phoenix], eatType[pub], food[Fast food], priceRange[less than £20], area[city centre], familyFriendly[yes], near[Raja Indian Cuisine]"	"the phoenix is a pub that serves fast food in the city centre near raja indian cuisine. it is kid friendly and has a price range of less than £20."
"name[The Phoenix], eatType[pub], food[Fast food], priceRange[less than £20], area[riverside], familyFriendly[no], near[Raja Indian Cuisine]"	"the phoenix is a pub near raja indian cuisine in the riverside area. it is not family-friendly and serves fast food at a less than £20 price range."
"name[The Phoenix], eatType[pub], food[Fast food], priceRange[less than £20], area[riverside], familyFriendly[yes], near[Raja Indian Cuisine]"	"the phoenix is a family friendly pub serving fast food in the riverside area. it is near raja indian cuisine and has a price range of less than £20."
"name[The Phoenix], eatType[pub], food[Fast food], priceRange[moderate], area[city centre], familyFriendly[no], near[Raja Indian Cuisine]"	"the phoenix is a pub that serves fast food in the city centre near raja indian cuisine. it is not child friendly and has a price range of moderate."
"name[The Phoenix], eatType[pub], food[Fast food], priceRange[moderate], area[city centre], familyFriendly[yes], near[Raja Indian Cuisine]"	"the phoenix is a pub that serves fast food in the city centre near raja indian cuisine. it is kid friendly and has a price range of moderate."
"name[The Phoenix], eatType[pub], food[Fast food], priceRange[moderate], area[riverside], familyFriendly[no], near[Raja Indian Cuisine]"	"the phoenix is a pub near raja indian cuisine in the riverside area. it is not family-friendly and serves fast food at a moderate price range."
"name[The Phoenix], eatType[pub], food[Fast food], priceRange[moderate], area[riverside], familyFriendly[yes], near[Raja Indian Cuisine]"	"the phoenix is a family friendly pub serving fast food in the riverside area. it is near raja indian cuisine and has a price range of moderate."
"name[The Phoenix], eatType[pub], food[Fast food], priceRange[moderate], customer rating[3 out of 5], area[riverside], familyFriendly[yes], near[Café Sicilia]"	"the phoenix is a family friendly pub located near café sicilia. it is a moderate priced pub with a 3 out of 5 customer rating."
"name[The Phoenix], eatType[pub], food[Fast food], priceRange[more than £30], area[riverside], familyFriendly[yes], near[Raja Indian Cuisine]"	"the phoenix is a family friendly pub serving fast food in the riverside area. it is near raja indian cuisine and has a price range of more than £30."
"name[The Phoenix], eatType[pub], food[Fast food], priceRange[more than £30], customer rating[high], area[city centre], familyFriendly[no], near[Café Sicilia]"	"the phoenix is a pub that serves fast food in the city centre near café sicilia. it is not child friendly and has a more than £30 price range and a customer rating of high."
"name[The Phoenix], eatType[pub], food[Fast food], priceRange[more than £30], customer rating[high], area[city centre], familyFriendly[yes], near[Café Sicilia]"	"the phoenix is a family-friendly pub located near café sicilia in the city centre. it serves fast food at a more than £30 price."
"name[The Phoenix], eatType[pub], food[Fast food], priceRange[more than £30], customer rating[high], area[riverside], familyFriendly[no], near[Café Sicilia]"	"the phoenix is a fast food pub near café sicilia. it is not family-friendly. it is in the riverside area. it has a high customer rating and a price range of more than £30."
"name[The Phoenix], eatType[pub], food[Fast food], priceRange[more than £30], customer rating[high], area[riverside], familyFriendly[yes], near[Café Sicilia]"	"the phoenix is a family friendly pub located near café sicilia. it is a more than £30 priced pub with a high customer rating."
"name[The Phoenix], eatType[pub], food[French], priceRange[£20-25], area[riverside], familyFriendly[yes], near[Raja Indian Cuisine]"	"the phoenix is a family friendly pub serving french food. it is located near raja indian cuisine in the riverside area."
"name[The Phoenix], eatType[pub], food[French], priceRange[£20-25], customer rating[3 out of 5], area[city centre], familyFriendly[no], near[Café Sicilia]"	"the phoenix is a pub that serves french food. it is located in the city centre near café sicilia. it is not child friendly and has a 3 out of 5 customer rating. the price range is £20-25."
"name[The Phoenix], eatType[pub], food[French], priceRange[£20-25], customer rating[3 out of 5], area[city centre], familyFriendly[yes], near[Café Sicilia]"	"the phoenix is a family-friendly pub serving french food. it is located in the city centre near café sicilia. it has a 3 out of 5 customer rating and a price range of £20-25."
"name[The Phoenix], eatType[pub], food[French], priceRange[£20-25], customer rating[3 out of 5], area[riverside], familyFriendly[no], near[Café Sicilia]"	"the phoenix is a pub that serves french food. it is located near café sicilia in riverside. it is not child friendly and has a 3 out of 5 customer rating."
"name[The Phoenix], eatType[pub], food[French], priceRange[£20-25], customer rating[3 out of 5], area[riverside], familyFriendly[yes], near[Café Sicilia]"	"the phoenix is a family friendly pub located near café sicilia. it is located in the city centre."
"name[The Phoenix], eatType[pub], food[French], priceRange[£20-25], customer rating[3 out of 5], area[riverside], familyFriendly[yes], near[Crowne Plaza Hotel]"	"the phoenix is a family friendly pub located near crowne plaza hotel. it is located in the city centre."
"name[The Phoenix], eatType[pub], food[French], priceRange[£20-25], customer rating[high], area[city centre], familyFriendly[no], near[Crowne Plaza Hotel]"	"the phoenix is a pub that serves french food. it is located in the city centre near crowne plaza hotel. it is not child friendly and has a high customer rating. the price range is £20-25."
"name[The Phoenix], eatType[pub], food[French], priceRange[£20-25], customer rating[high], area[city centre], familyFriendly[yes], near[Crowne Plaza Hotel]"	"the phoenix is a family-friendly pub serving french food. it is located in the city centre near crowne plaza hotel. it has a high customer rating and a price range of £20-25."
"name[The Phoenix], eatType[pub], food[French], priceRange[£20-25], customer rating[high], area[riverside], familyFriendly[no], near[Crowne Plaza Hotel]"	"the phoenix is a pub that serves french food. it is located near crowne plaza hotel in riverside. it is not child friendly and has a high customer rating."
"name[The Phoenix], eatType[pub], food[French], priceRange[£20-25], customer rating[high], area[riverside], familyFriendly[yes], near[Crowne Plaza Hotel]"	"the phoenix is a family friendly pub located near crowne plaza hotel. it is located in the city centre."
"name[The Phoenix], eatType[pub], food[French], priceRange[cheap], area[riverside], familyFriendly[yes], near[Raja Indian Cuisine]"	"the phoenix is a family friendly pub serving french food. it is located near raja indian cuisine in the riverside area."
"name[The Phoenix], eatType[pub], food[French], priceRange[cheap], customer rating[5 out of 5], area[city centre], familyFriendly[no], near[Crowne Plaza Hotel]"	"the phoenix is a pub that serves french food. it is located in the city centre near crowne plaza hotel. it is not child friendly and has a 5 out of 5 customer rating. the price range is cheap."
"name[The Phoenix], eatType[pub], food[French], priceRange[cheap], customer rating[5 out of 5], area[city centre], familyFriendly[yes], near[Crowne Plaza Hotel]"	"the phoenix is a family-friendly pub serving french food. it is located in the city centre near crowne plaza hotel. it has a 5 out of 5 customer rating and a price range of cheap."
"name[The Phoenix], eatType[pub], food[French], priceRange[cheap], customer rating[5 out of 5], area[riverside], familyFriendly[no], near[Crowne Plaza Hotel]"	"the phoenix is a pub that serves french food. it is located near crowne plaza hotel in riverside. it is not child friendly and has a 5 out of 5 customer rating."
"name[The Phoenix], eatType[pub], food[French], priceRange[cheap], customer rating[5 out of 5], area[riverside], familyFriendly[yes], near[Crowne Plaza Hotel]"	"the phoenix is a family friendly pub located near crowne plaza hotel. it is located in the city centre."
"name[The Phoenix], eatType[pub], food[French], priceRange[high], area[riverside], familyFriendly[yes], near[Raja Indian Cuisine]"	"the phoenix is a family friendly pub serving french food. it is located near raja indian cuisine in the riverside area."
"name[The Phoenix], eatType[pub], food[French], priceRange[high], customer rating[3 out of 5], area[city centre], familyFriendly[no], near[Crowne Plaza Hotel]"	"the phoenix is a pub that serves french food. it is located in the city centre near crowne plaza hotel. it is not child friendly and has a 3 out of 5 customer rating. the price range is high."
"name[The Phoenix], eatType[pub], food[French], priceRange[high], customer rating[3 out of 5], area[city centre], familyFriendly[yes], near[Crowne Plaza Hotel]"	"the phoenix is a family-friendly pub serving french food. it is located in the city centre near crowne plaza hotel. it has a 3 out of 5 customer rating and a price range of high."
"name[The Phoenix], eatType[pub], food[French], priceRange[high], customer rating[3 out of 5], area[riverside], familyFriendly[no], near[Crowne Plaza Hotel]"	"the phoenix is a pub that serves french food. it is located near crowne plaza hotel in riverside. it is not child friendly and has a 3 out of 5 customer rating."
"name[The Phoenix], eatType[pub], food[French], priceRange[high], customer rating[3 out of 5], area[riverside], familyFriendly[yes], near[Crowne Plaza Hotel]"	"the phoenix is a family friendly pub located near crowne plaza hotel. it is located in the city centre."
"name[The Phoenix], eatType[pub], food[French], priceRange[less than £20], customer rating[average], area[city centre], familyFriendly[no], near[Crowne Plaza Hotel]"	"the phoenix is a pub that serves french food. it is located in the city centre near crowne plaza hotel. it is not child friendly and has an average customer rating. the price range is less than £20."
"name[The Phoenix], eatType[pub], food[French], priceRange[less than £20], customer rating[average], area[city centre], familyFriendly[yes], near[Crowne Plaza Hotel]"	"the phoenix is a family-friendly pub serving french food. it is located in the city centre near crowne plaza hotel. it has an average customer rating and a price range of less than £20."
"name[The Phoenix], eatType[pub], food[French], priceRange[less than £20], customer rating[average], area[riverside], familyFriendly[no], near[Crowne Plaza Hotel]"	"the phoenix is a pub that serves french food. it is located near crowne plaza hotel in riverside. it is not child friendly and has an average customer rating."
"name[The Phoenix], eatType[pub], food[French], priceRange[less than £20], customer rating[average], area[riverside], familyFriendly[yes], near[Crowne Plaza Hotel]"	"the phoenix is a family friendly pub located near crowne plaza hotel. it is located in the city centre."
"name[The Phoenix], eatType[pub], food[French], priceRange[less than £20], customer rating[low], area[city centre], familyFriendly[no], near[Crowne Plaza Hotel]"	"the phoenix is a pub that serves french food. it is located in the city centre near crowne plaza hotel. it is not child friendly and has a low customer rating. the price range is less than £20."
"name[The Phoenix], eatType[pub], food[French], priceRange[less than £20], customer rating[low], area[city centre], familyFriendly[yes], near[Crowne Plaza Hotel]"	"the phoenix is a family-friendly pub serving french food. it is located in the city centre near crowne plaza hotel. it has a low customer rating and a price range of less than £20."
"name[The Phoenix], eatType[pub], food[French], priceRange[less than £20], customer rating[low], area[riverside], familyFriendly[no], near[Crowne Plaza Hotel]"	"the phoenix is a pub that serves french food. it is located near crowne plaza hotel in riverside. it is not child friendly and has a low customer rating."
"name[The Phoenix], eatType[pub], food[French], priceRange[less than £20], customer rating[low], area[riverside], familyFriendly[yes], near[Crowne Plaza Hotel]"	"the phoenix is a family friendly pub located near crowne plaza hotel. it is located in the city centre."
"name[The Phoenix], eatType[pub], food[French], priceRange[moderate], customer rating[1 out of 5], area[city centre], familyFriendly[no], near[Crowne Plaza Hotel]"	"the phoenix is a pub that serves french food. it is located in the city centre near crowne plaza hotel. it is not child friendly and has a 1 out of 5 customer rating. the price range is moderate."
"name[The Phoenix], eatType[pub], food[French], priceRange[moderate], customer rating[1 out of 5], area[city centre], familyFriendly[yes], near[Crowne Plaza Hotel]"	"the phoenix is a family-friendly pub serving french food. it is located in the city centre near crowne plaza hotel. it has a 1 out of 5 customer rating and a price range of moderate."
"name[The Phoenix], eatType[pub], food[French], priceRange[moderate], customer rating[1 out of 5], area[riverside], familyFriendly[no], near[Crowne Plaza Hotel]"	"the phoenix is a pub that serves french food. it is located near crowne plaza hotel in riverside. it is not child friendly and has a 1 out of 5 customer rating."
"name[The Phoenix], eatType[pub], food[French], priceRange[moderate], customer rating[1 out of 5], area[riverside], familyFriendly[yes], near[Crowne Plaza Hotel]"	"the phoenix is a family friendly pub located near crowne plaza hotel. it is located in the city centre."
"name[The Phoenix], eatType[pub], food[French], priceRange[more than £30], customer rating[5 out of 5], area[city centre], familyFriendly[no], near[Crowne Plaza Hotel]"	"the phoenix is a pub that serves french food. it is located in the city centre near crowne plaza hotel. it is not child friendly and has a 5 out of 5 customer rating. the price range is more than £30."
"name[The Phoenix], eatType[pub], food[French], priceRange[more than £30], customer rating[5 out of 5], area[city centre], familyFriendly[yes], near[Crowne Plaza Hotel]"	"the phoenix is a family-friendly pub serving french food. it is located in the city centre near crowne plaza hotel. it has a 5 out of 5 customer rating and a price range of more than £30."
"name[The Phoenix], eatType[pub], food[French], priceRange[more than £30], customer rating[5 out of 5], area[riverside], familyFriendly[no], near[Crowne Plaza Hotel]"	"the phoenix is a pub that serves french food. it is located near crowne plaza hotel in riverside. it is not child friendly and has a 5 out of 5 customer rating."
"name[The Phoenix], eatType[pub], food[French], priceRange[more than £30], customer rating[5 out of 5], area[riverside], familyFriendly[yes], near[Crowne Plaza Hotel]"	"the phoenix is a family friendly pub located near crowne plaza hotel. it is located in the city centre."
"name[The Phoenix], eatType[pub], food[French], priceRange[more than £30], customer rating[low], area[city centre], familyFriendly[no], near[Crowne Plaza Hotel]"	"the phoenix is a pub that serves french food. it is located in the city centre near crowne plaza hotel. it is not child friendly and has a low customer rating. the price range is more than £30."
"name[The Phoenix], eatType[pub], food[French], priceRange[more than £30], customer rating[low], area[city centre], familyFriendly[yes], near[Crowne Plaza Hotel]"	"the phoenix is a family-friendly pub serving french food. it is located in the city centre near crowne plaza hotel. it has a low customer rating and a price range of more than £30."
"name[The Phoenix], eatType[pub], food[French], priceRange[more than £30], customer rating[low], area[riverside], familyFriendly[no], near[Crowne Plaza Hotel]"	"the phoenix is a pub that serves french food. it is located near crowne plaza hotel in riverside. it is not child friendly and has a low customer rating."
"name[The Phoenix], eatType[pub], food[French], priceRange[more than £30], customer rating[low], area[riverside], familyFriendly[yes], near[Crowne Plaza Hotel]"	"the phoenix is a family friendly pub located near crowne plaza hotel. it is located in the city centre."
"name[The Phoenix], eatType[restaurant], food[Fast food], priceRange[cheap], area[riverside], familyFriendly[yes], near[Raja Indian Cuisine]"	"the phoenix is a family friendly restaurant located near raja indian cuisine."
"name[The Phoenix], eatType[restaurant], food[Fast food], priceRange[high], area[city centre], familyFriendly[no], near[Raja Indian Cuisine]"	"the phoenix is a fast food restaurant located in the city centre near raja indian cuisine. it is not child friendly and has a price range of high."
"name[The Phoenix], eatType[restaurant], food[Fast food], priceRange[high], area[city centre], familyFriendly[yes], near[Raja Indian Cuisine]"	"the phoenix is a family-friendly fast food restaurant located near raja indian cuisine in the city centre. it has a high price range."
"name[The Phoenix], eatType[restaurant], food[Fast food], priceRange[high], area[riverside], familyFriendly[no], near[Raja Indian Cuisine]"	"the phoenix is a fast food restaurant located near raja indian cuisine in the riverside area. it is not family-friendly and has a price range of high."
"name[The Phoenix], eatType[restaurant], food[Fast food], priceRange[high], area[riverside], familyFriendly[yes], near[Raja Indian Cuisine]"	"the phoenix is a family friendly restaurant located near raja indian cuisine."
"name[The Phoenix], eatType[restaurant], food[Fast food], priceRange[less than £20], area[city centre], familyFriendly[no], near[Raja Indian Cuisine]"	"the phoenix is a fast food restaurant located in the city centre near raja indian cuisine. it is not child friendly and has a price range of less than £20."
"name[The Phoenix], eatType[restaurant], food[Fast food], priceRange[less than £20], area[city centre], familyFriendly[yes], near[Raja Indian Cuisine]"	"the phoenix is a family-friendly fast food restaurant located near raja indian cuisine in the city centre. it has a less than £20 price range."
"name[The Phoenix], eatType[restaurant], food[Fast food], priceRange[less than £20], area[riverside], familyFriendly[no], near[Raja Indian Cuisine]"	"the phoenix is a fast food restaurant located near raja indian cuisine in the riverside area. it is not family-friendly and has a price range of less than £20."
"name[The Phoenix], eatType[restaurant], food[Fast food], priceRange[less than £20], area[riverside], familyFriendly[yes], near[Raja Indian Cuisine]"	"the phoenix is a family friendly restaurant located near raja indian cuisine."
"name[The Phoenix], eatType[restaurant], food[Fast food], priceRange[moderate], area[city centre], familyFriendly[no], near[Raja Indian Cuisine]"	"the phoenix is a fast food restaurant located in the city centre near raja indian cuisine. it is not child friendly and has a price range of moderate."
"name[The Phoenix], eatType[restaurant], food[Fast food], priceRange[moderate], area[city centre], familyFriendly[yes], near[Raja Indian Cuisine]"	"the phoenix is a family-friendly fast food restaurant located near raja indian cuisine in the city centre. it has a moderate price range."
"name[The Phoenix], eatType[restaurant], food[Fast food], priceRange[moderate], area[riverside], familyFriendly[no], near[Raja Indian Cuisine]"	"the phoenix is a fast food restaurant located near raja indian cuisine in the riverside area. it is not family-friendly and has a price range of moderate."
"name[The Phoenix], eatType[restaurant], food[Fast food], priceRange[moderate], area[riverside], familyFriendly[yes], near[Raja Indian Cuisine]"	"the phoenix is a family friendly restaurant located near raja indian cuisine."
"name[The Phoenix], eatType[restaurant], food[Fast food], priceRange[more than £30], area[riverside], familyFriendly[yes], near[Raja Indian Cuisine]"	"the phoenix is a family friendly restaurant located near raja indian cuisine."
"name[The Phoenix], eatType[restaurant], food[French], priceRange[£20-25], area[riverside], familyFriendly[yes], near[Raja Indian Cuisine]"	"the phoenix is a family friendly restaurant serving french food in the riverside area near raja indian cuisine. the price range is £20-25."
"name[The Phoenix], eatType[restaurant], food[French], priceRange[cheap], area[riverside], familyFriendly[yes], near[Raja Indian Cuisine]"	"the phoenix is a family friendly restaurant serving french food in the riverside area near raja indian cuisine. the price range is cheap."
"name[The Phoenix], eatType[restaurant], food[French], priceRange[high], area[riverside], familyFriendly[yes], near[Raja Indian Cuisine]"	"the phoenix is a family friendly restaurant serving french food in the riverside area near raja indian cuisine. the price range is high."
"name[The Phoenix], eatType[restaurant], food[Indian], priceRange[£20-25], customer rating[high], area[city centre], familyFriendly[no], near[Crowne Plaza Hotel]"	"the phoenix is a restaurant providing indian food in the £20-25 price range. it is located in the city centre. it is near crowne plaza hotel. its customer rating is high."
"name[The Phoenix], eatType[restaurant], food[Indian], priceRange[£20-25], customer rating[high], area[city centre], familyFriendly[yes], near[Crowne Plaza Hotel]"	"the phoenix is a restaurant providing indian food in the £20-25 price range. it is located in the city centre. it is near crowne plaza hotel. its customer rating is high."
"name[The Phoenix], eatType[restaurant], food[Indian], priceRange[£20-25], customer rating[high], area[riverside], familyFriendly[no], near[Crowne Plaza Hotel]"	"the phoenix is a restaurant providing indian food in the £20-25 price range. it is located in the riverside. it is near crowne plaza hotel. its customer rating is high."
"name[The Phoenix], eatType[restaurant], food[Indian], priceRange[£20-25], customer rating[high], area[riverside], familyFriendly[yes], near[Crowne Plaza Hotel]"	"the phoenix is a restaurant providing indian food in the £20-25 price range. it is located in the riverside. it is near crowne plaza hotel. its customer rating is high."
"name[The Phoenix], eatType[restaurant], food[Indian], priceRange[cheap], customer rating[5 out of 5], area[city centre], familyFriendly[no], near[Crowne Plaza Hotel]"	"the phoenix is a restaurant providing indian food in the cheap price range. it is located in the city centre. it is near crowne plaza hotel. its customer rating is 5 out of 5."
"name[The Phoenix], eatType[restaurant], food[Indian], priceRange[cheap], customer rating[5 out of 5], area[city centre], familyFriendly[yes], near[Crowne Plaza Hotel]"	"the phoenix is a restaurant providing indian food in the cheap price range. it is located in the city centre. it is near crowne plaza hotel. its customer rating is 5 out of 5."
"name[The Phoenix], eatType[restaurant], food[Indian], priceRange[cheap], customer rating[5 out of 5], area[riverside], familyFriendly[no], near[Crowne Plaza Hotel]"	"the phoenix is a restaurant providing indian food in the cheap price range. it is located in the riverside. it is near crowne plaza hotel. its customer rating is 5 out of 5."
"name[The Phoenix], eatType[restaurant], food[Indian], priceRange[cheap], customer rating[5 out of 5], area[riverside], familyFriendly[no], near[Express by Holiday Inn]"	"the phoenix is a restaurant providing indian food in the cheap price range. it is located in the riverside. it is near express by holiday inn. its customer rating is 5 out of 5."
"name[The Phoenix], eatType[restaurant], food[Indian], priceRange[cheap], customer rating[5 out of 5], area[riverside], familyFriendly[yes], near[Express by Holiday Inn]"	"the phoenix is a restaurant providing indian food in the cheap price range. it is located in the riverside. it is near express by holiday inn. its customer rating is 5 out of 5."
"name[The Phoenix], eatType[restaurant], food[Indian], priceRange[cheap], customer rating[average], area[city centre], familyFriendly[no], near[Express by Holiday Inn]"	"the phoenix is a restaurant providing indian food in the cheap price range. it is located in the city centre. it is near express by holiday inn. its customer rating is average."
"name[The Plough], eatType[pub], food[Chinese], priceRange[£20-25], area[riverside], familyFriendly[yes], near[Raja Indian Cuisine]"	"the plough is a pub that serves chinese food in the £20-25 price range. it is located in the riverside. it is near raja indian cuisine."
"name[The Plough], eatType[pub], food[Chinese], priceRange[cheap], area[riverside], familyFriendly[yes], near[Raja Indian Cuisine]"	"the plough is a pub that serves chinese food in the cheap price range. it is located in the riverside. it is near raja indian cuisine."
"name[The Plough], eatType[pub], food[Chinese], priceRange[high], area[city centre], familyFriendly[no], near[Raja Indian Cuisine]"	"the plough is a pub that serves chinese food in the city centre near raja indian cuisine. it is not kid friendly and has a price range of high."
"name[The Plough], eatType[pub], food[Chinese], priceRange[high], area[city centre], familyFriendly[yes], near[Raja Indian Cuisine]"	"the plough is a pub that serves chinese food in the city centre near raja indian cuisine. it is family friendly and has a high price range."
"name[The Plough], eatType[pub], food[Chinese], priceRange[high], area[riverside], familyFriendly[no], near[Raja Indian Cuisine]"	"the plough is a pub that serves chinese food. it is located near raja indian cuisine in the riverside area. it is not family friendly and has a high price range."
"name[The Plough], eatType[pub], food[Chinese], priceRange[high], area[riverside], familyFriendly[yes], near[Raja Indian Cuisine]"	"the plough is a pub that serves chinese food in the high price range. it is located in the riverside. it is near raja indian cuisine."
"name[The Plough], eatType[pub], food[Chinese], priceRange[less than £20], area[city centre], familyFriendly[no], near[Raja Indian Cuisine]"	"the plough is a pub that serves chinese food in the city centre near raja indian cuisine. it is not kid friendly and has a price range of less than £20."
"name[The Plough], eatType[restaurant], food[Chinese], priceRange[£20-25], area[riverside], familyFriendly[yes], near[Raja Indian Cuisine]"	"the plough is a chinese restaurant located near raja indian cuisine in riverside. it is kid friendly and has a £20-25 price range."
"name[The Plough], eatType[restaurant], food[Chinese], priceRange[cheap], area[riverside], familyFriendly[yes], near[Raja Indian Cuisine]"	"the plough is a chinese restaurant located near raja indian cuisine in riverside. it is kid friendly and has a cheap price range."
"name[The Plough], eatType[restaurant], food[Chinese], priceRange[high], area[city centre], familyFriendly[no], near[Raja Indian Cuisine]"	"the plough is a chinese restaurant located in the city centre near raja indian cuisine. it is not child friendly and has a high price range."
"name[The Plough], eatType[restaurant], food[Chinese], priceRange[high], area[city centre], familyFriendly[yes], near[Raja Indian Cuisine]"	"the plough is a chinese restaurant located in the city centre near raja indian cuisine. it is family friendly and has a high price range."
"name[The Plough], eatType[restaurant], food[Chinese], priceRange[high], area[riverside], familyFriendly[no], near[Raja Indian Cuisine]"	"the plough is a chinese restaurant located near raja indian cuisine in the riverside area. it is not family friendly and has a high price range."
"name[The Plough], eatType[restaurant], food[Chinese], priceRange[high], area[riverside], familyFriendly[yes], near[Raja Indian Cuisine]"	"the plough is a chinese restaurant located near raja indian cuisine in riverside. it is kid friendly and has a high price range."
"name[The Plough], eatType[restaurant], food[Chinese], priceRange[less than £20], area[city centre], familyFriendly[no], near[Raja Indian Cuisine]"	"the plough is a chinese restaurant located in the city centre near raja indian cuisine. it is not child friendly and has a less than £20 price range."
"name[The Punter], eatType[pub], food[Chinese], priceRange[less than £20], area[city centre], familyFriendly[yes], near[Raja Indian Cuisine]"	"the punter is a pub that serves chinese food in the city centre near raja indian cuisine. it is family friendly and has a less than £20 price range."
"name[The Punter], eatType[pub], food[Chinese], priceRange[less than £20], area[riverside], familyFriendly[no], near[Raja Indian Cuisine]"	"the punter is a pub that serves chinese food. it is located near raja indian cuisine in the riverside area. it is not family friendly and has a less than £20 price range."
"name[The Punter], eatType[pub], food[Chinese], priceRange[less than £20], area[riverside], familyFriendly[yes], near[Raja Indian Cuisine]"	"the punter is a pub that serves chinese food in the less than £20 price range. it is located in the riverside. it is near raja indian cuisine."
"name[The Punter], eatType[pub], food[Chinese], priceRange[moderate], area[city centre], familyFriendly[no], near[Raja Indian Cuisine]"	"the punter is a pub that serves chinese food in the city centre near raja indian cuisine. it is not kid friendly and has a price range of moderate."
"name[The Punter], eatType[pub], food[Chinese], priceRange[moderate], area[city centre], familyFriendly[yes], near[Raja Indian Cuisine]"	"the punter is a pub that serves chinese food in the city centre near raja indian cuisine. it is family friendly and has a moderate price range."
"name[The Punter], eatType[pub], food[Chinese], priceRange[moderate], area[riverside], familyFriendly[no], near[Raja Indian Cuisine]"	"the punter is a pub that serves chinese food. it is located near raja indian cuisine in the riverside area. it is not family friendly and has a moderate price range."
"name[The Punter], eatType[pub], food[Chinese], priceRange[moderate], area[riverside], familyFriendly[yes], near[Raja Indian Cuisine]"	"the punter is a pub that serves chinese food in the moderate price range. it is located in the riverside. it is near raja indian cuisine."
"name[The Punter], eatType[pub], food[Chinese], priceRange[more than £30], area[riverside], familyFriendly[yes], near[Raja Indian Cuisine]"	"the punter is a pub that serves chinese food in the more than £30 price range. it is located in the riverside. it is near raja indian cuisine."
"name[The Punter], eatType[pub], food[English], priceRange[£20-25], area[riverside], familyFriendly[yes], near[Raja Indian Cuisine]"	"the punter is a family friendly pub serving english food. it is located near raja indian cuisine in the riverside area."
"name[The Punter], eatType[pub], food[English], priceRange[cheap], area[riverside], familyFriendly[yes], near[Raja Indian Cuisine]"	"the punter is a family friendly pub serving english food. it is located near raja indian cuisine in the riverside area."
"name[The Punter], eatType[pub], food[English], priceRange[high], area[city centre], familyFriendly[no], near[Raja Indian Cuisine]"	"the punter is a pub that serves english food. it is located in the city centre near raja indian cuisine. it is not child friendly and has a price range of high."
"name[The Punter], eatType[pub], food[English], priceRange[high], area[city centre], familyFriendly[yes], near[Raja Indian Cuisine]"	"the punter is a pub that serves english food. it is located in the city centre near raja indian cuisine. it is family-friendly and has a high price range."
"name[The Punter], eatType[pub], food[English], priceRange[high], area[riverside], familyFriendly[no], near[Raja Indian Cuisine]"	"the punter is a pub that serves english food. it is located near raja indian cuisine in the riverside area. it is not child friendly and has a price range of high."
"name[The Punter], eatType[pub], food[English], priceRange[high], area[riverside], familyFriendly[yes], near[Raja Indian Cuisine]"	"the punter is a family friendly pub serving english food. it is located near raja indian cuisine in the riverside area."
"name[The Punter], eatType[pub], food[Italian], priceRange[high], customer rating[average], area[city centre], familyFriendly[no], near[Rainbow Vegetarian Café]"	"the punter is a pub that serves italian food. it is located in the city centre near rainbow vegetarian café. it is not child friendly and has an average customer rating."
"name[The Punter], eatType[restaurant], food[Chinese], priceRange[less than £20], area[city centre], familyFriendly[yes], near[Raja Indian Cuisine]"	"the punter is a chinese restaurant located in the city centre near raja indian cuisine. it is family friendly and has a less than £20 price range."
"name[The Punter], eatType[restaurant], food[Chinese], priceRange[less than £20], area[riverside], familyFriendly[no], near[Raja Indian Cuisine]"	"the punter is a chinese restaurant located near raja indian cuisine in the riverside area. it is not family friendly and has a less than £20 price range."
"name[The Punter], eatType[restaurant], food[Chinese], priceRange[less than £20], area[riverside], familyFriendly[yes], near[Raja Indian Cuisine]"	"the punter is a chinese restaurant located near raja indian cuisine in riverside. it is kid friendly and has a less than £20 price range."
"name[The Punter], eatType[restaurant], food[Chinese], priceRange[moderate], area[city centre], familyFriendly[no], near[Raja Indian Cuisine]"	"the punter is a chinese restaurant located in the city centre near raja indian cuisine. it is not child friendly and has a moderate price range."
"name[The Punter], eatType[restaurant], food[Chinese], priceRange[moderate], area[city centre], familyFriendly[yes], near[Raja Indian Cuisine]"	"the punter is a chinese restaurant located in the city centre near raja indian cuisine. it is family friendly and has a moderate price range."
"name[The Punter], eatType[restaurant], food[Chinese], priceRange[moderate], area[riverside], familyFriendly[no], near[Raja Indian Cuisine]"	"the punter is a chinese restaurant located near raja indian cuisine in the riverside area. it is not family friendly and has a moderate price range."
"name[The Punter], eatType[restaurant], food[Chinese], priceRange[moderate], area[riverside], familyFriendly[yes], near[Raja Indian Cuisine]"	"the punter is a chinese restaurant located near raja indian cuisine in riverside. it is kid friendly and has a moderate price range."
"name[The Punter], eatType[restaurant], food[Chinese], priceRange[more than £30], area[riverside], familyFriendly[yes], near[Raja Indian Cuisine]"	"the punter is a chinese restaurant located near raja indian cuisine in riverside. it is kid friendly and has a more than £30 price range."
"name[The Punter], eatType[restaurant], food[English], priceRange[£20-25], area[riverside], familyFriendly[yes], near[Raja Indian Cuisine]"	"the punter is a family friendly restaurant serving english food. it is located near raja indian cuisine in the riverside area."
"name[The Punter], eatType[restaurant], food[English], priceRange[cheap], area[riverside], familyFriendly[yes], near[Raja Indian Cuisine]"	"the punter is a family friendly restaurant serving english food. it is located near raja indian cuisine in the riverside area."
"name[The Punter], eatType[restaurant], food[English], priceRange[high], area[city centre], familyFriendly[no], near[Raja Indian Cuisine]"	"the punter is a restaurant that serves english food. it is located in the city centre near raja indian cuisine. it is not child friendly and has a high price range."
"name[The Punter], eatType[restaurant], food[English], priceRange[high], area[city centre], familyFriendly[yes], near[Raja Indian Cuisine]"	"the punter is a family-friendly restaurant serving english food. it is located in the city centre near raja indian cuisine. the price range is high."
"name[The Punter], eatType[restaurant], food[English], priceRange[high], area[riverside], familyFriendly[no], near[Raja Indian Cuisine]"	"the punter is a restaurant providing english food in the high price range. it is located in the riverside area near raja indian cuisine."
"name[The Punter], eatType[restaurant], food[English], priceRange[high], area[riverside], familyFriendly[yes], near[Raja Indian Cuisine]"	"the punter is a family friendly restaurant serving english food. it is located near raja indian cuisine in the riverside area."
"name[The Punter], eatType[restaurant], food[Indian], priceRange[cheap], customer rating[average], area[city centre], familyFriendly[yes], near[Express by Holiday Inn]"	"the punter is a restaurant providing indian food in the cheap price range. it is located in the city centre. it is near express by holiday inn. its customer rating is average."
"name[The Punter], eatType[restaurant], food[Indian], priceRange[cheap], customer rating[average], area[riverside], familyFriendly[no], near[Express by Holiday Inn]"	"the punter is a restaurant providing indian food in the cheap price range. it is located in the riverside. it is near express by holiday inn. its customer rating is average."
"name[The Punter], eatType[restaurant], food[Indian], priceRange[cheap], customer rating[average], area[riverside], familyFriendly[yes], near[Express by Holiday Inn]"	"the punter is a restaurant providing indian food in the cheap price range. it is located in the riverside. it is near express by holiday inn. its customer rating is average."
"name[The Punter], eatType[restaurant], food[Indian], priceRange[high], customer rating[1 out of 5], area[city centre], familyFriendly[no], near[Express by Holiday Inn]"	"the punter is a restaurant providing indian food in the high price range. it is located in the city centre. it is near express by holiday inn. its customer rating is 1 out of 5."
"name[The Punter], eatType[restaurant], food[Indian], priceRange[high], customer rating[1 out of 5], area[city centre], familyFriendly[yes], near[Express by Holiday Inn]"	"the punter is a restaurant providing indian food in the high price range. it is located in the city centre. it is near express by holiday inn. its customer rating is 1 out of 5."
"name[The Punter], eatType[restaurant], food[Indian], priceRange[high], customer rating[1 out of 5], area[riverside], familyFriendly[no], near[Express by Holiday Inn]"	"the punter is a restaurant providing indian food in the high price range. it is located in the riverside. it is near express by holiday inn. its customer rating is 1 out of 5."
"name[The Punter], eatType[restaurant], food[Indian], priceRange[high], customer rating[1 out of 5], area[riverside], familyFriendly[yes], near[Express by Holiday Inn]"	"the punter is a restaurant providing indian food in the high price range. it is located in the riverside. it is near express by holiday inn. its customer rating is 1 out of 5."
"name[The Punter], eatType[restaurant], food[Indian], priceRange[high], customer rating[average], area[city centre], familyFriendly[no], near[Express by Holiday Inn]"	"the punter is a restaurant providing indian food in the high price range. it is located in the city centre. it is near express by holiday inn. its customer rating is average."
"name[The Punter], eatType[restaurant], food[Indian], priceRange[high], customer rating[average], area[city centre], familyFriendly[yes], near[Express by Holiday Inn]"	"the punter is a restaurant providing indian food in the high price range. it is located in the city centre. it is near express by holiday inn. its customer rating is average."
"name[The Punter], eatType[restaurant], food[Indian], priceRange[high], customer rating[average], area[riverside], familyFriendly[no], near[Express by Holiday Inn]"	"the punter is a restaurant providing indian food in the high price range. it is located in the riverside. it is near express by holiday inn. its customer rating is average."
"name[The Punter], eatType[restaurant], food[Indian], priceRange[high], customer rating[average], area[riverside], familyFriendly[yes], near[Express by Holiday Inn]"	"the punter is a restaurant providing indian food in the high price range. it is located in the riverside. it is near express by holiday inn. its customer rating is average."
"name[The Punter], eatType[restaurant], food[Indian], priceRange[less than £20], customer rating[low], area[city centre], familyFriendly[no], near[Express by Holiday Inn]"	"the punter is a restaurant providing indian food in the less than £20 price range. it is located in the city centre. it is near express by holiday inn. its customer rating is low."
"name[The Punter], eatType[restaurant], food[Indian], priceRange[less than £20], customer rating[low], area[city centre], familyFriendly[yes], near[Express by Holiday Inn]"	"the punter is a restaurant providing indian food in the less than £20 price range. it is located in the city centre. it is near express by holiday inn. its customer rating is low."
"name[The Punter], eatType[restaurant], food[Indian], priceRange[less than £20], customer rating[low], area[riverside], familyFriendly[no], near[Express by Holiday Inn]"	"the punter is a restaurant providing indian food in the less than £20 price range. it is located in the riverside. it is near express by holiday inn. its customer rating is low."
"name[The Punter], eatType[restaurant], food[Indian], priceRange[less than £20], customer rating[low], area[riverside], familyFriendly[yes], near[Express by Holiday Inn]"	"the punter is a restaurant providing indian food in the less than £20 price range. it is located in the riverside. it is near express by holiday inn. its customer rating is low."
"name[The Punter], eatType[restaurant], food[Indian], priceRange[moderate], customer rating[1 out of 5], area[city centre], familyFriendly[no], near[Express by Holiday Inn]"	"the punter is a restaurant providing indian food in the moderate price range. it is located in the city centre. it is near express by holiday inn. its customer rating is 1 out of 5."
"name[The Punter], eatType[restaurant], food[Indian], priceRange[moderate], customer rating[1 out of 5], area[city centre], familyFriendly[yes], near[Express by Holiday Inn]"	"the punter is a restaurant providing indian food in the moderate price range. it is located in the city centre. it is near express by holiday inn. its customer rating is 1 out of 5."
"name[The Punter], eatType[restaurant], food[Indian], priceRange[moderate], customer rating[1 out of 5], area[riverside], familyFriendly[no], near[Express by Holiday Inn]"	"the punter is a restaurant providing indian food in the moderate price range. it is located in the riverside. it is near express by holiday inn. its customer rating is 1 out of 5."
"name[The Punter], eatType[restaurant], food[Indian], priceRange[moderate], customer rating[1 out of 5], area[riverside], familyFriendly[yes], near[Express by Holiday Inn]"	"the punter is a restaurant providing indian food in the moderate price range. it is located in the riverside. it is near express by holiday inn. its customer rating is 1 out of 5."
"name[The Punter], eatType[restaurant], food[Indian], priceRange[moderate], customer rating[3 out of 5], area[city centre], familyFriendly[no], near[Express by Holiday Inn]"	"the punter is a restaurant providing indian food in the moderate price range. it is located in the city centre. it is near express by holiday inn. its customer rating is 3 out of 5."
"name[The Punter], eatType[restaurant], food[Indian], priceRange[moderate], customer rating[3 out of 5], area[city centre], familyFriendly[yes], near[Express by Holiday Inn]"	"the punter is a restaurant providing indian food in the moderate price range. it is located in the city centre. it is near express by holiday inn. its customer rating is 3 out of 5."
"name[The Punter], eatType[restaurant], food[Indian], priceRange[moderate], customer rating[3 out of 5], area[riverside], familyFriendly[no], near[Express by Holiday Inn]"	"the punter is a restaurant providing indian food in the moderate price range. it is located in the riverside. it is near express by holiday inn. its customer rating is 3 out of 5."
"name[The Punter], eatType[restaurant], food[Indian], priceRange[moderate], customer rating[3 out of 5], area[riverside], familyFriendly[yes], near[Express by Holiday Inn]"	"the punter is a restaurant providing indian food in the moderate price range. it is located in the riverside. it is near express by holiday inn. its customer rating is 3 out of 5."
"name[The Punter], eatType[restaurant], food[Indian], priceRange[more than £30], customer rating[high], area[city centre], familyFriendly[no], near[Express by Holiday Inn]"	"the punter is a restaurant providing indian food in the more than £30 price range. it is located in the city centre. it is near express by holiday inn. its customer rating is high."
"name[The Punter], eatType[restaurant], food[Indian], priceRange[more than £30], customer rating[high], area[city centre], familyFriendly[yes], near[Express by Holiday Inn]"	"the punter is a restaurant providing indian food in the more than £30 price range. it is located in the city centre. it is near express by holiday inn. its customer rating is high."
"name[The Punter], eatType[restaurant], food[Indian], priceRange[more than £30], customer rating[high], area[riverside], familyFriendly[no], near[Express by Holiday Inn]"	"the punter is a restaurant providing indian food in the more than £30 price range. it is located in the riverside. it is near express by holiday inn. its customer rating is high."
"name[The Punter], eatType[restaurant], food[Indian], priceRange[more than £30], customer rating[high], area[riverside], familyFriendly[yes], near[Express by Holiday Inn]"	"the punter is a restaurant providing indian food in the more than £30 price range. it is located in the riverside. it is near express by holiday inn. its customer rating is high."
"name[The Punter], eatType[restaurant], food[Italian], priceRange[£20-25], customer rating[high], area[city centre], familyFriendly[no], near[Express by Holiday Inn]"	"the punter is a £20-25 italian restaurant located in the city centre near express by holiday inn. it is not family-friendly and has a customer rating of high."
"name[The Punter], eatType[restaurant], food[Italian], priceRange[£20-25], customer rating[high], area[city centre], familyFriendly[yes], near[Express by Holiday Inn]"	"the punter is a family-friendly italian restaurant located near express by holiday inn in the city centre. it has a high customer rating and a price range of £20-25."
"name[The Punter], eatType[restaurant], food[Italian], priceRange[£20-25], customer rating[high], area[riverside], familyFriendly[no], near[Express by Holiday Inn]"	"the punter is a £20-25 italian restaurant located in riverside near express by holiday inn. it is not family-friendly and has a customer rating of high."
"name[The Punter], eatType[restaurant], food[Italian], priceRange[£20-25], customer rating[high], area[riverside], familyFriendly[yes], near[Express by Holiday Inn]"	"the punter is a family friendly restaurant located near the express by holiday inn."
"name[The Punter], eatType[restaurant], food[Italian], priceRange[cheap], customer rating[5 out of 5], area[city centre], familyFriendly[no], near[Express by Holiday Inn]"	"the punter is a cheap italian restaurant located in the city centre near express by holiday inn. it is not family-friendly and has a customer rating of 5 out of 5."
"name[The Punter], eatType[restaurant], food[Italian], priceRange[cheap], customer rating[5 out of 5], area[city centre], familyFriendly[no], near[Rainbow Vegetarian Café]"	"the punter is a cheap italian restaurant located in the city centre near rainbow vegetarian café. it is not family-friendly and has a customer rating of 5 out of 5."
"name[The Punter], eatType[restaurant], food[Italian], priceRange[cheap], customer rating[5 out of 5], area[city centre], familyFriendly[yes], near[Rainbow Vegetarian Café]"	"the punter is a family-friendly italian restaurant located near rainbow vegetarian café in the city centre. it has a 5 out of 5 customer rating and a price range of cheap."
"name[The Punter], eatType[restaurant], food[Italian], priceRange[cheap], customer rating[5 out of 5], area[riverside], familyFriendly[no], near[Rainbow Vegetarian Café]"	"the punter is a cheap italian restaurant located in riverside near rainbow vegetarian café. it is not family-friendly and has a customer rating of 5 out of 5."
"name[The Punter], eatType[restaurant], food[Italian], priceRange[cheap], customer rating[5 out of 5], area[riverside], familyFriendly[yes], near[Rainbow Vegetarian Café]"	"the punter is a family friendly restaurant located near the rainbow vegetarian café."
"name[The Punter], eatType[restaurant], food[Italian], priceRange[cheap], customer rating[average], area[city centre], familyFriendly[no], near[Rainbow Vegetarian Café]"	"the punter is a cheap italian restaurant located in the city centre near rainbow vegetarian café. it is not family-friendly and has a customer rating of average."
"name[The Punter], eatType[restaurant], food[Italian], priceRange[cheap], customer rating[average], area[city centre], familyFriendly[yes], near[Rainbow Vegetarian Café]"	"the punter is a family-friendly italian restaurant located near rainbow vegetarian café in the city centre. it has an average customer rating and a price range of cheap."
"name[The Punter], eatType[restaurant], food[Italian], priceRange[cheap], customer rating[average], area[riverside], familyFriendly[no], near[Rainbow Vegetarian Café]"	"the punter is a cheap italian restaurant located in riverside near rainbow vegetarian café. it is not family-friendly and has a customer rating of average."
"name[The Punter], eatType[restaurant], food[Italian], priceRange[cheap], customer rating[average], area[riverside], familyFriendly[yes], near[Rainbow Vegetarian Café]"	"the punter is a family friendly restaurant located near the rainbow vegetarian café."
"name[The Punter], eatType[restaurant], food[Italian], priceRange[high], customer rating[1 out of 5], area[city centre], familyFriendly[no], near[Rainbow Vegetarian Café]"	"the punter is a high italian restaurant located in the city centre near rainbow vegetarian café. it is not family-friendly and has a customer rating of 1 out of 5."
"name[The Punter], eatType[restaurant], food[Italian], priceRange[high], customer rating[1 out of 5], area[city centre], familyFriendly[yes], near[Rainbow Vegetarian Café]"	"the punter is a family-friendly italian restaurant located near rainbow vegetarian café in the city centre. it has a 1 out of 5 customer rating and a price range of high."
"name[The Punter], eatType[restaurant], food[Italian], priceRange[high], customer rating[1 out of 5], area[riverside], familyFriendly[no], near[Rainbow Vegetarian Café]"	"the punter is a high italian restaurant located in riverside near rainbow vegetarian café. it is not family-friendly and has a customer rating of 1 out of 5."
"name[The Punter], eatType[restaurant], food[Italian], priceRange[high], customer rating[1 out of 5], area[riverside], familyFriendly[yes], near[Rainbow Vegetarian Café]"	"the punter is a family friendly restaurant located near the rainbow vegetarian café."
"name[The Vaults], eatType[pub], food[French], priceRange[high], area[riverside], familyFriendly[yes], near[Raja Indian Cuisine]"	"the vaults is a family friendly pub serving french food. it is located near raja indian cuisine in the riverside area."
"name[The Vaults], eatType[pub], food[French], priceRange[less than £20], area[city centre], familyFriendly[no], near[Raja Indian Cuisine]"	"the vaults is a pub that serves french food. it is located in the city centre near raja indian cuisine. it is not child friendly and has a price range of less than £20."
"name[The Vaults], eatType[pub], food[French], priceRange[less than £20], area[city centre], familyFriendly[yes], near[Raja Indian Cuisine]"	"the vaults is a pub that serves french food. it is located in the city centre near raja indian cuisine. it is family-friendly and has a price range of less than £20."
"name[The Vaults], eatType[pub], food[French], priceRange[less than £20], area[riverside], familyFriendly[no], near[Raja Indian Cuisine]"	"the vaults is a pub near raja indian cuisine in the riverside area. it serves french food for less than £20. it is not child friendly."
"name[The Vaults], eatType[pub], food[French], priceRange[less than £20], area[riverside], familyFriendly[yes], near[Raja Indian Cuisine]"	"the vaults is a family friendly pub serving french food. it is located near raja indian cuisine in the riverside area."
"name[The Vaults], eatType[pub], food[French], priceRange[moderate], area[city centre], familyFriendly[no], near[Raja Indian Cuisine]"	"the vaults is a pub that serves french food. it is located in the city centre near raja indian cuisine. it is not child friendly and has a price range of moderate."
"name[The Vaults], eatType[pub], food[French], priceRange[moderate], area[city centre], familyFriendly[yes], near[Raja Indian Cuisine]"	"the vaults is a pub that serves french food. it is located in the city centre near raja indian cuisine. it is family-friendly and has a price range of moderate."
"name[The Vaults], eatType[pub], food[French], priceRange[moderate], area[riverside], familyFriendly[no], near[Raja Indian Cuisine]"	"the vaults is a pub near raja indian cuisine in the riverside area. it serves french food for moderate. it is not child friendly."
"name[The Vaults], eatType[pub], food[French], priceRange[moderate], area[riverside], familyFriendly[yes], near[Raja Indian Cuisine]"	"the vaults is a family friendly pub serving french food. it is located near raja indian cuisine in the riverside area."
"name[The Vaults], eatType[pub], food[French], priceRange[more than £30], area[city centre], familyFriendly[no], near[Raja Indian Cuisine]"	"the vaults is a pub that serves french food. it is located in the city centre near raja indian cuisine. it is not child friendly and has a price range of more than £30."
"name[The Vaults], eatType[pub], food[French], priceRange[more than £30], area[city centre], familyFriendly[yes], near[Raja Indian Cuisine]"	"the vaults is a pub that serves french food. it is located in the city centre near raja indian cuisine. it is family-friendly and has a price range of more than £30."
"name[The Vaults], eatType[pub], food[French], priceRange[more than £30], area[riverside], familyFriendly[no], near[Raja Indian Cuisine]"	"the vaults is a pub near raja indian cuisine in the riverside area. it serves french food for more than £30. it is not child friendly."
"name[The Vaults], eatType[pub], food[French], priceRange[more than £30], area[riverside], familyFriendly[yes], near[Raja Indian Cuisine]"	"the vaults is a family friendly pub serving french food. it is located near raja indian cuisine in the riverside area."
"name[The Vaults], eatType[pub], food[Indian], priceRange[£20-25], area[riverside], familyFriendly[yes], near[Raja Indian Cuisine]"	"the vaults is a pub that serves indian food. it is located in the riverside area near raja indian cuisine. it is kid friendly and has a £20-25 price range."
"name[The Vaults], eatType[pub], food[Indian], priceRange[cheap], area[riverside], familyFriendly[yes], near[Raja Indian Cuisine]"	"the vaults is a pub that serves indian food. it is located in the riverside area near raja indian cuisine. it is kid friendly and has a cheap price range."
"name[The Vaults], eatType[pub], food[Indian], priceRange[high], area[city centre], familyFriendly[no], near[Raja Indian Cuisine]"	"the vaults is a pub that serves indian food for high. it is located in the city centre near raja indian cuisine and is not child friendly."
"name[The Vaults], eatType[pub], food[Indian], priceRange[high], area[city centre], familyFriendly[yes], near[Raja Indian Cuisine]"	"the vaults is a pub that serves indian food in the high price range. it is located in the city centre near raja indian cuisine and is kid friendly."
"name[The Vaults], eatType[pub], food[Italian], priceRange[high], customer rating[average], area[city centre], familyFriendly[no], near[Rainbow Vegetarian Café]"	"the vaults is a pub that serves italian food. it is located in the city centre near rainbow vegetarian café. it is not child friendly and has an average customer rating."
"name[The Vaults], eatType[pub], food[Italian], priceRange[high], customer rating[average], area[city centre], familyFriendly[yes], near[Rainbow Vegetarian Café]"	"the vaults is a family-friendly pub serving italian food. it is located in the city centre near rainbow vegetarian café. it has an average customer rating and a price range of high."
"name[The Vaults], eatType[pub], food[Italian], priceRange[high], customer rating[average], area[riverside], familyFriendly[no], near[Rainbow Vegetarian Café]"	"the vaults is a pub that serves italian food. it is located in riverside near rainbow vegetarian café. it is not kid friendly and has an average customer rating. it has a price range of high."
"name[The Vaults], eatType[pub], food[Italian], priceRange[high], customer rating[average], area[riverside], familyFriendly[yes], near[Rainbow Vegetarian Café]"	"the vaults is a family friendly pub that serves italian food. it is located near rainbow vegetarian café in the riverside area. it has an average customer rating and a price range of high."
"name[The Vaults], eatType[pub], food[Italian], priceRange[less than £20], customer rating[low], area[city centre], familyFriendly[no], near[Rainbow Vegetarian Café]"	"the vaults is a pub that serves italian food. it is located in the city centre near rainbow vegetarian café. it is not child friendly and has a low customer rating."
"name[The Vaults], eatType[pub], food[Italian], priceRange[less than £20], customer rating[low], area[city centre], familyFriendly[yes], near[Rainbow Vegetarian Café]"	"the vaults is a family-friendly pub serving italian food. it is located in the city centre near rainbow vegetarian café. it has a low customer rating and a price range of less than £20."
"name[The Vaults], eatType[pub], food[Italian], priceRange[less than £20], customer rating[low], area[riverside], familyFriendly[no], near[Rainbow Vegetarian Café]"	"the vaults is a pub that serves italian food. it is located in riverside near rainbow vegetarian café. it is not kid friendly and has a low customer rating. it has a price range of less than £20."
"name[The Vaults], eatType[pub], food[Italian], priceRange[less than £20], customer rating[low], area[riverside], familyFriendly[yes], near[Rainbow Vegetarian Café]"	"the vaults is a family friendly pub that serves italian food. it is located near rainbow vegetarian café in the riverside area. it has a low customer rating and a price range of less than £20."
"name[The Vaults], eatType[pub], food[Italian], priceRange[moderate], customer rating[1 out of 5], area[city centre], familyFriendly[no], near[Rainbow Vegetarian Café]"	"the vaults is a pub that serves italian food. it is located in the city centre near rainbow vegetarian café. it is not child friendly and has a 1 out of 5 customer rating."
"name[The Vaults], eatType[pub], food[Italian], priceRange[moderate], customer rating[1 out of 5], area[city centre], familyFriendly[yes], near[Rainbow Vegetarian Café]"	"the vaults is a family-friendly pub serving italian food. it is located in the city centre near rainbow vegetarian café. it has a 1 out of 5 customer rating and a price range of moderate."
"name[The Vaults], eatType[pub], food[Italian], priceRange[moderate], customer rating[1 out of 5], area[riverside], familyFriendly[no], near[Rainbow Vegetarian Café]"	"the vaults is a pub that serves italian food. it is located in riverside near rainbow vegetarian café. it is not kid friendly and has a 1 out of 5 customer rating. it has a price range of moderate."
"name[The Vaults], eatType[pub], food[Italian], priceRange[moderate], customer rating[1 out of 5], area[riverside], familyFriendly[yes], near[Rainbow Vegetarian Café]"	"the vaults is a family friendly pub that serves italian food. it is located near rainbow vegetarian café in the riverside area. it has a 1 out of 5 customer rating and a price range of moderate."
"name[The Vaults], eatType[pub], food[Italian], priceRange[moderate], customer rating[3 out of 5], area[city centre], familyFriendly[no], near[Rainbow Vegetarian Café]"	"the vaults is a pub that serves italian food. it is located in the city centre near rainbow vegetarian café. it is not child friendly and has a 3 out of 5 customer rating."
"name[The Vaults], eatType[pub], food[Italian], priceRange[moderate], customer rating[3 out of 5], area[city centre], familyFriendly[yes], near[Rainbow Vegetarian Café]"	"the vaults is a family-friendly pub serving italian food. it is located in the city centre near rainbow vegetarian café. it has a 3 out of 5 customer rating and a price range of moderate."
"name[The Vaults], eatType[pub], food[Italian], priceRange[moderate], customer rating[3 out of 5], area[riverside], familyFriendly[no], near[Rainbow Vegetarian Café]"	"the vaults is a pub that serves italian food. it is located in riverside near rainbow vegetarian café. it is not kid friendly and has a 3 out of 5 customer rating. it has a price range of moderate."
"name[The Vaults], eatType[pub], food[Italian], priceRange[moderate], customer rating[3 out of 5], area[riverside], familyFriendly[yes], near[Rainbow Vegetarian Café]"	"the vaults is a family friendly pub that serves italian food. it is located near rainbow vegetarian café in the riverside area. it has a 3 out of 5 customer rating and a price range of moderate."
"name[The Vaults], eatType[pub], food[Italian], priceRange[more than £30], customer rating[high], area[city centre], familyFriendly[no], near[Rainbow Vegetarian Café]"	"the vaults is a pub that serves italian food. it is located in the city centre near rainbow vegetarian café. it is not child friendly and has a high customer rating."
"name[The Vaults], eatType[pub], food[Italian], priceRange[more than £30], customer rating[high], area[city centre], familyFriendly[yes], near[Rainbow Vegetarian Café]"	"the vaults is a family-friendly pub serving italian food. it is located in the city centre near rainbow vegetarian café. it has a high customer rating and a price range of more than £30."
"name[The Vaults], eatType[pub], food[Italian], priceRange[more than £30], customer rating[high], area[riverside], familyFriendly[no], near[Rainbow Vegetarian Café]"	"the vaults is a pub that serves italian food. it is located in riverside near rainbow vegetarian café. it is not kid friendly and has a high customer rating. it has a price range of more than £30."
"name[The Vaults], eatType[pub], food[Italian], priceRange[more than £30], customer rating[high], area[riverside], familyFriendly[yes], near[Rainbow Vegetarian Café]"	"the vaults is a family friendly pub that serves italian food. it is located near rainbow vegetarian café in the riverside area. it has a high customer rating and a price range of more than £30."
"name[The Vaults], eatType[pub], food[Japanese], priceRange[£20-25], customer rating[3 out of 5], area[city centre], familyFriendly[no], near[Rainbow Vegetarian Café]"	"the vaults is a pub that serves japanese food. it is located in the city centre near rainbow vegetarian café. it is not child friendly and has a 3 out of 5 customer rating."
"name[The Vaults], eatType[pub], food[Japanese], priceRange[£20-25], customer rating[3 out of 5], area[city centre], familyFriendly[yes], near[Rainbow Vegetarian Café]"	"the vaults is a family-friendly pub serving japanese food. it is located in the city centre near rainbow vegetarian café. it has a 3 out of 5 customer rating and a price range of £20-25."
"name[The Vaults], eatType[pub], food[Japanese], priceRange[£20-25], customer rating[3 out of 5], area[riverside], familyFriendly[no], near[Rainbow Vegetarian Café]"	"the vaults is a japanese pub located near rainbow vegetarian café in riverside. it is not kid friendly and has a price range of £20-25. it has a customer rating of 3 out of 5."
"name[The Vaults], eatType[pub], food[Japanese], priceRange[£20-25], customer rating[3 out of 5], area[riverside], familyFriendly[yes], near[Rainbow Vegetarian Café]"	"the vaults is a family friendly pub located near rainbow vegetarian café. it is located in the city centre."
"name[The Vaults], eatType[pub], food[Japanese], priceRange[£20-25], customer rating[high], area[city centre], familyFriendly[no], near[Rainbow Vegetarian Café]"	"the vaults is a pub that serves japanese food. it is located in the city centre near rainbow vegetarian café. it is not child friendly and has a high customer rating."
"name[The Vaults], eatType[pub], food[Japanese], priceRange[£20-25], customer rating[high], area[city centre], familyFriendly[yes], near[Rainbow Vegetarian Café]"	"the vaults is a family-friendly pub serving japanese food. it is located in the city centre near rainbow vegetarian café. it has a high customer rating and a price range of £20-25."
"name[The Vaults], eatType[pub], food[Japanese], priceRange[£20-25], customer rating[high], area[riverside], familyFriendly[no], near[Rainbow Vegetarian Café]"	"the vaults is a japanese pub located near rainbow vegetarian café in riverside. it is not kid friendly and has a price range of £20-25. it has a customer rating of high."
"name[The Vaults], eatType[pub], food[Japanese], priceRange[£20-25], customer rating[high], area[riverside], familyFriendly[no], near[Raja Indian Cuisine]"	"the vaults is a japanese pub located near raja indian cuisine in riverside. it is not kid friendly and has a price range of £20-25. it has a customer rating of high."
"name[The Vaults], eatType[pub], food[Japanese], priceRange[£20-25], customer rating[high], area[riverside], familyFriendly[yes], near[Raja Indian Cuisine]"	"the vaults is a family friendly pub located near raja indian cuisine. it is located in the city centre."
"name[The Vaults], eatType[pub], food[Japanese], priceRange[cheap], customer rating[5 out of 5], area[city centre], familyFriendly[no], near[Raja Indian Cuisine]"	"the vaults is a pub that serves japanese food. it is located in the city centre near raja indian cuisine. it is not child friendly and has a 5 out of 5 customer rating."
"name[The Vaults], eatType[pub], food[Japanese], priceRange[cheap], customer rating[5 out of 5], area[city centre], familyFriendly[yes], near[Raja Indian Cuisine]"	"the vaults is a family-friendly pub serving japanese food. it is located in the city centre near raja indian cuisine. it has a 5 out of 5 customer rating and a price range of cheap."
"name[The Vaults], eatType[pub], food[Japanese], priceRange[cheap], customer rating[5 out of 5], area[riverside], familyFriendly[no], near[Raja Indian Cuisine]"	"the vaults is a japanese pub located near raja indian cuisine in riverside. it is not kid friendly and has a price range of cheap. it has a customer rating of 5 out of 5."
"name[The Vaults], eatType[pub], food[Japanese], priceRange[cheap], customer rating[5 out of 5], area[riverside], familyFriendly[yes], near[Raja Indian Cuisine]"	"the vaults is a family friendly pub located near raja indian cuisine. it is located in the city centre."
"name[The Vaults], eatType[pub], food[Japanese], priceRange[high], customer rating[3 out of 5], area[city centre], familyFriendly[no], near[Raja Indian Cuisine]"	"the vaults is a pub that serves japanese food. it is located in the city centre near raja indian cuisine. it is not child friendly and has a 3 out of 5 customer rating."
"name[The Vaults], eatType[pub], food[Japanese], priceRange[high], customer rating[3 out of 5], area[city centre], familyFriendly[yes], near[Raja Indian Cuisine]"	"the vaults is a family-friendly pub serving japanese food. it is located in the city centre near raja indian cuisine. it has a 3 out of 5 customer rating and a price range of high."
"name[The Vaults], eatType[pub], food[Japanese], priceRange[high], customer rating[3 out of 5], area[riverside], familyFriendly[no], near[Raja Indian Cuisine]"	"the vaults is a japanese pub located near raja indian cuisine in riverside. it is not kid friendly and has a price range of high. it has a customer rating of 3 out of 5."
"name[The Vaults], eatType[pub], food[Japanese], priceRange[high], customer rating[3 out of 5], area[riverside], familyFriendly[yes], near[Raja Indian Cuisine]"	"the vaults is a family friendly pub located near raja indian cuisine. it is located in the city centre."
"name[The Vaults], eatType[pub], food[Japanese], priceRange[less than £20], customer rating[average], area[city centre], familyFriendly[no], near[Raja Indian Cuisine]"	"the vaults is a pub that serves japanese food. it is located in the city centre near raja indian cuisine. it is not child friendly and has an average customer rating."
"name[The Vaults], eatType[pub], food[Japanese], priceRange[less than £20], customer rating[average], area[city centre], familyFriendly[yes], near[Raja Indian Cuisine]"	"the vaults is a family-friendly pub serving japanese food. it is located in the city centre near raja indian cuisine. it has an average customer rating and a price range of less than £20."
"name[The Vaults], eatType[pub], food[Japanese], priceRange[less than £20], customer rating[average], area[riverside], familyFriendly[no], near[Raja Indian Cuisine]"	"the vaults is a japanese pub located near raja indian cuisine in riverside. it is not kid friendly and has a price range of less than £20. it has a customer rating of average."
"name[The Vaults], eatType[pub], food[Japanese], priceRange[less than £20], customer rating[average], area[riverside], familyFriendly[yes], near[Raja Indian Cuisine]"	"the vaults is a family friendly pub located near raja indian cuisine. it is located in the city centre."
"name[The Vaults], eatType[pub], food[Japanese], priceRange[less than £20], customer rating[low], area[city centre], familyFriendly[no], near[Raja Indian Cuisine]"	"the vaults is a pub that serves japanese food. it is located in the city centre near raja indian cuisine. it is not child friendly and has a low customer rating."
"name[The Vaults], eatType[pub], food[Japanese], priceRange[less than £20], customer rating[low], area[city centre], familyFriendly[yes], near[Raja Indian Cuisine]"	"the vaults is a family-friendly pub serving japanese food. it is located in the city centre near raja indian cuisine. it has a low customer rating and a price range of less than £20."
"name[The Vaults], eatType[pub], food[Japanese], priceRange[less than £20], customer rating[low], area[riverside], familyFriendly[no], near[Raja Indian Cuisine]"	"the vaults is a japanese pub located near raja indian cuisine in riverside. it is not kid friendly and has a price range of less than £20. it has a customer rating of low."
"name[The Vaults], eatType[pub], food[Japanese], priceRange[less than £20], customer rating[low], area[riverside], familyFriendly[yes], near[Raja Indian Cuisine]"	"the vaults is a family friendly pub located near raja indian cuisine. it is located in the city centre."
"name[The Vaults], eatType[pub], food[Japanese], priceRange[moderate], customer rating[1 out of 5], area[city centre], familyFriendly[no], near[Raja Indian Cuisine]"	"the vaults is a pub that serves japanese food. it is located in the city centre near raja indian cuisine. it is not child friendly and has a 1 out of 5 customer rating."
"name[The Vaults], eatType[pub], food[Japanese], priceRange[moderate], customer rating[1 out of 5], area[city centre], familyFriendly[yes], near[Raja Indian Cuisine]"	"the vaults is a family-friendly pub serving japanese food. it is located in the city centre near raja indian cuisine. it has a 1 out of 5 customer rating and a price range of moderate."
"name[The Vaults], eatType[restaurant], food[French], priceRange[high], area[riverside], familyFriendly[yes], near[Raja Indian Cuisine]"	"the vaults is a family friendly restaurant serving french food in the riverside area near raja indian cuisine. the price range is high."
"name[The Vaults], eatType[restaurant], food[French], priceRange[less than £20], area[city centre], familyFriendly[no], near[Raja Indian Cuisine]"	"the vaults is a french restaurant located in the city centre near raja indian cuisine. it is not child friendly and has a price range of less than £20."
"name[The Vaults], eatType[restaurant], food[French], priceRange[less than £20], area[city centre], familyFriendly[yes], near[Raja Indian Cuisine]"	"the vaults is a family-friendly french restaurant with a price range of less than £20. it is located in the city centre near raja indian cuisine."
"name[The Vaults], eatType[restaurant], food[French], priceRange[less than £20], area[riverside], familyFriendly[no], near[Raja Indian Cuisine]"	"the vaults is a french restaurant located near raja indian cuisine in riverside. it is not family-friendly and has a price range of less than £20."
"name[The Vaults], eatType[restaurant], food[French], priceRange[less than £20], area[riverside], familyFriendly[yes], near[Raja Indian Cuisine]"	"the vaults is a family friendly restaurant serving french food in the riverside area near raja indian cuisine. the price range is less than £20."
"name[The Vaults], eatType[restaurant], food[French], priceRange[moderate], area[city centre], familyFriendly[no], near[Raja Indian Cuisine]"	"the vaults is a french restaurant located in the city centre near raja indian cuisine. it is not child friendly and has a price range of moderate."
"name[The Vaults], eatType[restaurant], food[French], priceRange[moderate], area[city centre], familyFriendly[yes], near[Raja Indian Cuisine]"	"the vaults is a family-friendly french restaurant with a price range of moderate. it is located in the city centre near raja indian cuisine."
"name[The Vaults], eatType[restaurant], food[French], priceRange[moderate], area[riverside], familyFriendly[no], near[Raja Indian Cuisine]"	"the vaults is a french restaurant located near raja indian cuisine in riverside. it is not family-friendly and has a price range of moderate."
"name[The Vaults], eatType[restaurant], food[French], priceRange[moderate], area[riverside], familyFriendly[yes], near[Raja Indian Cuisine]"	"the vaults is a family friendly restaurant serving french food in the riverside area near raja indian cuisine. the price range is moderate."
"name[The Vaults], eatType[restaurant], food[French], priceRange[more than £30], area[city centre], familyFriendly[no], near[Raja Indian Cuisine]"	"the vaults is a french restaurant located in the city centre near raja indian cuisine. it is not child friendly and has a price range of more than £30."
"name[The Vaults], eatType[restaurant], food[French], priceRange[more than £30], area[city centre], familyFriendly[yes], near[Raja Indian Cuisine]"	"the vaults is a family-friendly french restaurant with a price range of more than £30. it is located in the city centre near raja indian cuisine."
"name[The Vaults], eatType[restaurant], food[French], priceRange[more than £30], area[riverside], familyFriendly[no], near[Raja Indian Cuisine]"	"the vaults is a french restaurant located near raja indian cuisine in riverside. it is not family-friendly and has a price range of more than £30."
"name[The Vaults], eatType[restaurant], food[French], priceRange[more than £30], area[riverside], familyFriendly[yes], near[Raja Indian Cuisine]"	"the vaults is a family friendly restaurant serving french food in the riverside area near raja indian cuisine. the price range is more than £30."
"name[The Vaults], eatType[restaurant], food[Indian], priceRange[£20-25], area[riverside], familyFriendly[yes], near[Raja Indian Cuisine]"	"the vaults is a restaurant that serves indian food. it is located in the riverside area near raja indian cuisine. it is kid friendly and has a £20-25 price range."
"name[The Vaults], eatType[restaurant], food[Indian], priceRange[cheap], area[riverside], familyFriendly[yes], near[Raja Indian Cuisine]"	"the vaults is a restaurant that serves indian food. it is located in the riverside area near raja indian cuisine. it is kid friendly and has a cheap price range."
"name[The Vaults], eatType[restaurant], food[Indian], priceRange[high], area[city centre], familyFriendly[no], near[Raja Indian Cuisine]"	"the vaults is a restaurant that serves indian food for high. it is located in the city centre near raja indian cuisine and is not child friendly."
"name[The Vaults], eatType[restaurant], food[Indian], priceRange[high], area[city centre], familyFriendly[yes], near[Raja Indian Cuisine]"	"the vaults is a family friendly indian restaurant located in the city centre near raja indian cuisine. it has a high price range."
"name[The Waterman], eatType[pub], food[Indian], priceRange[high], area[city centre], familyFriendly[yes], near[Raja Indian Cuisine]"	"the waterman is a pub that serves indian food in the high price range. it is located in the city centre near raja indian cuisine and is kid friendly."
"name[The Waterman], eatType[pub], food[Indian], priceRange[high], area[riverside], familyFriendly[no], near[Raja Indian Cuisine]"	"the waterman is a pub that serves indian food for high. it is located in the riverside area near raja indian cuisine. it is not family friendly."
"name[The Waterman], eatType[pub], food[Indian], priceRange[high], area[riverside], familyFriendly[yes], near[Raja Indian Cuisine]"	"the waterman is a pub that serves indian food. it is located in the riverside area near raja indian cuisine. it is kid friendly and has a high price range."
"name[The Waterman], eatType[pub], food[Indian], priceRange[less than £20], area[city centre], familyFriendly[no], near[Raja Indian Cuisine]"	"the waterman is a pub that serves indian food for less than £20. it is located in the city centre near raja indian cuisine and is not child friendly."
"name[The Waterman], eatType[pub], food[Indian], priceRange[less than £20], area[city centre], familyFriendly[yes], near[Raja Indian Cuisine]"	"the waterman is a pub that serves indian food in the less than £20 price range. it is located in the city centre near raja indian cuisine and is kid friendly."
"name[The Waterman], eatType[pub], food[Indian], priceRange[less than £20], area[riverside], familyFriendly[no], near[Raja Indian Cuisine]"	"the waterman is a pub that serves indian food for less than £20. it is located in the riverside area near raja indian cuisine. it is not family friendly."
"name[The Waterman], eatType[pub], food[Indian], priceRange[less than £20], area[riverside], familyFriendly[yes], near[Raja Indian Cuisine]"	"the waterman is a pub that serves indian food. it is located in the riverside area near raja indian cuisine. it is kid friendly and has a less than £20 price range."
"name[The Waterman], eatType[pub], food[Indian], priceRange[moderate], area[city centre], familyFriendly[no], near[Raja Indian Cuisine]"	"the waterman is a pub that serves indian food for moderate. it is located in the city centre near raja indian cuisine and is not child friendly."
"name[The Waterman], eatType[pub], food[Indian], priceRange[moderate], area[city centre], familyFriendly[yes], near[Raja Indian Cuisine]"	"the waterman is a pub that serves indian food in the moderate price range. it is located in the city centre near raja indian cuisine and is kid friendly."
"name[The Waterman], eatType[pub], food[Indian], priceRange[moderate], area[riverside], familyFriendly[no], near[Raja Indian Cuisine]"	"the waterman is a pub that serves indian food for moderate. it is located in the riverside area near raja indian cuisine. it is not family friendly."
"name[The Waterman], eatType[pub], food[Indian], priceRange[moderate], area[riverside], familyFriendly[yes], near[Raja Indian Cuisine]"	"the waterman is a pub that serves indian food. it is located in the riverside area near raja indian cuisine. it is kid friendly and has a moderate price range."
"name[The Waterman], eatType[pub], food[Indian], priceRange[more than £30], area[riverside], familyFriendly[yes], near[Raja Indian Cuisine]"	"the waterman is a pub that serves indian food. it is located in the riverside area near raja indian cuisine. it is kid friendly and has a more than £30 price range."
"name[The Waterman], eatType[pub], food[Italian], priceRange[£20-25], area[riverside], familyFriendly[yes], near[Raja Indian Cuisine]"	"the waterman is a pub that serves italian food. it is located in riverside near raja indian cuisine. it is children friendly and has a price range of £20-25."
"name[The Waterman], eatType[pub], food[Italian], priceRange[cheap], area[riverside], familyFriendly[yes], near[Raja Indian Cuisine]"	"the waterman is a pub that serves italian food. it is located in riverside near raja indian cuisine. it is children friendly and has a price range of cheap."
"name[The Waterman], eatType[pub], food[Italian], priceRange[high], area[city centre], familyFriendly[no], near[Raja Indian Cuisine]"	"the waterman is a pub that serves italian food. it is located in the city centre near raja indian cuisine. it is not child friendly and has a price range of high."
"name[The Waterman], eatType[pub], food[Italian], priceRange[high], area[city centre], familyFriendly[yes], near[Raja Indian Cuisine]"	"the waterman is a family-friendly pub that serves italian food. it is located in the city centre near raja indian cuisine. it has a high price range."
"name[The Waterman], eatType[pub], food[Italian], priceRange[high], area[riverside], familyFriendly[no], near[Raja Indian Cuisine]"	"the waterman is a pub that serves italian food. it is located in the riverside area near raja indian cuisine. it is not child friendly and has a price range of high."
"name[The Waterman], eatType[pub], food[Italian], priceRange[high], area[riverside], familyFriendly[yes], near[Raja Indian Cuisine]"	"the waterman is a pub that serves italian food. it is located in riverside near raja indian cuisine. it is children friendly and has a price range of high."
"name[The Waterman], eatType[pub], food[Italian], priceRange[less than £20], area[city centre], familyFriendly[no], near[Raja Indian Cuisine]"	"the waterman is a pub that serves italian food. it is located in the city centre near raja indian cuisine. it is not child friendly and has a price range of less than £20."
"name[The Waterman], eatType[pub], food[Italian], priceRange[less than £20], area[city centre], familyFriendly[yes], near[Raja Indian Cuisine]"	"the waterman is a family-friendly pub that serves italian food. it is located in the city centre near raja indian cuisine. it has a less than £20 price range."
"name[The Waterman], eatType[pub], food[Italian], priceRange[less than £20], area[riverside], familyFriendly[no], near[Raja Indian Cuisine]"	"the waterman is a pub that serves italian food. it is located in the riverside area near raja indian cuisine. it is not child friendly and has a price range of less than £20."
"name[The Waterman], eatType[restaurant], food[Indian], priceRange[high], area[city centre], familyFriendly[yes], near[Raja Indian Cuisine]"	"the waterman is a family friendly indian restaurant located in the city centre near raja indian cuisine. it has a high price range."
"name[The Waterman], eatType[restaurant], food[Indian], priceRange[high], area[riverside], familyFriendly[no], near[Raja Indian Cuisine]"	"the waterman is a restaurant providing indian food in the high price range. it is located in the riverside. it is near raja indian cuisine."
"name[The Waterman], eatType[restaurant], food[Indian], priceRange[high], area[riverside], familyFriendly[yes], near[Raja Indian Cuisine]"	"the waterman is a restaurant that serves indian food. it is located in the riverside area near raja indian cuisine. it is kid friendly and has a high price range."
"name[The Waterman], eatType[restaurant], food[Indian], priceRange[less than £20], area[city centre], familyFriendly[no], near[Raja Indian Cuisine]"	"the waterman is a restaurant that serves indian food for less than £20. it is located in the city centre near raja indian cuisine and is not child friendly."
"name[The Waterman], eatType[restaurant], food[Indian], priceRange[less than £20], area[city centre], familyFriendly[yes], near[Raja Indian Cuisine]"	"the waterman is a family friendly indian restaurant located in the city centre near raja indian cuisine. it has a less than £20 price range."
"name[The Waterman], eatType[restaurant], food[Indian], priceRange[less than £20], area[riverside], familyFriendly[no], near[Raja Indian Cuisine]"	"the waterman is a restaurant providing indian food in the less than £20 price range. it is located in the riverside. it is near raja indian cuisine."
"name[The Waterman], eatType[restaurant], food[Indian], priceRange[less than £20], area[riverside], familyFriendly[yes], near[Raja Indian Cuisine]"	"the waterman is a restaurant that serves indian food. it is located in the riverside area near raja indian cuisine. it is kid friendly and has a less than £20 price range."
"name[The Waterman], eatType[restaurant], food[Indian], priceRange[moderate], area[city centre], familyFriendly[no], near[Raja Indian Cuisine]"	"the waterman is a restaurant that serves indian food for moderate. it is located in the city centre near raja indian cuisine and is not child friendly."
"name[The Waterman], eatType[restaurant], food[Indian], priceRange[moderate], area[city centre], familyFriendly[yes], near[Raja Indian Cuisine]"	"the waterman is a family friendly indian restaurant located in the city centre near raja indian cuisine. it has a moderate price range."
"name[The Waterman], eatType[restaurant], food[Indian], priceRange[moderate], area[riverside], familyFriendly[no], near[Raja Indian Cuisine]"	"the waterman is a restaurant providing indian food in the moderate price range. it is located in the riverside. it is near raja indian cuisine."
"name[The Waterman], eatType[restaurant], food[Indian], priceRange[moderate], area[riverside], familyFriendly[yes], near[Raja Indian Cuisine]"	"the waterman is a restaurant that serves indian food. it is located in the riverside area near raja indian cuisine. it is kid friendly and has a moderate price range."
"name[The Waterman], eatType[restaurant], food[Indian], priceRange[more than £30], area[riverside], familyFriendly[yes], near[Raja Indian Cuisine]"	"the waterman is a restaurant that serves indian food. it is located in the riverside area near raja indian cuisine. it is kid friendly and has a more than £30 price range."
"name[The Waterman], eatType[restaurant], food[Italian], priceRange[£20-25], area[riverside], familyFriendly[yes], near[Raja Indian Cuisine]"	"the waterman is a family friendly restaurant located near raja indian cuisine."
"name[The Waterman], eatType[restaurant], food[Italian], priceRange[cheap], area[riverside], familyFriendly[yes], near[Raja Indian Cuisine]"	"the waterman is a family friendly restaurant located near raja indian cuisine."
"name[The Waterman], eatType[restaurant], food[Italian], priceRange[high], area[city centre], familyFriendly[no], near[Raja Indian Cuisine]"	"the waterman is a high italian restaurant located in the city centre near raja indian cuisine. it is not family-friendly."
"name[The Waterman], eatType[restaurant], food[Italian], priceRange[high], area[city centre], familyFriendly[yes], near[Raja Indian Cuisine]"	"the waterman is a family-friendly italian restaurant with a high price range. it is located in the city centre near raja indian cuisine."
"name[The Waterman], eatType[restaurant], food[Italian], priceRange[high], area[riverside], familyFriendly[no], near[Raja Indian Cuisine]"	"the waterman is a restaurant providing italian food in the high price range. it is located in the riverside area near raja indian cuisine. it is not family-friendly."
"name[The Waterman], eatType[restaurant], food[Italian], priceRange[high], area[riverside], familyFriendly[yes], near[Raja Indian Cuisine]"	"the waterman is a family friendly restaurant located near raja indian cuisine."
"name[The Waterman], eatType[restaurant], food[Italian], priceRange[less than £20], area[city centre], familyFriendly[no], near[Raja Indian Cuisine]"	"the waterman is a less than £20 italian restaurant located in the city centre near raja indian cuisine. it is not family-friendly."
"name[The Waterman], eatType[restaurant], food[Italian], priceRange[less than £20], area[city centre], familyFriendly[yes], near[Raja Indian Cuisine]"	"the waterman is a family-friendly italian restaurant with a less than £20 price range. it is located in the city centre near raja indian cuisine."
"name[The Waterman], eatType[restaurant], food[Italian], priceRange[less than £20], area[riverside], familyFriendly[no], near[Raja Indian Cuisine]"	"the waterman is a restaurant providing italian food in the less than £20 price range. it is located in the riverside area near raja indian cuisine. it is not family-friendly."
"name[The Wrestlers], eatType[pub], food[Italian], priceRange[less than £20], area[riverside], familyFriendly[no], near[Raja Indian Cuisine]"	"the wrestlers is a pub that serves italian food. it is located in the riverside area near raja indian cuisine. it is not child friendly and has a price range of less than £20."
"name[The Wrestlers], eatType[pub], food[Italian], priceRange[less than £20], area[riverside], familyFriendly[yes], near[Raja Indian Cuisine]"	"the wrestlers is a pub that serves italian food. it is located in riverside near raja indian cuisine. it is children friendly and has a price range of less than £20."
"name[The Wrestlers], eatType[pub], food[Italian], priceRange[moderate], area[city centre], familyFriendly[no], near[Raja Indian Cuisine]"	"the wrestlers is a pub that serves italian food. it is located in the city centre near raja indian cuisine. it is not child friendly and has a price range of moderate."
"name[The Wrestlers], eatType[pub], food[Italian], priceRange[moderate], area[city centre], familyFriendly[yes], near[Raja Indian Cuisine]"	"the wrestlers is a family-friendly pub that serves italian food. it is located in the city centre near raja indian cuisine. it has a moderate price range."
"name[The Wrestlers], eatType[pub], food[Italian], priceRange[moderate], area[riverside], familyFriendly[no], near[Raja Indian Cuisine]"	"the wrestlers is a pub that serves italian food. it is located in the riverside area near raja indian cuisine. it is not child friendly and has a price range of moderate."
"name[The Wrestlers], eatType[pub], food[Italian], priceRange[moderate], area[riverside], familyFriendly[yes], near[Raja Indian Cuisine]"	"the wrestlers is a pub that serves italian food. it is located in riverside near raja indian cuisine. it is children friendly and has a price range of moderate."
"name[The Wrestlers], eatType[pub], food[Italian], priceRange[more than £30], area[riverside], familyFriendly[yes], near[Raja Indian Cuisine]"	"the wrestlers is a pub that serves italian food. it is located in riverside near raja indian cuisine. it is children friendly and has a price range of more than £30."
"name[The Wrestlers], eatType[pub], food[Japanese], priceRange[£20-25], area[riverside], familyFriendly[yes], near[Raja Indian Cuisine]"	"the wrestlers is a family friendly pub that serves japanese food. it is located near raja indian cuisine in the riverside area."
"name[The Wrestlers], eatType[pub], food[Japanese], priceRange[cheap], area[riverside], familyFriendly[yes], near[Raja Indian Cuisine]"	"the wrestlers is a family friendly pub that serves japanese food. it is located near raja indian cuisine in the riverside area."
"name[The Wrestlers], eatType[pub], food[Japanese], priceRange[high], area[riverside], familyFriendly[yes], near[Raja Indian Cuisine]"	"the wrestlers is a family friendly pub that serves japanese food. it is located near raja indian cuisine in the riverside area."
"name[The Wrestlers], eatType[pub], food[Japanese], priceRange[less than £20], area[city centre], familyFriendly[no], near[Raja Indian Cuisine]"	"the wrestlers is a pub that serves japanese food. it is located in the city centre near raja indian cuisine. it is not child friendly and has a price range of less than £20."
"name[The Wrestlers], eatType[pub], food[Japanese], priceRange[less than £20], area[city centre], familyFriendly[yes], near[Raja Indian Cuisine]"	"the wrestlers is a pub that serves japanese food. it is located in the city centre near raja indian cuisine. it is kid friendly and has a price range of less than £20."
"name[The Wrestlers], eatType[pub], food[Japanese], priceRange[less than £20], area[riverside], familyFriendly[no], near[Raja Indian Cuisine]"	"the wrestlers is a pub that serves japanese food. it is located near raja indian cuisine in the riverside area. it is not child friendly and has a price range of less than £20."
"name[The Wrestlers], eatType[pub], food[Japanese], priceRange[less than £20], area[riverside], familyFriendly[yes], near[Raja Indian Cuisine]"	"the wrestlers is a family friendly pub that serves japanese food. it is located near raja indian cuisine in the riverside area."
"name[The Wrestlers], eatType[pub], food[Japanese], priceRange[moderate], area[city centre], familyFriendly[no], near[Raja Indian Cuisine]"	"the wrestlers is a pub that serves japanese food. it is located in the city centre near raja indian cuisine. it is not child friendly and has a price range of moderate."
"name[The Wrestlers], eatType[pub], food[Japanese], priceRange[moderate], area[city centre], familyFriendly[yes], near[Raja Indian Cuisine]"	"the wrestlers is a pub that serves japanese food. it is located in the city centre near raja indian cuisine. it is kid friendly and has a price range of moderate."
"name[The Wrestlers], eatType[pub], food[Japanese], priceRange[moderate], area[riverside], familyFriendly[no], near[Raja Indian Cuisine]"	"the wrestlers is a pub that serves japanese food. it is located near raja indian cuisine in the riverside area. it is not child friendly and has a price range of moderate."
"name[The Wrestlers], eatType[pub], food[Japanese], priceRange[moderate], area[riverside], familyFriendly[yes], near[Raja Indian Cuisine]"	"the wrestlers is a family friendly pub that serves japanese food. it is located near raja indian cuisine in the riverside area."
"name[The Wrestlers], eatType[pub], food[Japanese], priceRange[moderate], customer rating[1 out of 5], area[city centre], familyFriendly[yes], near[Raja Indian Cuisine]"	"the wrestlers is a family-friendly pub serving japanese food. it is located in the city centre near raja indian cuisine. it has a 1 out of 5 customer rating and a price range of moderate."
"name[The Wrestlers], eatType[pub], food[Japanese], priceRange[moderate], customer rating[1 out of 5], area[riverside], familyFriendly[no], near[Raja Indian Cuisine]"	"the wrestlers is a japanese pub located near raja indian cuisine in riverside. it is not kid friendly and has a price range of moderate. it has a customer rating of 1 out of 5."
"name[The Wrestlers], eatType[pub], food[Japanese], priceRange[moderate], customer rating[1 out of 5], area[riverside], familyFriendly[yes], near[Raja Indian Cuisine]"	"the wrestlers is a family friendly pub located near raja indian cuisine. it is located in the city centre."
"name[The Wrestlers], eatType[pub], food[Japanese], priceRange[more than £30], area[city centre], familyFriendly[no], near[Raja Indian Cuisine]"	"the wrestlers is a pub that serves japanese food. it is located in the city centre near raja indian cuisine. it is not child friendly and has a price range of more than £30."
"name[The Wrestlers], eatType[pub], food[Japanese], priceRange[more than £30], area[city centre], familyFriendly[yes], near[Raja Indian Cuisine]"	"the wrestlers is a pub that serves japanese food. it is located in the city centre near raja indian cuisine. it is kid friendly and has a price range of more than £30."
"name[The Wrestlers], eatType[pub], food[Japanese], priceRange[more than £30], area[riverside], familyFriendly[no], near[Raja Indian Cuisine]"	"the wrestlers is a pub that serves japanese food. it is located near raja indian cuisine in the riverside area. it is not child friendly and has a price range of more than £30."
"name[The Wrestlers], eatType[pub], food[Japanese], priceRange[more than £30], area[riverside], familyFriendly[yes], near[Raja Indian Cuisine]"	"the wrestlers is a family friendly pub that serves japanese food. it is located near raja indian cuisine in the riverside area."
"name[The Wrestlers], eatType[pub], food[Japanese], priceRange[more than £30], customer rating[5 out of 5], area[city centre], familyFriendly[no], near[Raja Indian Cuisine]"	"the wrestlers is a pub that serves japanese food. it is located in the city centre near raja indian cuisine. it is not child friendly and has a 5 out of 5 customer rating."
"name[The Wrestlers], eatType[pub], food[Japanese], priceRange[more than £30], customer rating[5 out of 5], area[city centre], familyFriendly[yes], near[Raja Indian Cuisine]"	"the wrestlers is a family-friendly pub serving japanese food. it is located in the city centre near raja indian cuisine. it has a 5 out of 5 customer rating and a price range of more than £30."
"name[The Wrestlers], eatType[pub], food[Japanese], priceRange[more than £30], customer rating[5 out of 5], area[riverside], familyFriendly[no], near[Raja Indian Cuisine]"	"the wrestlers is a japanese pub located near raja indian cuisine in riverside. it is not kid friendly and has a price range of more than £30. it has a customer rating of 5 out of 5."
"name[The Wrestlers], eatType[pub], food[Japanese], priceRange[more than £30], customer rating[5 out of 5], area[riverside], familyFriendly[yes], near[Raja Indian Cuisine]"	"the wrestlers is a family friendly pub located near raja indian cuisine. it is located in the city centre."
"name[The Wrestlers], eatType[pub], food[Japanese], priceRange[more than £30], customer rating[low], area[city centre], familyFriendly[no], near[Raja Indian Cuisine]"	"the wrestlers is a pub that serves japanese food. it is located in the city centre near raja indian cuisine. it is not child friendly and has a low customer rating."
"name[The Wrestlers], eatType[pub], food[Japanese], priceRange[more than £30], customer rating[low], area[city centre], familyFriendly[yes], near[Raja Indian Cuisine]"	"the wrestlers is a family-friendly pub serving japanese food. it is located in the city centre near raja indian cuisine. it has a low customer rating and a price range of more than £30."
"name[The Wrestlers], eatType[pub], food[Japanese], priceRange[more than £30], customer rating[low], area[riverside], familyFriendly[no], near[Raja Indian Cuisine]"	"the wrestlers is a japanese pub located near raja indian cuisine in riverside. it is not kid friendly and has a price range of more than £30. it has a customer rating of low."
"name[The Wrestlers], eatType[pub], food[Japanese], priceRange[more than £30], customer rating[low], area[riverside], familyFriendly[yes], near[Raja Indian Cuisine]"	"the wrestlers is a family friendly pub located near raja indian cuisine. it is located in the city centre."
"name[The Wrestlers], eatType[restaurant], food[Italian], priceRange[less than £20], area[riverside], familyFriendly[no], near[Raja Indian Cuisine]"	"the wrestlers is a restaurant providing italian food in the less than £20 price range. it is located in the riverside area near raja indian cuisine. it is not family-friendly."
"name[The Wrestlers], eatType[restaurant], food[Italian], priceRange[less than £20], area[riverside], familyFriendly[yes], near[Raja Indian Cuisine]"	"the wrestlers is a family friendly restaurant located near raja indian cuisine."
"name[The Wrestlers], eatType[restaurant], food[Italian], priceRange[moderate], area[city centre], familyFriendly[no], near[Raja Indian Cuisine]"	"the wrestlers is a moderate italian restaurant located in the city centre near raja indian cuisine. it is not family-friendly."
"name[The Wrestlers], eatType[restaurant], food[Italian], priceRange[moderate], area[city centre], familyFriendly[yes], near[Raja Indian Cuisine]"	"the wrestlers is a family-friendly italian restaurant with a moderate price range. it is located in the city centre near raja indian cuisine."
"name[The Wrestlers], eatType[restaurant], food[Italian], priceRange[moderate], area[riverside], familyFriendly[no], near[Raja Indian Cuisine]"	"the wrestlers is a restaurant providing italian food in the moderate price range. it is located in the riverside area near raja indian cuisine. it is not family-friendly."
"name[The Wrestlers], eatType[restaurant], food[Italian], priceRange[moderate], area[riverside], familyFriendly[yes], near[Raja Indian Cuisine]"	"the wrestlers is a family friendly restaurant located near raja indian cuisine."
"name[The Wrestlers], eatType[restaurant], food[Italian], priceRange[more than £30], area[riverside], familyFriendly[yes], near[Raja Indian Cuisine]"	"the wrestlers is a family friendly restaurant located near raja indian cuisine."
"name[The Wrestlers], eatType[restaurant], food[Japanese], priceRange[£20-25], area[riverside], familyFriendly[yes], near[Raja Indian Cuisine]"	"the wrestlers is a family friendly restaurant that serves japanese food. it is located near raja indian cuisine in the riverside area."
"name[The Wrestlers], eatType[restaurant], food[Japanese], priceRange[cheap], area[riverside], familyFriendly[yes], near[Raja Indian Cuisine]"	"the wrestlers is a family friendly restaurant that serves japanese food. it is located near raja indian cuisine in the riverside area."
"name[The Wrestlers], eatType[restaurant], food[Japanese], priceRange[high], area[riverside], familyFriendly[yes], near[Raja Indian Cuisine]"	"the wrestlers is a family friendly restaurant that serves japanese food. it is located near raja indian cuisine in the riverside area."
"name[The Wrestlers], eatType[restaurant], food[Japanese], priceRange[less than £20], area[city centre], familyFriendly[no], near[Raja Indian Cuisine]"	"the wrestlers is a japanese restaurant located in the city centre near raja indian cuisine. it is not child friendly and has a price range of less than £20."
"name[The Wrestlers], eatType[restaurant], food[Japanese], priceRange[less than £20], area[city centre], familyFriendly[yes], near[Raja Indian Cuisine]"	"the wrestlers is a japanese restaurant located in the city centre near raja indian cuisine. it is family-friendly and has a price range of less than £20."
"name[The Wrestlers], eatType[restaurant], food[Japanese], priceRange[less than £20], area[riverside], familyFriendly[no], near[Raja Indian Cuisine]"	"the wrestlers is a japanese restaurant near raja indian cuisine in riverside. it is not family-friendly and has a price range of less than £20."
"name[The Wrestlers], eatType[restaurant], food[Japanese], priceRange[less than £20], area[riverside], familyFriendly[yes], near[Raja Indian Cuisine]"	"the wrestlers is a family friendly restaurant that serves japanese food. it is located near raja indian cuisine in the riverside area."
"name[The Wrestlers], eatType[restaurant], food[Japanese], priceRange[moderate], area[city centre], familyFriendly[no], near[Raja Indian Cuisine]"	"the wrestlers is a japanese restaurant located in the city centre near raja indian cuisine. it is not child friendly and has a price range of moderate."
"name[The Wrestlers], eatType[restaurant], food[Japanese], priceRange[moderate], area[city centre], familyFriendly[yes], near[Raja Indian Cuisine]"	"the wrestlers is a japanese restaurant located in the city centre near raja indian cuisine. it is family-friendly and has a price range of moderate."
"name[The Wrestlers], eatType[restaurant], food[Japanese], priceRange[moderate], area[riverside], familyFriendly[no], near[Raja Indian Cuisine]"	"the wrestlers is a japanese restaurant near raja indian cuisine in riverside. it is not family-friendly and has a price range of moderate."
"name[The Wrestlers], eatType[restaurant], food[Japanese], priceRange[moderate], area[riverside], familyFriendly[yes], near[Raja Indian Cuisine]"	"the wrestlers is a family friendly restaurant that serves japanese food. it is located near raja indian cuisine in the riverside area."
"name[The Wrestlers], eatType[restaurant], food[Japanese], priceRange[more than £30], area[city centre], familyFriendly[no], near[Raja Indian Cuisine]"	"the wrestlers is a japanese restaurant located in the city centre near raja indian cuisine. it is not child friendly and has a price range of more than £30."
"name[The Wrestlers], eatType[restaurant], food[Japanese], priceRange[more than £30], area[city centre], familyFriendly[yes], near[Raja Indian Cuisine]"	"the wrestlers is a japanese restaurant located in the city centre near raja indian cuisine. it is family-friendly and has a price range of more than £30."
"name[The Wrestlers], eatType[restaurant], food[Japanese], priceRange[more than £30], area[riverside], familyFriendly[no], near[Raja Indian Cuisine]"	"the wrestlers is a japanese restaurant near raja indian cuisine in riverside. it is not family-friendly and has a price range of more than £30."
"name[The Wrestlers], eatType[restaurant], food[Japanese], priceRange[more than £30], area[riverside], familyFriendly[yes], near[Raja Indian Cuisine]"	"the wrestlers is a family friendly restaurant that serves japanese food. it is located near raja indian cuisine in the riverside area."
"name[Wildwood], eatType[coffee shop], area[riverside]"	"wildwood is a coffee shop. it is located in the riverside area."
"name[Wildwood], eatType[pub], area[riverside]"	"wildwood is a pub that is located in the riverside area."
"name[Wildwood], eatType[pub], food[French], area[riverside], familyFriendly[yes], near[Raja Indian Cuisine]"	"wildwood is a family friendly pub that serves french food. it is located near raja indian cuisine in the riverside area."
"name[Wildwood], eatType[pub], food[Indian], area[city centre], familyFriendly[no], near[Raja Indian Cuisine]"	"wildwood is a pub that serves indian food. it is located in the city centre near raja indian cuisine and is not family friendly."
"name[Wildwood], eatType[pub], food[Indian], area[city centre], familyFriendly[yes], near[Raja Indian Cuisine]"	"wildwood is a pub that serves indian food. it is located in the city centre near raja indian cuisine and is family friendly."
"name[Wildwood], eatType[pub], food[Indian], area[riverside], familyFriendly[no], near[Raja Indian Cuisine]"	"wildwood is a pub that serves indian food. it is located in riverside near raja indian cuisine and is not family friendly."
"name[Wildwood], eatType[pub], food[Indian], area[riverside], familyFriendly[yes], near[Raja Indian Cuisine]"	"wildwood is a pub that serves indian food. it is located in the riverside area near raja indian cuisine and is family friendly."
"name[Wildwood], eatType[pub], food[Italian], area[city centre], familyFriendly[no], near[Raja Indian Cuisine]"	"wildwood is a pub located in the city centre near raja indian cuisine. it serves italian food and is not family-friendly."
"name[Wildwood], eatType[pub], food[Italian], area[city centre], familyFriendly[yes], near[Raja Indian Cuisine]"	"wildwood is a family-friendly pub serving italian food. it is located in the city centre near raja indian cuisine."
"name[Wildwood], eatType[pub], food[Italian], area[riverside], familyFriendly[no], near[Raja Indian Cuisine]"	"wildwood is a pub located near raja indian cuisine. it is not family friendly."
"name[Wildwood], eatType[pub], food[Italian], area[riverside], familyFriendly[yes], near[Raja Indian Cuisine]"	"wildwood is a family friendly pub serving italian food. it is located in the riverside area near raja indian cuisine."
"name[Wildwood], eatType[restaurant], food[French], area[riverside], familyFriendly[yes], near[Raja Indian Cuisine]"	"wildwood is a family friendly restaurant that serves french food and is located near raja indian cuisine in the riverside area."
"name[Wildwood], eatType[restaurant], food[Indian], area[city centre], familyFriendly[no], near[Raja Indian Cuisine]"	"wildwood is a restaurant that serves indian food. it is located in the city centre near raja indian cuisine and is not family friendly."
"name[Wildwood], eatType[restaurant], food[Indian], area[city centre], familyFriendly[yes], near[Raja Indian Cuisine]"	"wildwood is a family friendly indian restaurant located in the city centre near raja indian cuisine."
"name[Wildwood], eatType[restaurant], food[Indian], area[riverside], familyFriendly[no], near[Raja Indian Cuisine]"	"wildwood is a restaurant that serves indian food. it is located in riverside near raja indian cuisine."
"name[Wildwood], eatType[restaurant], food[Indian], area[riverside], familyFriendly[yes], near[Raja Indian Cuisine]"	"wildwood is a family friendly indian restaurant in riverside near raja indian cuisine."
"name[Wildwood], eatType[restaurant], food[Italian], area[city centre], familyFriendly[no], near[Raja Indian Cuisine]"	"wildwood is a restaurant located in the city centre near raja indian cuisine. it serves italian food and is not family-friendly."
"name[Wildwood], eatType[restaurant], food[Italian], area[city centre], familyFriendly[yes], near[Raja Indian Cuisine]"	"wildwood is a family-friendly italian restaurant in the city centre near raja indian cuisine."
"name[Wildwood], eatType[restaurant], food[Italian], area[riverside], familyFriendly[no], near[Raja Indian Cuisine]"	"wildwood is a restaurant located near raja indian cuisine in the riverside area. it serves italian food and is not family-friendly."
"name[Wildwood], eatType[restaurant], food[Italian], area[riverside], familyFriendly[yes], near[Raja Indian Cuisine]"	"wildwood is a family friendly italian restaurant in riverside near raja indian cuisine."
"name[Zizzi], eatType[coffee shop], area[riverside]"	"zizzi is a coffee shop. it is located in the riverside area."
"name[Zizzi], eatType[coffee shop], customer rating[average], near[Burger King]"	"zizzi is a coffee shop near burger king. it has an average customer rating."
"name[Zizzi], eatType[coffee shop], customer rating[high], near[Burger King]"	"zizzi is a coffee shop near burger king. it has a high customer rating."
"name[Zizzi], eatType[coffee shop], near[The Sorrento]"	"zizzi is a coffee shop. it is located near the sorrento."
"name[Zizzi], eatType[pub], area[riverside]"	"zizzi is a pub that is located in the riverside area."
"name[Zizzi], eatType[pub], customer rating[average], near[Burger King]"	"zizzi is a pub near burger king. it has an average customer rating."
"name[Zizzi], eatType[pub], customer rating[high], near[Burger King]"	"zizzi is a pub near burger king. it has a high customer rating."
"name[Zizzi], eatType[pub], near[The Sorrento]"	"zizzi is a pub that serves japanese food. it is located near the sorrento."
