MR	output
"name[Blue Spice], eatType[coffee shop], area[city centre]"	In the city centre there is a coffee shop called Blue Spice that sells adult only experience .
"name[Blue Spice], eatType[coffee shop], area[riverside]"	Blue Spice is a coffee shop that offers coffee . You can find it in the riverside area .
"name[Blue Spice], eatType[coffee shop], customer rating[5 out of 5], near[Crowne Plaza Hotel]"	With a customer rating of 5 out of 5 , Blue Spice coffee shop might be near the Crowne Plaza Hotel . It might stop for a coffee shop .
"name[Blue Spice], eatType[coffee shop], customer rating[average], near[Burger King]"	Blue Spice is a coffee shop located neat Burger King .
"name[Blue Spice], eatType[coffee shop], customer rating[average], near[Crowne Plaza Hotel]"	You can find Blue Spice coffee shop near Crowne Plaza Hotel . It has an average customer rating and child are welcome .
"name[Blue Spice], eatType[pub], area[city centre]"	Blue Spice is a pub in the city center .
"name[Blue Spice], eatType[pub], area[riverside]"	The Blue Spice is a pub near the river . It is a great place to take a view .
"name[Blue Spice], eatType[pub], customer rating[5 out of 5], near[Crowne Plaza Hotel]"	Near Crowne Plaza Hotel , there is a pub named Blue Spice with a 5 out of 5 customer rating .
"name[Blue Spice], eatType[pub], customer rating[average], near[Burger King]"	There is a pub called Blue Spice near Burger King that has gourmet food and an average customer rating .
"name[Blue Spice], eatType[pub], customer rating[average], near[Crowne Plaza Hotel]"	Blue Spice is a pub near Crowne Plaza Hotel . It has an average consumer rating .
"name[Blue Spice], eatType[pub], food[Chinese], area[city centre], familyFriendly[no], near[Rainbow Vegetarian Café]"	Blue Spice is a pub that serves Chinese food . It is adults only and is located near Rainbow Vegetarian Café in the city centre .
"name[Blue Spice], eatType[pub], food[Chinese], area[city centre], familyFriendly[yes], near[Rainbow Vegetarian Café]"	Blue Spice is a family friendly pub serving noodle food . It is located near Rainbow Vegetarian Café .
"name[Blue Spice], eatType[pub], food[Chinese], area[riverside], familyFriendly[no], near[Rainbow Vegetarian Café]"	In the riverside area near Rainbow Vegetarian Café is a Chinese pub called Blue Spice that is not family friendly .
"name[Blue Spice], eatType[pub], food[Chinese], area[riverside], familyFriendly[yes], near[Rainbow Vegetarian Café]"	In the riverside area near the Rainbow Vegetarian Café is a pub called Blue Spice that serves Chinese food and is kid friendly .
"name[Blue Spice], eatType[pub], food[English], area[city centre], familyFriendly[no], near[Rainbow Vegetarian Café]"	Blue Spice is an English pub near Rainbow Vegetarian Café in the city centre . It is adult only .
"name[Blue Spice], eatType[pub], food[English], area[city centre], familyFriendly[yes], near[Rainbow Vegetarian Café]"	Blue Spice is a family - friendly pub providing English food . It is located in the city centre near Rainbow Vegetarian Café .
"name[Blue Spice], eatType[pub], food[English], area[riverside], familyFriendly[no], near[Rainbow Vegetarian Café]"	Blue Spice is a no family - friendly pub providing English food . It is located in riverside near Rainbow Vegetarian Café .
"name[Blue Spice], eatType[pub], food[English], area[riverside], familyFriendly[yes], near[Rainbow Vegetarian Café]"	In the riverside area near the Rainbow Vegetarian Café is an English cuisine pub called Blue Spice that is for the whole family .
"name[Blue Spice], eatType[restaurant], food[Chinese], area[city centre], familyFriendly[no], near[Rainbow Vegetarian Café]"	Blue Spice is a restaurant that delivers Chinese food . It is located in the city centre near Rainbow Vegetarian Café . It is not family friendly .
"name[Blue Spice], eatType[restaurant], food[Chinese], area[city centre], familyFriendly[yes], near[Rainbow Vegetarian Café]"	There is a restaurant called Blue Spice that provides Chinese food . It is located in the city centre near the Rainbow Vegetarian Café and is family friendly .
"name[Blue Spice], eatType[restaurant], food[Chinese], area[riverside], familyFriendly[no], near[Rainbow Vegetarian Café]"	Blue Spice is a favorite favorite restaurant . Located near the Rainbow Vegetarian Café .
"name[Blue Spice], eatType[restaurant], food[Chinese], area[riverside], familyFriendly[yes], near[Rainbow Vegetarian Café]"	Blue Spice is a restaurant providing Chinese food It is located in the riverside . It is near Rainbow Vegetarian Café .
"name[Blue Spice], eatType[restaurant], food[English], area[city centre], familyFriendly[no], near[Rainbow Vegetarian Café]"	Blue Spice is a family - friendly English style restaurant near Rainbow Vegetarian Café in the city centre .
"name[Blue Spice], eatType[restaurant], food[English], area[city centre], familyFriendly[yes], near[Rainbow Vegetarian Café]"	Blue Spice is a restaurant located in the city centre near Rainbow Vegetarian Café . It serves great English food in a family - friendly environment .
"name[Blue Spice], eatType[restaurant], food[English], area[riverside], familyFriendly[no], near[Rainbow Vegetarian Café]"	Blue Spice is an adult Rated restaurant located near Rainbow Vegetarian Café . It is serving English food .
"name[Blue Spice], eatType[restaurant], food[English], area[riverside], familyFriendly[yes], near[Rainbow Vegetarian Café]"	Blue Spice is a children friendly restaurant in the riverside area near Rainbow Vegetarian Café . They serve English food .
"name[Clowns], eatType[coffee shop], customer rating[3 out of 5], near[All Bar One]"	Rated 3 out of 5 by customers , Clowns offers coffee shop style experience . You can find Clowns near All Bar One . Located in the city centre area .
"name[Clowns], eatType[coffee shop], customer rating[5 out of 5], near[Crowne Plaza Hotel]"	If you 're looking for a coffee shop near Crowne Plaza Hotel , Clowns is rated 5 out of 5 and is rated 5 out of 5 .
"name[Clowns], eatType[coffee shop], near[The Sorrento]"	Clowns is a coffee shop situated near The Sorrento .
"name[Clowns], eatType[pub], customer rating[3 out of 5], near[All Bar One]"	Clowns is a pub near All Bar One with rank 3 out of 5
"name[Clowns], eatType[pub], customer rating[5 out of 5], near[Crowne Plaza Hotel]"	Near the Crowne Plaza Hotel , there is a pub called Clowns . customers give it different out of 5 .
"name[Clowns], eatType[pub], near[The Sorrento]"	A pub named Clowns is rated pub situated near The Sorrento .
"name[Cocum], eatType[coffee shop], customer rating[high], near[Burger King]"	For a highly rated coffee shop that cant head to Burger King , head to Cocum .
"name[Cocum], eatType[coffee shop], customer rating[high], near[Café Sicilia]"	Cocum is a high priced coffee shop with a high customer rating near Café Sicilia .
"name[Cocum], eatType[coffee shop], customer rating[low], near[Café Sicilia]"	If you are looking for a coffee shop that sells low rated food , Cocum will find it near Café Sicilia .
"name[Cocum], eatType[coffee shop], customer rating[low], near[Express by Holiday Inn]"	For a coffee shop with a low customer rating , try Cocum , located near Express by Holiday Inn .
"name[Cocum], eatType[coffee shop], near[The Rice Boat]"	Cocum is a coffee shop close to The Rice Boat .
"name[Cocum], eatType[coffee shop], near[The Sorrento]"	Near The Sorrento you can find a coffee shop named Cocum .
"name[Cocum], eatType[pub], customer rating[high], near[Burger King]"	A pub names Cocum has a high customer rating and is located near Burger King .
"name[Cocum], eatType[pub], customer rating[high], near[Café Sicilia]"	Cocum is a pub near Café Sicilia with a high customer rating and prices are high .
"name[Cocum], eatType[pub], customer rating[low], near[Café Sicilia]"	There is a pub called Cocum near Café Sicilia that has a low customer rating .
"name[Cocum], eatType[pub], customer rating[low], near[Express by Holiday Inn]"	There is a pub menu rated low near Express by Holiday Inn called Cocum .
"name[Cocum], eatType[pub], near[The Rice Boat]"	Near The Rice Boat is a pub called Cocum .
"name[Cocum], eatType[pub], near[The Sorrento]"	For a pub near The Sorrento , go to Cocum .
"name[Cotto], eatType[coffee shop], near[The Bakers]"	Cotto is a coffee shop located neat The Bakers neat The Bakers .
"name[Cotto], eatType[pub], near[The Bakers]"	Near The Bakers is a pub named Cotto .
"name[Giraffe], eatType[coffee shop], near[The Bakers]"	Giraffe is a coffee shop that serves coffee and is located near The Bakers .
"name[Giraffe], eatType[coffee shop], near[The Rice Boat]"	Giraffe is a child friendly coffee shop that serves coffee and found near The Rice Boat .
"name[Giraffe], eatType[pub], food[English], area[riverside], familyFriendly[yes], near[Rainbow Vegetarian Café]"	Giraffe is a pub offering English style food in a children friendly environment . It is located near the Rainbow Vegetarian Café in the riverside area .
"name[Giraffe], eatType[pub], food[Fast food], area[city centre], familyFriendly[no], near[Rainbow Vegetarian Café]"	In the city centre near the Rainbow Vegetarian Café you can get fast food at Giraffe . This place is not family - friendly .
"name[Giraffe], eatType[pub], food[Fast food], area[city centre], familyFriendly[yes], near[Rainbow Vegetarian Café]"	Giraffe is a child - friendly Fast food pub available in the city centre near Rainbow Vegetarian Café .
"name[Giraffe], eatType[pub], food[Fast food], area[riverside], familyFriendly[no], near[Rainbow Vegetarian Café]"	Giraffe is a pub near Rainbow Vegetarian Café in the riverside area . It serves fast food and is not family - friendly .
"name[Giraffe], eatType[pub], food[Fast food], area[riverside], familyFriendly[yes], near[Rainbow Vegetarian Café]"	Giraffe is a pub known for kids fast food near Crown Vegetarian Café in the riverside area .
"name[Giraffe], eatType[pub], food[Fast food], area[riverside], familyFriendly[yes], near[Raja Indian Cuisine]"	Situated in the riverside area near Raja Indian Cuisine , Giraffe is a kid friendly fast food venue .
"name[Giraffe], eatType[pub], food[French], area[city centre], familyFriendly[no], near[Raja Indian Cuisine]"	There is a French pub near Raja Indian Cuisine in the city centre called Giraffe . It is not family - friendly .
"name[Giraffe], eatType[pub], food[French], area[city centre], familyFriendly[yes], near[Raja Indian Cuisine]"	Giraffe is a family - friendly pub that serves French food . It is located in the city centre near Raja Indian Cuisine .
"name[Giraffe], eatType[pub], food[French], area[riverside], familyFriendly[no], near[Raja Indian Cuisine]"	Giraffe is a pub near Raja Indian Cuisine in the riverside area . It serves French food and is not family - friendly .
"name[Giraffe], eatType[pub], food[French], area[riverside], familyFriendly[yes], near[Raja Indian Cuisine]"	Giraffe is a family friendly pub in the riverside area near Raja Indian Cuisine that serves French cuisine .
"name[Giraffe], eatType[pub], near[The Bakers]"	Try Giraffe in the northern northern northern The Bakers . You can find an excellent pub .
"name[Giraffe], eatType[pub], near[The Rice Boat]"	For non family friendly pub , try Giraffe , near The Rice Boat .
"name[Giraffe], eatType[restaurant], food[English], area[riverside], familyFriendly[yes], near[Rainbow Vegetarian Café]"	Giraffe is a beautiful restaurant close to the Rainbow Vegetarian Café . It is reasonably liked place serves English food and is children friendly .
"name[Giraffe], eatType[restaurant], food[Fast food], area[city centre], familyFriendly[no], near[Rainbow Vegetarian Café]"	Giraffe is a restaurant located in the city centre near Rainbow Vegetarian Café that serves Fast food and dishes are not family - friendly .
"name[Giraffe], eatType[restaurant], food[Fast food], area[city centre], familyFriendly[yes], near[Rainbow Vegetarian Café]"	Giraffe is a family - friendly restaurant serving fast food fare . It is located near Rainbow Vegetarian Café in the city centre .
"name[Giraffe], eatType[restaurant], food[Fast food], area[riverside], familyFriendly[no], near[Rainbow Vegetarian Café]"	In the riverside area near Rainbow Vegetarian Café there is a fast food place called Giraffe that is not family - friendly .
"name[Giraffe], eatType[restaurant], food[Fast food], area[riverside], familyFriendly[yes], near[Rainbow Vegetarian Café]"	Giraffe is a family friendly restaurant in the riverside area near Rainbow Vegetarian Café that serves Fast food .
"name[Giraffe], eatType[restaurant], food[Fast food], area[riverside], familyFriendly[yes], near[Raja Indian Cuisine]"	Giraffe is a family friendly fast food restaurant . It can be found in the riverside area near Raja Indian Cuisine .
"name[Giraffe], eatType[restaurant], food[French], area[city centre], familyFriendly[no], near[Raja Indian Cuisine]"	Giraffe is a French restaurant located within the city centre near Raja Indian Cuisine . It is not family - friendly .
"name[Giraffe], eatType[restaurant], food[French], area[city centre], familyFriendly[yes], near[Raja Indian Cuisine]"	In the city centre near Raja Indian Cuisine is a family - friendly French restaurant called Giraffe .
"name[Giraffe], eatType[restaurant], food[French], area[riverside], familyFriendly[no], near[Raja Indian Cuisine]"	Next to Raja Indian Cuisine is the Giraffe restaurant . We are not family friendly . Our food is French and we are located on the riverside .
"name[Giraffe], eatType[restaurant], food[French], area[riverside], familyFriendly[yes], near[Raja Indian Cuisine]"	Giraffe is a restaurant style child friendly restaurant serving French food in the riverside area near Raja Indian Cuisine .
"name[Green Man], eatType[coffee shop], customer rating[1 out of 5], near[All Bar One]"	Customers give Green Man 1 out of 5 . It is a coffee shop near All Bar One .
"name[Green Man], eatType[coffee shop], customer rating[3 out of 5], near[All Bar One]"	Green Man is an amazing coffee shop with amazing customers of 3 out of 5 stars . It is a lovely place to eat . It is located near All Bar One .
"name[Green Man], eatType[pub], customer rating[1 out of 5], near[All Bar One]"	For a pub with a customer rating of 1 out of 5 , go to Green Man near All Bar One .
"name[Green Man], eatType[pub], customer rating[3 out of 5], near[All Bar One]"	Green Man is a 3 out of 5 rated pub near All Bar One .
"name[Green Man], eatType[pub], food[Italian], area[riverside], familyFriendly[yes], near[Express by Holiday Inn]"	Green Man is a Children friendly Italian pub near Express by Holiday Inn in riverside .
"name[Green Man], eatType[pub], food[Italian], area[riverside], familyFriendly[yes], near[Raja Indian Cuisine]"	Green Man is a family friendly Italian pub in the riverside area near Crown Indian Cuisine .
"name[Green Man], eatType[pub], food[Japanese], area[city centre], familyFriendly[no], near[Express by Holiday Inn]"	Green Man is a Japanese pub located in the city centre near Express by Holiday Inn . It is not family - friendly .
"name[Green Man], eatType[pub], food[Japanese], area[city centre], familyFriendly[yes], near[Express by Holiday Inn]"	Green Man is a family - friendly pub selling Japanese food in the city centre near Express by Holiday Inn however it is family - friendly .
"name[Green Man], eatType[pub], food[Japanese], area[riverside], familyFriendly[no], near[Express by Holiday Inn]"	Green Man is a pub in the riverside area near Express by Holiday Inn . It serves Japanese food and is not family - friendly .
"name[Green Man], eatType[pub], food[Japanese], area[riverside], familyFriendly[yes], near[Express by Holiday Inn]"	Green Man is a kids friendly pub serving Japanese food in the riverside area near Express by Holiday Inn .
"name[Green Man], eatType[restaurant], food[Italian], area[riverside], familyFriendly[yes], near[Express by Holiday Inn]"	Green Man is a children friendly restaurant offering Italian food in the riverside area near Express by Holiday Inn .
"name[Green Man], eatType[restaurant], food[Italian], area[riverside], familyFriendly[yes], near[Raja Indian Cuisine]"	In the riverside area near Raja Indian Cuisine is a children friendly Italian place called Green Man .
"name[Green Man], eatType[restaurant], food[Japanese], area[city centre], familyFriendly[no], near[Express by Holiday Inn]"	Green Man is a Japanese restaurant located in the city center near Express by Holiday Inn . It is not family - friendly .
"name[Green Man], eatType[restaurant], food[Japanese], area[city centre], familyFriendly[yes], near[Express by Holiday Inn]"	In the city centre near Express by Holiday Inn is a family - friendly Japanese restaurant called Green Man .
"name[Green Man], eatType[restaurant], food[Japanese], area[riverside], familyFriendly[no], near[Express by Holiday Inn]"	Green Man is a pasta restaurant located near Express by Holiday Inn . It is an adult only restaurant .
"name[Green Man], eatType[restaurant], food[Japanese], area[riverside], familyFriendly[yes], near[Express by Holiday Inn]"	Located in the riverside area near Express by Holiday Inn is a children friendly restaurant that serves Japanese food called Green Man .
"name[Loch Fyne], eatType[coffee shop], area[riverside]"	Located near the river , Loch Fyne offers coffee and coffee .
"name[Loch Fyne], eatType[pub], area[riverside]"	Loch Fyne is a pub that is rated Loch Fyne in the riverside area .
"name[Strada], eatType[coffee shop], area[city centre]"	Strada is a coffee shop in the city center with prices means means Strada .
"name[Strada], eatType[coffee shop], customer rating[1 out of 5], near[All Bar One]"	For a coffee shop near All Bar One , try Strada . It has a perfect customer rating of 1 out of 5 however .
"name[Strada], eatType[coffee shop], customer rating[1 out of 5], near[Rainbow Vegetarian Café]"	Strada is a coffee shop near Rainbow Vegetarian Café . It has a customer rating of 1 out of 5 .
"name[Strada], eatType[coffee shop], customer rating[low], near[Express by Holiday Inn]"	Strada is a coffee shop near Express by Holiday Inn . It has been given low ratings .
"name[Strada], eatType[pub], area[city centre]"	Strada is a pub in the city centre with prince range of city centre .
"name[Strada], eatType[pub], customer rating[1 out of 5], near[All Bar One]"	Strada is a pub near All Bar One that is rated 1 out of 5 .
"name[Strada], eatType[pub], customer rating[1 out of 5], near[Rainbow Vegetarian Café]"	Customers give a 1 out of 5 pub called Strada near Rainbow Vegetarian Café .
"name[Strada], eatType[pub], customer rating[low], near[Express by Holiday Inn]"	Strada is a pub near Express by Holiday Inn . It has a low customer satisfaction rating .
"name[The Cricketers], eatType[coffee shop], customer rating[1 out of 5], familyFriendly[yes], near[Avalon]"	Near Avalon is a coffee shop named The Cricketers . It is kid friendly and rated 1 out of 5 .
"name[The Cricketers], eatType[coffee shop], customer rating[3 out of 5], familyFriendly[yes], near[Avalon]"	The Cricketers is a children friendly coffee shop near Avalon . It has a customer rating of 3 out of 5 .
"name[The Cricketers], eatType[coffee shop], customer rating[3 out of 5], familyFriendly[yes], near[Crowne Plaza Hotel]"	For a coffee shop with fries and fries . Priced 3 out of 5 , try The Cricketers near Crowne Plaza Hotel .
"name[The Cricketers], eatType[coffee shop], customer rating[5 out of 5], familyFriendly[no], near[Crowne Plaza Hotel]"	The Cricketers is a highly rated coffee shop near Crowne Plaza Hotel . It is not children allowed .
"name[The Cricketers], eatType[coffee shop], customer rating[5 out of 5], familyFriendly[yes], near[Crowne Plaza Hotel]"	The Cricketers is a kids friendly coffee shop near Crowne Plaza Hotel with a customer rating of 5 out of 5 .
"name[The Cricketers], eatType[coffee shop], customer rating[average], familyFriendly[no], near[Café Sicilia]"	The Cricketers is a nice coffee shop near Café Sicilia . It has an average customer rating and is not family - friendly .
"name[The Cricketers], eatType[coffee shop], customer rating[average], familyFriendly[no], near[Crowne Plaza Hotel]"	The Cricketers is a coffee shop with a non family - friendly environment and an average customer rating . It is located near Crowne Plaza Hotel .
"name[The Cricketers], eatType[coffee shop], customer rating[average], familyFriendly[yes], near[Café Sicilia]"	Near Café Sicilia is a kid friendly coffee shop named The Cricketers . It has an average customer rating .
"name[The Cricketers], eatType[coffee shop], customer rating[high], familyFriendly[yes], near[Café Sicilia]"	Close to Café Sicilia is a coffee shop called The Cricketers . This children friendly coffee shop is rated highly by customers .
"name[The Cricketers], eatType[coffee shop], customer rating[high], familyFriendly[yes], near[Express by Holiday Inn]"	The Cricketers is a kids friendly coffee shop offering high prices . It has a high customer rating and is located near Express by Holiday Inn .
"name[The Cricketers], eatType[coffee shop], customer rating[low], familyFriendly[no], near[Express by Holiday Inn]"	The Cricketers is a coffee shop near Express by Holiday Inn . It has a low customer satisfaction rating and is not considered family - friendly . Join Us .
"name[The Cricketers], eatType[coffee shop], customer rating[low], familyFriendly[no], near[Ranch]"	The Cricketers is a coffee shop near Ranch . It is not considered family - friendly and has low customer ratings .
"name[The Cricketers], eatType[coffee shop], customer rating[low], familyFriendly[yes], near[Ranch]"	The Cricketers is a child friendly coffee shop near Ranch . It has a low customer rating .
"name[The Cricketers], eatType[restaurant], customer rating[1 out of 5], familyFriendly[yes], near[Avalon]"	The Cricketers is a child friendly restaurant near Avalon . It is rated 1 out of 5 .
"name[The Cricketers], eatType[restaurant], customer rating[3 out of 5], familyFriendly[yes], near[Avalon]"	Located near Avalon , The Cricketers is a restaurant with a kid friendly environment and a customer rating of 3 out of 5 .
"name[The Cricketers], eatType[restaurant], customer rating[3 out of 5], familyFriendly[yes], near[Crowne Plaza Hotel]"	The Cricketers is a family friendly restaurant close to the Crowne Plaza Hotel .
"name[The Cricketers], eatType[restaurant], customer rating[5 out of 5], familyFriendly[no], near[Crowne Plaza Hotel]"	A highly rated restaurant called The Cricketers boasts a 5 out of 5 rating . This family - friendly experience can be found near Crowne Plaza Hotel .
"name[The Cricketers], eatType[restaurant], customer rating[5 out of 5], familyFriendly[yes], near[Crowne Plaza Hotel]"	The Cricketers is a child friendly restaurant near Crowne Plaza Hotel with a customer rating of 5 out of 5 .
"name[The Cricketers], eatType[restaurant], customer rating[average], familyFriendly[no], near[Café Sicilia]"	Near Café Sicilia is a restaurant called The Cricketers . It is not family - friendly and has an average customer rating .
"name[The Cricketers], eatType[restaurant], customer rating[average], familyFriendly[no], near[Crowne Plaza Hotel]"	There is a restaurant that serves 3 star food . It is called The Cricketers and is close to the Crowne Plaza Hotel .
"name[The Cricketers], eatType[restaurant], customer rating[average], familyFriendly[yes], near[Café Sicilia]"	A child friendly restaurant situated near Café Sicilia is called The Cricketers . It has an average customer rating .
"name[The Cricketers], eatType[restaurant], customer rating[high], familyFriendly[yes], near[Café Sicilia]"	Near Café Sicilia is a family friendly restaurant called The Cricketers with a high customer rating .
"name[The Cricketers], eatType[restaurant], customer rating[high], familyFriendly[yes], near[Express by Holiday Inn]"	The Cricketers is a high priced , child friendly restaurant near Express by Holiday Inn .
"name[The Cricketers], eatType[restaurant], customer rating[low], familyFriendly[no], near[Express by Holiday Inn]"	The Cricketers is a restaurant in the center of the city near Express by Holiday Inn . It has a low customer rating and is not a family - friendly place to go to go to .
"name[The Cricketers], eatType[restaurant], customer rating[low], familyFriendly[no], near[Ranch]"	The Cricketers is a non - family - friendly restaurant located near the Ranch . It has a low customer satisfaction rating .
"name[The Cricketers], eatType[restaurant], customer rating[low], familyFriendly[yes], near[Ranch]"	Near Ranch there is a family friendly restaurant named The Cricketers with a low customer rating .
"name[The Cricketers], eatType[restaurant], food[Chinese], priceRange[£20-25], customer rating[high], area[city centre], familyFriendly[no], near[All Bar One]"	The Cricketers is a Chinese restaurant in the city centre near All Bar One . It has a high customer rating and is not kid friendly . It is priced between 20 - 25 .
"name[The Cricketers], eatType[restaurant], food[Chinese], priceRange[£20-25], customer rating[high], area[city centre], familyFriendly[yes], near[All Bar One]"	The Cricketers is a restaurant providing Chinese food in the £ 20 - 25 price range . It is located in the city centre . It is near All Bar One . Its customer rating is high .
"name[The Cricketers], eatType[restaurant], food[Chinese], priceRange[£20-25], customer rating[high], area[riverside], familyFriendly[no], near[All Bar One]"	There is a Chinese restaurant called The Cricketers in the riverside area near All Bar One . It has a high customer rating and a price range of £ 20 - 25 . It is not children friendly .
"name[The Cricketers], eatType[restaurant], food[Chinese], priceRange[£20-25], customer rating[high], area[riverside], familyFriendly[yes], near[All Bar One]"	The Cricketers is a delicious Chinese restaurant with great quality food with prices £ 20 - 25 . This place is staying in the riverside area near All Bar One . It is child friendly .
"name[The Cricketers], eatType[restaurant], food[Chinese], priceRange[cheap], customer rating[5 out of 5], area[city centre], familyFriendly[no], near[All Bar One]"	Located in the city centre near All Bar One , The Cricketers is a cheap Chinese restaurant with a customer point of 5 out of 5 known . It is not a family friendly atmosphere .
"name[The Cricketers], eatType[restaurant], food[Chinese], priceRange[cheap], customer rating[5 out of 5], area[city centre], familyFriendly[yes], near[All Bar One]"	Located in the city centre near All Bar One is a family friendly Chinese restaurant called The Cricketers . It has a customer rating of 5 out of 5 and cost cheap .
"name[The Cricketers], eatType[restaurant], food[Chinese], priceRange[cheap], customer rating[5 out of 5], area[riverside], familyFriendly[no], near[All Bar One]"	In the riverside area near All Bar One is a Chinese restaurant called The Cricketers . It is not family friendly and has a customer rating of 5 out of 5 .
"name[The Cricketers], eatType[restaurant], food[Chinese], priceRange[cheap], customer rating[5 out of 5], area[riverside], familyFriendly[yes], near[All Bar One]"	There is a family friendly restaurant in the riverside area near All Bar One called The Cricketers . It also provides cheap Chinese food and has a customer rating of 5 out of 5 .
"name[The Cricketers], eatType[restaurant], food[Chinese], priceRange[cheap], customer rating[average], area[city centre], familyFriendly[no], near[All Bar One]"	The Cricketers is a restaurant that provides Chinese food in the cheap price range . It is located in the city centre . It is near All Bar One . Its customer rating is average .
"name[The Cricketers], eatType[restaurant], food[Chinese], priceRange[cheap], customer rating[average], area[city centre], familyFriendly[yes], near[All Bar One]"	The Cricketers is a restaurant that provides Chinese food in the cheap price range . It is located in the city centre . It is near All Bar One . Its customer rating is average .
"name[The Cricketers], eatType[restaurant], food[Chinese], priceRange[cheap], customer rating[average], area[riverside], familyFriendly[no], near[All Bar One]"	The Cricketers is a Chinese restaurant with average ratings and cheap cost . It is located in riverside near All Bar One and is not family friendly .
"name[The Cricketers], eatType[restaurant], food[Chinese], priceRange[cheap], customer rating[average], area[riverside], familyFriendly[yes], near[All Bar One]"	The Cricketers is a restaurant providing Chinese food in the cheap price range . It is located in the riverside . It is near All Bar One . Its customer rating is average .
"name[The Cricketers], eatType[restaurant], food[Chinese], priceRange[high], customer rating[1 out of 5], area[city centre], familyFriendly[no], near[All Bar One]"	The Cricketers is a child free Chinese free experience . Located in the city centre near All Bar One , The Cricketers has a great customer rating of 1 out of 5 and a high price range .
"name[The Cricketers], eatType[restaurant], food[Chinese], priceRange[high], customer rating[1 out of 5], area[city centre], familyFriendly[yes], near[All Bar One]"	In the city centre near All Bar One is a family - friendly restaurant called The Cricketers . It offers quite starting Chinese food and has an excellent customer rating of 1 out of 5 .
"name[The Cricketers], eatType[restaurant], food[Chinese], priceRange[high], customer rating[1 out of 5], area[riverside], familyFriendly[no], near[All Bar One]"	There is a high priced restaurant in the riverside area called The Cricketers . They serve Chinese food and are non child friendly . They are near All Bar One and have a customer rating of 1 out of 5 .
"name[The Cricketers], eatType[restaurant], food[Chinese], priceRange[high], customer rating[1 out of 5], area[riverside], familyFriendly[yes], near[All Bar One]"	The Cricketers is a restaurant providing Chinese food in the high price range . It is located in the riverside . It is near All Bar One . Its customer rating is 1 out of 5 .
"name[The Cricketers], eatType[restaurant], food[Chinese], priceRange[high], customer rating[average], area[city centre], familyFriendly[no], near[All Bar One]"	The Cricketers is a location that serves Chinese food in the city centre near All Bar One . It has a high price range and an average customer rating . It is not children friendly .
"name[The Cricketers], eatType[restaurant], food[Chinese], priceRange[high], customer rating[average], area[city centre], familyFriendly[yes], near[All Bar One]"	The Cricketers is a kid friendly Chinese restaurant with a high price range and an average customer rating . It is located in the city centre near All Bar One .
"name[The Cricketers], eatType[restaurant], food[Chinese], priceRange[high], customer rating[average], area[riverside], familyFriendly[no], near[All Bar One]"	The Cricketers is a high priced Chinese restaurant that is not kid friendly . It is located in the riverside area near All Bar One .
"name[The Cricketers], eatType[restaurant], food[Chinese], priceRange[high], customer rating[average], area[riverside], familyFriendly[yes], near[All Bar One]"	The Cricketers is a high priced restaurant serving Chinese food . It is located in the riverside area near All Bar One and is child friendly . previous previous give it has a 3 out of 5 stars .
"name[The Cricketers], eatType[restaurant], food[Chinese], priceRange[less than £20], customer rating[low], area[city centre], familyFriendly[no], near[All Bar One]"	There is a restaurant called The Cricketers located in the city centre near All Bar One . It has a low customer rating and is not family friendly . It also provides Chinese food for less than £ 20 .
"name[The Cricketers], eatType[restaurant], food[Chinese], priceRange[less than £20], customer rating[low], area[city centre], familyFriendly[yes], near[All Bar One]"	The Cricketers is a restaurant that provides Chinese food in a family friendly environment . It has a lower customer rating and lower prices . It is located in the city centre near All Bar One .
"name[The Cricketers], eatType[restaurant], food[Chinese], priceRange[less than £20], customer rating[low], area[riverside], familyFriendly[no], near[All Bar One]"	The Cricketers is a restaurant that serves Chinese food for less than £ 20 . It has a low customer rating and is not family - friendly . It is located on the riverside side near All Bar One .
"name[The Cricketers], eatType[restaurant], food[Chinese], priceRange[less than £20], customer rating[low], area[riverside], familyFriendly[yes], near[All Bar One]"	The Cricketers is a Chinese restaurant that serves food for less than £ 20 in a family friendly atmosphere . It is located in the riverside area near All Bar One and has a low customer rating .
"name[The Cricketers], eatType[restaurant], food[Chinese], priceRange[moderate], customer rating[1 out of 5], area[city centre], familyFriendly[no], near[All Bar One]"	In the city centre near All Bar One is a Chinese restaurant called The Cricketers . It has a moderate price range and a customer rating of 1 out of 5 . It is not kid friendly .
"name[The Cricketers], eatType[restaurant], food[Chinese], priceRange[moderate], customer rating[1 out of 5], area[city centre], familyFriendly[yes], near[All Bar One]"	The Cricketers is a restaurant serving Chinese food in the moderate price range . It is children friendly and positive us . It is located in the city centre near All Bar One .
"name[The Cricketers], eatType[restaurant], food[Chinese], priceRange[moderate], customer rating[1 out of 5], area[riverside], familyFriendly[no], near[All Bar One]"	The Cricketers is a restaurant providing Chinese food in the moderate price range . It is located in the riverside near All Bar One . It is not kids friendly and has a customer rating of 1 out of 5 .
"name[The Cricketers], eatType[restaurant], food[Chinese], priceRange[moderate], customer rating[1 out of 5], area[riverside], familyFriendly[yes], near[All Bar One]"	The Cricketers is a restaurant that provides Chinese food in the moderate price range . It is located in the riverside . It is near All Bar One . Its customer rating is 1 out of 5 .
"name[The Cricketers], eatType[restaurant], food[Chinese], priceRange[moderate], customer rating[3 out of 5], area[city centre], familyFriendly[no], near[All Bar One]"	The Cricketers is a moderately priced Chinese restaurant in the city centre near All Bar One . It has a customer rating of 3 out of 5 and is not kids friendly .
"name[The Cricketers], eatType[restaurant], food[Chinese], priceRange[moderate], customer rating[3 out of 5], area[city centre], familyFriendly[yes], near[All Bar One]"	The Cricketers is a light - priced Chinese menu restaurant with a friends of friends and friends . It is located in the city centre near All Bar One . Child friendly .
"name[The Cricketers], eatType[restaurant], food[Chinese], priceRange[moderate], customer rating[3 out of 5], area[riverside], familyFriendly[no], near[All Bar One]"	The Cricketers is a Chinese restaurant with a moderate price range . It has a customer rating of 3 out of 5 and is not kid friendly . It is in riverside near All Bar One .
"name[The Cricketers], eatType[restaurant], food[Chinese], priceRange[moderate], customer rating[3 out of 5], area[riverside], familyFriendly[yes], near[All Bar One]"	The Cricketers is a restaurant providing Chinese food in the moderate price range . It is located in the riverside . It is near All Bar One . Its customer rating is 3 out of 5 .
"name[The Cricketers], eatType[restaurant], food[Chinese], priceRange[more than £30], customer rating[high], area[city centre], familyFriendly[no], near[All Bar One]"	The Cricketers is a Chinese restaurant located in the city centre near All Bar One . It has a high customer rating and a price range of more than £ 30 .
"name[The Cricketers], eatType[restaurant], food[Chinese], priceRange[more than £30], customer rating[high], area[city centre], familyFriendly[yes], near[All Bar One]"	The Cricketers is a restaurant providing Chinese food in the more than £ 30 price range . It is located in the city centre . It is near All Bar One . Its customer rating is high .
"name[The Cricketers], eatType[restaurant], food[Chinese], priceRange[more than £30], customer rating[high], area[riverside], familyFriendly[no], near[All Bar One]"	The Cricketers is a restaurant serving high priced Chinese food in the riverside area near All Bar One . It is not children friendly and has a high customer rating .
"name[The Cricketers], eatType[restaurant], food[Chinese], priceRange[more than £30], customer rating[high], area[riverside], familyFriendly[yes], near[All Bar One]"	The Cricketers is a restaurant providing Chinese food in the more than £ 30 price range . It is located in the riverside . It is near All Bar One . Its customer rating is high .
"name[The Cricketers], eatType[restaurant], food[English], priceRange[£20-25], customer rating[high], area[city centre], familyFriendly[no], near[All Bar One]"	The Cricketers is an English restaurant in the city centre near All Bar One . It has a high customer rating and a price range of £ 20 - 25 . It is not Kid friendly .
"name[The Cricketers], eatType[restaurant], food[English], priceRange[£20-25], customer rating[high], area[city centre], familyFriendly[yes], near[All Bar One]"	The Cricketers is a kid friendly restaurant serving English food in the city centre near All Bar One . It is moderately priced and has high customer ratings .
"name[The Cricketers], eatType[restaurant], food[English], priceRange[£20-25], customer rating[high], area[riverside], familyFriendly[no], near[All Bar One]"	The Cricketers is an English restaurant in the riverside area near All Bar One . It has a high customer rating and is not kids friendly . The price range is £ 20 - 25 .
"name[The Cricketers], eatType[restaurant], food[English], priceRange[£20-25], customer rating[high], area[riverside], familyFriendly[yes], near[All Bar One]"	The Cricketers restaurant offers a medium priced menu items . It is located near All Bar One and is recommended to families .
"name[The Cricketers], eatType[restaurant], food[English], priceRange[cheap], customer rating[5 out of 5], area[city centre], familyFriendly[no], near[Café Rouge]"	The Cricketers is a great night , kids friendly restaurant serving cheap English food . It is located next to Café Rouge in the city centre .
"name[The Cricketers], eatType[restaurant], food[English], priceRange[cheap], customer rating[5 out of 5], area[city centre], familyFriendly[yes], near[Café Rouge]"	A cheap restaurant called The Cricketers can be found near Café Rouge in the city centre . It cant 5 star recommended and is recommended for families .
"name[The Cricketers], eatType[restaurant], food[English], priceRange[cheap], customer rating[5 out of 5], area[riverside], familyFriendly[no], near[Café Rouge]"	In the riverside area , near Café Rouge , there is a restaurant called The Cricketers that serves cheap English food . It is not families friendly and has a customer rating of 5 out of 5 .
"name[The Cricketers], eatType[restaurant], food[English], priceRange[cheap], customer rating[5 out of 5], area[riverside], familyFriendly[yes], near[Café Rouge]"	The Cricketers is a cheap , family friendly bite near Café Rouge .
"name[The Cricketers], eatType[restaurant], food[English], priceRange[cheap], customer rating[average], area[city centre], familyFriendly[no], near[Café Rouge]"	The Cricketers is a restaurant located beside Café Rouge in the city centre . They serve cheaply given English food and are not family - friendly .
"name[The Cricketers], eatType[restaurant], food[English], priceRange[cheap], customer rating[average], area[city centre], familyFriendly[yes], near[Café Rouge]"	The Cricketers is a family - friendly English restaurant located in the city centre near Café Rouge . It has received average ratings and cheap prices .
"name[The Cricketers], eatType[restaurant], food[English], priceRange[cheap], customer rating[average], area[riverside], familyFriendly[no], near[Café Rouge]"	The Cricketers is a restaurant serving moderately priced English food . It is located in the riverside area near Café Rouge . Customers rate it as average .
"name[The Cricketers], eatType[restaurant], food[English], priceRange[cheap], customer rating[average], area[riverside], familyFriendly[yes], near[Café Rouge]"	The Cricketers is a family friendly restaurant that serves well pasta in the low price range . It is located in the riverside area near Café Rouge .
"name[The Cricketers], eatType[restaurant], food[English], priceRange[high], customer rating[1 out of 5], area[city centre], familyFriendly[no], near[Café Rouge]"	The Cricketers is an expensive 1 out of 5 rated restaurant that sells English food . It is not a close to Café Rouge and is not children friendly .
"name[The Cricketers], eatType[restaurant], food[English], priceRange[high], customer rating[1 out of 5], area[city centre], familyFriendly[yes], near[Café Rouge]"	The Cricketers is a family - friendly restaurant that offers high prices and tasty English food . It is located near Café Rouge in the city centre .
"name[The Cricketers], eatType[restaurant], food[English], priceRange[high], customer rating[1 out of 5], area[riverside], familyFriendly[no], near[Café Rouge]"	Located near Café Rouge , The Cricketers is a restaurant providing high priced British food . It is not children friendly and receives 1 out of 5 stars .
"name[The Cricketers], eatType[restaurant], food[English], priceRange[high], customer rating[1 out of 5], area[riverside], familyFriendly[yes], near[Café Rouge]"	Located near Café Rouge , The Cricketers is an expensive family friendly restaurant with a customer rating of 1 out of 5 .
"name[The Cricketers], eatType[restaurant], food[English], priceRange[high], customer rating[average], area[city centre], familyFriendly[no], near[Café Rouge]"	In the city center near Café Rouge , there is a restaurant called The Cricketers that serves high priced fast food and is not child friendly .
"name[The Cricketers], eatType[restaurant], food[English], priceRange[high], customer rating[average], area[city centre], familyFriendly[yes], near[Café Rouge]"	The Cricketers is a high - end restaurant style restaurant serving English food . Located in the city centre near Café Rouge , it is children friendly and has average ratings .
"name[The Cricketers], eatType[restaurant], food[English], priceRange[high], customer rating[average], area[riverside], familyFriendly[no], near[Café Rouge]"	The Cricketers is a new restaurant offering expensive night and makes . It has an average customer rating and is not good for child . It is located near Café Rouge in the riverside area .
"name[The Mill], eatType[pub], food[English], priceRange[high], area[riverside], familyFriendly[yes], near[Raja Indian Cuisine]"	Located near Raja Indian Cuisine , the British pub The Mill is a nice priced child friendly establishment that serves traditional meals .
"name[The Mill], eatType[pub], food[English], priceRange[less than £20], area[city centre], familyFriendly[no], near[Raja Indian Cuisine]"	The Mill is a pub near Raja Indian Cuisine in the city centre . It serves great English food for less than £ 20 and is not family - friendly .
"name[The Mill], eatType[pub], food[English], priceRange[less than £20], area[city centre], familyFriendly[yes], near[Raja Indian Cuisine]"	The Mill is an English pub in the city centre near Raja Indian Cuisine . It is family - friendly with a price range of less than £ 20 .
"name[The Mill], eatType[pub], food[English], priceRange[less than £20], area[riverside], familyFriendly[no], near[Raja Indian Cuisine]"	The Mill is an inexpensive English pub in the riverside area near Raja Indian Cuisine . It is not family - friendly .
"name[The Mill], eatType[pub], food[English], priceRange[less than £20], area[riverside], familyFriendly[yes], near[Raja Indian Cuisine]"	Families are welcome at The Mill which sells delicious pasta fare for all ages . It is located near Raja Indian Cuisine .
"name[The Mill], eatType[pub], food[English], priceRange[moderate], area[city centre], familyFriendly[no], near[Raja Indian Cuisine]"	The Mill is a moderately priced English pub in the city centre near Raja Indian Cuisine . It is not kids friendly .
"name[The Mill], eatType[pub], food[English], priceRange[moderate], area[city centre], familyFriendly[yes], near[Raja Indian Cuisine]"	The Mill is a pub offering traditional English food . It is moderately priced and kids are welcome . It is located in the city centre near Raja Indian Cuisine .
"name[The Mill], eatType[pub], food[English], priceRange[moderate], area[riverside], familyFriendly[no], near[Raja Indian Cuisine]"	The Mill is a moderately priced pub in the riverside area near Raja Indian Cuisine . It sells English food and is not kids friendly .
"name[The Mill], eatType[pub], food[English], priceRange[moderate], area[riverside], familyFriendly[yes], near[Raja Indian Cuisine]"	The Mill is a kid friendly pub with a moderate price range . It is located near Raja Indian Cuisine .
"name[The Mill], eatType[pub], food[English], priceRange[more than £30], area[riverside], familyFriendly[yes], near[Raja Indian Cuisine]"	Located near Raja Indian Cuisine in the riverside area , The Mill offers English food at higher prices . generally children welcome with children .
"name[The Mill], eatType[pub], food[Fast food], priceRange[£20-25], area[riverside], familyFriendly[yes], near[Raja Indian Cuisine]"	The Mill is located close to Raja Indian Cuisine in the riverside area . It is a kids friendly pub that offers Fast food with prices ranging from £ 20 - 25 .
"name[The Mill], eatType[pub], food[Fast food], priceRange[£20-25], customer rating[high], area[city centre], familyFriendly[no], near[Café Rouge]"	The Mill is a fast food pub near Café Rouge in the city centre . It has high customer ratings and is priced at £ 20 - 25 . It is not children friendly .
"name[The Mill], eatType[pub], food[Fast food], priceRange[£20-25], customer rating[high], area[city centre], familyFriendly[yes], near[Café Rouge]"	There is a pub near Café Rouge in the city centre called The Mill . They serve fast food with a price range of £ 20 - 25 . It is a good choice and is kid friendly .
"name[The Mill], eatType[pub], food[Fast food], priceRange[£20-25], customer rating[high], area[riverside], familyFriendly[no], near[Café Rouge]"	Fast food can be found at the pub called The Mill . It is located in the riverside area near Café Rouge . It has a good price bracket of £ 20 - 25 and is not good for family .
"name[The Mill], eatType[pub], food[Fast food], priceRange[£20-25], customer rating[high], area[riverside], familyFriendly[yes], near[Café Rouge]"	The Mill is a pub that serve fast food . It can be found in the riverside area near Café Rouge . It has high prices and provides a kid friendly atmosphere .
"name[The Mill], eatType[pub], food[Fast food], priceRange[£20-25], customer rating[high], area[riverside], familyFriendly[yes], near[Café Sicilia]"	Located near Café Sicilia in the riverside area , The Mill is a family friendly fast food pub with a high customer rating .
"name[The Mill], eatType[pub], food[Fast food], priceRange[cheap], area[riverside], familyFriendly[yes], near[Raja Indian Cuisine]"	The Mill is a cheap Fast food place near Raja Indian Cuisine in riverside . It is kids friendly .
"name[The Mill], eatType[pub], food[Fast food], priceRange[cheap], customer rating[5 out of 5], area[city centre], familyFriendly[no], near[Café Sicilia]"	Located in the city centre near Café Sicilia , The Mill is a pub that earned a 5 out of 5 customer rating . It also provides cheap fast food . It is not family - friendly .
"name[The Mill], eatType[pub], food[Fast food], priceRange[cheap], customer rating[5 out of 5], area[city centre], familyFriendly[yes], near[Café Sicilia]"	The Mill is a cheap , family - friendly fast food pub in the city centre near Café Sicilia . It has a customer rating of 5 out of 5 .
"name[The Mill], eatType[pub], food[Fast food], priceRange[cheap], customer rating[5 out of 5], area[riverside], familyFriendly[no], near[Café Sicilia]"	The Mill is a great Fast food pub in the riverside area near Café Sicilia . It is not family - friendly and has a great customer rating of 5 out of 5 .
"name[The Mill], eatType[pub], food[Fast food], priceRange[cheap], customer rating[5 out of 5], area[riverside], familyFriendly[yes], near[Café Sicilia]"	The Mill can be found near Café Sicilia . It is a cheap , family friendly pub with a five star rating and full service .
"name[The Mill], eatType[pub], food[Fast food], priceRange[cheap], customer rating[average], area[city centre], familyFriendly[no], near[Café Sicilia]"	There is a cheap pub called The Mill near Café Sicilia in the city centre . It serves fast food and has an average customer rating .
"name[The Mill], eatType[pub], food[Fast food], priceRange[cheap], customer rating[average], area[city centre], familyFriendly[yes], near[Café Sicilia]"	The Mill is a fast food pub located in the city centre near Café Sicilia . It may have a cheap price range and is child friendly .
"name[The Mill], eatType[pub], food[Fast food], priceRange[cheap], customer rating[average], area[riverside], familyFriendly[no], near[Café Sicilia]"	You can get cheap meals at The Mill pub near Café Sicilia . However , it is not family - friendly .
"name[The Mill], eatType[pub], food[Fast food], priceRange[cheap], customer rating[average], area[riverside], familyFriendly[yes], near[Café Sicilia]"	The Mill is a cheap Fast food pub sold in the riverside area near Café Sicilia . It is family friendly service with an average customer rating .
"name[The Mill], eatType[pub], food[Fast food], priceRange[high], customer rating[1 out of 5], area[city centre], familyFriendly[no], near[Café Sicilia]"	The Mill is a high priced Fast food pub in the center of the city near Café Sicilia . It is not children friendly and has a 1 out of 5 rating from customers .
"name[The Mill], eatType[pub], food[Fast food], priceRange[high], customer rating[1 out of 5], area[city centre], familyFriendly[yes], near[Café Sicilia]"	The Mill is a low - priced , family - friendly pub where you can get quick food . It is located in the city centre near Café Sicilia . It has a quick away of 1 out of 5 .
"name[The Mill], eatType[pub], food[Fast food], priceRange[high], customer rating[1 out of 5], area[riverside], familyFriendly[no], near[Café Sicilia]"	Enjoy adult fast food at The Mill in the riverside area near Café Sicilia . It has a customer rating of 1 out of 5 and is not family - friendly .
"name[The Mill], eatType[pub], food[Fast food], priceRange[high], customer rating[1 out of 5], area[riverside], familyFriendly[yes], near[Café Sicilia]"	The Mill is a good pub visit expensive serving fast style food . It does not allow children and has a customer rating of 1 out of 5 . It is located along the riverside near Café Sicilia .
"name[The Mill], eatType[pub], food[Fast food], priceRange[high], customer rating[average], area[city centre], familyFriendly[no], near[Café Sicilia]"	The Mill is a pub serving Fast food in the city centre near Café Sicilia . It has a high price range and an average customer rating . It is not children friendly .
"name[The Mill], eatType[pub], food[Fast food], priceRange[high], customer rating[average], area[city centre], familyFriendly[yes], near[Café Sicilia]"	There is a Fast food pub near Café Sicilia called The Mill . It has a high price range and is quite quality . It is children friendly and will like it .
"name[The Mill], eatType[pub], food[Fast food], priceRange[high], customer rating[average], area[riverside], familyFriendly[no], near[Café Sicilia]"	Near Café Sicilia in the riverside area is a Fast food pub called The Mill . It has a high price range and an average customer rating . It is not child friendly .
"name[The Mill], eatType[pub], food[Fast food], priceRange[high], customer rating[average], area[riverside], familyFriendly[yes], near[Café Sicilia]"	The Mill is an expensive family friendly pub with a good rating . It is located near Café Sicilia .
"name[The Mill], eatType[pub], food[Fast food], priceRange[less than £20], customer rating[low], area[city centre], familyFriendly[no], near[Café Sicilia]"	The Mill is a fast food pub located in the city centre near Café Sicilia . It has quite low customer ratings and is not family - friendly .
"name[The Mill], eatType[pub], food[Fast food], priceRange[less than £20], customer rating[low], area[city centre], familyFriendly[yes], near[Café Sicilia]"	Located in the city centre near Café Sicilia , The Mill is a family - friendly pub that sells burgers and fries .
"name[The Mill], eatType[pub], food[Fast food], priceRange[less than £20], customer rating[low], area[riverside], familyFriendly[no], near[Café Sicilia]"	The Mill is a fast food pub with a price range of less than £ 20 . It is not family - friendly and has a low customer rating . It is close to Café Sicilia in the riverside area .
"name[The Mill], eatType[pub], food[Fast food], priceRange[less than £20], customer rating[low], area[riverside], familyFriendly[yes], near[Café Sicilia]"	The Mill is a pub that serves fast food at prices less than £ 20 . However , it is family friendly and has a low customer rating . It is located near Café Sicilia in the riverside area . However , it will note it has a low customer rating .
"name[The Mill], eatType[pub], food[Fast food], priceRange[moderate], customer rating[1 out of 5], area[city centre], familyFriendly[no], near[Café Sicilia]"	For reasonably priced fast food , check out The Mill in the city centre near Café Sicilia . It is not child friendly and has a customer rating of 1 out of 5 .
"name[The Mill], eatType[pub], food[Fast food], priceRange[moderate], customer rating[1 out of 5], area[city centre], familyFriendly[yes], near[Café Sicilia]"	The Mill is a moderately priced pub that offers Fast food . It is located in the city centre near Café Sicilia . It is kid friendly and customers rate it 1 out of 5 .
"name[The Mill], eatType[pub], food[Fast food], priceRange[moderate], customer rating[1 out of 5], area[riverside], familyFriendly[no], near[Café Sicilia]"	Low budget fast food for adults can be found at The Mill pub . It can be found near Café Sicilia in the riverside area .
"name[The Mill], eatType[pub], food[Fast food], priceRange[moderate], customer rating[1 out of 5], area[riverside], familyFriendly[yes], near[Café Sicilia]"	The Mill is a family friendly pub that serves fast food in the riverside area near Café Sicilia . It has a moderate price range and a customer rating of 1 out of 5 .
"name[The Mill], eatType[pub], food[Fast food], priceRange[moderate], customer rating[3 out of 5], area[city centre], familyFriendly[no], near[Café Sicilia]"	The Mill is a pub offering Fast food in the city centre near Café Sicilia . It is rated poorly by customers and bring a moderate price . It is not family - friendly though .
"name[The Mill], eatType[pub], food[Fast food], priceRange[moderate], customer rating[3 out of 5], area[city centre], familyFriendly[yes], near[Café Sicilia]"	There is a kid friendly Fast food pub called The Mill near Café Sicilia in the city centre . It is rated 3 out of 5 by customers .
"name[The Mill], eatType[pub], food[Fast food], priceRange[moderate], customer rating[3 out of 5], area[riverside], familyFriendly[no], near[Café Sicilia]"	The Mill is a 3 star pub located near Café Sicilia . It is a moderately priced fast food establishment .
"name[The Mill], eatType[pub], food[Fast food], priceRange[moderate], customer rating[3 out of 5], area[riverside], familyFriendly[yes], near[Café Sicilia]"	The Mill is a moderately priced family friendly pub located near Café Sicilia .
"name[The Mill], eatType[restaurant], food[English], priceRange[high], area[riverside], familyFriendly[yes], near[Raja Indian Cuisine]"	There is a children friendly restaurant called The Mill in the riverside area near Raja Indian Cuisine . It serves high priced English food .
"name[The Mill], eatType[restaurant], food[English], priceRange[high], customer rating[average], area[riverside], familyFriendly[yes], near[Café Rouge]"	The Mill is a family friendly restaurant that offers English fare in the higher price bracket . It is located near Café Rouge in the riverside area .
"name[The Mill], eatType[restaurant], food[English], priceRange[less than £20], area[city centre], familyFriendly[no], near[Raja Indian Cuisine]"	The Mill is a restaurant located within the city centre near Raja Indian Cuisine . It is not family - friendly and has a price range of less than £ 20 .
"name[The Mill], eatType[restaurant], food[English], priceRange[less than £20], area[city centre], familyFriendly[yes], near[Raja Indian Cuisine]"	The Mill is a low priced family - friendly English restaurant in the city centre near Raja Indian Cuisine .
"name[The Mill], eatType[restaurant], food[English], priceRange[less than £20], area[riverside], familyFriendly[no], near[Raja Indian Cuisine]"	The Mill is an affordable English restaurant near Raja Indian Cuisine in the riverside area . The meals are none family friendly .
"name[The Mill], eatType[restaurant], food[English], priceRange[less than £20], area[riverside], familyFriendly[yes], near[Raja Indian Cuisine]"	A family friendly restaurant with riverside views called The Mill is close to Raja Indian Cuisine .
"name[The Mill], eatType[restaurant], food[English], priceRange[less than £20], customer rating[low], area[city centre], familyFriendly[no], near[Café Rouge]"	The Mill is an English restaurant located in the city centre near Café Rouge . It has a low customer rating and is not kid friendly .
"name[The Mill], eatType[restaurant], food[English], priceRange[less than £20], customer rating[low], area[city centre], familyFriendly[yes], near[Café Rouge]"	Café Rouge is located next to the center of the city . It is a family - friendly English style restaurant called The Mill . It has a low customer rating .
"name[The Mill], eatType[restaurant], food[English], priceRange[less than £20], customer rating[low], area[riverside], familyFriendly[no], near[Café Rouge]"	The Mill is a restaurant located near Café Rouge in the riverside area . It has a low customer rating and is not family - friendly .
"name[The Mill], eatType[restaurant], food[English], priceRange[less than £20], customer rating[low], area[riverside], familyFriendly[yes], near[Café Rouge]"	The Mill is a family friendly restaurant in the riverside area near Café Rouge offering English food for less than £ 20 . It has a low customer rating .
"name[The Mill], eatType[restaurant], food[English], priceRange[moderate], area[city centre], familyFriendly[no], near[Raja Indian Cuisine]"	The Mill is a moderately priced English restaurant in the city centre near Raja Indian Cuisine . It is not kid friendly .
"name[The Mill], eatType[restaurant], food[English], priceRange[moderate], area[city centre], familyFriendly[yes], near[Raja Indian Cuisine]"	There is a family - friendly restaurant called The Mill near Raja Indian Cuisine in the city centre . It serves moderately priced English food .
"name[The Mill], eatType[restaurant], food[English], priceRange[moderate], area[riverside], familyFriendly[no], near[Raja Indian Cuisine]"	There is a restaurant near Raja Indian Cuisine in the riverside area called The Mill . It serves moderately priced English food and is not family - friendly .
"name[The Mill], eatType[restaurant], food[English], priceRange[moderate], area[riverside], familyFriendly[yes], near[Raja Indian Cuisine]"	Close to Raja Indian Cuisine , The Mill restaurant serves low priced food and is north of the city centre .
"name[The Mill], eatType[restaurant], food[English], priceRange[moderate], customer rating[1 out of 5], area[city centre], familyFriendly[no], near[Café Rouge]"	The Mill is a moderately priced English restaurant in the city centre near Café Rouge . It has a customer rating of 1 out of 5 and is not child friendly .
"name[The Mill], eatType[restaurant], food[English], priceRange[moderate], customer rating[1 out of 5], area[city centre], familyFriendly[yes], near[Café Rouge]"	The Mill is a kid friendly moderately priced restaurant that serves English food . It is located in the city centre near Café Rouge and has a customer rating of 1 out of 5 .
"name[The Mill], eatType[restaurant], food[English], priceRange[moderate], customer rating[1 out of 5], area[riverside], familyFriendly[no], near[Café Rouge]"	The Mill is a mid - priced restaurant . Located near Café Rouge , it is rated one star .
"name[The Mill], eatType[restaurant], food[English], priceRange[moderate], customer rating[1 out of 5], area[riverside], familyFriendly[yes], near[Café Rouge]"	The Mill is an affordable option and superb dine just north of the city center . near Café Rouge .
"name[The Mill], eatType[restaurant], food[English], priceRange[moderate], customer rating[3 out of 5], area[city centre], familyFriendly[no], near[Café Rouge]"	There is an English restaurant near Café Rouge in the city centre . Its ratings are 3 out of 5 and it is called The Mill . It is not great for kid and typical dishes are moderate .
"name[The Mill], eatType[restaurant], food[English], priceRange[moderate], customer rating[3 out of 5], area[city centre], familyFriendly[yes], near[Café Rouge]"	The Mill is a restaurant offering moderately priced English food . It is located in the city centre near Café Rouge and is kid friendly .
"name[The Mill], eatType[restaurant], food[English], priceRange[moderate], customer rating[3 out of 5], area[riverside], familyFriendly[no], near[Café Rouge]"	The Mill is a moderately priced English restaurant with a customer rating of 3 out of 5 . Kids are not welcome . It is located in the riverside area near Café Rouge .
"name[The Mill], eatType[restaurant], food[English], priceRange[moderate], customer rating[3 out of 5], area[riverside], familyFriendly[yes], near[Café Rouge]"	The Mill is a family - friendly restaurant on the river just next to Café Rouge . It has a mid price range .
"name[The Mill], eatType[restaurant], food[English], priceRange[more than £30], area[riverside], familyFriendly[yes], near[Raja Indian Cuisine]"	The Mill is a family - friendly restaurant offering spaghetti and breakfast at prices . It is located near Raja Indian Cuisine .
"name[The Mill], eatType[restaurant], food[English], priceRange[more than £30], customer rating[high], area[city centre], familyFriendly[no], near[Café Rouge]"	The Mill is an English restaurant located in the city centre near Café Rouge . It is not child friendly and costs more than £ 30 . Prices are more than £ 30 .
"name[The Mill], eatType[restaurant], food[English], priceRange[more than £30], customer rating[high], area[city centre], familyFriendly[yes], near[Café Rouge]"	The Mill is a child friendly restaurant that serves English food . It is located in the city centre near Café Rouge . It is priced more than £ 30 and has high customer ratings .
"name[The Mill], eatType[restaurant], food[English], priceRange[more than £30], customer rating[high], area[riverside], familyFriendly[no], near[Café Rouge]"	The Mill is an English restaurant in the riverside area near Café Rouge . It has a high customer rating , is not children friendly , and has a price range of more than £ 30 . This establishment is not a children friendly establishment .
"name[The Mill], eatType[restaurant], food[English], priceRange[more than £30], customer rating[high], area[riverside], familyFriendly[yes], near[Café Rouge]"	The Mill is an expensive family friendly restaurant beside the river and Café Rouge .
"name[The Mill], eatType[restaurant], food[Fast food], priceRange[£20-25], area[riverside], familyFriendly[yes], near[Raja Indian Cuisine]"	Located next to Raja Indian Cuisine is a family friendly restaurant named The Mill . Check out The Mill , a wide range of delicious meals .
"name[The Mill], eatType[restaurant], food[Fast food], priceRange[cheap], area[riverside], familyFriendly[yes], near[Raja Indian Cuisine]"	The Mill is a restaurant providing Fast food in the low price range . It is located in the riverside near Raja Indian Cuisine .
"name[The Phoenix], eatType[pub], food[Fast food], priceRange[cheap], area[riverside], familyFriendly[yes], near[Raja Indian Cuisine]"	The Phoenix is a low cost family friendly pub located near Raja Indian Cuisine .
"name[The Phoenix], eatType[pub], food[Fast food], priceRange[high], area[city centre], familyFriendly[no], near[Raja Indian Cuisine]"	The Phoenix is a pub near Raja Indian Cuisine in the city center . It is moderately priced and not family - friendly .
"name[The Phoenix], eatType[pub], food[Fast food], priceRange[high], area[city centre], familyFriendly[yes], near[Raja Indian Cuisine]"	The Phoenix is a great pub in the city centre near Raja Indian Cuisine . They offer fast food at high prices and are children friendly .
"name[The Phoenix], eatType[pub], food[Fast food], priceRange[high], area[riverside], familyFriendly[no], near[Raja Indian Cuisine]"	The Phoenix is a children friendly pub that offers fast food options . It is located in the riverside area near Raja Indian Cuisine .
"name[The Phoenix], eatType[pub], food[Fast food], priceRange[high], area[riverside], familyFriendly[yes], near[Raja Indian Cuisine]"	The Phoenix is the best class pub located near Raja Indian Cuisine . Child friendly class high class make .
"name[The Phoenix], eatType[pub], food[Fast food], priceRange[less than £20], area[city centre], familyFriendly[no], near[Raja Indian Cuisine]"	The Phoenix is a fast food pub in the city centre near Raja Indian Cuisine . It is not family - friendly and the price range is less than £ 20 .
"name[The Phoenix], eatType[pub], food[Fast food], priceRange[less than £20], area[city centre], familyFriendly[yes], near[Raja Indian Cuisine]"	In the center of the city near Raja Indian Cuisine is a family - friendly eatery named The Phoenix that provides fast food for less than £ 20 .
"name[The Phoenix], eatType[pub], food[Fast food], priceRange[less than £20], area[riverside], familyFriendly[no], near[Raja Indian Cuisine]"	In the riverside area near Raja Indian Cuisine is a Fast food pub called The Phoenix . It is not kid friendly and has a price range of less than £ 20 .
"name[The Phoenix], eatType[pub], food[Fast food], priceRange[less than £20], area[riverside], familyFriendly[yes], near[Raja Indian Cuisine]"	In the riverside area near Raja Indian Cuisine is a family friendly pub called The Phoenix that offers Fast food for less than £ 20 .
"name[The Phoenix], eatType[pub], food[Fast food], priceRange[moderate], area[city centre], familyFriendly[no], near[Raja Indian Cuisine]"	The Phoenix is a pub offering Fast food in the city centre near Raja Indian Cuisine . It is not child friendly and has a moderate price range .
"name[The Phoenix], eatType[pub], food[Fast food], priceRange[moderate], area[city centre], familyFriendly[yes], near[Raja Indian Cuisine]"	The Phoenix is a moderate priced pub that serves fast food . Kids are located in the city centre near Raja Indian Cuisine . Kids are home .
"name[The Phoenix], eatType[pub], food[Fast food], priceRange[moderate], area[riverside], familyFriendly[no], near[Raja Indian Cuisine]"	The Phoenix is a pub near Raja Indian Cuisine in the riverside area . It serves moderate priced Fast food and is not kid friendly .
"name[The Phoenix], eatType[pub], food[Fast food], priceRange[moderate], area[riverside], familyFriendly[yes], near[Raja Indian Cuisine]"	The Phoenix is a family friendly environment that offers mid - priced food . It is located near Raja Indian Cuisine .
"name[The Phoenix], eatType[pub], food[Fast food], priceRange[moderate], customer rating[3 out of 5], area[riverside], familyFriendly[yes], near[Café Sicilia]"	The Phoenix is a moderately priced kid friendly pub with a customer rating of 3 out of 5 . It sells fast food and is located near Café Sicilia in the riverside area .
"name[The Phoenix], eatType[pub], food[Fast food], priceRange[more than £30], area[riverside], familyFriendly[yes], near[Raja Indian Cuisine]"	The Phoenix is a pub catering for children style fast food . It is located in the riverside area near Raja Indian Cuisine and has a lot of mid price range .
"name[The Phoenix], eatType[pub], food[Fast food], priceRange[more than £30], customer rating[high], area[city centre], familyFriendly[no], near[Café Sicilia]"	The Phoenix offers Fast food experience for more than £ 30 . This pub is not children friendly . Located in the city centre , you will find it near Café Sicilia .
"name[The Phoenix], eatType[pub], food[Fast food], priceRange[more than £30], customer rating[high], area[city centre], familyFriendly[yes], near[Café Sicilia]"	The Phoenix is a pub that provides Fast food . It is based in the city centre near Café Sicilia . It has a high customer rating and is kids friendly . The price range is more than £ 30 .
"name[The Phoenix], eatType[pub], food[Fast food], priceRange[more than £30], customer rating[high], area[riverside], familyFriendly[no], near[Café Sicilia]"	The Phoenix is a non child friendly pub located near Café Sicilia in the riverside area . Prices are more than £ 30 and it serves fast food . Prices are more than £ 30 .
"name[The Phoenix], eatType[pub], food[Fast food], priceRange[more than £30], customer rating[high], area[riverside], familyFriendly[yes], near[Café Sicilia]"	The Phoenix is a family friendly pub that serves burgers and fries . It has 3 out of 5 stars and is located near Café Sicilia .
"name[The Phoenix], eatType[pub], food[French], priceRange[£20-25], area[riverside], familyFriendly[yes], near[Raja Indian Cuisine]"	The Phoenix is a pub in the riverside area near Raja Indian Cuisine . Prices range from £ 20 - 25 . Prices are £ 20 - 25 . It is a new kids friendly pub to get French food . The bill fall fall in the riverside area .
"name[The Phoenix], eatType[pub], food[French], priceRange[£20-25], customer rating[3 out of 5], area[city centre], familyFriendly[no], near[Café Sicilia]"	The Phoenix is a pub featuring French food with prices between £ 20 - 25 . It is located in the city center near Café Sicilia and is not children friendly .
"name[The Phoenix], eatType[pub], food[French], priceRange[£20-25], customer rating[3 out of 5], area[city centre], familyFriendly[yes], near[Café Sicilia]"	There is a pub called The Phoenix that offers French food in the city centre near Café Sicilia . It has 3 out of 5 customer reviews and is kid friendly .
"name[The Phoenix], eatType[pub], food[French], priceRange[£20-25], customer rating[3 out of 5], area[riverside], familyFriendly[no], near[Café Sicilia]"	In the riverside area , near Café Sicilia , there is a pub that serves French food called The Phoenix . It is not kid friendly and has a customer rating of 3 out of 5 .
"name[The Phoenix], eatType[pub], food[French], priceRange[£20-25], customer rating[3 out of 5], area[riverside], familyFriendly[yes], near[Café Sicilia]"	The Phoenix is a pub near Café Sicilia . They serve French food and are kid friendly . They are priced £ 20 - 25 and are rated 3 out of 5 .
"name[The Phoenix], eatType[pub], food[French], priceRange[£20-25], customer rating[3 out of 5], area[riverside], familyFriendly[yes], near[Crowne Plaza Hotel]"	Near the Crowne Plaza Hotel , there is a three star wine and cheese restaurant called The Phoenix . It is family friendly and is medium priced .
"name[The Phoenix], eatType[pub], food[French], priceRange[£20-25], customer rating[high], area[city centre], familyFriendly[no], near[Crowne Plaza Hotel]"	The Phoenix is a pub that delivers French cuisine . It is highly rated and is not kids friendly . It is located in the city centre near the Crowne Plaza Hotel .
"name[The Phoenix], eatType[pub], food[French], priceRange[£20-25], customer rating[high], area[city centre], familyFriendly[yes], near[Crowne Plaza Hotel]"	A kid friendly pub with high ratings named The Phoenix serves French food and has a price range of 20 - 25 euros . It is located in the city centre near the Crowne Plaza Hotel .
"name[The Phoenix], eatType[pub], food[French], priceRange[£20-25], customer rating[high], area[riverside], familyFriendly[no], near[Crowne Plaza Hotel]"	The Phoenix is a pub that provides French food in the £ 20 - 25 price range . It is located in the riverside . It is near Crowne Plaza Hotel . Its customer rating is high .
"name[The Phoenix], eatType[pub], food[French], priceRange[£20-25], customer rating[high], area[riverside], familyFriendly[yes], near[Crowne Plaza Hotel]"	There is a medium - price pub called The Phoenix that provides expensive food . It is located near Crowne Plaza Hotel .
"name[The Phoenix], eatType[pub], food[French], priceRange[cheap], area[riverside], familyFriendly[yes], near[Raja Indian Cuisine]"	Go to The Phoenix , a great pub located near Raja Indian Cuisine . It offers products at a low price .
"name[The Phoenix], eatType[pub], food[French], priceRange[cheap], customer rating[5 out of 5], area[city centre], familyFriendly[no], near[Crowne Plaza Hotel]"	The Phoenix is a cheap French pub located in the city centre near the Crowne Plaza Hotel . It has a perfect customer rating of 5 out of 5 and is not a family - friendly environment .
"name[The Phoenix], eatType[pub], food[French], priceRange[cheap], customer rating[5 out of 5], area[city centre], familyFriendly[yes], near[Crowne Plaza Hotel]"	Near the Crowne Plaza Hotel in the city centre is a well rated , family - friendly French pub offering cheap food called The Phoenix .
"name[The Phoenix], eatType[pub], food[French], priceRange[cheap], customer rating[5 out of 5], area[riverside], familyFriendly[no], near[Crowne Plaza Hotel]"	There is a French pub called The Phoenix near Crowne Plaza Hotel in the riverside area . It is priced cheap and has a customer rating of 5 out of 5 . It is not kid friendly .
"name[The Phoenix], eatType[pub], food[French], priceRange[cheap], customer rating[5 out of 5], area[riverside], familyFriendly[yes], near[Crowne Plaza Hotel]"	The Phoenix is a family friendly pub that also offers Oriental Oriental food . It is located near the Crowne Plaza Hotel . It provides Oriental cheese and fondue with a 5 out of 5 rating .
"name[The Phoenix], eatType[pub], food[French], priceRange[high], area[riverside], familyFriendly[yes], near[Raja Indian Cuisine]"	Expensive convenient and tastes at The Phoenix pub near Raja Indian Cuisine .
"name[The Phoenix], eatType[pub], food[French], priceRange[high], customer rating[3 out of 5], area[city centre], familyFriendly[no], near[Crowne Plaza Hotel]"	Don 't bring the children , The Phoenix is a French pub that services a high price range . Located in the city centre near the Crowne Plaza Hotel .
"name[The Phoenix], eatType[pub], food[French], priceRange[high], customer rating[3 out of 5], area[city centre], familyFriendly[yes], near[Crowne Plaza Hotel]"	The Phoenix is a pub serving high priced French food . It is located in the city centre near the Crowne Plaza Hotel and is child friendly .
"name[The Phoenix], eatType[pub], food[French], priceRange[high], customer rating[3 out of 5], area[riverside], familyFriendly[no], near[Crowne Plaza Hotel]"	The Phoenix is a French pub in the riverside area near Crowne Plaza Hotel . It has a customer rating of 3 out of 5 and is not kid friendly .
"name[The Phoenix], eatType[pub], food[French], priceRange[high], customer rating[3 out of 5], area[riverside], familyFriendly[yes], near[Crowne Plaza Hotel]"	There is a high priced , three star pub named The Phoenix . It is located near the Crowne Plaza Hotel and is rated 3 out of 5 for families .
"name[The Phoenix], eatType[pub], food[French], priceRange[less than £20], customer rating[average], area[city centre], familyFriendly[no], near[Crowne Plaza Hotel]"	The Phoenix is a pub offering French cuisine . It has an average customer rating and is not family - friendly . It is located in the city centre near the Crowne Plaza Hotel .
"name[The Phoenix], eatType[pub], food[French], priceRange[less than £20], customer rating[average], area[city centre], familyFriendly[yes], near[Crowne Plaza Hotel]"	The Phoenix is a family - friendly French pub in the city centre near Crowne Plaza Hotel with an average customer rating and a price range of less than 20 euros .
"name[The Phoenix], eatType[pub], food[French], priceRange[less than £20], customer rating[average], area[riverside], familyFriendly[no], near[Crowne Plaza Hotel]"	The Phoenix is a pub that serves French food in the riverside area near the Crowne Plaza Hotel . It is not family - friendly and has a price range of less than £ 20 .
"name[The Phoenix], eatType[pub], food[French], priceRange[less than £20], customer rating[average], area[riverside], familyFriendly[yes], near[Crowne Plaza Hotel]"	In the riverside area near the Crowne Plaza Hotel you will find The Phoenix . It is a French pub with decent prices and is kids friendly .
"name[The Phoenix], eatType[pub], food[French], priceRange[less than £20], customer rating[low], area[city centre], familyFriendly[no], near[Crowne Plaza Hotel]"	In the city centre near the Crowne Plaza Hotel is a French pub called The Phoenix . It has a low customer rating and is not family - friendly . The price range is less than 20 pounds .
"name[The Phoenix], eatType[pub], food[French], priceRange[less than £20], customer rating[low], area[city centre], familyFriendly[yes], near[Crowne Plaza Hotel]"	In the city centre near the Crowne Plaza Hotel is a family - friendly pub called The Phoenix . It offers French food for less than £ 20 and has a low customer rating .
"name[The Phoenix], eatType[pub], food[French], priceRange[less than £20], customer rating[low], area[riverside], familyFriendly[no], near[Crowne Plaza Hotel]"	The Phoenix is a pub that is not family - friendly . It has a low customer rating and costs less than 20 pounds . It is located near the Crowne Plaza Hotel .
"name[The Phoenix], eatType[pub], food[French], priceRange[less than £20], customer rating[low], area[riverside], familyFriendly[yes], near[Crowne Plaza Hotel]"	The Phoenix is a family friendly pub that serves French food in the riverside area near the Crowne Plaza Hotel . It has a low customer rating and ranges less than £ 20 .
"name[The Phoenix], eatType[pub], food[French], priceRange[moderate], customer rating[1 out of 5], area[city centre], familyFriendly[no], near[Crowne Plaza Hotel]"	There is a French pub named The Phoenix near the Crowne Plaza Hotel in the city centre . Customers have rated it 1 out of 5 and it is not kid friendly . It is moderately priced .
"name[The Phoenix], eatType[pub], food[French], priceRange[moderate], customer rating[1 out of 5], area[city centre], familyFriendly[yes], near[Crowne Plaza Hotel]"	Theres want the moderate price range , The Phoenix is a kids friendly pub that sells French food . It is located in the city centre near the Crowne Plaza Hotel and has a customer rating of 1 out of 5 .
"name[The Phoenix], eatType[pub], food[French], priceRange[moderate], customer rating[1 out of 5], area[riverside], familyFriendly[no], near[Crowne Plaza Hotel]"	The Phoenix is a pub offering French food . It has moderate customer ratings and is not child friendly . It is in the riverside area near the Crowne Plaza Hotel and has a moderate price range .
"name[The Phoenix], eatType[pub], food[French], priceRange[moderate], customer rating[1 out of 5], area[riverside], familyFriendly[yes], near[Crowne Plaza Hotel]"	The Phoenix serves medium priced eating in a family friendly environment . It is located near the Crowne Plaza Hotel .
"name[The Phoenix], eatType[pub], food[French], priceRange[more than £30], customer rating[5 out of 5], area[city centre], familyFriendly[no], near[Crowne Plaza Hotel]"	The Phoenix is a children friendly restaurants in the city centre near the Crowne Plaza Hotel . They serve French food for more than £ 30 . Customers rate it 5 out of 5 .
"name[The Phoenix], eatType[pub], food[French], priceRange[more than £30], customer rating[5 out of 5], area[city centre], familyFriendly[yes], near[Crowne Plaza Hotel]"	The Phoenix is a pub that serves French food with prices more than £ 30 . It is located in the city centre near the Crowne Plaza Hotel and is child friendly .
"name[The Phoenix], eatType[pub], food[French], priceRange[more than £30], customer rating[5 out of 5], area[riverside], familyFriendly[no], near[Crowne Plaza Hotel]"	With a customer rating of 5 out of 5 , The Phoenix is a children - friendly French pub charging more than £ 30 . Located in the riverside area near the Crowne Plaza Hotel .
"name[The Phoenix], eatType[pub], food[French], priceRange[more than £30], customer rating[5 out of 5], area[riverside], familyFriendly[yes], near[Crowne Plaza Hotel]"	Expensive pub The Phoenix has a five star rating and is family friendly . It is located near the Crowne Plaza Hotel .
"name[The Phoenix], eatType[pub], food[French], priceRange[more than £30], customer rating[low], area[city centre], familyFriendly[no], near[Crowne Plaza Hotel]"	The Phoenix is a luxury , adult only French pub . Located in the city centre near the Crowne Plaza Hotel .
"name[The Phoenix], eatType[pub], food[French], priceRange[more than £30], customer rating[low], area[city centre], familyFriendly[yes], near[Crowne Plaza Hotel]"	If you are in the steps of the city centre and near the Crowne Plaza Hotel , there is a family - friendly pub yet French food restaurant call The Phoenix . It has a low customer rating and the price range is more than £ 30 .
"name[The Phoenix], eatType[pub], food[French], priceRange[more than £30], customer rating[low], area[riverside], familyFriendly[no], near[Crowne Plaza Hotel]"	The Phoenix is a facility located near the Crowne Plaza Hotel . It is not a family - friendly facility . They offer French food and have a low customer rating .
"name[The Phoenix], eatType[pub], food[French], priceRange[more than £30], customer rating[low], area[riverside], familyFriendly[yes], near[Crowne Plaza Hotel]"	The Phoenix is a one star family friendly pub close to the Crowne Plaza Hotel offering fine French cuisine .
"name[The Phoenix], eatType[restaurant], food[Fast food], priceRange[cheap], area[riverside], familyFriendly[yes], near[Raja Indian Cuisine]"	The Phoenix is a cheap , family friendly restaurant in the riverside area near Raja Indian Cuisine . Meal Meal also fast food .
"name[The Phoenix], eatType[restaurant], food[Fast food], priceRange[high], area[city centre], familyFriendly[no], near[Raja Indian Cuisine]"	The Phoenix is a restaurant providing fast food in the high price range . It is not children friendly and can be found in the city centre near Raja Indian Cuisine .
"name[The Phoenix], eatType[restaurant], food[Fast food], priceRange[high], area[city centre], familyFriendly[yes], near[Raja Indian Cuisine]"	The Phoenix is a cheaply priced fast food restaurant in the city centre near Raja Indian Cuisine . It is children friendly .
"name[The Phoenix], eatType[restaurant], food[Fast food], priceRange[high], area[riverside], familyFriendly[no], near[Raja Indian Cuisine]"	The Phoenix is a high priced fast food outlet in the riverside area near Raja Indian Cuisine . It is not kid friendly .
"name[The Phoenix], eatType[restaurant], food[Fast food], priceRange[high], area[riverside], familyFriendly[yes], near[Raja Indian Cuisine]"	The Phoenix restaurant serves fast food in a child friendly atmosphere . It has a high price range and you can expect to pay high . It is located in the riverside area near Raja Indian Cuisine .
"name[The Phoenix], eatType[restaurant], food[Fast food], priceRange[less than £20], area[city centre], familyFriendly[no], near[Raja Indian Cuisine]"	The Phoenix is an adult oriented fast food restaurant located near Raja Indian Cuisine in the city centre .
"name[The Phoenix], eatType[restaurant], food[Fast food], priceRange[less than £20], area[city centre], familyFriendly[yes], near[Raja Indian Cuisine]"	The Phoenix is a family - friendly restaurant that offers fast food for less than £ 20 . It is located near Raja Indian Cuisine in the city centre .
"name[The Phoenix], eatType[restaurant], food[Fast food], priceRange[less than £20], area[riverside], familyFriendly[no], near[Raja Indian Cuisine]"	The Phoenix is a Fast food restaurant located in riverside near Raja Indian Cuisine . It is not family - friendly and has prices less than £ 20 .
"name[The Phoenix], eatType[restaurant], food[Fast food], priceRange[less than £20], area[riverside], familyFriendly[yes], near[Raja Indian Cuisine]"	The Phoenix is a well - priced , well - family - friendly restaurant . It is also located near Raja Indian Cuisine .
"name[The Phoenix], eatType[restaurant], food[Fast food], priceRange[moderate], area[city centre], familyFriendly[no], near[Raja Indian Cuisine]"	The Phoenix is a restaurant located in the city centre near Raja Indian Cuisine that delivers take - away deliveries for upwards of couples . It is moderately priced and child - friendly .
"name[The Phoenix], eatType[restaurant], food[Fast food], priceRange[moderate], area[city centre], familyFriendly[yes], near[Raja Indian Cuisine]"	Located near Raja Indian Cuisine in the city centre is a moderately priced fast food place called The Phoenix . Kid friendly .
"name[The Phoenix], eatType[restaurant], food[Fast food], priceRange[moderate], area[riverside], familyFriendly[no], near[Raja Indian Cuisine]"	The Phoenix is a moderately priced Fast food restaurant in the riverside area near Raja Indian Cuisine . It is not kid friendly .
"name[The Phoenix], eatType[restaurant], food[Fast food], priceRange[moderate], area[riverside], familyFriendly[yes], near[Raja Indian Cuisine]"	For a kid friendly restaurant go to The Phoenix , a moderately priced Fast food spot in the riverside area near Raja Indian Cuisine .
"name[The Phoenix], eatType[restaurant], food[Fast food], priceRange[more than £30], area[riverside], familyFriendly[yes], near[Raja Indian Cuisine]"	The Phoenix is a great burger restaurant located near Raja Indian Cuisine . It is a restrooms restrooms restaurant conveniently located in the city centre .
"name[The Phoenix], eatType[restaurant], food[French], priceRange[£20-25], area[riverside], familyFriendly[yes], near[Raja Indian Cuisine]"	The Phoenix is a French restaurant in the riverside area near Raja Indian Cuisine . Kids are welcome . The price range is £ 20 - 25 .
"name[The Phoenix], eatType[restaurant], food[French], priceRange[cheap], area[riverside], familyFriendly[yes], near[Raja Indian Cuisine]"	The Phoenix is a cheap , family friendly restaurant that serves French food . It is located in the riverside area near Raja Indian Cuisine .
"name[The Phoenix], eatType[restaurant], food[French], priceRange[high], area[riverside], familyFriendly[yes], near[Raja Indian Cuisine]"	In the riverside area near Raja Indian Cuisine is a children friendly restaurant that serves expensive French food called The Phoenix .
"name[The Phoenix], eatType[restaurant], food[Indian], priceRange[£20-25], customer rating[high], area[city centre], familyFriendly[no], near[Crowne Plaza Hotel]"	The Phoenix is an Indian restaurant situated in the city centre near the Crowne Plaza Hotel . It is not children friendly . Prices ranging from £ 20 - 25 .
"name[The Phoenix], eatType[restaurant], food[Indian], priceRange[£20-25], customer rating[high], area[city centre], familyFriendly[yes], near[Crowne Plaza Hotel]"	The Phoenix is a restaurant that provides Indian food in the £ 20 - 25 price range . It is located in the city centre . It is near Crowne Plaza Hotel . Its customer rating is high .
"name[The Phoenix], eatType[restaurant], food[Indian], priceRange[£20-25], customer rating[high], area[riverside], familyFriendly[no], near[Crowne Plaza Hotel]"	The Phoenix is an Indian restaurant with a high price range . It is located in the block of Crowne Plaza Hotel .
"name[The Phoenix], eatType[restaurant], food[Indian], priceRange[£20-25], customer rating[high], area[riverside], familyFriendly[yes], near[Crowne Plaza Hotel]"	The Phoenix is an Indian restaurant in the riverside area near the Crowne Plaza Hotel . It has a high customer rating and a price range of 20 - 25 pounds .
"name[The Phoenix], eatType[restaurant], food[Indian], priceRange[cheap], customer rating[5 out of 5], area[city centre], familyFriendly[no], near[Crowne Plaza Hotel]"	The Phoenix is a restaurant that provides Indian food in the top price range . It has a top customer rating of 5 out of 5 and is not family friendly . It is located in the city centre near the Crowne Plaza Hotel .
"name[The Phoenix], eatType[restaurant], food[Indian], priceRange[cheap], customer rating[5 out of 5], area[city centre], familyFriendly[yes], near[Crowne Plaza Hotel]"	The Phoenix is a family friendly restaurant that serves cheap Indian food . Located in the city centre near Crowne Plaza Hotel , it has a customer rating of 5 out of 5 .
"name[The Phoenix], eatType[restaurant], food[Indian], priceRange[cheap], customer rating[5 out of 5], area[riverside], familyFriendly[no], near[Crowne Plaza Hotel]"	The Phoenix is a cheap Indian restaurant with 5 out of 5 customer ratings . It is not family friendly and is in the riverside area near Crowne Plaza Hotel .
"name[The Phoenix], eatType[restaurant], food[Indian], priceRange[cheap], customer rating[5 out of 5], area[riverside], familyFriendly[no], near[Express by Holiday Inn]"	In the riverside area near Express by Holiday Inn is a cheap Indian restaurant with a customer rating of 5 out of 5 called The Phoenix . It is not family friendly .
"name[The Phoenix], eatType[restaurant], food[Indian], priceRange[cheap], customer rating[5 out of 5], area[riverside], familyFriendly[yes], near[Express by Holiday Inn]"	The Phoenix is a family friendly restaurant that serves cheap Indian food . Located in the riverside area near Express by Holiday Inn , it has a 5 out of 5 customer rating .
"name[The Phoenix], eatType[restaurant], food[Indian], priceRange[cheap], customer rating[average], area[city centre], familyFriendly[no], near[Express by Holiday Inn]"	There is a cheap Indian restaurant in the city centre near Express by Holiday Inn named The Phoenix . It has an average customer rating and is not family friendly .
"name[The Plough], eatType[pub], food[Chinese], priceRange[£20-25], area[riverside], familyFriendly[yes], near[Raja Indian Cuisine]"	The Plough is a low - priced , family friendly pub located on the outskirts of the Raja Indian Cuisine .
"name[The Plough], eatType[pub], food[Chinese], priceRange[cheap], area[riverside], familyFriendly[yes], near[Raja Indian Cuisine]"	The Plough is a cheap , family friendly Chinese place in riverside near Raja Indian Cuisine .
"name[The Plough], eatType[pub], food[Chinese], priceRange[high], area[city centre], familyFriendly[no], near[Raja Indian Cuisine]"	The Plough is a Chinese pub near Raja Indian Cuisine in the city centre . It is not child friendly and prices are high .
"name[The Plough], eatType[pub], food[Chinese], priceRange[high], area[city centre], familyFriendly[yes], near[Raja Indian Cuisine]"	In the city centre near Raja Indian Cuisine is a pub that sells Chinese food called The Plough . They have a high price range and are welcome children services .
"name[The Plough], eatType[pub], food[Chinese], priceRange[high], area[riverside], familyFriendly[no], near[Raja Indian Cuisine]"	The Plough is a pub in the riverside area near Raja Indian Cuisine . It serves Chinese food at a high price range and is not child friendly .
"name[The Plough], eatType[pub], food[Chinese], priceRange[high], area[riverside], familyFriendly[yes], near[Raja Indian Cuisine]"	There is a pub named The Plough that is children friendly and also located close to Raja Indian Cuisine . It also provides Chinese food at a high price range .
"name[The Plough], eatType[pub], food[Chinese], priceRange[less than £20], area[city centre], familyFriendly[no], near[Raja Indian Cuisine]"	The Plough is a low - priced pub serving Chinese dishes . It is not family friendly and is located in the city centre near Raja Indian Cuisine .
"name[The Plough], eatType[restaurant], food[Chinese], priceRange[£20-25], area[riverside], familyFriendly[yes], near[Raja Indian Cuisine]"	There is a Chinese venue in the riverside area near Raja Indian Cuisine . It is kids friendly and has a price range of £ 20 - 25 . It is called The Plough and provide food .
"name[The Plough], eatType[restaurant], food[Chinese], priceRange[cheap], area[riverside], familyFriendly[yes], near[Raja Indian Cuisine]"	The Plough is a restaurant that provides Chinese food in the cheap price range . It is located in the riverside . It is near Raja Indian Cuisine .
"name[The Plough], eatType[restaurant], food[Chinese], priceRange[high], area[city centre], familyFriendly[no], near[Raja Indian Cuisine]"	Located near Raja Indian Cuisine in the city centre , The Plough is a Chinese restaurant where you can enjoyed at high price per head . Though not allow children .
"name[The Plough], eatType[restaurant], food[Chinese], priceRange[high], area[city centre], familyFriendly[yes], near[Raja Indian Cuisine]"	The Plough is a child friendly Chinese restaurant with a high price range in the city centre near Raja Indian Cuisine .
"name[The Plough], eatType[restaurant], food[Chinese], priceRange[high], area[riverside], familyFriendly[no], near[Raja Indian Cuisine]"	There is a high priced Chinese restaurant in riverside called The Plough . It is near Raja Indian Cuisine and is not considered child friendly .
"name[The Plough], eatType[restaurant], food[Chinese], priceRange[high], area[riverside], familyFriendly[yes], near[Raja Indian Cuisine]"	The Plough is a restaurant that provides Chinese food in the high price range . It is located in the riverside . It is near Raja Indian Cuisine .
"name[The Plough], eatType[restaurant], food[Chinese], priceRange[less than £20], area[city centre], familyFriendly[no], near[Raja Indian Cuisine]"	The Plough is a restaurant that offers Chinese food for less than £ 20 . It is not family friendly and is located in the city centre near Raja Indian Cuisine .
"name[The Punter], eatType[pub], food[Chinese], priceRange[less than £20], area[city centre], familyFriendly[yes], near[Raja Indian Cuisine]"	The Punter is a family friendly pub style restaurant that offers inexpensive Chinese food . It is placed in the city centre near Raja Indian Cuisine .
"name[The Punter], eatType[pub], food[Chinese], priceRange[less than £20], area[riverside], familyFriendly[no], near[Raja Indian Cuisine]"	The Punter is a low priced pub that is not family friendly . It is located near Raja Indian Cuisine .
"name[The Punter], eatType[pub], food[Chinese], priceRange[less than £20], area[riverside], familyFriendly[yes], near[Raja Indian Cuisine]"	Located in the riverside area near Raja Indian Cuisine , The Punter is a family friendly pub that offers Chinese food within a price range of less than £ 20 .
"name[The Punter], eatType[pub], food[Chinese], priceRange[moderate], area[city centre], familyFriendly[no], near[Raja Indian Cuisine]"	Moderately priced , The Punter serves Chinese food in the city centre near Raja Indian Cuisine . It is not kid friendly .
"name[The Punter], eatType[pub], food[Chinese], priceRange[moderate], area[city centre], familyFriendly[yes], near[Raja Indian Cuisine]"	The Punter is a Chinese pub that averages prices . It is located in the city centre near Raja Indian Cuisine and is family friendly .
"name[The Punter], eatType[pub], food[Chinese], priceRange[moderate], area[riverside], familyFriendly[no], near[Raja Indian Cuisine]"	The Punter is a Chinese pub with good prices , you can bring your kids . It is located in the riverside area near Raja Indian Cuisine .
"name[The Punter], eatType[pub], food[Chinese], priceRange[moderate], area[riverside], familyFriendly[yes], near[Raja Indian Cuisine]"	In the riverside area near Raja Indian Cuisine is a moderately priced , Kid friendly pub called The Punter serving Chinese food .
"name[The Punter], eatType[pub], food[Chinese], priceRange[more than £30], area[riverside], familyFriendly[yes], near[Raja Indian Cuisine]"	There is a Chinese pub called The Punter in Riverside near Raja Indian Cuisine . It is child friendly and has a price range of small 30 per person .
"name[The Punter], eatType[pub], food[English], priceRange[£20-25], area[riverside], familyFriendly[yes], near[Raja Indian Cuisine]"	The Punter is a kids friendly pub in the riverside area near Raja Indian Cuisine . They serve English food for £ 20 - 25 .
"name[The Punter], eatType[pub], food[English], priceRange[cheap], area[riverside], familyFriendly[yes], near[Raja Indian Cuisine]"	The Punter is a cheap , family friendly pub that offers English food . It is located in the riverside area near Raja Indian Cuisine .
"name[The Punter], eatType[pub], food[English], priceRange[high], area[city centre], familyFriendly[no], near[Raja Indian Cuisine]"	The Punter serves expensive English food in the city centre near Raja Indian Cuisine . It is not child friendly .
"name[The Punter], eatType[pub], food[English], priceRange[high], area[city centre], familyFriendly[yes], near[Raja Indian Cuisine]"	English food is served at The Punter in the city centre near Raja Indian Cuisine . It is a family - friendly pub with a high price range .
"name[The Punter], eatType[pub], food[English], priceRange[high], area[riverside], familyFriendly[no], near[Raja Indian Cuisine]"	The Punter is a child friendly pub in the riverside area near Raja Indian Cuisine . It serves moderately priced English food .
"name[The Punter], eatType[pub], food[English], priceRange[high], area[riverside], familyFriendly[yes], near[Raja Indian Cuisine]"	A child friendly pub called The Punter serves English food and has a high price range . It is located near Raja Indian Cuisine by the river .
"name[The Punter], eatType[pub], food[Italian], priceRange[high], customer rating[average], area[city centre], familyFriendly[no], near[Rainbow Vegetarian Café]"	There is an Italian pub named The Punter near Rainbow Vegetarian Café in the city centre . It has an average customer rating though though it is not children friendly .
"name[The Punter], eatType[restaurant], food[Chinese], priceRange[less than £20], area[city centre], familyFriendly[yes], near[Raja Indian Cuisine]"	The Punter is a family friendly restaurant in the town centre near Raja Indian Cuisine . It is inexpensive and serves Chinese food .
"name[The Punter], eatType[restaurant], food[Chinese], priceRange[less than £20], area[riverside], familyFriendly[no], near[Raja Indian Cuisine]"	The Punter is a Chinese restaurant located in the riverside area near Raja Indian Cuisine . It is inexpensive and not family friendly . You can spend less than 20 pounds .
"name[The Punter], eatType[restaurant], food[Chinese], priceRange[less than £20], area[riverside], familyFriendly[yes], near[Raja Indian Cuisine]"	In the riverside area near Raja Indian Cuisine is a child friendly Chinese restaurant named The Punter . The price range is less than £ 20 .
"name[The Punter], eatType[restaurant], food[Chinese], priceRange[moderate], area[city centre], familyFriendly[no], near[Raja Indian Cuisine]"	The Punter is a Chinese restaurant in the city centre near Raja Indian Cuisine . It is not kid friendly and prices are moderate .
"name[The Punter], eatType[restaurant], food[Chinese], priceRange[moderate], area[city centre], familyFriendly[yes], near[Raja Indian Cuisine]"	The Punter restaurant serves moderately priced Chinese food in the city centre near Raja Indian Cuisine . It is kids friendly .
"name[The Punter], eatType[restaurant], food[Chinese], priceRange[moderate], area[riverside], familyFriendly[no], near[Raja Indian Cuisine]"	The Punter is a moderately priced Chinese restaurant located in riverside near Raja Indian Cuisine . It is not kids friendly .
"name[The Punter], eatType[restaurant], food[Chinese], priceRange[moderate], area[riverside], familyFriendly[yes], near[Raja Indian Cuisine]"	The Punter is a restaurant providing Chinese food in the moderate price range . It is located in the riverside . It is near Raja Indian Cuisine .
"name[The Punter], eatType[restaurant], food[Chinese], priceRange[more than £30], area[riverside], familyFriendly[yes], near[Raja Indian Cuisine]"	The Punter is a family friendly restaurant that serves Chinese food for more than £ 30 . It is located in the riverside area near Raja Indian Cuisine .
"name[The Punter], eatType[restaurant], food[English], priceRange[£20-25], area[riverside], familyFriendly[yes], near[Raja Indian Cuisine]"	The Punter is a kids friendly restaurant offering English food in the £ 20 - 25 price range . It is located in the riverside area near Raja Indian Cuisine .
"name[The Punter], eatType[restaurant], food[English], priceRange[cheap], area[riverside], familyFriendly[yes], near[Raja Indian Cuisine]"	In the riverside area near Raja Indian Cuisine is a cheap family friendly English place named The Punter .
"name[The Punter], eatType[restaurant], food[English], priceRange[high], area[city centre], familyFriendly[no], near[Raja Indian Cuisine]"	The Punter is an English restaurant in the city centre near Raja Indian Cuisine . It has a high price range and is not children friendly .
"name[The Punter], eatType[restaurant], food[English], priceRange[high], area[city centre], familyFriendly[yes], near[Raja Indian Cuisine]"	In the city centre near Raja Indian Cuisine is a high priced child friendly restaurant that serves English food called The Punter .
"name[The Punter], eatType[restaurant], food[English], priceRange[high], area[riverside], familyFriendly[no], near[Raja Indian Cuisine]"	The Punter is a restaurant providing English food in the high price range . It is located in the riverside area near Raja Indian Cuisine and is not children friendly .
"name[The Punter], eatType[restaurant], food[English], priceRange[high], area[riverside], familyFriendly[yes], near[Raja Indian Cuisine]"	A restaurant called The Punter situated near Raja Indian Cuisine is situated in the riverside area and is children friendly .
"name[The Punter], eatType[restaurant], food[Indian], priceRange[cheap], customer rating[average], area[city centre], familyFriendly[yes], near[Express by Holiday Inn]"	The Punter is a family friendly restaurant that serves cheap Indian food . Located in the city centre near Express by Holiday Inn , it has an average customer rating .
"name[The Punter], eatType[restaurant], food[Indian], priceRange[cheap], customer rating[average], area[riverside], familyFriendly[no], near[Express by Holiday Inn]"	The Punter is a restaurant that sells Indian food in the cheap price range . It is located in the riverside area near Express by Holiday Inn . without the kids home . It has an average customer rating and is not kids friendly .
"name[The Punter], eatType[restaurant], food[Indian], priceRange[cheap], customer rating[average], area[riverside], familyFriendly[yes], near[Express by Holiday Inn]"	There is a low rated , family friendly restaurant called The Punter that serves moderately priced Indian food near the river and Express by Holiday Inn .
"name[The Punter], eatType[restaurant], food[Indian], priceRange[high], customer rating[1 out of 5], area[city centre], familyFriendly[no], near[Express by Holiday Inn]"	There is a highly priced restaurant called The Punter in the city centre near Express by Holiday Inn . They serve Indian food and have a customer rating of one out of 5 . They are not children friendly .
"name[The Punter], eatType[restaurant], food[Indian], priceRange[high], customer rating[1 out of 5], area[city centre], familyFriendly[yes], near[Express by Holiday Inn]"	Theres a high price range , The Punter is a children friendly restaurant serving Indian food . It will be meal in the city centre near Express by Holiday Inn and has a customer rating of 1 out of 5 .
"name[The Punter], eatType[restaurant], food[Indian], priceRange[high], customer rating[1 out of 5], area[riverside], familyFriendly[no], near[Express by Holiday Inn]"	The Punter is an expensive adults only restaurant that sells Indian food . It is located in the riverside area near the Express by Holiday Inn .
"name[The Punter], eatType[restaurant], food[Indian], priceRange[high], customer rating[1 out of 5], area[riverside], familyFriendly[yes], near[Express by Holiday Inn]"	The Punter restaurant offers Indian food at a high price . It can be found in the riverside area near Express by Holiday Inn . It is children friendly and has a customer rating of 1 out of 5 .
"name[The Punter], eatType[restaurant], food[Indian], priceRange[high], customer rating[average], area[city centre], familyFriendly[no], near[Express by Holiday Inn]"	The Punter is a restaurant that provides Indian food in the high price range . It is located in the city centre . It is near Express by Holiday Inn . Its customer rating is average .
"name[The Punter], eatType[restaurant], food[Indian], priceRange[high], customer rating[average], area[city centre], familyFriendly[yes], near[Express by Holiday Inn]"	The Punter is an Indian restaurant located in the city centre near Express by Holiday Inn . It has a high price range and is child friendly .
"name[The Punter], eatType[restaurant], food[Indian], priceRange[high], customer rating[average], area[riverside], familyFriendly[no], near[Express by Holiday Inn]"	In the riverside area , near the Express by Holiday Inn , there is an Indian restaurant called The Punter . It is high priced and not child friendly .
"name[The Punter], eatType[restaurant], food[Indian], priceRange[high], customer rating[average], area[riverside], familyFriendly[yes], near[Express by Holiday Inn]"	The Punter is a restaurant providing Indian food in the high price range . It is located in the riverside . It is near Express by Holiday Inn . Its customer rating is average .
"name[The Punter], eatType[restaurant], food[Indian], priceRange[less than £20], customer rating[low], area[city centre], familyFriendly[no], near[Express by Holiday Inn]"	The Punter is a restaurant where you can order Indian food for less than £ 20 . It is not allow children and holds a low customer rating . It is located in the city centre near the Express by Holiday Inn . It is not children friendly .
"name[The Punter], eatType[restaurant], food[Indian], priceRange[less than £20], customer rating[low], area[city centre], familyFriendly[yes], near[Express by Holiday Inn]"	There is a cheap restaurant The Punter located in the city centre near Express by Holiday Inn that provides Indian foods . It has a low customer rating and is family friendly .
"name[The Punter], eatType[restaurant], food[Indian], priceRange[less than £20], customer rating[low], area[riverside], familyFriendly[no], near[Express by Holiday Inn]"	Located in the riverside area near Express by Holiday Inn , The Punter is a restaurant that serves Indian food costing less than 20 pounds . It has a low customer rating and is not family friendly .
"name[The Punter], eatType[restaurant], food[Indian], priceRange[less than £20], customer rating[low], area[riverside], familyFriendly[yes], near[Express by Holiday Inn]"	For cheaply priced Indian food in the riverside area , look no further than The Punter . It is a family friendly restaurant with a low customer rating and is located near Express by Holiday Inn .
"name[The Punter], eatType[restaurant], food[Indian], priceRange[moderate], customer rating[1 out of 5], area[city centre], familyFriendly[no], near[Express by Holiday Inn]"	The Punter is a moderately priced Indian restaurant in the city centre near Express by Holiday Inn . It has a customer rating of 1 out of 5 and is not kid friendly .
"name[The Punter], eatType[restaurant], food[Indian], priceRange[moderate], customer rating[1 out of 5], area[city centre], familyFriendly[yes], near[Express by Holiday Inn]"	The Punter is a moderately priced , kid friendly Indian restaurant with 1 out of 5 satisfaction . It is located in the city center near Express by Holiday Inn .
"name[The Punter], eatType[restaurant], food[Indian], priceRange[moderate], customer rating[1 out of 5], area[riverside], familyFriendly[no], near[Express by Holiday Inn]"	The Punter is a moderate priced restaurant with a customer rating of 1 out of 5 . It serves Indian food and is not kid friendly . It is located in the riverside area near Express by Holiday Inn .
"name[The Punter], eatType[restaurant], food[Indian], priceRange[moderate], customer rating[1 out of 5], area[riverside], familyFriendly[yes], near[Express by Holiday Inn]"	In the riverside area near Express by Holiday Inn is a child friendly restaurant that serves Indian food called The Punter . It has a moderate price range and a customer rating of 1 out of 5 .
"name[The Punter], eatType[restaurant], food[Indian], priceRange[moderate], customer rating[3 out of 5], area[city centre], familyFriendly[no], near[Express by Holiday Inn]"	The Punter is an Indian restaurant with a moderate price range . It has a customer rating of 3 out of 5 and is not kid friendly . It is located in the city centre near Express by Holiday Inn .
"name[The Punter], eatType[restaurant], food[Indian], priceRange[moderate], customer rating[3 out of 5], area[city centre], familyFriendly[yes], near[Express by Holiday Inn]"	The Punter is a three out of five stars Indian restaurant . It is moderately priced and also kid friendly . It is located in the city centre near Express by Holiday Inn .
"name[The Punter], eatType[restaurant], food[Indian], priceRange[moderate], customer rating[3 out of 5], area[riverside], familyFriendly[no], near[Express by Holiday Inn]"	If you 're looking for moderately priced Indian food , adults only rated 3 out of 5 , try The Punter . It is a new restaurant in the riverside area near Express by Holiday Inn , leave the best better .
"name[The Punter], eatType[restaurant], food[Indian], priceRange[moderate], customer rating[3 out of 5], area[riverside], familyFriendly[yes], near[Express by Holiday Inn]"	With moderate prices and a 3 out of 5 customer rating , The Punter serves Indian food in a Kids friendly experience in the riverside area near Express by Holiday Inn .
"name[The Punter], eatType[restaurant], food[Indian], priceRange[more than £30], customer rating[high], area[city centre], familyFriendly[no], near[Express by Holiday Inn]"	The Punter is a restaurant selling Indian food costing more than £ 30 . It has a high customer rating and can be found in the city centre near Express by Holiday Inn . It is not children friendly .
"name[The Punter], eatType[restaurant], food[Indian], priceRange[more than £30], customer rating[high], area[city centre], familyFriendly[yes], near[Express by Holiday Inn]"	Located in the city centre , The Punter is a family - friendly Indian restaurant with a high customer rating costing starting at more than £ 30 . It is close to Express by Holiday Inn .
"name[The Punter], eatType[restaurant], food[Indian], priceRange[more than £30], customer rating[high], area[riverside], familyFriendly[no], near[Express by Holiday Inn]"	The Punter is a restaurant that serves Indian food for more than £ 30 . It has a high customer rating and is not children friendly . It is located in the riverside area near Express by Holiday Inn .
"name[The Punter], eatType[restaurant], food[Indian], priceRange[more than £30], customer rating[high], area[riverside], familyFriendly[yes], near[Express by Holiday Inn]"	The Punter is a highly rated restaurant offering higher priced Indian food . Families are welcome . They are located near Express by Holiday Inn .
"name[The Punter], eatType[restaurant], food[Italian], priceRange[£20-25], customer rating[high], area[city centre], familyFriendly[no], near[Express by Holiday Inn]"	The Punter is an Italian restaurant located in the city centre near Express by Holiday Inn . It has a high customer rating with a price range of £ 20 - 25 and an adult atmosphere .
"name[The Punter], eatType[restaurant], food[Italian], priceRange[£20-25], customer rating[high], area[city centre], familyFriendly[yes], near[Express by Holiday Inn]"	The Punter is a high rated restaurant that serves Italian food . It is priced at £ 20 - 25 and is kids friendly . It is located in the city center near Express by Holiday Inn .
"name[The Punter], eatType[restaurant], food[Italian], priceRange[£20-25], customer rating[high], area[riverside], familyFriendly[no], near[Express by Holiday Inn]"	The Punter is a moderately priced restaurant selling Italian food in the riverside area near Express by Holiday Inn . It is not family - friendly and has a high customer rating .
"name[The Punter], eatType[restaurant], food[Italian], priceRange[£20-25], customer rating[high], area[riverside], familyFriendly[yes], near[Express by Holiday Inn]"	The Punter is a family friendly Italian restaurant alongside the riverside near Express by Holiday Inn with a high customer rating and a price range of £ 20 - 25 .
"name[The Punter], eatType[restaurant], food[Italian], priceRange[cheap], customer rating[5 out of 5], area[city centre], familyFriendly[no], near[Express by Holiday Inn]"	The Punter is a cheap Italian restaurant that can be found in the center of the city near Express by Holiday Inn . It boasts a customer rating of 5 out of 5 and is not family - friendly place .
"name[The Punter], eatType[restaurant], food[Italian], priceRange[cheap], customer rating[5 out of 5], area[city centre], familyFriendly[no], near[Rainbow Vegetarian Café]"	The Punter is a cheap Italian restaurant located in the city centre , near the Rainbow Vegetarian Café . It has a great customer rating of 5 out of 5 and is not a family - friendly atmosphere .
"name[The Punter], eatType[restaurant], food[Italian], priceRange[cheap], customer rating[5 out of 5], area[city centre], familyFriendly[yes], near[Rainbow Vegetarian Café]"	The Punter is a cheap , family - friendly restaurant that offers Italian food . It is located in the city centre near Rainbow Vegetarian Café and has a customer rating of 5 out of 5 .
"name[The Punter], eatType[restaurant], food[Italian], priceRange[cheap], customer rating[5 out of 5], area[riverside], familyFriendly[no], near[Rainbow Vegetarian Café]"	There is a cheap restaurant The Punter located north of the city centre near the Rainbow Vegetarian Café .
"name[The Punter], eatType[restaurant], food[Italian], priceRange[cheap], customer rating[5 out of 5], area[riverside], familyFriendly[yes], near[Rainbow Vegetarian Café]"	The Punter is a cheap restaurant serving hamburgers in a family - friendly setting . It is located near the river side and Rainbow Vegetarian Café .
"name[The Punter], eatType[restaurant], food[Italian], priceRange[cheap], customer rating[average], area[city centre], familyFriendly[no], near[Rainbow Vegetarian Café]"	The Punter is a cheap Italian restaurant located in the city centre near Rainbow Vegetarian Café . They gave an average customer rating and is not family - friendly . It is a good option .
"name[The Punter], eatType[restaurant], food[Italian], priceRange[cheap], customer rating[average], area[city centre], familyFriendly[yes], near[Rainbow Vegetarian Café]"	In the city centre near Rainbow Vegetarian Café is a family - friendly Italian restaurant named The Punter . It has an average customer rating and is cheap .
"name[The Punter], eatType[restaurant], food[Italian], priceRange[cheap], customer rating[average], area[riverside], familyFriendly[no], near[Rainbow Vegetarian Café]"	The Punter is a restaurant providing Italian food in the cheap price range . It is located in the riverside . It is near Rainbow Vegetarian Café . Its customer rating is average .
"name[The Punter], eatType[restaurant], food[Italian], priceRange[cheap], customer rating[average], area[riverside], familyFriendly[yes], near[Rainbow Vegetarian Café]"	The Punter is a local restaurant located near Rainbow Vegetarian Café .
"name[The Punter], eatType[restaurant], food[Italian], priceRange[high], customer rating[1 out of 5], area[city centre], familyFriendly[no], near[Rainbow Vegetarian Café]"	The Punter is an Italian restaurant in the city centre near Rainbow Vegetarian Café . It has a high price range and a customer rating of 1 out of 5 . It is not child friendly .
"name[The Punter], eatType[restaurant], food[Italian], priceRange[high], customer rating[1 out of 5], area[city centre], familyFriendly[yes], near[Rainbow Vegetarian Café]"	Near Rainbow Vegetarian Café is a family - friendly restaurant called The Punter . It has high prices and offers Italian food . It is rated 1 out of 5 .
"name[The Punter], eatType[restaurant], food[Italian], priceRange[high], customer rating[1 out of 5], area[riverside], familyFriendly[no], near[Rainbow Vegetarian Café]"	The Punter is a 1 stars restaurant located near the Rainbow Vegetarian Café . They serve Italian food in a children friendly environment .
"name[The Punter], eatType[restaurant], food[Italian], priceRange[high], customer rating[1 out of 5], area[riverside], familyFriendly[yes], near[Rainbow Vegetarian Café]"	In the riverside area near the Rainbow Vegetarian Café you can find The Punter . It is a family friendly Italian restaurant with a 1 out of 5 customer rating .
"name[The Vaults], eatType[pub], food[French], priceRange[high], area[riverside], familyFriendly[yes], near[Raja Indian Cuisine]"	The Vaults is a kids friendly French pub in the riverside area near Raja Indian Cuisine with a high price range .
"name[The Vaults], eatType[pub], food[French], priceRange[less than £20], area[city centre], familyFriendly[no], near[Raja Indian Cuisine]"	The Vaults pub sells French food in the city centre near Raja Indian Cuisine . It is not family - friendly and has a consumer consumer rating of less than £ 20 .
"name[The Vaults], eatType[pub], food[French], priceRange[less than £20], area[city centre], familyFriendly[yes], near[Raja Indian Cuisine]"	The Vaults is a family - friendly pub in the center of the city near Raja Indian Cuisine that serves French food for less than £ 20 .
"name[The Vaults], eatType[pub], food[French], priceRange[less than £20], area[riverside], familyFriendly[no], near[Raja Indian Cuisine]"	Enjoy a small nice pub for kids , home to The Vaults , a French pub near Raja Indian Cuisine in the riverside area . It has a price range of less than £ 20 and is not a kids appropriate place to eat .
"name[The Vaults], eatType[pub], food[French], priceRange[less than £20], area[riverside], familyFriendly[yes], near[Raja Indian Cuisine]"	If you 're in the riverside area , go to The Vaults . It is a pub near Raja Indian Cuisine . It is inexpensive and family friendly .
"name[The Vaults], eatType[pub], food[French], priceRange[moderate], area[city centre], familyFriendly[no], near[Raja Indian Cuisine]"	The Vaults is a pub that features French food in the city centre near Raja Indian Cuisine . It offer moderate price items and is not kid friendly .
"name[The Vaults], eatType[pub], food[French], priceRange[moderate], area[city centre], familyFriendly[yes], near[Raja Indian Cuisine]"	The Vaults is a French style pub in the city centre near Raja Indian Cuisine . It has a moderate price range and a family - friendly environment . You can bring your kids .
"name[The Vaults], eatType[pub], food[French], priceRange[moderate], area[riverside], familyFriendly[no], near[Raja Indian Cuisine]"	Near Raja Indian Cuisine you will find The Vaults pub . It is moderately priced and not family friendly .
"name[The Vaults], eatType[pub], food[French], priceRange[moderate], area[riverside], familyFriendly[yes], near[Raja Indian Cuisine]"	The Vaults is a child friendly pub with moderate prices . It can be found in the riverside area near Raja Indian Cuisine .
"name[The Vaults], eatType[pub], food[French], priceRange[more than £30], area[city centre], familyFriendly[no], near[Raja Indian Cuisine]"	The Vaults is a mature pub with priced menu and cheeses . It is located in the city centre near Raja Indian Cuisine and is a kid - friendly place .
"name[The Vaults], eatType[pub], food[French], priceRange[more than £30], area[city centre], familyFriendly[yes], near[Raja Indian Cuisine]"	The Vaults is a French place without children . It is situated near Raja Indian Cuisine and the price range is more than 30 pounds .
"name[The Vaults], eatType[pub], food[French], priceRange[more than £30], area[riverside], familyFriendly[no], near[Raja Indian Cuisine]"	The Vaults is a middle price range pub in the middle of the city near Raja Indian Cuisine . They provide French food and are not children friendly .
"name[The Vaults], eatType[pub], food[French], priceRange[more than £30], area[riverside], familyFriendly[yes], near[Raja Indian Cuisine]"	There is a children friendly pub in the riverside area near Raja Indian Cuisine that serves French food and has a price range of more than £ 30 . It is called The Vaults .
"name[The Vaults], eatType[pub], food[Indian], priceRange[£20-25], area[riverside], familyFriendly[yes], near[Raja Indian Cuisine]"	The Vaults is a pub serving Indian food around the £ 20 - 25 price ranges . It is located in the riverside area near Raja Indian Cuisine and is child friendly .
"name[The Vaults], eatType[pub], food[Indian], priceRange[cheap], area[riverside], familyFriendly[yes], near[Raja Indian Cuisine]"	The Vaults is a pub that provides Indian food in the cheap price range . It is located in the riverside . It is near Raja Indian Cuisine .
"name[The Vaults], eatType[pub], food[Indian], priceRange[high], area[city centre], familyFriendly[no], near[Raja Indian Cuisine]"	The Vaults is an Indian pub situated near Raja Indian Cuisine in the city centre . It has a high price range and is not children friendly .
"name[The Vaults], eatType[pub], food[Indian], priceRange[high], area[city centre], familyFriendly[yes], near[Raja Indian Cuisine]"	The Vaults is a child friendly Indian pub with a high price range in the city centre near Raja Indian Cuisine .
"name[The Vaults], eatType[pub], food[Italian], priceRange[high], customer rating[average], area[city centre], familyFriendly[no], near[Rainbow Vegetarian Café]"	The Vaults is a pub serving Italian food . It is located near Rainbow Vegetarian Café in the city centre . It is not child friendly , although it has an average customer rating .
"name[The Vaults], eatType[pub], food[Italian], priceRange[high], customer rating[average], area[city centre], familyFriendly[yes], near[Rainbow Vegetarian Café]"	The Vaults is a pub that serves Italian food . It is located in the city centre near the Rainbow Vegetarian Café . It is child friendly and has an average customer rating .
"name[The Vaults], eatType[pub], food[Italian], priceRange[high], customer rating[average], area[riverside], familyFriendly[no], near[Rainbow Vegetarian Café]"	Located near the Rainbow Vegetarian Café is an averagely priced Italian pub named The Vaults . It is not considered child friendly and has an average customer rating .
"name[The Vaults], eatType[pub], food[Italian], priceRange[high], customer rating[average], area[riverside], familyFriendly[yes], near[Rainbow Vegetarian Café]"	For a three star high cost pub near the Rainbow Vegetarian Café , check out The Vaults .
"name[The Vaults], eatType[pub], food[Italian], priceRange[less than £20], customer rating[low], area[city centre], familyFriendly[no], near[Rainbow Vegetarian Café]"	The Vaults is a pub near the Rainbow Vegetarian Café in the city centre that features Italian cuisine meals for less than £ 20 . It is not family - friendly and has a low customer rating .
"name[The Vaults], eatType[pub], food[Italian], priceRange[less than £20], customer rating[low], area[city centre], familyFriendly[yes], near[Rainbow Vegetarian Café]"	In the center of the city , try The Vaults . It is a pub near the Rainbow Vegetarian Café . It is inexpensive and got a low customer rating even though it 's family - friendly though .
"name[The Vaults], eatType[pub], food[Italian], priceRange[less than £20], customer rating[low], area[riverside], familyFriendly[no], near[Rainbow Vegetarian Café]"	The Vaults is a pub serving Italian food in the riverside area near Rainbow Vegetarian Café . It is not family - friendly and rate less than £ 20 . It is rated low .
"name[The Vaults], eatType[pub], food[Italian], priceRange[less than £20], customer rating[low], area[riverside], familyFriendly[yes], near[Rainbow Vegetarian Café]"	The Vaults is a low cost pub that may be north of the city center . near the Rainbow Vegetarian Café .
"name[The Vaults], eatType[pub], food[Italian], priceRange[moderate], customer rating[1 out of 5], area[city centre], familyFriendly[no], near[Rainbow Vegetarian Café]"	The Vaults is a pub providing Italian food in the city center near Rainbow Vegetarian Café . Providing food ranging within the moderate range . It is not family - friendly and has a customer rating of 1 out of 5 .
"name[The Vaults], eatType[pub], food[Italian], priceRange[moderate], customer rating[1 out of 5], area[city centre], familyFriendly[yes], near[Rainbow Vegetarian Café]"	There is an Italian pub named The Vaults near Rainbow Vegetarian Café in the city centre . It has a customer rating of 1 out of 5 and is moderately prices . It is kid friendly .
"name[The Vaults], eatType[pub], food[Italian], priceRange[moderate], customer rating[1 out of 5], area[riverside], familyFriendly[no], near[Rainbow Vegetarian Café]"	The Vaults is a children friendly pub near Rainbow Vegetarian Café in the riverside area . It serves Italian food and is rate 1 out of 5 by customers . The prices are moderate .
"name[The Vaults], eatType[pub], food[Italian], priceRange[moderate], customer rating[1 out of 5], area[riverside], familyFriendly[yes], near[Rainbow Vegetarian Café]"	There is a family orientated pub called The Vaults , although it is situated near the Rainbow Vegetarian Café . It has moderate prices and earned a customer rating of 1 out of 5 .
"name[The Vaults], eatType[pub], food[Italian], priceRange[moderate], customer rating[3 out of 5], area[city centre], familyFriendly[no], near[Rainbow Vegetarian Café]"	There is a pub named The Vaults that offers moderate priced Italian food . It is not kid friendly and has a customer rating of 3 out of 5 . It is located in the city centre near Rainbow Vegetarian Café .
"name[The Vaults], eatType[pub], food[Italian], priceRange[moderate], customer rating[3 out of 5], area[city centre], familyFriendly[yes], near[Rainbow Vegetarian Café]"	The Vaults is a kids friendly Italian pub in the city centre near Rainbow Vegetarian Café . It has a moderate price range and a customer rating of 3 out of 5 .
"name[The Vaults], eatType[pub], food[Italian], priceRange[moderate], customer rating[3 out of 5], area[riverside], familyFriendly[no], near[Rainbow Vegetarian Café]"	The Vaults is an Italian pub with a moderately priced atmosphere . It is located in the riverside area near the Rainbow Vegetarian Café and has a customer rating of 3 out of 5 .
"name[The Vaults], eatType[pub], food[Italian], priceRange[moderate], customer rating[3 out of 5], area[riverside], familyFriendly[yes], near[Rainbow Vegetarian Café]"	The Vaults is a full priced pasta restaurant beside Rainbow Vegetarian Café . It is family friendly and is beside the river .
"name[The Vaults], eatType[pub], food[Italian], priceRange[more than £30], customer rating[high], area[city centre], familyFriendly[no], near[Rainbow Vegetarian Café]"	There is a pub named The Vaults that serves high cost Italian food . It is located in the city center near the Rainbow Vegetarian Café and receives high customer ratings .
"name[The Vaults], eatType[pub], food[Italian], priceRange[more than £30], customer rating[high], area[city centre], familyFriendly[yes], near[Rainbow Vegetarian Café]"	The Vaults is an Italian pub with a high customer rating though it is children friendly and can be found near Rainbow Vegetarian Café in the city centre . The price range is more than £ 30 .
"name[The Vaults], eatType[pub], food[Italian], priceRange[more than £30], customer rating[high], area[riverside], familyFriendly[no], near[Rainbow Vegetarian Café]"	If you are looking for Italian food with a price range of more than £ 30 , there is a pub called The Vaults which may be situated in the riverside area near the Rainbow Vegetarian Café . It has a high customer rating and is not quite child friendly .
"name[The Vaults], eatType[pub], food[Italian], priceRange[more than £30], customer rating[high], area[riverside], familyFriendly[yes], near[Rainbow Vegetarian Café]"	In the riverside area near Rainbow Vegetarian Café is a children friendly high rated Italian pub named The Vaults with a price range of more than £ 30 .
"name[The Vaults], eatType[pub], food[Japanese], priceRange[£20-25], customer rating[3 out of 5], area[city centre], familyFriendly[no], near[Rainbow Vegetarian Café]"	The Vaults is a kid friendly pub serving Japanese food in the city centre near Rainbow Vegetarian Café . It has a customer rating of 3 out of 5 and a price range of £ 20 - 25 .
"name[The Vaults], eatType[pub], food[Japanese], priceRange[£20-25], customer rating[3 out of 5], area[city centre], familyFriendly[yes], near[Rainbow Vegetarian Café]"	The Vaults is a Japanese pub located in the city centre near Rainbow Vegetarian Café . It has a customer rating of 3 out of 5 and is child friendly .
"name[The Vaults], eatType[pub], food[Japanese], priceRange[£20-25], customer rating[3 out of 5], area[riverside], familyFriendly[no], near[Rainbow Vegetarian Café]"	The Vaults is a Japanese pub near Rainbow Vegetarian Café in the riverside area . It has a customer rating of 3 out of 5 and has meals ranging from 20 - 25 pounds .
"name[The Vaults], eatType[pub], food[Japanese], priceRange[£20-25], customer rating[3 out of 5], area[riverside], familyFriendly[yes], near[Rainbow Vegetarian Café]"	There is a three out of five star pub called The Vaults that serves sushi and is located near Rainbow Vegetarian Café . It is family friendly and cost £ 20 - 25 .
"name[The Vaults], eatType[pub], food[Japanese], priceRange[£20-25], customer rating[high], area[city centre], familyFriendly[no], near[Rainbow Vegetarian Café]"	The Vaults is a pub for adults in the city centre near Rainbow Vegetarian Café . It serves Japanese food ranging from £ 20 - 25 and is highly rated .
"name[The Vaults], eatType[pub], food[Japanese], priceRange[£20-25], customer rating[high], area[city centre], familyFriendly[yes], near[Rainbow Vegetarian Café]"	In the city centre near Rainbow Vegetarian Café there is a pub called The Vaults that serves Japanese food . It is kids friendly and has a high customer rating . The price range is £ 20 - 25 .
"name[The Vaults], eatType[pub], food[Japanese], priceRange[£20-25], customer rating[high], area[riverside], familyFriendly[no], near[Rainbow Vegetarian Café]"	The Vaults serves authentic Japanese food at prices between £ 20 - 25 . It is not a great environment . It is located next to the Rainbow Vegetarian Café .
"name[The Vaults], eatType[pub], food[Japanese], priceRange[£20-25], customer rating[high], area[riverside], familyFriendly[no], near[Raja Indian Cuisine]"	The Vaults is a Japanese pub whose prices range from £ 20 - 25 . Located in the riverside area near Raja Indian Cuisine , it is not kid - free and gets high customer ratings .
"name[The Vaults], eatType[pub], food[Japanese], priceRange[£20-25], customer rating[high], area[riverside], familyFriendly[yes], near[Raja Indian Cuisine]"	The Vaults is a low priced sushi restaurant . It is family friendly and is close to the river next to Raja Indian Cuisine .
"name[The Vaults], eatType[pub], food[Japanese], priceRange[cheap], customer rating[5 out of 5], area[city centre], familyFriendly[no], near[Raja Indian Cuisine]"	There is a pub called The Vaults located near Raja Indian Cuisine in the city centre . Although it is not family - friendly , it sells value for twenty and twenty star . However , it has a customer rating of 5 out of 5 star .
"name[The Vaults], eatType[pub], food[Japanese], priceRange[cheap], customer rating[5 out of 5], area[city centre], familyFriendly[yes], near[Raja Indian Cuisine]"	The Vaults is a cheap , 5 out of 5 rated Japanese pub in the city centre near Raja Indian Cuisine .
"name[The Vaults], eatType[pub], food[Japanese], priceRange[cheap], customer rating[5 out of 5], area[riverside], familyFriendly[no], near[Raja Indian Cuisine]"	Located within the riverside area near Raja Indian Cuisine , The Vaults is an amazing Japanese pub . It is not a family - friendly establishment and is highly rated by customers .
"name[The Vaults], eatType[pub], food[Japanese], priceRange[cheap], customer rating[5 out of 5], area[riverside], familyFriendly[yes], near[Raja Indian Cuisine]"	The Vaults pub offers quality inexpensive Sushi in the river near Raja Indian Cuisine .
"name[The Vaults], eatType[pub], food[Japanese], priceRange[high], customer rating[3 out of 5], area[city centre], familyFriendly[no], near[Raja Indian Cuisine]"	Expensive Japanese food restaurant called The Vaults has a customer rating of 3 out of 5 and is not kid friendly . It is located in the city centre near Raja Indian Cuisine .
"name[The Vaults], eatType[pub], food[Japanese], priceRange[high], customer rating[3 out of 5], area[city centre], familyFriendly[yes], near[Raja Indian Cuisine]"	In the city centre , near Raja Indian Cuisine , you will find The Vaults . It is a Japanese pub with high prices and a customer rating of 3 out of 5 . You will find this restaurant that is family - friendly . The views is high . It serves Japanese food .
"name[The Vaults], eatType[pub], food[Japanese], priceRange[high], customer rating[3 out of 5], area[riverside], familyFriendly[no], near[Raja Indian Cuisine]"	The Vaults is a pub close to Raja Indian Cuisine that unfortunately unfortunately unfortunately amazing Japanese foods . The price range is reasonable and children are welcome , though it has a three - star rating .
"name[The Vaults], eatType[pub], food[Japanese], priceRange[high], customer rating[3 out of 5], area[riverside], familyFriendly[yes], near[Raja Indian Cuisine]"	There is an expensive pub The Vaults located near Raja Indian Cuisine that provides seafood .
"name[The Vaults], eatType[pub], food[Japanese], priceRange[less than £20], customer rating[average], area[city centre], familyFriendly[no], near[Raja Indian Cuisine]"	The Vaults , near Raja Indian Cuisine in the city centre , is a low cost pub that serves average rated Japanese food in an adult atmosphere .
"name[The Vaults], eatType[pub], food[Japanese], priceRange[less than £20], customer rating[average], area[city centre], familyFriendly[yes], near[Raja Indian Cuisine]"	In the city centre near Raja Indian Cuisine is a family - friendly pub called The Vaults serving Japanese food with prices less than £ 20 and an average customer rating .
"name[The Vaults], eatType[pub], food[Japanese], priceRange[less than £20], customer rating[average], area[riverside], familyFriendly[no], near[Raja Indian Cuisine]"	There is a Japanese pub called The Vaults in the riverside area near Raja Indian Cuisine . It has an average customer rating and is not family - friendly . It has a price range of less than 20 pounds .
"name[The Vaults], eatType[pub], food[Japanese], priceRange[less than £20], customer rating[average], area[riverside], familyFriendly[yes], near[Raja Indian Cuisine]"	Located near Raja Indian Cuisine is a low - cost , family friendly pub called The Vaults . It is rated average by customers .
"name[The Vaults], eatType[pub], food[Japanese], priceRange[less than £20], customer rating[low], area[city centre], familyFriendly[no], near[Raja Indian Cuisine]"	The Vaults is a pub steps of the city centre . The prices are less than £ 20 . They also serve a variety of Japanese food . We are not child friendly and are located near Raja Indian Cuisine .
"name[The Vaults], eatType[pub], food[Japanese], priceRange[less than £20], customer rating[low], area[city centre], familyFriendly[yes], near[Raja Indian Cuisine]"	The Vaults is a family - friendly pub that earned a low customer rating . It serves Japanese food for less than £ 20 and is located near Raja Indian Cuisine in the city centre .
"name[The Vaults], eatType[pub], food[Japanese], priceRange[less than £20], customer rating[low], area[riverside], familyFriendly[no], near[Raja Indian Cuisine]"	If you are looking for Japanese food in the riverside area , visit The Vaults . It is not a family - friendly pub . It is located near Raja Indian Cuisine . However , it has a low customer rating and a price range of less than 20 sterling . However , it is not family - friendly .
"name[The Vaults], eatType[pub], food[Japanese], priceRange[less than £20], customer rating[low], area[riverside], familyFriendly[yes], near[Raja Indian Cuisine]"	The Vaults is a family friendly pub with prices less than £ 20 . It serves Japanese food and is located in the riverside area near Raja Indian Cuisine . It has a low customer rating .
"name[The Vaults], eatType[pub], food[Japanese], priceRange[moderate], customer rating[1 out of 5], area[city centre], familyFriendly[no], near[Raja Indian Cuisine]"	The Vaults is a Japanese pub found in the city centre near Raja Indian Cuisine . It is moderately priced and kids friendly . The customers have given it a 1 out of 5 rating .
"name[The Vaults], eatType[pub], food[Japanese], priceRange[moderate], customer rating[1 out of 5], area[city centre], familyFriendly[yes], near[Raja Indian Cuisine]"	The Vaults is a pub that serves moderately priced Japanese food . It is a kid friendly venue with a customer rating of 1 out of 5 . It is located in the city centre near Raja Indian Cuisine .
"name[The Vaults], eatType[restaurant], food[French], priceRange[high], area[riverside], familyFriendly[yes], near[Raja Indian Cuisine]"	A child friendly French food environment called The Vaults is located near Raja Indian Cuisine and got a good price range and usually beverages .
"name[The Vaults], eatType[restaurant], food[French], priceRange[less than £20], area[city centre], familyFriendly[no], near[Raja Indian Cuisine]"	A non - family - friendly restaurant called The Vaults serves French food in the city centre near Raja Indian Cuisine . It is priced less than £ 20 .
"name[The Vaults], eatType[restaurant], food[French], priceRange[less than £20], area[city centre], familyFriendly[yes], near[Raja Indian Cuisine]"	In the city centre near Raja Indian Cuisine is a family - friendly French restaurant called The Vaults .
"name[The Vaults], eatType[restaurant], food[French], priceRange[less than £20], area[riverside], familyFriendly[no], near[Raja Indian Cuisine]"	The Vaults is an inexpensive wine and cheese restaurant located next to Raja Indian Cuisine .
"name[The Vaults], eatType[restaurant], food[French], priceRange[less than £20], area[riverside], familyFriendly[yes], near[Raja Indian Cuisine]"	Good French food at The Vaults restaurant in riverside near Raja Indian Cuisine .
"name[The Vaults], eatType[restaurant], food[French], priceRange[moderate], area[city centre], familyFriendly[no], near[Raja Indian Cuisine]"	The Vaults restaurant offers French food in the city centre near Raja Indian Cuisine . It is not family - friendly and has a moderate price range .
"name[The Vaults], eatType[restaurant], food[French], priceRange[moderate], area[city centre], familyFriendly[yes], near[Raja Indian Cuisine]"	There is a reasonably priced child friendly restaurant called The Vaults . It is located near Raja Indian Cuisine in the city centre . It serves French food items .
"name[The Vaults], eatType[restaurant], food[French], priceRange[moderate], area[riverside], familyFriendly[no], near[Raja Indian Cuisine]"	Close to Raja Indian Cuisine , The Vaults is a moderately priced restaurant that caters to families .
"name[The Vaults], eatType[restaurant], food[French], priceRange[moderate], area[riverside], familyFriendly[yes], near[Raja Indian Cuisine]"	The Vaults is a low - priced restaurant near the River and Raja Indian Cuisine .
"name[The Vaults], eatType[restaurant], food[French], priceRange[more than £30], area[city centre], familyFriendly[no], near[Raja Indian Cuisine]"	The Vaults is a French restaurant in the city centre near Raja Indian Cuisine . It is priced more than £ 30 and is not child friendly .
"name[The Vaults], eatType[restaurant], food[French], priceRange[more than £30], area[city centre], familyFriendly[yes], near[Raja Indian Cuisine]"	If you are looking for French food in the higher price range , The Vaults is a kid friendly restaurant in the city centre near Raja Indian Cuisine .
"name[The Vaults], eatType[restaurant], food[French], priceRange[more than £30], area[riverside], familyFriendly[no], near[Raja Indian Cuisine]"	The Vaults is a restaurant that servers French food in the riverside area near Raja Indian Cuisine . It is not child friendly and has a price range of more than £ 30 .
"name[The Vaults], eatType[restaurant], food[French], priceRange[more than £30], area[riverside], familyFriendly[yes], near[Raja Indian Cuisine]"	In the riverside area near Raja Indian Cuisine is a child friendly French restaurant named The Vaults . It costs more than £ 30 .
"name[The Vaults], eatType[restaurant], food[Indian], priceRange[£20-25], area[riverside], familyFriendly[yes], near[Raja Indian Cuisine]"	The Vaults is a children friendly Indian restaurant in the riverside area near Raja Indian Cuisine with a price range of £ 20 - 25 .
"name[The Vaults], eatType[restaurant], food[Indian], priceRange[cheap], area[riverside], familyFriendly[yes], near[Raja Indian Cuisine]"	The Vaults is a restaurant providing Indian food in the cheap price range . It is located in the riverside . It is near Raja Indian Cuisine .
"name[The Vaults], eatType[restaurant], food[Indian], priceRange[high], area[city centre], familyFriendly[no], near[Raja Indian Cuisine]"	The Vaults restaurant serves Indian food in the high price range . Bring your children . It is located in the city centre near Raja Indian Cuisine .
"name[The Vaults], eatType[restaurant], food[Indian], priceRange[high], area[city centre], familyFriendly[yes], near[Raja Indian Cuisine]"	The Vaults is a high priced , family friendly restaurant serving Indian food in the city centre near Raja Indian Cuisine .
"name[The Waterman], eatType[pub], food[Indian], priceRange[high], area[city centre], familyFriendly[yes], near[Raja Indian Cuisine]"	The Waterman is a pub with high prices located in the city centre near Raja Indian Cuisine . They serve Indian food and are children friendly .
"name[The Waterman], eatType[pub], food[Indian], priceRange[high], area[riverside], familyFriendly[no], near[Raja Indian Cuisine]"	The Waterman pub serves highly rated Indian cuisine in the riverside area near Raja Indian Cuisine . It is not considered child friendly .
"name[The Waterman], eatType[pub], food[Indian], priceRange[high], area[riverside], familyFriendly[yes], near[Raja Indian Cuisine]"	In the riverside area near Raja Indian Cuisine is an Indian pub called The Waterman . It has a high price range and is children friendly .
"name[The Waterman], eatType[pub], food[Indian], priceRange[less than £20], area[city centre], familyFriendly[no], near[Raja Indian Cuisine]"	For good prices , bring your family to The Waterman pub . It offers Indian cuisine and is located in the city center near Raja Indian Cuisine .
"name[The Waterman], eatType[pub], food[Indian], priceRange[less than £20], area[city centre], familyFriendly[yes], near[Raja Indian Cuisine]"	The Waterman is a family friendly pub that serves Indian food for less than £ 20 . It is located in the city centre near Raja Indian Cuisine .
"name[The Waterman], eatType[pub], food[Indian], priceRange[less than £20], area[riverside], familyFriendly[no], near[Raja Indian Cuisine]"	The Waterman is a pub providing Indian food in the less than £ 20 price range . It is located in the riverside . It is near Raja Indian Cuisine .
"name[The Waterman], eatType[pub], food[Indian], priceRange[less than £20], area[riverside], familyFriendly[yes], near[Raja Indian Cuisine]"	The Waterman is a family friendly pub that serves Indian food for less than £ 20 in the riverside area near Raja Indian Cuisine .
"name[The Waterman], eatType[pub], food[Indian], priceRange[moderate], area[city centre], familyFriendly[no], near[Raja Indian Cuisine]"	In the city centre near Raja Indian Cuisine is a pub serving Indian food called The Waterman . It is not children friendly and moderately priced .
"name[The Waterman], eatType[pub], food[Indian], priceRange[moderate], area[city centre], familyFriendly[yes], near[Raja Indian Cuisine]"	Moderately priced The Waterman pub offers Indian food in the city centre near Raja Indian Cuisine . It is a child friendly atmosphere .
"name[The Waterman], eatType[pub], food[Indian], priceRange[moderate], area[riverside], familyFriendly[no], near[Raja Indian Cuisine]"	The Waterman is a moderate price ranged pub in the riverside area near Raja Indian Cuisine . Children are not welcome .
"name[The Waterman], eatType[pub], food[Indian], priceRange[moderate], area[riverside], familyFriendly[yes], near[Raja Indian Cuisine]"	The Waterman is a moderate priced pub also offering Indian food . It is located in the riverside area near Raja Indian Cuisine and is kid friendly .
"name[The Waterman], eatType[pub], food[Indian], priceRange[more than £30], area[riverside], familyFriendly[yes], near[Raja Indian Cuisine]"	The Waterman is a pub that allows children . It is located near Raja Indian Cuisine and prices are more than £ 30 .
"name[The Waterman], eatType[pub], food[Italian], priceRange[£20-25], area[riverside], familyFriendly[yes], near[Raja Indian Cuisine]"	In the riverside area near Raja Indian Cuisine is a kid friendly Italian pub called The Waterman with prices between £ 20 - 25 .
"name[The Waterman], eatType[pub], food[Italian], priceRange[cheap], area[riverside], familyFriendly[yes], near[Raja Indian Cuisine]"	The Waterman is a pub in the riverside area near Raja Indian Cuisine . It is cheaply priced and family friendly .
"name[The Waterman], eatType[pub], food[Italian], priceRange[high], area[city centre], familyFriendly[no], near[Raja Indian Cuisine]"	The Waterman offers Italian style food at high prices . It is located in the city centre near Raja Indian Cuisine and is not time for children . Enjoy children .
"name[The Waterman], eatType[pub], food[Italian], priceRange[high], area[city centre], familyFriendly[yes], near[Raja Indian Cuisine]"	The Waterman is a children friendly Italian pub in the city centre near Raja Indian Cuisine with high prices .
"name[The Waterman], eatType[pub], food[Italian], priceRange[high], area[riverside], familyFriendly[no], near[Raja Indian Cuisine]"	The Waterman is a highly priced Italian pub in riverside near Raja Indian Cuisine . It is not family - friendly and has high prices .
"name[The Waterman], eatType[pub], food[Italian], priceRange[high], area[riverside], familyFriendly[yes], near[Raja Indian Cuisine]"	The Waterman is a high priced , child friendly pub along the outskirts of the city near Raja Indian Cuisine .
"name[The Waterman], eatType[pub], food[Italian], priceRange[less than £20], area[city centre], familyFriendly[no], near[Raja Indian Cuisine]"	The Waterman is a cheap pub located in the city centre near Raja Indian Cuisine . It is not family - friendly .
"name[The Waterman], eatType[pub], food[Italian], priceRange[less than £20], area[city centre], familyFriendly[yes], near[Raja Indian Cuisine]"	The Waterman is a family - friendly pub that found in the city centre near Raja Indian Cuisine . It serves affordable Italian food per around £ 20 per around .
"name[The Waterman], eatType[pub], food[Italian], priceRange[less than £20], area[riverside], familyFriendly[no], near[Raja Indian Cuisine]"	There is a cheap pub The Waterman located along the river near Raja Indian Cuisine . It is not family friendly .
"name[The Waterman], eatType[restaurant], food[Indian], priceRange[high], area[city centre], familyFriendly[yes], near[Raja Indian Cuisine]"	The Waterman is a high priced child friendly restaurant serving Indian food in the city centre near Raja Indian Cuisine .
"name[The Waterman], eatType[restaurant], food[Indian], priceRange[high], area[riverside], familyFriendly[no], near[Raja Indian Cuisine]"	The Waterman is a high priced Indian restaurant in riverside near Raja Indian Cuisine . It is not kid friendly .
"name[The Waterman], eatType[restaurant], food[Indian], priceRange[high], area[riverside], familyFriendly[yes], near[Raja Indian Cuisine]"	The Waterman restaurant offers Indian food in the high price range . It is a child friendly establishment in the riverside area near Raja Indian Cuisine .
"name[The Waterman], eatType[restaurant], food[Indian], priceRange[less than £20], area[city centre], familyFriendly[no], near[Raja Indian Cuisine]"	Located near Raja Indian Cuisine in the city center , The Waterman restaurant serves Indian food for less than £ 20 . It is not family friendly .
"name[The Waterman], eatType[restaurant], food[Indian], priceRange[less than £20], area[city centre], familyFriendly[yes], near[Raja Indian Cuisine]"	In the city centre near Raja Indian Cuisine is a low cost Indian restaurant called The Waterman .
"name[The Waterman], eatType[restaurant], food[Indian], priceRange[less than £20], area[riverside], familyFriendly[no], near[Raja Indian Cuisine]"	The Waterman is a restaurant that provides Indian food in the less than £ 20 price range . It is located in the riverside . It is near Raja Indian Cuisine .
"name[The Waterman], eatType[restaurant], food[Indian], priceRange[less than £20], area[riverside], familyFriendly[yes], near[Raja Indian Cuisine]"	The Waterman is a family friendly restaurant that offers Indian food for less than £ 20 . It is located in the riverside area near Raja Indian Cuisine .
"name[The Waterman], eatType[restaurant], food[Indian], priceRange[moderate], area[city centre], familyFriendly[no], near[Raja Indian Cuisine]"	There is an Indian restaurant called The Waterman near Raja Indian Cuisine in the city centre . Along the Waterman is moderately priced and not family friendly .
"name[The Waterman], eatType[restaurant], food[Indian], priceRange[moderate], area[city centre], familyFriendly[yes], near[Raja Indian Cuisine]"	The Waterman is a family friendly restaurant that provides Indian food . It can be found in the city centre near Raja Indian Cuisine . It is mid - priced and is family friendly .
"name[The Waterman], eatType[restaurant], food[Indian], priceRange[moderate], area[riverside], familyFriendly[no], near[Raja Indian Cuisine]"	The Waterman restaurant serves moderately priced Indian food in the riverside area near Raja Indian Cuisine . It is not kid friendly .
"name[The Waterman], eatType[restaurant], food[Indian], priceRange[moderate], area[riverside], familyFriendly[yes], near[Raja Indian Cuisine]"	The Waterman is a moderately priced family friendly Indian restaurant in Riverside near Raja Indian Cuisine .
"name[The Waterman], eatType[restaurant], food[Indian], priceRange[more than £30], area[riverside], familyFriendly[yes], near[Raja Indian Cuisine]"	There is an Indian restaurant named The Waterman near Raja Indian Cuisine in riverside . It costs more than £ 30 and is children friendly .
"name[The Waterman], eatType[restaurant], food[Italian], priceRange[£20-25], area[riverside], familyFriendly[yes], near[Raja Indian Cuisine]"	The Waterman is an Italian restaurant in riverside near Raja Indian Cuisine . It is usually prices between £ 20 - 25 and is kid friendly .
"name[The Waterman], eatType[restaurant], food[Italian], priceRange[cheap], area[riverside], familyFriendly[yes], near[Raja Indian Cuisine]"	For a cheap restaurant providing Italian food in the riverside area near Raja Indian Cuisine , check out The Waterman . It is kid friendly .
"name[The Waterman], eatType[restaurant], food[Italian], priceRange[high], area[city centre], familyFriendly[no], near[Raja Indian Cuisine]"	The Waterman features Italian food in the city centre near Raja Indian Cuisine . It is not a family - friendly restaurant .
"name[The Waterman], eatType[restaurant], food[Italian], priceRange[high], area[city centre], familyFriendly[yes], near[Raja Indian Cuisine]"	The Waterman is a highly rated child friendly restaurant in the city centre near Raja Indian Cuisine . It offers Italian style dishes .
"name[The Waterman], eatType[restaurant], food[Italian], priceRange[high], area[riverside], familyFriendly[no], near[Raja Indian Cuisine]"	The Waterman is a highly priced Italian restaurant located close to Raja Indian Cuisine in the riverside area . It is not child friendly .
"name[The Waterman], eatType[restaurant], food[Italian], priceRange[high], area[riverside], familyFriendly[yes], near[Raja Indian Cuisine]"	The Waterman is a kid friendly Italian restaurant in the riverside area near Raja Indian Cuisine with a high price range .
"name[The Waterman], eatType[restaurant], food[Italian], priceRange[less than £20], area[city centre], familyFriendly[no], near[Raja Indian Cuisine]"	The Waterman is a cheap Italian restaurant located in the city centre near Raja Indian Cuisine . It is not considered family - friendly .
"name[The Waterman], eatType[restaurant], food[Italian], priceRange[less than £20], area[city centre], familyFriendly[yes], near[Raja Indian Cuisine]"	The Waterman is a low priced family - friendly Italian restaurant in the city centre near Raja Indian Cuisine .
"name[The Waterman], eatType[restaurant], food[Italian], priceRange[less than £20], area[riverside], familyFriendly[no], near[Raja Indian Cuisine]"	Serving Italian food , The Waterman is a family - friendly restaurant with prices less than £ 20 . It is situated in the riverside area near Raja Indian Cuisine .
"name[The Wrestlers], eatType[pub], food[Italian], priceRange[less than £20], area[riverside], familyFriendly[no], near[Raja Indian Cuisine]"	Though not family - friendly , The Wrestlers is an Italian pub near Raja Indian Cuisine in the riverside area . Though it is priced less than £ 20 .
"name[The Wrestlers], eatType[pub], food[Italian], priceRange[less than £20], area[riverside], familyFriendly[yes], near[Raja Indian Cuisine]"	The Wrestlers is a low - cost , family - friendly pub located in Luton near Raja Indian Cuisine . It has Italian food and a place to Euros .
"name[The Wrestlers], eatType[pub], food[Italian], priceRange[moderate], area[city centre], familyFriendly[no], near[Raja Indian Cuisine]"	The Wrestlers pub offers Italian food in the city centre near Raja Indian Cuisine . It is not family - friendly and has a moderate price range .
"name[The Wrestlers], eatType[pub], food[Italian], priceRange[moderate], area[city centre], familyFriendly[yes], near[Raja Indian Cuisine]"	The Wrestlers is a pub located in the city centre near Raja Indian Cuisine . It has moderate prices and is kids friendly .
"name[The Wrestlers], eatType[pub], food[Italian], priceRange[moderate], area[riverside], familyFriendly[no], near[Raja Indian Cuisine]"	The Wrestlers is a moderately priced Italian pub in riverside near Raja Indian Cuisine . It is not kid friendly .
"name[The Wrestlers], eatType[pub], food[Italian], priceRange[moderate], area[riverside], familyFriendly[yes], near[Raja Indian Cuisine]"	In the riverside area near Raja Indian Cuisine is an Italian style pub called The Wrestlers . It has moderate prices and is kids friendly .
"name[The Wrestlers], eatType[pub], food[Italian], priceRange[more than £30], area[riverside], familyFriendly[yes], near[Raja Indian Cuisine]"	Child friendly The Wrestlers serves Italian style food at prices more than £ 30 . It is located in the riverside area near Raja Indian Cuisine .
"name[The Wrestlers], eatType[pub], food[Japanese], priceRange[£20-25], area[riverside], familyFriendly[yes], near[Raja Indian Cuisine]"	The Wrestlers is a pub serving Japanese food in the riverside area near Raja Indian Cuisine . It is child friendly and has a price range of £ 20 - 25 .
"name[The Wrestlers], eatType[pub], food[Japanese], priceRange[cheap], area[riverside], familyFriendly[yes], near[Raja Indian Cuisine]"	The Wrestlers is a cheap , family friendly pub that sells Japanese food . It is also near Raja Indian Cuisine in the riverside area .
"name[The Wrestlers], eatType[pub], food[Japanese], priceRange[high], area[riverside], familyFriendly[yes], near[Raja Indian Cuisine]"	Located near Raja Indian Cuisine , The Wrestlers is a kid friendly pub give offering higher price ranged Japanese food . Located in the riverside area .
"name[The Wrestlers], eatType[pub], food[Japanese], priceRange[less than £20], area[city centre], familyFriendly[no], near[Raja Indian Cuisine]"	The Wrestlers is a non - family - friendly pub with meals less than £ 20 . It serves Japanese food in the center of the city near Raja Indian Cuisine . Families are welcome .
"name[The Wrestlers], eatType[pub], food[Japanese], priceRange[less than £20], area[city centre], familyFriendly[yes], near[Raja Indian Cuisine]"	The Wrestlers is a family - friendly pub located in the city centre near Raja Indian Cuisine . It offers Japanese food at prices less than £ 20 .
"name[The Wrestlers], eatType[pub], food[Japanese], priceRange[less than £20], area[riverside], familyFriendly[no], near[Raja Indian Cuisine]"	The Wrestlers is a place selling Japanese food in the riverside area near Raja Indian Cuisine . It is not family - friendly and has a price range of less than £ 20 .
"name[The Wrestlers], eatType[pub], food[Japanese], priceRange[less than £20], area[riverside], familyFriendly[yes], near[Raja Indian Cuisine]"	The Wrestlers is a family friendly pub in the riverside area near Raja Indian Cuisine . It serves Japanese food for less than £ 20 .
"name[The Wrestlers], eatType[pub], food[Japanese], priceRange[moderate], area[city centre], familyFriendly[no], near[Raja Indian Cuisine]"	The Wrestlers is not suitable for families and serves mid - range Japanese food . It is located in the city centre near Raja Indian Cuisine .
"name[The Wrestlers], eatType[pub], food[Japanese], priceRange[moderate], area[city centre], familyFriendly[yes], near[Raja Indian Cuisine]"	The Wrestlers is a pub providing Japanese food in the city centre near Raja Indian Cuisine . It is child friendly and has a moderate price range .
"name[The Wrestlers], eatType[pub], food[Japanese], priceRange[moderate], area[riverside], familyFriendly[no], near[Raja Indian Cuisine]"	The Wrestlers is located outside of the city centre near Raja Indian Cuisine . It sells moderate priced Japanese food and is not children friendly .
"name[The Wrestlers], eatType[pub], food[Japanese], priceRange[moderate], area[riverside], familyFriendly[yes], near[Raja Indian Cuisine]"	The Wrestlers is a moderately priced pub in the riverside area near Raja Indian Cuisine . It is also kid friendly serving Japanese food .
"name[The Wrestlers], eatType[pub], food[Japanese], priceRange[moderate], customer rating[1 out of 5], area[city centre], familyFriendly[yes], near[Raja Indian Cuisine]"	For a child friendly , decent expensive Japanese pub in the city centre near Raja Indian Cuisine , come to The Wrestlers .
"name[The Wrestlers], eatType[pub], food[Japanese], priceRange[moderate], customer rating[1 out of 5], area[riverside], familyFriendly[no], near[Raja Indian Cuisine]"	The Wrestlers offers sushi at a medium price . It is located near Raja Indian Cuisine and is not family friendly .
"name[The Wrestlers], eatType[pub], food[Japanese], priceRange[moderate], customer rating[1 out of 5], area[riverside], familyFriendly[yes], near[Raja Indian Cuisine]"	The Wrestlers is a family friendly pub serving restaurants in the mid price range . Great next to Raja Indian Cuisine . It is located next to the riverside .
"name[The Wrestlers], eatType[pub], food[Japanese], priceRange[more than £30], area[city centre], familyFriendly[no], near[Raja Indian Cuisine]"	The Wrestlers is a pub serving Japanese cuisine in the city centre near Raja Indian Cuisine . It is higher pricey and not child friendly .
"name[The Wrestlers], eatType[pub], food[Japanese], priceRange[more than £30], area[city centre], familyFriendly[yes], near[Raja Indian Cuisine]"	The Wrestlers is a children friendly pub in the city centre near Raja Indian Cuisine that features Japanese food for more than £ 30 .
"name[The Wrestlers], eatType[pub], food[Japanese], priceRange[more than £30], area[riverside], familyFriendly[no], near[Raja Indian Cuisine]"	The Wrestlers is a pub serving Japanese food in the riverside area near Raja Indian Cuisine . It is not child friendly and costs more than £ 30 .
"name[The Wrestlers], eatType[pub], food[Japanese], priceRange[more than £30], area[riverside], familyFriendly[yes], near[Raja Indian Cuisine]"	For a pub that serves Japanese cuisine , try The Wrestlers . It is located near Raja Indian Cuisine in the riverside area . It is considered child friendly and has a price range of more than £ 30 .
"name[The Wrestlers], eatType[pub], food[Japanese], priceRange[more than £30], customer rating[5 out of 5], area[city centre], familyFriendly[no], near[Raja Indian Cuisine]"	The Wrestlers is a restaurant that delivers Japanese food around around 30 pounds . It is not child friendly . Located in the city centre near Raja Indian Cuisine , it has a customer rating of 5 out of 5 .
"name[The Wrestlers], eatType[pub], food[Japanese], priceRange[more than £30], customer rating[5 out of 5], area[city centre], familyFriendly[yes], near[Raja Indian Cuisine]"	The Wrestlers is a child friendly Japanese pub located in the city centre near Raja Indian Cuisine . Customers gave it a variety of 5 out of 5 and a variety of more than 30 euros .
"name[The Wrestlers], eatType[pub], food[Japanese], priceRange[more than £30], customer rating[5 out of 5], area[riverside], familyFriendly[no], near[Raja Indian Cuisine]"	The Wrestlers is a pub providing Japanese food . It is located near Raja Indian Cuisine in riverside . It is not children friendly and has a customer rating of 5 out of 5 . The price range is more than £ 30 .
"name[The Wrestlers], eatType[pub], food[Japanese], priceRange[more than £30], customer rating[5 out of 5], area[riverside], familyFriendly[yes], near[Raja Indian Cuisine]"	The Wrestlers is a 5 star sushi restaurant located near Raja Indian Cuisine .
"name[The Wrestlers], eatType[pub], food[Japanese], priceRange[more than £30], customer rating[low], area[city centre], familyFriendly[no], near[Raja Indian Cuisine]"	The Wrestlers is a Japanese pub near Raja Indian Cuisine in the city centre . Prices are more than £ 30 . It has a low customer rating and is not children friendly .
"name[The Wrestlers], eatType[pub], food[Japanese], priceRange[more than £30], customer rating[low], area[city centre], familyFriendly[yes], near[Raja Indian Cuisine]"	The Wrestlers is a family - friendly Japanese pub in the city centre near Raja Indian Cuisine . However , it has a low customer rating and a price range of more than £ 30 .
"name[The Wrestlers], eatType[pub], food[Japanese], priceRange[more than £30], customer rating[low], area[riverside], familyFriendly[no], near[Raja Indian Cuisine]"	The Wrestlers is a higher price range Japanese pub . It is not suitable for children and has a low customer rating . It is located in the riverside area near Raja Indian Cuisine .
"name[The Wrestlers], eatType[pub], food[Japanese], priceRange[more than £30], customer rating[low], area[riverside], familyFriendly[yes], near[Raja Indian Cuisine]"	There is a pub called The Wrestlers that is located near Raja Indian Cuisine . It has wonderful food although it is within the high price range .
"name[The Wrestlers], eatType[restaurant], food[Italian], priceRange[less than £20], area[riverside], familyFriendly[no], near[Raja Indian Cuisine]"	The Wrestlers is an Italian restaurant that can be found within the riverside area near Raja Indian Cuisine . It is within the low price range and is not family - friendly .
"name[The Wrestlers], eatType[restaurant], food[Italian], priceRange[less than £20], area[riverside], familyFriendly[yes], near[Raja Indian Cuisine]"	The Wrestlers restaurant is located near Raja Indian Cuisine . It offers Italian meals for the whole family . The prices are less than £ 20 .
"name[The Wrestlers], eatType[restaurant], food[Italian], priceRange[moderate], area[city centre], familyFriendly[no], near[Raja Indian Cuisine]"	The Wrestlers is a moderately priced Italian restaurant in the city centre near Raja Indian Cuisine . It is not child friendly .
"name[The Wrestlers], eatType[restaurant], food[Italian], priceRange[moderate], area[city centre], familyFriendly[yes], near[Raja Indian Cuisine]"	The Wrestlers serves Italian style food in the city centre near Raja Indian Cuisine . It is kid friendly and has a moderate price range .
"name[The Wrestlers], eatType[restaurant], food[Italian], priceRange[moderate], area[riverside], familyFriendly[no], near[Raja Indian Cuisine]"	The Wrestlers is an Italian restaurant in the riverside area near Raja Indian Cuisine . It has a moderate price range and is not kids friendly .
"name[The Wrestlers], eatType[restaurant], food[Italian], priceRange[moderate], area[riverside], familyFriendly[yes], near[Raja Indian Cuisine]"	The Wrestlers is a kid friendly Italian restaurant in Riverside near Raja Indian Cuisine . It is moderately priced .
"name[The Wrestlers], eatType[restaurant], food[Italian], priceRange[more than £30], area[riverside], familyFriendly[yes], near[Raja Indian Cuisine]"	The Wrestlers is a family friendly Italian restaurant in the riverside area near Raja Indian Cuisine . It has a price bracket of more than 30 pounds .
"name[The Wrestlers], eatType[restaurant], food[Japanese], priceRange[£20-25], area[riverside], familyFriendly[yes], near[Raja Indian Cuisine]"	There is a kids friendly restaurant called The Wrestlers in the riverside area near Raja Indian Cuisine . It serves Japanese food and has a price range of £ 20 - 25 .
"name[The Wrestlers], eatType[restaurant], food[Japanese], priceRange[cheap], area[riverside], familyFriendly[yes], near[Raja Indian Cuisine]"	The Wrestlers is a low cost family friendly Japanese restaurant in the riverside area near Raja Indian Cuisine .
"name[The Wrestlers], eatType[restaurant], food[Japanese], priceRange[high], area[riverside], familyFriendly[yes], near[Raja Indian Cuisine]"	The Wrestlers is a high rated Japanese restaurant serving kid friendly atmosphere in the riverside area near Raja Indian Cuisine .
"name[The Wrestlers], eatType[restaurant], food[Japanese], priceRange[less than £20], area[city centre], familyFriendly[no], near[Raja Indian Cuisine]"	Welcome to The Wrestlers . We are not family - friendly . Our food is Japanese and we are located in the city centre near Raja Indian Cuisine . Our price range is less than £ 20 .
"name[The Wrestlers], eatType[restaurant], food[Japanese], priceRange[less than £20], area[city centre], familyFriendly[yes], near[Raja Indian Cuisine]"	The Wrestlers is a Japanese restaurant with meals under £ 20 . It is a place for families . Also , it is located near Raja Indian Cuisine in the city centre .
"name[The Wrestlers], eatType[restaurant], food[Japanese], priceRange[less than £20], area[riverside], familyFriendly[no], near[Raja Indian Cuisine]"	The Wrestlers is a Japanese restaurant that is not for the whole family . It is located near Raja Indian Cuisine .
"name[The Wrestlers], eatType[restaurant], food[Japanese], priceRange[less than £20], area[riverside], familyFriendly[yes], near[Raja Indian Cuisine]"	The Wrestlers is a great Japanese restaurant with prices less than 20 euros . It is a fantastic place to eat near Raja Indian Cuisine in the center of the city .
"name[The Wrestlers], eatType[restaurant], food[Japanese], priceRange[moderate], area[city centre], familyFriendly[no], near[Raja Indian Cuisine]"	In the city centre near Raja Indian Cuisine is a moderately priced Japanese restaurant called The Wrestlers . It is not kid friendly .
"name[The Wrestlers], eatType[restaurant], food[Japanese], priceRange[moderate], area[city centre], familyFriendly[yes], near[Raja Indian Cuisine]"	In the city centre near Raja Indian Cuisine is a kid friendly Japanese restaurant named The Wrestlers with a moderate price range .
"name[The Wrestlers], eatType[restaurant], food[Japanese], priceRange[moderate], area[riverside], familyFriendly[no], near[Raja Indian Cuisine]"	The Wrestlers is a Japanese restaurant located close to Raja Indian Cuisine . It is not kids friendly and has a moderate price range .
"name[The Wrestlers], eatType[restaurant], food[Japanese], priceRange[moderate], area[riverside], familyFriendly[yes], near[Raja Indian Cuisine]"	The Wrestlers is a restaurant providing sushi in the low - price range . It is located north of the city center . near Raja Indian Cuisine .
"name[The Wrestlers], eatType[restaurant], food[Japanese], priceRange[more than £30], area[city centre], familyFriendly[no], near[Raja Indian Cuisine]"	For an expensive adult free Japanese restaurant , try The Wrestlers in the city centre near Raja Indian Cuisine .
"name[The Wrestlers], eatType[restaurant], food[Japanese], priceRange[more than £30], area[city centre], familyFriendly[yes], near[Raja Indian Cuisine]"	The Wrestlers offers Japanese food in a family - friendly atmosphere . It has ranges over 30 euros and is close to Raja Indian Cuisine .
"name[The Wrestlers], eatType[restaurant], food[Japanese], priceRange[more than £30], area[riverside], familyFriendly[no], near[Raja Indian Cuisine]"	If you 're looking for an adults only Japanese restaurant , try The Wrestlers . It is really good and situated near Raja Indian Cuisine . The prices are more than £ 30 .
"name[The Wrestlers], eatType[restaurant], food[Japanese], priceRange[more than £30], area[riverside], familyFriendly[yes], near[Raja Indian Cuisine]"	The Wrestlers is a children friendly Japanese restaurant that can be found in the riverside area near Raja Indian Cuisine . It is higher priced .
"name[Wildwood], eatType[coffee shop], area[riverside]"	Wildwood is a coffee shop that provides typical foods and wine . It is located in the city center . and can be found on the outskirts of the city center .
"name[Wildwood], eatType[pub], area[riverside]"	Located near the river , Wildwood is a pub serving pub .
"name[Wildwood], eatType[pub], food[French], area[riverside], familyFriendly[yes], near[Raja Indian Cuisine]"	Wildwood is a kids friendly pub in the riverside area near Raja Indian Cuisine that sells French food .
"name[Wildwood], eatType[pub], food[Indian], area[city centre], familyFriendly[no], near[Raja Indian Cuisine]"	Wildwood is a non - family friendly Indian pub in the city centre near Raja Indian Cuisine .
"name[Wildwood], eatType[pub], food[Indian], area[city centre], familyFriendly[yes], near[Raja Indian Cuisine]"	Wildwood is a family friendly pub in the city centre near Raja Indian Cuisine . They serve Indian food .
"name[Wildwood], eatType[pub], food[Indian], area[riverside], familyFriendly[no], near[Raja Indian Cuisine]"	Wildwood is a pub that provides Indian food . Along the riverside near Raja Indian Cuisine , it is not family friendly .
"name[Wildwood], eatType[pub], food[Indian], area[riverside], familyFriendly[yes], near[Raja Indian Cuisine]"	Wildwood pub serves Indian food and is kid friendly . It is located in the city center near Raja Indian Cuisine .
"name[Wildwood], eatType[pub], food[Italian], area[city centre], familyFriendly[no], near[Raja Indian Cuisine]"	The Wildwood pub is located near Raja Indian Cuisine in the city center . It is not a family - friendly breakfast restaurant .
"name[Wildwood], eatType[pub], food[Italian], area[city centre], familyFriendly[yes], near[Raja Indian Cuisine]"	Located close to Raja Indian Cuisine in the city centre , Wildwood is a great place to eat and the best place to eat .
"name[Wildwood], eatType[pub], food[Italian], area[riverside], familyFriendly[no], near[Raja Indian Cuisine]"	For an adult pub in the riverside area , try Wildwood , which serves Italian food near Raja Indian Cuisine .
"name[Wildwood], eatType[pub], food[Italian], area[riverside], familyFriendly[yes], near[Raja Indian Cuisine]"	There is a family friendly Italian pub called Wildwood in the riverside area near Crown Indian Cuisine .
"name[Wildwood], eatType[restaurant], food[French], area[riverside], familyFriendly[yes], near[Raja Indian Cuisine]"	In the riverside area near Raja Indian Cuisine is a family friendly restaurant called Wildwood that serves French food .
"name[Wildwood], eatType[restaurant], food[Indian], area[city centre], familyFriendly[no], near[Raja Indian Cuisine]"	In the city centre near Raja Indian Cuisine is a restaurant called Wildwood that is not family friendly .
"name[Wildwood], eatType[restaurant], food[Indian], area[city centre], familyFriendly[yes], near[Raja Indian Cuisine]"	You will find Wildwood , a family friendly Indian restaurant in the city centre near Raja Indian Cuisine .
"name[Wildwood], eatType[restaurant], food[Indian], area[riverside], familyFriendly[no], near[Raja Indian Cuisine]"	The adult restaurant Wildwood serves Indian food in the riverside area near Raja Indian Cuisine .
"name[Wildwood], eatType[restaurant], food[Indian], area[riverside], familyFriendly[yes], near[Raja Indian Cuisine]"	Come to the family friendly Wildwood Indian pup in the riverside area near Raja Indian Cuisine .
"name[Wildwood], eatType[restaurant], food[Italian], area[city centre], familyFriendly[no], near[Raja Indian Cuisine]"	Wildwood is a restaurant providing Italian food . It is located in city center near Raja Indian Cuisine .
"name[Wildwood], eatType[restaurant], food[Italian], area[city centre], familyFriendly[yes], near[Raja Indian Cuisine]"	In the heart of the city near Raja Indian Cuisine , Wildwood is a family - friendly Italian restaurant that will make your place to go .
"name[Wildwood], eatType[restaurant], food[Italian], area[riverside], familyFriendly[no], near[Raja Indian Cuisine]"	If you 're looking for a new place to eat , Wildwood is a short called the road and the road from Raja Indian Cuisine .
"name[Wildwood], eatType[restaurant], food[Italian], area[riverside], familyFriendly[yes], near[Raja Indian Cuisine]"	There is a kids friendly restaurant serving Italian food in the riverside area near Raja Indian Cuisine called Wildwood .
"name[Zizzi], eatType[coffee shop], area[riverside]"	Located along the river side , Zizzi is a coffee shop offering snacks .
"name[Zizzi], eatType[coffee shop], customer rating[average], near[Burger King]"	Close to Burger King , Zizzi is an average rated coffee shop .
"name[Zizzi], eatType[coffee shop], customer rating[high], near[Burger King]"	The highly rated coffee shop Zizzi is located near Burger King . It is a coffee shop .
"name[Zizzi], eatType[coffee shop], near[The Sorrento]"	Near The Sorrento is a coffee shop called Zizzi .
"name[Zizzi], eatType[pub], area[riverside]"	Near the river you will find a pub called Zizzi .
"name[Zizzi], eatType[pub], customer rating[average], near[Burger King]"	Zizzi is an average rated pub near Burger King .
"name[Zizzi], eatType[pub], customer rating[high], near[Burger King]"	Located near Burger King is a pub called Zizzi . It has a high customer rating and is priced high .
"name[Zizzi], eatType[pub], near[The Sorrento]"	Near The Sorrento is a pub named Zizzi .
