MR	output
"name[Blue Spice], eatType[coffee shop], area[city centre]"	Blue spice is a coffee shop in the city centre.
"name[Blue Spice], eatType[coffee shop], area[riverside]"	Blue spice is a coffee shop in the riverside area.
"name[Blue Spice], eatType[coffee shop], customer rating[5 out of 5], near[Crowne Plaza Hotel]"	Blue spice is a coffee shop near crowne plaza hotel with a customer rating of 5 out of 5.
"name[Blue Spice], eatType[coffee shop], customer rating[average], near[Burger King]"	Blue spice is a coffee shop located near burger king.
"name[Blue Spice], eatType[coffee shop], customer rating[average], near[Crowne Plaza Hotel]"	Blue spice is a coffee shop near the crowne plaza hotel with an average customer rating.
"name[Blue Spice], eatType[pub], area[city centre]"	Blue spice is a pub in the city centre.
"name[Blue Spice], eatType[pub], area[riverside]"	Blue spice is a pub in the riverside area.
"name[Blue Spice], eatType[pub], customer rating[5 out of 5], near[Crowne Plaza Hotel]"	Blue spice is a pub near the crowne plaza hotel with a customer rating of 5 out of 5.
"name[Blue Spice], eatType[pub], customer rating[average], near[Burger King]"	Blue spice is a pub near burger king with an average customer rating.
"name[Blue Spice], eatType[pub], customer rating[average], near[Crowne Plaza Hotel]"	Blue spice is a pub near the crowne plaza hotel with an average customer rating.
"name[Blue Spice], eatType[pub], food[Chinese], area[city centre], familyFriendly[no], near[Rainbow Vegetarian Café]"	Blue spice is a pub providing chinese food in the city centre near rainbow vegetarian café.
"name[Blue Spice], eatType[pub], food[Chinese], area[city centre], familyFriendly[yes], near[Rainbow Vegetarian Café]"	Blue spice is a pub located in the city centre near rainbow vegetarian café.
"name[Blue Spice], eatType[pub], food[Chinese], area[riverside], familyFriendly[no], near[Rainbow Vegetarian Café]"	Blue spice is a pub that serves chinese food in the riverside area near rainbow vegetarian café.
"name[Blue Spice], eatType[pub], food[Chinese], area[riverside], familyFriendly[yes], near[Rainbow Vegetarian Café]"	Blue spice is a pub that serves chinese food and is located near rainbow vegetarian café.
"name[Blue Spice], eatType[pub], food[English], area[city centre], familyFriendly[no], near[Rainbow Vegetarian Café]"	Blue spice is a pub located in the city centre near rainbow vegetarian café.
"name[Blue Spice], eatType[pub], food[English], area[city centre], familyFriendly[yes], near[Rainbow Vegetarian Café]"	Blue spice is a family-friendly pub located in the city centre near rainbow vegetarian café.
"name[Blue Spice], eatType[pub], food[English], area[riverside], familyFriendly[no], near[Rainbow Vegetarian Café]"	Blue spice is a pub near rainbow vegetarian café in riverside. it is not family-friendly.
"name[Blue Spice], eatType[pub], food[English], area[riverside], familyFriendly[yes], near[Rainbow Vegetarian Café]"	Blue spice is a family friendly pub located near rainbow vegetarian café.
"name[Blue Spice], eatType[restaurant], food[Chinese], area[city centre], familyFriendly[no], near[Rainbow Vegetarian Café]"	Blue spice is a chinese restaurant located in the city centre near rainbow vegetarian café.
"name[Blue Spice], eatType[restaurant], food[Chinese], area[city centre], familyFriendly[yes], near[Rainbow Vegetarian Café]"	Blue spice is a chinese restaurant located in the city centre near rainbow vegetarian café.
"name[Blue Spice], eatType[restaurant], food[Chinese], area[riverside], familyFriendly[no], near[Rainbow Vegetarian Café]"	Blue spice is a chinese restaurant located in the riverside area near rainbow vegetarian café.
"name[Blue Spice], eatType[restaurant], food[Chinese], area[riverside], familyFriendly[yes], near[Rainbow Vegetarian Café]"	Blue spice is a chinese restaurant in the riverside area near rainbow vegetarian café.
"name[Blue Spice], eatType[restaurant], food[English], area[city centre], familyFriendly[no], near[Rainbow Vegetarian Café]"	Blue spice is a english restaurant located in the city centre near rainbow vegetarian café.
"name[Blue Spice], eatType[restaurant], food[English], area[city centre], familyFriendly[yes], near[Rainbow Vegetarian Café]"	Blue spice is a family-friendly english restaurant located in the city centre near rainbow vegetarian café.
"name[Blue Spice], eatType[restaurant], food[English], area[riverside], familyFriendly[no], near[Rainbow Vegetarian Café]"	Blue spice is a restaurant near rainbow vegetarian café in riverside. it is not family-friendly.
"name[Blue Spice], eatType[restaurant], food[English], area[riverside], familyFriendly[yes], near[Rainbow Vegetarian Café]"	Blue spice is a family friendly restaurant located near rainbow vegetarian café.
"name[Clowns], eatType[coffee shop], customer rating[3 out of 5], near[All Bar One]"	Clowns is a coffee shop near all bar one with a customer rating of 3 out of 5.
"name[Clowns], eatType[coffee shop], customer rating[5 out of 5], near[Crowne Plaza Hotel]"	Clowns is a coffee shop located near the crowne plaza hotel.
"name[Clowns], eatType[coffee shop], near[The Sorrento]"	Clowns is a coffee shop near the sorrento.
"name[Clowns], eatType[pub], customer rating[3 out of 5], near[All Bar One]"	Clowns is a pub near all bar one with a customer rating of 3 out of 5.
"name[Clowns], eatType[pub], customer rating[5 out of 5], near[Crowne Plaza Hotel]"	Clowns is a pub near the crowne plaza hotel with a customer rating of 5 out of 5.
"name[Clowns], eatType[pub], near[The Sorrento]"	Clowns is a pub near the sorrento.
"name[Cocum], eatType[coffee shop], customer rating[high], near[Burger King]"	Cocum is a coffee shop near burger king.
"name[Cocum], eatType[coffee shop], customer rating[high], near[Café Sicilia]"	Cocum is a coffee shop near café sicilia with a high customer rating.
"name[Cocum], eatType[coffee shop], customer rating[low], near[Café Sicilia]"	Cocum is a coffee shop near café sicilia with a low customer rating.
"name[Cocum], eatType[coffee shop], customer rating[low], near[Express by Holiday Inn]"	Cocum is a coffee shop near express by holiday inn.
"name[Cocum], eatType[coffee shop], near[The Rice Boat]"	Cocum is a coffee shop near the rice boat.
"name[Cocum], eatType[coffee shop], near[The Sorrento]"	Cocum is a coffee shop near the sorrento.
"name[Cocum], eatType[pub], customer rating[high], near[Burger King]"	Cocum is a pub near burger king with a high customer rating.
"name[Cocum], eatType[pub], customer rating[high], near[Café Sicilia]"	Cocum is a pub near café sicilia with a high customer rating.
"name[Cocum], eatType[pub], customer rating[low], near[Café Sicilia]"	Cocum is a pub near café sicilia with a low customer rating.
"name[Cocum], eatType[pub], customer rating[low], near[Express by Holiday Inn]"	Cocum is a pub near express by holiday inn with a low customer rating.
"name[Cocum], eatType[pub], near[The Rice Boat]"	Cocum is a pub near the rice boat.
"name[Cocum], eatType[pub], near[The Sorrento]"	Cocum is a pub near the sorrento.
"name[Cotto], eatType[coffee shop], near[The Bakers]"	Cotto is a coffee shop near the bakers.
"name[Cotto], eatType[pub], near[The Bakers]"	Cotto is a pub near the bakers.
"name[Giraffe], eatType[coffee shop], near[The Bakers]"	Giraffe is a coffee shop near the bakers.
"name[Giraffe], eatType[coffee shop], near[The Rice Boat]"	Giraffe is a coffee shop near the rice boat.
"name[Giraffe], eatType[pub], food[English], area[riverside], familyFriendly[yes], near[Rainbow Vegetarian Café]"	Giraffe is a family friendly pub near rainbow vegetarian café.
"name[Giraffe], eatType[pub], food[Fast food], area[city centre], familyFriendly[no], near[Rainbow Vegetarian Café]"	Giraffe is a fast food pub located in the city centre near rainbow vegetarian café. it is not family-friendly.
"name[Giraffe], eatType[pub], food[Fast food], area[city centre], familyFriendly[yes], near[Rainbow Vegetarian Café]"	Giraffe is a family-friendly fast food pub in the city centre near rainbow vegetarian café.
"name[Giraffe], eatType[pub], food[Fast food], area[riverside], familyFriendly[no], near[Rainbow Vegetarian Café]"	Giraffe is a pub that serves fast food. it is located near rainbow vegetarian café.
"name[Giraffe], eatType[pub], food[Fast food], area[riverside], familyFriendly[yes], near[Rainbow Vegetarian Café]"	Giraffe is a family friendly pub located near rainbow vegetarian café.
"name[Giraffe], eatType[pub], food[Fast food], area[riverside], familyFriendly[yes], near[Raja Indian Cuisine]"	Giraffe is a family friendly pub located near raja indian cuisine.
"name[Giraffe], eatType[pub], food[French], area[city centre], familyFriendly[no], near[Raja Indian Cuisine]"	Giraffe is a pub located in the city centre near raja indian cuisine. it is not family-friendly.
"name[Giraffe], eatType[pub], food[French], area[city centre], familyFriendly[yes], near[Raja Indian Cuisine]"	Giraffe is a family-friendly pub located near raja indian cuisine in the city centre.
"name[Giraffe], eatType[pub], food[French], area[riverside], familyFriendly[no], near[Raja Indian Cuisine]"	Giraffe is a pub near raja indian cuisine in the riverside area. it is not family-friendly.
"name[Giraffe], eatType[pub], food[French], area[riverside], familyFriendly[yes], near[Raja Indian Cuisine]"	Giraffe is a family friendly pub located near raja indian cuisine in the riverside area.
"name[Giraffe], eatType[pub], near[The Bakers]"	Giraffe is a pub near the bakers.
"name[Giraffe], eatType[pub], near[The Rice Boat]"	Giraffe is a pub near the rice boat.
"name[Giraffe], eatType[restaurant], food[English], area[riverside], familyFriendly[yes], near[Rainbow Vegetarian Café]"	Giraffe is a family friendly restaurant in the riverside area near rainbow vegetarian café.
"name[Giraffe], eatType[restaurant], food[Fast food], area[city centre], familyFriendly[no], near[Rainbow Vegetarian Café]"	Giraffe is a fast food restaurant located in the city centre near rainbow vegetarian café. it is not family-friendly.
"name[Giraffe], eatType[restaurant], food[Fast food], area[city centre], familyFriendly[yes], near[Rainbow Vegetarian Café]"	Giraffe is a fast food restaurant located in the city centre near rainbow vegetarian café.
"name[Giraffe], eatType[restaurant], food[Fast food], area[riverside], familyFriendly[no], near[Rainbow Vegetarian Café]"	Giraffe is a fast food restaurant located in the riverside area near rainbow vegetarian café.
"name[Giraffe], eatType[restaurant], food[Fast food], area[riverside], familyFriendly[yes], near[Rainbow Vegetarian Café]"	Giraffe is a fast food restaurant in the riverside area near rainbow vegetarian café.
"name[Giraffe], eatType[restaurant], food[Fast food], area[riverside], familyFriendly[yes], near[Raja Indian Cuisine]"	Giraffe is a fast food restaurant in the riverside area near raja indian cuisine.
"name[Giraffe], eatType[restaurant], food[French], area[city centre], familyFriendly[no], near[Raja Indian Cuisine]"	Giraffe is a french restaurant located in the city centre near raja indian cuisine.
"name[Giraffe], eatType[restaurant], food[French], area[city centre], familyFriendly[yes], near[Raja Indian Cuisine]"	Giraffe is a french restaurant in the city centre near raja indian cuisine.
"name[Giraffe], eatType[restaurant], food[French], area[riverside], familyFriendly[no], near[Raja Indian Cuisine]"	Giraffe is a french restaurant in the riverside area near raja indian cuisine.
"name[Giraffe], eatType[restaurant], food[French], area[riverside], familyFriendly[yes], near[Raja Indian Cuisine]"	Giraffe is a french restaurant in the riverside area near raja indian cuisine.
"name[Green Man], eatType[coffee shop], customer rating[1 out of 5], near[All Bar One]"	Green man is a coffee shop located near all bar one.
"name[Green Man], eatType[coffee shop], customer rating[3 out of 5], near[All Bar One]"	Green man is a coffee shop near all bar one with a customer rating of 3 out of 5.
"name[Green Man], eatType[pub], customer rating[1 out of 5], near[All Bar One]"	Green man is a pub near all bar one with a customer rating of 1 out of 5.
"name[Green Man], eatType[pub], customer rating[3 out of 5], near[All Bar One]"	Green man is a pub near all bar one with a customer rating of 3 out of 5.
"name[Green Man], eatType[pub], food[Italian], area[riverside], familyFriendly[yes], near[Express by Holiday Inn]"	Green man is a family friendly pub near express by holiday inn.
"name[Green Man], eatType[pub], food[Italian], area[riverside], familyFriendly[yes], near[Raja Indian Cuisine]"	Green man is a family friendly pub located near raja indian cuisine in the riverside area.
"name[Green Man], eatType[pub], food[Japanese], area[city centre], familyFriendly[no], near[Express by Holiday Inn]"	Green man is a japanese pub in the city centre near express by holiday inn. it is not family-friendly.
"name[Green Man], eatType[pub], food[Japanese], area[city centre], familyFriendly[yes], near[Express by Holiday Inn]"	Green man is a family-friendly japanese pub located in the city centre near express by holiday inn.
"name[Green Man], eatType[pub], food[Japanese], area[riverside], familyFriendly[no], near[Express by Holiday Inn]"	Green man is a pub near express by holiday inn in riverside. it serves japanese food and is not family-friendly.
"name[Green Man], eatType[pub], food[Japanese], area[riverside], familyFriendly[yes], near[Express by Holiday Inn]"	Green man is a family friendly pub located near express by holiday inn.
"name[Green Man], eatType[restaurant], food[Italian], area[riverside], familyFriendly[yes], near[Express by Holiday Inn]"	Green man is a family friendly restaurant located near express by holiday inn.
"name[Green Man], eatType[restaurant], food[Italian], area[riverside], familyFriendly[yes], near[Raja Indian Cuisine]"	Green man is a family friendly italian restaurant in the riverside area.
"name[Green Man], eatType[restaurant], food[Japanese], area[city centre], familyFriendly[no], near[Express by Holiday Inn]"	Green man is a japanese restaurant located in the city centre near express by holiday inn. it is not family-friendly.
"name[Green Man], eatType[restaurant], food[Japanese], area[city centre], familyFriendly[yes], near[Express by Holiday Inn]"	Green man is a japanese restaurant located in the city centre near express by holiday inn.
"name[Green Man], eatType[restaurant], food[Japanese], area[riverside], familyFriendly[no], near[Express by Holiday Inn]"	Green man is a japanese restaurant in the riverside area near express by holiday inn. it is not family-friendly.
"name[Green Man], eatType[restaurant], food[Japanese], area[riverside], familyFriendly[yes], near[Express by Holiday Inn]"	Green man is a japanese restaurant in the riverside area near express by holiday inn.
"name[Loch Fyne], eatType[coffee shop], area[riverside]"	Loch fyne is a coffee shop in the riverside area.
"name[Loch Fyne], eatType[pub], area[riverside]"	Loch fyne is a pub in the riverside area.
"name[Strada], eatType[coffee shop], area[city centre]"	Strada is a coffee shop in the city centre.
"name[Strada], eatType[coffee shop], customer rating[1 out of 5], near[All Bar One]"	Strada is a coffee shop with a customer rating of 1 out of 5 and is near all bar one.
"name[Strada], eatType[coffee shop], customer rating[1 out of 5], near[Rainbow Vegetarian Café]"	Strada is a coffee shop near rainbow vegetarian café with a customer rating of 1 out of 5.
"name[Strada], eatType[coffee shop], customer rating[low], near[Express by Holiday Inn]"	Strada is a coffee shop near express by holiday inn.
"name[Strada], eatType[pub], area[city centre]"	Strada is a pub in the city centre.
"name[Strada], eatType[pub], customer rating[1 out of 5], near[All Bar One]"	Strada is a pub near all bar one with a customer rating of 1 out of 5.
"name[Strada], eatType[pub], customer rating[1 out of 5], near[Rainbow Vegetarian Café]"	Strada is a pub near rainbow vegetarian café with a customer rating of 1 out of 5.
"name[Strada], eatType[pub], customer rating[low], near[Express by Holiday Inn]"	Strada is a pub near express by holiday inn with a low customer rating.
"name[The Cricketers], eatType[coffee shop], customer rating[1 out of 5], familyFriendly[yes], near[Avalon]"	The cricketers is a family friendly coffee shop near avalon with a customer rating of 1 out of 5.
"name[The Cricketers], eatType[coffee shop], customer rating[3 out of 5], familyFriendly[yes], near[Avalon]"	The cricketers is a family friendly coffee shop near avalon.
"name[The Cricketers], eatType[coffee shop], customer rating[3 out of 5], familyFriendly[yes], near[Crowne Plaza Hotel]"	The cricketers is a children friendly coffee shop near crowne plaza hotel.
"name[The Cricketers], eatType[coffee shop], customer rating[5 out of 5], familyFriendly[no], near[Crowne Plaza Hotel]"	The cricketers is a coffee shop near the crowne plaza hotel. it is not family-friendly and has a customer rating of 5 out of 5.
"name[The Cricketers], eatType[coffee shop], customer rating[5 out of 5], familyFriendly[yes], near[Crowne Plaza Hotel]"	The cricketers is a family friendly coffee shop near the crowne plaza hotel.
"name[The Cricketers], eatType[coffee shop], customer rating[average], familyFriendly[no], near[Café Sicilia]"	The cricketers is a coffee shop near café sicilia. it has an average customer rating and is not family-friendly.
"name[The Cricketers], eatType[coffee shop], customer rating[average], familyFriendly[no], near[Crowne Plaza Hotel]"	The cricketers is a coffee shop located near the crowne plaza hotel.
"name[The Cricketers], eatType[coffee shop], customer rating[average], familyFriendly[yes], near[Café Sicilia]"	The cricketers is a family friendly coffee shop near café sicilia with an average customer rating.
"name[The Cricketers], eatType[coffee shop], customer rating[high], familyFriendly[yes], near[Café Sicilia]"	The cricketers is a children friendly coffee shop near café sicilia with a high customer rating.
"name[The Cricketers], eatType[coffee shop], customer rating[high], familyFriendly[yes], near[Express by Holiday Inn]"	The cricketers is a children friendly coffee shop near express by holiday inn.
"name[The Cricketers], eatType[coffee shop], customer rating[low], familyFriendly[no], near[Express by Holiday Inn]"	The cricketers is a coffee shop located near express by holiday inn.
"name[The Cricketers], eatType[coffee shop], customer rating[low], familyFriendly[no], near[Ranch]"	The cricketers is a coffee shop near ranch. it has a low customer rating and is not family-friendly.
"name[The Cricketers], eatType[coffee shop], customer rating[low], familyFriendly[yes], near[Ranch]"	The cricketers is a family friendly coffee shop near ranch with a low customer rating.
"name[The Cricketers], eatType[restaurant], customer rating[1 out of 5], familyFriendly[yes], near[Avalon]"	The cricketers is a family friendly restaurant with a customer rating of 1 out of 5.
"name[The Cricketers], eatType[restaurant], customer rating[3 out of 5], familyFriendly[yes], near[Avalon]"	The cricketers is a family friendly restaurant with a customer rating of 3 out of 5.
"name[The Cricketers], eatType[restaurant], customer rating[3 out of 5], familyFriendly[yes], near[Crowne Plaza Hotel]"	The cricketers is a family friendly restaurant near the crowne plaza hotel.
"name[The Cricketers], eatType[restaurant], customer rating[5 out of 5], familyFriendly[no], near[Crowne Plaza Hotel]"	The cricketers is a restaurant near the crowne plaza hotel. it is not family-friendly and has a customer rating of 5 out of 5.
"name[The Cricketers], eatType[restaurant], customer rating[5 out of 5], familyFriendly[yes], near[Crowne Plaza Hotel]"	The cricketers is a family friendly restaurant near the crowne plaza hotel.
"name[The Cricketers], eatType[restaurant], customer rating[average], familyFriendly[no], near[Café Sicilia]"	The cricketers is a restaurant near café sicilia with an average customer rating.
"name[The Cricketers], eatType[restaurant], customer rating[average], familyFriendly[no], near[Crowne Plaza Hotel]"	The cricketers is a restaurant near the crowne plaza hotel. it is not family-friendly and has an average customer rating.
"name[The Cricketers], eatType[restaurant], customer rating[average], familyFriendly[yes], near[Café Sicilia]"	The cricketers is a family friendly restaurant near café sicilia.
"name[The Cricketers], eatType[restaurant], customer rating[high], familyFriendly[yes], near[Café Sicilia]"	The cricketers is a child friendly restaurant near café sicilia.
"name[The Cricketers], eatType[restaurant], customer rating[high], familyFriendly[yes], near[Express by Holiday Inn]"	The cricketers is a child friendly restaurant near express by holiday inn.
"name[The Cricketers], eatType[restaurant], customer rating[low], familyFriendly[no], near[Express by Holiday Inn]"	The cricketers is a restaurant near express by holiday inn. it is not family-friendly.
"name[The Cricketers], eatType[restaurant], customer rating[low], familyFriendly[no], near[Ranch]"	The cricketers is a restaurant located near ranch.
"name[The Cricketers], eatType[restaurant], customer rating[low], familyFriendly[yes], near[Ranch]"	The cricketers is a family friendly restaurant with a low customer rating.
"name[The Cricketers], eatType[restaurant], food[Chinese], priceRange[£20-25], customer rating[high], area[city centre], familyFriendly[no], near[All Bar One]"	The cricketers is a chinese restaurant in the city centre near all bar one.
"name[The Cricketers], eatType[restaurant], food[Chinese], priceRange[£20-25], customer rating[high], area[city centre], familyFriendly[yes], near[All Bar One]"	The cricketers is a chinese restaurant in the city centre near all bar one.
"name[The Cricketers], eatType[restaurant], food[Chinese], priceRange[£20-25], customer rating[high], area[riverside], familyFriendly[no], near[All Bar One]"	The cricketers is a high rated chinese restaurant located near all bar one.
"name[The Cricketers], eatType[restaurant], food[Chinese], priceRange[£20-25], customer rating[high], area[riverside], familyFriendly[yes], near[All Bar One]"	The cricketers is a kid friendly chinese restaurant in the riverside area near all bar one.
"name[The Cricketers], eatType[restaurant], food[Chinese], priceRange[cheap], customer rating[5 out of 5], area[city centre], familyFriendly[no], near[All Bar One]"	The cricketers is a cheap chinese restaurant in the city centre near all bar one. it has a customer rating of 5 out of 5.
"name[The Cricketers], eatType[restaurant], food[Chinese], priceRange[cheap], customer rating[5 out of 5], area[city centre], familyFriendly[yes], near[All Bar One]"	The cricketers is a family-friendly chinese restaurant located in the city centre near all bar one.
"name[The Cricketers], eatType[restaurant], food[Chinese], priceRange[cheap], customer rating[5 out of 5], area[riverside], familyFriendly[no], near[All Bar One]"	The cricketers is a cheap chinese restaurant located in the riverside area near all bar one.
"name[The Cricketers], eatType[restaurant], food[Chinese], priceRange[cheap], customer rating[5 out of 5], area[riverside], familyFriendly[yes], near[All Bar One]"	The cricketers is a cheap, family friendly chinese restaurant located near all bar one.
"name[The Cricketers], eatType[restaurant], food[Chinese], priceRange[cheap], customer rating[average], area[city centre], familyFriendly[no], near[All Bar One]"	The cricketers is a cheap chinese restaurant in the city centre near all bar one.
"name[The Cricketers], eatType[restaurant], food[Chinese], priceRange[cheap], customer rating[average], area[city centre], familyFriendly[yes], near[All Bar One]"	The cricketers is a family friendly chinese restaurant located in the city centre near all bar one.
"name[The Cricketers], eatType[restaurant], food[Chinese], priceRange[cheap], customer rating[average], area[riverside], familyFriendly[no], near[All Bar One]"	The cricketers is a cheap chinese restaurant near all bar one in the riverside area.
"name[The Cricketers], eatType[restaurant], food[Chinese], priceRange[cheap], customer rating[average], area[riverside], familyFriendly[yes], near[All Bar One]"	The cricketers is a cheap, family friendly chinese restaurant located near all bar one.
"name[The Cricketers], eatType[restaurant], food[Chinese], priceRange[high], customer rating[1 out of 5], area[city centre], familyFriendly[no], near[All Bar One]"	The cricketers is a high priced chinese restaurant located in the city centre near all bar one.
"name[The Cricketers], eatType[restaurant], food[Chinese], priceRange[high], customer rating[1 out of 5], area[city centre], familyFriendly[yes], near[All Bar One]"	The cricketers is a chinese restaurant in the high price range. it is located in the city centre. it is near all bar one.
"name[The Cricketers], eatType[restaurant], food[Chinese], priceRange[high], customer rating[1 out of 5], area[riverside], familyFriendly[no], near[All Bar One]"	The cricketers is a high priced chinese restaurant located in the riverside area near all bar one.
"name[The Cricketers], eatType[restaurant], food[Chinese], priceRange[high], customer rating[1 out of 5], area[riverside], familyFriendly[yes], near[All Bar One]"	The cricketers is a restaurant providing chinese food in the high price range. it is located in the riverside. its customer rating is 1 out of 5.
"name[The Cricketers], eatType[restaurant], food[Chinese], priceRange[high], customer rating[average], area[city centre], familyFriendly[no], near[All Bar One]"	The cricketers is a high priced chinese restaurant located in the city centre near all bar one.
"name[The Cricketers], eatType[restaurant], food[Chinese], priceRange[high], customer rating[average], area[city centre], familyFriendly[yes], near[All Bar One]"	The cricketers is a restaurant providing chinese food in the high price range. it is near all bar one in the city centre.
"name[The Cricketers], eatType[restaurant], food[Chinese], priceRange[high], customer rating[average], area[riverside], familyFriendly[no], near[All Bar One]"	The cricketers is a high priced chinese restaurant in the riverside area near all bar one.
"name[The Cricketers], eatType[restaurant], food[Chinese], priceRange[high], customer rating[average], area[riverside], familyFriendly[yes], near[All Bar One]"	The cricketers is a restaurant providing chinese food in the high price range. it is located in the riverside. it is near all bar one. its customer rating is average.
"name[The Cricketers], eatType[restaurant], food[Chinese], priceRange[less than £20], customer rating[low], area[city centre], familyFriendly[no], near[All Bar One]"	The cricketers is a restaurant providing chinese food in the less than £20 price range. it is located near all bar one. its customer rating is low.
"name[The Cricketers], eatType[restaurant], food[Chinese], priceRange[less than £20], customer rating[low], area[city centre], familyFriendly[yes], near[All Bar One]"	The cricketers is a family friendly chinese restaurant located in the city centre near all bar one.
"name[The Cricketers], eatType[restaurant], food[Chinese], priceRange[less than £20], customer rating[low], area[riverside], familyFriendly[no], near[All Bar One]"	The cricketers is a restaurant providing chinese food in the less than £20 price range. it is located near all bar one. its customer rating is low.
"name[The Cricketers], eatType[restaurant], food[Chinese], priceRange[less than £20], customer rating[low], area[riverside], familyFriendly[yes], near[All Bar One]"	The cricketers is a family friendly chinese restaurant located near all bar one.
"name[The Cricketers], eatType[restaurant], food[Chinese], priceRange[moderate], customer rating[1 out of 5], area[city centre], familyFriendly[no], near[All Bar One]"	The cricketers is a moderately priced chinese restaurant located in the city centre near all bar one.
"name[The Cricketers], eatType[restaurant], food[Chinese], priceRange[moderate], customer rating[1 out of 5], area[city centre], familyFriendly[yes], near[All Bar One]"	The cricketers is a restaurant providing chinese food in the moderate price range. it is located in the city centre. its customer rating is 1 out of 5.
"name[The Cricketers], eatType[restaurant], food[Chinese], priceRange[moderate], customer rating[1 out of 5], area[riverside], familyFriendly[no], near[All Bar One]"	The cricketers is a restaurant providing chinese food in the moderate price range. it is located in the riverside. it is near all bar one. its customer rating is 1 out of 5.
"name[The Cricketers], eatType[restaurant], food[Chinese], priceRange[moderate], customer rating[1 out of 5], area[riverside], familyFriendly[yes], near[All Bar One]"	The cricketers is a restaurant providing chinese food in the moderate price range. it is located in the riverside. it is near all bar one. its customer rating is 1 out of 5.
"name[The Cricketers], eatType[restaurant], food[Chinese], priceRange[moderate], customer rating[3 out of 5], area[city centre], familyFriendly[no], near[All Bar One]"	The cricketers is a moderately priced chinese restaurant located in the city centre near all bar one.
"name[The Cricketers], eatType[restaurant], food[Chinese], priceRange[moderate], customer rating[3 out of 5], area[city centre], familyFriendly[yes], near[All Bar One]"	The cricketers is a restaurant providing chinese food in the moderate price range. it is near all bar one in the city centre.
"name[The Cricketers], eatType[restaurant], food[Chinese], priceRange[moderate], customer rating[3 out of 5], area[riverside], familyFriendly[no], near[All Bar One]"	The cricketers is a restaurant providing chinese food in the moderate price range. it is located in the riverside. it is near all bar one. its customer rating is 3 out of 5.
"name[The Cricketers], eatType[restaurant], food[Chinese], priceRange[moderate], customer rating[3 out of 5], area[riverside], familyFriendly[yes], near[All Bar One]"	The cricketers is a restaurant providing chinese food in the moderate price range. it is located in the riverside. it is near all bar one. its customer rating is 3 out of 5.
"name[The Cricketers], eatType[restaurant], food[Chinese], priceRange[more than £30], customer rating[high], area[city centre], familyFriendly[no], near[All Bar One]"	The cricketers is a chinese restaurant located in the city centre near all bar one.
"name[The Cricketers], eatType[restaurant], food[Chinese], priceRange[more than £30], customer rating[high], area[city centre], familyFriendly[yes], near[All Bar One]"	The cricketers is a family friendly chinese restaurant in the city centre near all bar one.
"name[The Cricketers], eatType[restaurant], food[Chinese], priceRange[more than £30], customer rating[high], area[riverside], familyFriendly[no], near[All Bar One]"	The cricketers is a restaurant providing chinese food in the more than £30 price range. it is located near all bar one. its customer rating is high.
"name[The Cricketers], eatType[restaurant], food[Chinese], priceRange[more than £30], customer rating[high], area[riverside], familyFriendly[yes], near[All Bar One]"	The cricketers is a child friendly chinese restaurant in the riverside area near all bar one.
"name[The Cricketers], eatType[restaurant], food[English], priceRange[£20-25], customer rating[high], area[city centre], familyFriendly[no], near[All Bar One]"	The cricketers is a moderately priced english restaurant located in the city centre near all bar one.
"name[The Cricketers], eatType[restaurant], food[English], priceRange[£20-25], customer rating[high], area[city centre], familyFriendly[yes], near[All Bar One]"	The cricketers is a kid friendly english restaurant in the city centre near all bar one.
"name[The Cricketers], eatType[restaurant], food[English], priceRange[£20-25], customer rating[high], area[riverside], familyFriendly[no], near[All Bar One]"	The cricketers is a restaurant located near all bar one.
"name[The Cricketers], eatType[restaurant], food[English], priceRange[£20-25], customer rating[high], area[riverside], familyFriendly[yes], near[All Bar One]"	The cricketers is a family friendly restaurant located near all bar one.
"name[The Cricketers], eatType[restaurant], food[English], priceRange[cheap], customer rating[5 out of 5], area[city centre], familyFriendly[no], near[Café Rouge]"	The cricketers is a cheap english restaurant located in the city centre near café rouge. it is not family-friendly.
"name[The Cricketers], eatType[restaurant], food[English], priceRange[cheap], customer rating[5 out of 5], area[city centre], familyFriendly[yes], near[Café Rouge]"	The cricketers is a cheap, family-friendly english restaurant located in the city centre near café rouge.
"name[The Cricketers], eatType[restaurant], food[English], priceRange[cheap], customer rating[5 out of 5], area[riverside], familyFriendly[no], near[Café Rouge]"	The cricketers is a cheap, family-friendly restaurant located near café rouge.
"name[The Cricketers], eatType[restaurant], food[English], priceRange[cheap], customer rating[5 out of 5], area[riverside], familyFriendly[yes], near[Café Rouge]"	The cricketers is a family friendly restaurant located near café rouge.
"name[The Cricketers], eatType[restaurant], food[English], priceRange[cheap], customer rating[average], area[city centre], familyFriendly[no], near[Café Rouge]"	The cricketers is a cheap english restaurant located in the city centre near café rouge.
"name[The Cricketers], eatType[restaurant], food[English], priceRange[cheap], customer rating[average], area[city centre], familyFriendly[yes], near[Café Rouge]"	The cricketers is a cheap english restaurant located in the city centre near café rouge.
"name[The Cricketers], eatType[restaurant], food[English], priceRange[cheap], customer rating[average], area[riverside], familyFriendly[no], near[Café Rouge]"	The cricketers is a cheap english restaurant located near café rouge in the riverside area.
"name[The Cricketers], eatType[restaurant], food[English], priceRange[cheap], customer rating[average], area[riverside], familyFriendly[yes], near[Café Rouge]"	The cricketers is a cheap family friendly restaurant located near café rouge.
"name[The Cricketers], eatType[restaurant], food[English], priceRange[high], customer rating[1 out of 5], area[city centre], familyFriendly[no], near[Café Rouge]"	The cricketers is a high priced english restaurant located in the city centre near café rouge.
"name[The Cricketers], eatType[restaurant], food[English], priceRange[high], customer rating[1 out of 5], area[city centre], familyFriendly[yes], near[Café Rouge]"	The cricketers is a high priced english restaurant located in the city centre near café rouge.
"name[The Cricketers], eatType[restaurant], food[English], priceRange[high], customer rating[1 out of 5], area[riverside], familyFriendly[no], near[Café Rouge]"	The cricketers is a high priced english restaurant located in the riverside area near café rouge.
"name[The Cricketers], eatType[restaurant], food[English], priceRange[high], customer rating[1 out of 5], area[riverside], familyFriendly[yes], near[Café Rouge]"	The cricketers is a high priced restaurant located near café rouge.
"name[The Cricketers], eatType[restaurant], food[English], priceRange[high], customer rating[average], area[city centre], familyFriendly[no], near[Café Rouge]"	The cricketers is a high priced english restaurant located in the city centre near café rouge.
"name[The Cricketers], eatType[restaurant], food[English], priceRange[high], customer rating[average], area[city centre], familyFriendly[yes], near[Café Rouge]"	The cricketers is a high priced english restaurant located in the city centre near café rouge.
"name[The Cricketers], eatType[restaurant], food[English], priceRange[high], customer rating[average], area[riverside], familyFriendly[no], near[Café Rouge]"	The cricketers is a high-priced english restaurant located near café rouge.
"name[The Mill], eatType[pub], food[English], priceRange[high], area[riverside], familyFriendly[yes], near[Raja Indian Cuisine]"	The mill is a children friendly pub located near raja indian cuisine in the riverside area.
"name[The Mill], eatType[pub], food[English], priceRange[less than £20], area[city centre], familyFriendly[no], near[Raja Indian Cuisine]"	The mill is a pub providing english food in the less than £20 price range. it is located near raja indian cuisine in the city centre.
"name[The Mill], eatType[pub], food[English], priceRange[less than £20], area[city centre], familyFriendly[yes], near[Raja Indian Cuisine]"	The mill is a family-friendly pub located in the city centre near raja indian cuisine.
"name[The Mill], eatType[pub], food[English], priceRange[less than £20], area[riverside], familyFriendly[no], near[Raja Indian Cuisine]"	The mill is a pub that serves english food in the less than £20 price range. it is located near raja indian cuisine.
"name[The Mill], eatType[pub], food[English], priceRange[less than £20], area[riverside], familyFriendly[yes], near[Raja Indian Cuisine]"	The mill is a family friendly pub located near raja indian cuisine.
"name[The Mill], eatType[pub], food[English], priceRange[moderate], area[city centre], familyFriendly[no], near[Raja Indian Cuisine]"	The mill is a pub providing english food in the moderate price range. it is located in the city centre near raja indian cuisine.
"name[The Mill], eatType[pub], food[English], priceRange[moderate], area[city centre], familyFriendly[yes], near[Raja Indian Cuisine]"	The mill is a kid friendly pub located in the city centre near raja indian cuisine.
"name[The Mill], eatType[pub], food[English], priceRange[moderate], area[riverside], familyFriendly[no], near[Raja Indian Cuisine]"	The mill is a moderately priced english pub located near raja indian cuisine in the riverside area.
"name[The Mill], eatType[pub], food[English], priceRange[moderate], area[riverside], familyFriendly[yes], near[Raja Indian Cuisine]"	The mill is a family friendly pub located near raja indian cuisine.
"name[The Mill], eatType[pub], food[English], priceRange[more than £30], area[riverside], familyFriendly[yes], near[Raja Indian Cuisine]"	The mill is a family friendly pub located near raja indian cuisine in the riverside area.
"name[The Mill], eatType[pub], food[Fast food], priceRange[£20-25], area[riverside], familyFriendly[yes], near[Raja Indian Cuisine]"	The mill is a kid friendly pub located near raja indian cuisine.
"name[The Mill], eatType[pub], food[Fast food], priceRange[£20-25], customer rating[high], area[city centre], familyFriendly[no], near[Café Rouge]"	The mill is a fast food pub located in the city centre near café rouge. it has a high customer rating and is not kid friendly.
"name[The Mill], eatType[pub], food[Fast food], priceRange[£20-25], customer rating[high], area[city centre], familyFriendly[yes], near[Café Rouge]"	The mill is a fast food pub located in the city centre near café rouge.
"name[The Mill], eatType[pub], food[Fast food], priceRange[£20-25], customer rating[high], area[riverside], familyFriendly[no], near[Café Rouge]"	The mill is a fast food pub near café rouge with a high customer rating and a price range of £20-25.
"name[The Mill], eatType[pub], food[Fast food], priceRange[£20-25], customer rating[high], area[riverside], familyFriendly[yes], near[Café Rouge]"	The mill is a fast food pub in the riverside area near café rouge. it is kid friendly and has a high customer rating.
"name[The Mill], eatType[pub], food[Fast food], priceRange[£20-25], customer rating[high], area[riverside], familyFriendly[yes], near[Café Sicilia]"	The mill is a kid friendly fast food pub near café sicilia with a high customer rating.
"name[The Mill], eatType[pub], food[Fast food], priceRange[cheap], area[riverside], familyFriendly[yes], near[Raja Indian Cuisine]"	The mill is a cheap fast food pub near raja indian cuisine in the riverside area.
"name[The Mill], eatType[pub], food[Fast food], priceRange[cheap], customer rating[5 out of 5], area[city centre], familyFriendly[no], near[Café Sicilia]"	The mill is a cheap fast food pub located in the city centre near café sicilia. it is not family-friendly.
"name[The Mill], eatType[pub], food[Fast food], priceRange[cheap], customer rating[5 out of 5], area[city centre], familyFriendly[yes], near[Café Sicilia]"	The mill is a cheap fast food pub in the city centre near café sicilia. it has a customer rating of 5 out of 5.
"name[The Mill], eatType[pub], food[Fast food], priceRange[cheap], customer rating[5 out of 5], area[riverside], familyFriendly[no], near[Café Sicilia]"	The mill is a cheap fast food pub in the riverside area near café sicilia. it is not family-friendly.
"name[The Mill], eatType[pub], food[Fast food], priceRange[cheap], customer rating[5 out of 5], area[riverside], familyFriendly[yes], near[Café Sicilia]"	The mill is a cheap, family friendly pub located near café sicilia.
"name[The Mill], eatType[pub], food[Fast food], priceRange[cheap], customer rating[average], area[city centre], familyFriendly[no], near[Café Sicilia]"	The mill is a cheap fast food pub located in the city centre near café sicilia. it is not family-friendly.
"name[The Mill], eatType[pub], food[Fast food], priceRange[cheap], customer rating[average], area[city centre], familyFriendly[yes], near[Café Sicilia]"	The mill is a cheap fast food pub located in the city centre near café sicilia.
"name[The Mill], eatType[pub], food[Fast food], priceRange[cheap], customer rating[average], area[riverside], familyFriendly[no], near[Café Sicilia]"	The mill is a cheap fast food pub near café sicilia. it is not family-friendly.
"name[The Mill], eatType[pub], food[Fast food], priceRange[cheap], customer rating[average], area[riverside], familyFriendly[yes], near[Café Sicilia]"	The mill is a cheap, family-friendly pub located near café sicilia.
"name[The Mill], eatType[pub], food[Fast food], priceRange[high], customer rating[1 out of 5], area[city centre], familyFriendly[no], near[Café Sicilia]"	The mill is a fast food pub located in the city centre near café sicilia. it is not child friendly and has a customer rating of 1 out of 5.
"name[The Mill], eatType[pub], food[Fast food], priceRange[high], customer rating[1 out of 5], area[city centre], familyFriendly[yes], near[Café Sicilia]"	The mill is a pub that serves fast food in the high price range. it is located in the city centre, near café sicilia.
"name[The Mill], eatType[pub], food[Fast food], priceRange[high], customer rating[1 out of 5], area[riverside], familyFriendly[no], near[Café Sicilia]"	The mill is a fast food pub located in the riverside area near café sicilia.
"name[The Mill], eatType[pub], food[Fast food], priceRange[high], customer rating[1 out of 5], area[riverside], familyFriendly[yes], near[Café Sicilia]"	The mill is a pub that serves fast food. it is located near café sicilia.
"name[The Mill], eatType[pub], food[Fast food], priceRange[high], customer rating[average], area[city centre], familyFriendly[no], near[Café Sicilia]"	The mill is a high priced fast food pub located in the city centre near café sicilia. it is not children friendly.
"name[The Mill], eatType[pub], food[Fast food], priceRange[high], customer rating[average], area[city centre], familyFriendly[yes], near[Café Sicilia]"	The mill is a fast food pub located in the city centre near café sicilia.
"name[The Mill], eatType[pub], food[Fast food], priceRange[high], customer rating[average], area[riverside], familyFriendly[no], near[Café Sicilia]"	The mill is a fast food pub in the high price range. it is located near café sicilia.
"name[The Mill], eatType[pub], food[Fast food], priceRange[high], customer rating[average], area[riverside], familyFriendly[yes], near[Café Sicilia]"	The mill is a fast food pub located near café sicilia in the riverside area.
"name[The Mill], eatType[pub], food[Fast food], priceRange[less than £20], customer rating[low], area[city centre], familyFriendly[no], near[Café Sicilia]"	The mill is a fast food pub located in the city centre near café sicilia. it is not family-friendly and has a low customer rating.
"name[The Mill], eatType[pub], food[Fast food], priceRange[less than £20], customer rating[low], area[city centre], familyFriendly[yes], near[Café Sicilia]"	The mill is a family-friendly fast food pub in the city centre near café sicilia with a low customer rating.
"name[The Mill], eatType[pub], food[Fast food], priceRange[less than £20], customer rating[low], area[riverside], familyFriendly[no], near[Café Sicilia]"	The mill is a fast food pub in the riverside area near café sicilia. it is not family-friendly and has a low customer rating.
"name[The Mill], eatType[pub], food[Fast food], priceRange[less than £20], customer rating[low], area[riverside], familyFriendly[yes], near[Café Sicilia]"	The mill is a family friendly pub located near café café sicilia.
"name[The Mill], eatType[pub], food[Fast food], priceRange[moderate], customer rating[1 out of 5], area[city centre], familyFriendly[no], near[Café Sicilia]"	The mill is a fast food pub located in the city centre near café sicilia. it is not kid friendly and has a customer rating of 1 out of 5.
"name[The Mill], eatType[pub], food[Fast food], priceRange[moderate], customer rating[1 out of 5], area[city centre], familyFriendly[yes], near[Café Sicilia]"	The mill is a fast food pub in the city centre near café sicilia. it is kid friendly and has a customer rating of 1 out of 5.
"name[The Mill], eatType[pub], food[Fast food], priceRange[moderate], customer rating[1 out of 5], area[riverside], familyFriendly[no], near[Café Sicilia]"	The mill is a fast food pub in the riverside area near café sicilia. it is not kid friendly and has a customer rating of 1 out of 5.
"name[The Mill], eatType[pub], food[Fast food], priceRange[moderate], customer rating[1 out of 5], area[riverside], familyFriendly[yes], near[Café Sicilia]"	The mill is a kid friendly pub in the moderate price range. it is located near café sicilia.
"name[The Mill], eatType[pub], food[Fast food], priceRange[moderate], customer rating[3 out of 5], area[city centre], familyFriendly[no], near[Café Sicilia]"	The mill is a fast food pub located in the city centre near café sicilia. it is not kid friendly and has a customer rating of 3 out of 5.
"name[The Mill], eatType[pub], food[Fast food], priceRange[moderate], customer rating[3 out of 5], area[city centre], familyFriendly[yes], near[Café Sicilia]"	The mill is a fast food pub located near café sicilia in the city centre with a customer rating of 3 out of 5.
"name[The Mill], eatType[pub], food[Fast food], priceRange[moderate], customer rating[3 out of 5], area[riverside], familyFriendly[no], near[Café Sicilia]"	The mill is a moderately priced fast food pub located near café sicilia.
"name[The Mill], eatType[pub], food[Fast food], priceRange[moderate], customer rating[3 out of 5], area[riverside], familyFriendly[yes], near[Café Sicilia]"	The mill is a moderately priced pub located near café café sicilia.
"name[The Mill], eatType[restaurant], food[English], priceRange[high], area[riverside], familyFriendly[yes], near[Raja Indian Cuisine]"	The mill is a high priced english restaurant in the riverside area near raja indian cuisine.
"name[The Mill], eatType[restaurant], food[English], priceRange[high], customer rating[average], area[riverside], familyFriendly[yes], near[Café Rouge]"	The mill is a family friendly restaurant located near café rouge.
"name[The Mill], eatType[restaurant], food[English], priceRange[less than £20], area[city centre], familyFriendly[no], near[Raja Indian Cuisine]"	The mill is a english restaurant located in the city centre near raja indian cuisine.
"name[The Mill], eatType[restaurant], food[English], priceRange[less than £20], area[city centre], familyFriendly[yes], near[Raja Indian Cuisine]"	The mill is a family-friendly english restaurant located in the city centre near raja indian cuisine.
"name[The Mill], eatType[restaurant], food[English], priceRange[less than £20], area[riverside], familyFriendly[no], near[Raja Indian Cuisine]"	The mill is a english restaurant located near raja indian cuisine in the riverside area.
"name[The Mill], eatType[restaurant], food[English], priceRange[less than £20], area[riverside], familyFriendly[yes], near[Raja Indian Cuisine]"	The mill is a family friendly restaurant located near raja indian cuisine.
"name[The Mill], eatType[restaurant], food[English], priceRange[less than £20], customer rating[low], area[city centre], familyFriendly[no], near[Café Rouge]"	The mill is a cheap english restaurant located in the city centre near café rouge.
"name[The Mill], eatType[restaurant], food[English], priceRange[less than £20], customer rating[low], area[city centre], familyFriendly[yes], near[Café Rouge]"	The mill is a family-friendly english restaurant located in the city centre near café rouge.
"name[The Mill], eatType[restaurant], food[English], priceRange[less than £20], customer rating[low], area[riverside], familyFriendly[no], near[Café Rouge]"	The mill is a low-priced restaurant located near café rouge.
"name[The Mill], eatType[restaurant], food[English], priceRange[less than £20], customer rating[low], area[riverside], familyFriendly[yes], near[Café Rouge]"	The mill is a family friendly restaurant located near café rouge.
"name[The Mill], eatType[restaurant], food[English], priceRange[moderate], area[city centre], familyFriendly[no], near[Raja Indian Cuisine]"	The mill is a moderately priced english restaurant located in the city centre near raja indian cuisine.
"name[The Mill], eatType[restaurant], food[English], priceRange[moderate], area[city centre], familyFriendly[yes], near[Raja Indian Cuisine]"	The mill is a moderately priced english restaurant in the city centre near raja indian cuisine.
"name[The Mill], eatType[restaurant], food[English], priceRange[moderate], area[riverside], familyFriendly[no], near[Raja Indian Cuisine]"	The mill is a moderately priced english restaurant in the riverside area near raja indian cuisine.
"name[The Mill], eatType[restaurant], food[English], priceRange[moderate], area[riverside], familyFriendly[yes], near[Raja Indian Cuisine]"	The mill is a moderately priced english restaurant in the riverside area near raja indian cuisine.
"name[The Mill], eatType[restaurant], food[English], priceRange[moderate], customer rating[1 out of 5], area[city centre], familyFriendly[no], near[Café Rouge]"	The mill is a moderately priced english restaurant located in the city centre near café rouge.
"name[The Mill], eatType[restaurant], food[English], priceRange[moderate], customer rating[1 out of 5], area[city centre], familyFriendly[yes], near[Café Rouge]"	The mill is a moderately priced english restaurant located in the city centre near café rouge.
"name[The Mill], eatType[restaurant], food[English], priceRange[moderate], customer rating[1 out of 5], area[riverside], familyFriendly[no], near[Café Rouge]"	The mill is a moderately priced english restaurant located near café rouge.
"name[The Mill], eatType[restaurant], food[English], priceRange[moderate], customer rating[1 out of 5], area[riverside], familyFriendly[yes], near[Café Rouge]"	The mill is a moderately priced, family friendly restaurant located near café rouge.
"name[The Mill], eatType[restaurant], food[English], priceRange[moderate], customer rating[3 out of 5], area[city centre], familyFriendly[no], near[Café Rouge]"	The mill is a moderately priced english restaurant located in the city centre near café rouge.
"name[The Mill], eatType[restaurant], food[English], priceRange[moderate], customer rating[3 out of 5], area[city centre], familyFriendly[yes], near[Café Rouge]"	The mill is a moderately priced english restaurant located in the city centre near café rouge.
"name[The Mill], eatType[restaurant], food[English], priceRange[moderate], customer rating[3 out of 5], area[riverside], familyFriendly[no], near[Café Rouge]"	The mill is a moderately priced english restaurant located in the riverside area near café rouge.
"name[The Mill], eatType[restaurant], food[English], priceRange[moderate], customer rating[3 out of 5], area[riverside], familyFriendly[yes], near[Café Rouge]"	The mill is a moderately priced, kid friendly restaurant located near café rouge.
"name[The Mill], eatType[restaurant], food[English], priceRange[more than £30], area[riverside], familyFriendly[yes], near[Raja Indian Cuisine]"	The mill is a children friendly english restaurant in the riverside area near raja indian cuisine.
"name[The Mill], eatType[restaurant], food[English], priceRange[more than £30], customer rating[high], area[city centre], familyFriendly[no], near[Café Rouge]"	The mill is a english restaurant in the more than £30 price range. it is located in the city centre near café rouge.
"name[The Mill], eatType[restaurant], food[English], priceRange[more than £30], customer rating[high], area[city centre], familyFriendly[yes], near[Café Rouge]"	The mill is a child friendly english restaurant located in the city centre near café rouge.
"name[The Mill], eatType[restaurant], food[English], priceRange[more than £30], customer rating[high], area[riverside], familyFriendly[no], near[Café Rouge]"	The mill is a highly rated english restaurant located near café rouge.
"name[The Mill], eatType[restaurant], food[English], priceRange[more than £30], customer rating[high], area[riverside], familyFriendly[yes], near[Café Rouge]"	The mill is a child friendly english restaurant located near café rouge.
"name[The Mill], eatType[restaurant], food[Fast food], priceRange[£20-25], area[riverside], familyFriendly[yes], near[Raja Indian Cuisine]"	The mill is a fast food restaurant near raja indian cuisine in the riverside area.
"name[The Mill], eatType[restaurant], food[Fast food], priceRange[cheap], area[riverside], familyFriendly[yes], near[Raja Indian Cuisine]"	The mill is a cheap fast food restaurant in the riverside area near raja indian cuisine.
"name[The Phoenix], eatType[pub], food[Fast food], priceRange[cheap], area[riverside], familyFriendly[yes], near[Raja Indian Cuisine]"	The phoenix is a family friendly pub located near raja raja indian cuisine.
"name[The Phoenix], eatType[pub], food[Fast food], priceRange[high], area[city centre], familyFriendly[no], near[Raja Indian Cuisine]"	The phoenix is a high priced fast food pub located in the city centre near raja indian cuisine.
"name[The Phoenix], eatType[pub], food[Fast food], priceRange[high], area[city centre], familyFriendly[yes], near[Raja Indian Cuisine]"	The phoenix is a high-priced fast food pub located near raja indian cuisine in the city centre.
"name[The Phoenix], eatType[pub], food[Fast food], priceRange[high], area[riverside], familyFriendly[no], near[Raja Indian Cuisine]"	The phoenix is a fast food pub located near raja indian cuisine in the riverside area.
"name[The Phoenix], eatType[pub], food[Fast food], priceRange[high], area[riverside], familyFriendly[yes], near[Raja Indian Cuisine]"	The phoenix is a fast food pub located near raja indian cuisine in riverside.
"name[The Phoenix], eatType[pub], food[Fast food], priceRange[less than £20], area[city centre], familyFriendly[no], near[Raja Indian Cuisine]"	The phoenix is a fast food pub located in the city centre near raja indian cuisine.
"name[The Phoenix], eatType[pub], food[Fast food], priceRange[less than £20], area[city centre], familyFriendly[yes], near[Raja Indian Cuisine]"	The phoenix is a family-friendly fast food pub near raja indian cuisine in the city centre.
"name[The Phoenix], eatType[pub], food[Fast food], priceRange[less than £20], area[riverside], familyFriendly[no], near[Raja Indian Cuisine]"	The phoenix is a fast food pub in the riverside area near raja indian cuisine.
"name[The Phoenix], eatType[pub], food[Fast food], priceRange[less than £20], area[riverside], familyFriendly[yes], near[Raja Indian Cuisine]"	The phoenix is a family friendly fast food pub near raja indian cuisine in the riverside area.
"name[The Phoenix], eatType[pub], food[Fast food], priceRange[moderate], area[city centre], familyFriendly[no], near[Raja Indian Cuisine]"	The phoenix is a moderately priced fast food pub located in the city centre near raja indian cuisine.
"name[The Phoenix], eatType[pub], food[Fast food], priceRange[moderate], area[city centre], familyFriendly[yes], near[Raja Indian Cuisine]"	The phoenix is a fast food pub located in the city centre near raja indian cuisine.
"name[The Phoenix], eatType[pub], food[Fast food], priceRange[moderate], area[riverside], familyFriendly[no], near[Raja Indian Cuisine]"	The phoenix is a moderately priced fast food pub located in riverside near raja indian cuisine.
"name[The Phoenix], eatType[pub], food[Fast food], priceRange[moderate], area[riverside], familyFriendly[yes], near[Raja Indian Cuisine]"	The phoenix is a family friendly pub located near raja raja indian cuisine.
"name[The Phoenix], eatType[pub], food[Fast food], priceRange[moderate], customer rating[3 out of 5], area[riverside], familyFriendly[yes], near[Café Sicilia]"	The phoenix is a family friendly pub located near café sicilia.
"name[The Phoenix], eatType[pub], food[Fast food], priceRange[more than £30], area[riverside], familyFriendly[yes], near[Raja Indian Cuisine]"	The phoenix is a fast food pub located near raja indian cuisine in riverside.
"name[The Phoenix], eatType[pub], food[Fast food], priceRange[more than £30], customer rating[high], area[city centre], familyFriendly[no], near[Café Sicilia]"	The phoenix is a fast food pub in the more than £30 price range. it is located near café sicilia in the city centre.
"name[The Phoenix], eatType[pub], food[Fast food], priceRange[more than £30], customer rating[high], area[city centre], familyFriendly[yes], near[Café Sicilia]"	The phoenix is a child friendly pub located in the city centre near café sicilia. it serves fast food and has a high customer rating.
"name[The Phoenix], eatType[pub], food[Fast food], priceRange[more than £30], customer rating[high], area[riverside], familyFriendly[no], near[Café Sicilia]"	The phoenix is a fast food pub in the riverside area near café sicilia. it is not child friendly and has a price range of more than £30.
"name[The Phoenix], eatType[pub], food[Fast food], priceRange[more than £30], customer rating[high], area[riverside], familyFriendly[yes], near[Café Sicilia]"	The phoenix is a child friendly pub located near café sicilia.
"name[The Phoenix], eatType[pub], food[French], priceRange[£20-25], area[riverside], familyFriendly[yes], near[Raja Indian Cuisine]"	The phoenix is a kid friendly pub located near raja indian cuisine.
"name[The Phoenix], eatType[pub], food[French], priceRange[£20-25], customer rating[3 out of 5], area[city centre], familyFriendly[no], near[Café Sicilia]"	The phoenix is a french pub located in the city centre near café sicilia. it is not kid friendly and has a price range of £20-25.
"name[The Phoenix], eatType[pub], food[French], priceRange[£20-25], customer rating[3 out of 5], area[city centre], familyFriendly[yes], near[Café Sicilia]"	The phoenix is a family-friendly french pub located in the city centre near café sicilia with a customer rating of 3 out of 5.
"name[The Phoenix], eatType[pub], food[French], priceRange[£20-25], customer rating[3 out of 5], area[riverside], familyFriendly[no], near[Café Sicilia]"	The phoenix is a french pub near café sicilia with a customer rating of 3 out of 5 and is not kid friendly.
"name[The Phoenix], eatType[pub], food[French], priceRange[£20-25], customer rating[3 out of 5], area[riverside], familyFriendly[yes], near[Café Sicilia]"	The phoenix is a family friendly pub located near café sicilia.
"name[The Phoenix], eatType[pub], food[French], priceRange[£20-25], customer rating[3 out of 5], area[riverside], familyFriendly[yes], near[Crowne Plaza Hotel]"	The phoenix is a kid friendly pub located near crowne plaza hotel.
"name[The Phoenix], eatType[pub], food[French], priceRange[£20-25], customer rating[high], area[city centre], familyFriendly[no], near[Crowne Plaza Hotel]"	The phoenix is a pub providing french food in the £20-25 price range. it is located in the city centre and is near crowne plaza hotel.
"name[The Phoenix], eatType[pub], food[French], priceRange[£20-25], customer rating[high], area[city centre], familyFriendly[yes], near[Crowne Plaza Hotel]"	The phoenix is a family-friendly pub located in the city centre near crowne plaza hotel.
"name[The Phoenix], eatType[pub], food[French], priceRange[£20-25], customer rating[high], area[riverside], familyFriendly[no], near[Crowne Plaza Hotel]"	The phoenix is a pub that serves french food in the £20-25 price range. it is near crowne plaza hotel.
"name[The Phoenix], eatType[pub], food[French], priceRange[£20-25], customer rating[high], area[riverside], familyFriendly[yes], near[Crowne Plaza Hotel]"	The phoenix is a family-friendly pub located near the crowne plaza hotel.
"name[The Phoenix], eatType[pub], food[French], priceRange[cheap], area[riverside], familyFriendly[yes], near[Raja Indian Cuisine]"	The phoenix is a cheap french pub in the riverside area near raja indian cuisine.
"name[The Phoenix], eatType[pub], food[French], priceRange[cheap], customer rating[5 out of 5], area[city centre], familyFriendly[no], near[Crowne Plaza Hotel]"	The phoenix is a cheap french pub located in the city centre near the crowne plaza hotel. it is not family-friendly.
"name[The Phoenix], eatType[pub], food[French], priceRange[cheap], customer rating[5 out of 5], area[city centre], familyFriendly[yes], near[Crowne Plaza Hotel]"	The phoenix is a cheap, family-friendly french pub located in the city centre near the crowne plaza hotel.
"name[The Phoenix], eatType[pub], food[French], priceRange[cheap], customer rating[5 out of 5], area[riverside], familyFriendly[no], near[Crowne Plaza Hotel]"	The phoenix is a cheap french pub near crowne plaza hotel in the riverside area. it has a customer rating of 5 out of 5.
"name[The Phoenix], eatType[pub], food[French], priceRange[cheap], customer rating[5 out of 5], area[riverside], familyFriendly[yes], near[Crowne Plaza Hotel]"	The phoenix is a cheap, family friendly pub located near the crowne plaza hotel.
"name[The Phoenix], eatType[pub], food[French], priceRange[high], area[riverside], familyFriendly[yes], near[Raja Indian Cuisine]"	The phoenix is a children friendly french pub near raja indian cuisine in the riverside area.
"name[The Phoenix], eatType[pub], food[French], priceRange[high], customer rating[3 out of 5], area[city centre], familyFriendly[no], near[Crowne Plaza Hotel]"	The phoenix is a french pub located in the city centre near the crowne plaza hotel. it is not child friendly and has a customer rating of 3 out of 5.
"name[The Phoenix], eatType[pub], food[French], priceRange[high], customer rating[3 out of 5], area[city centre], familyFriendly[yes], near[Crowne Plaza Hotel]"	The phoenix is a high priced french pub located in the city centre near the crowne plaza hotel.
"name[The Phoenix], eatType[pub], food[French], priceRange[high], customer rating[3 out of 5], area[riverside], familyFriendly[no], near[Crowne Plaza Hotel]"	The phoenix is a pub that serves french food in the high price range. it is located near the crowne plaza hotel. its customer rating is 3 out of 5.
"name[The Phoenix], eatType[pub], food[French], priceRange[high], customer rating[3 out of 5], area[riverside], familyFriendly[yes], near[Crowne Plaza Hotel]"	The phoenix is a family friendly pub located near the crowne plaza hotel.
"name[The Phoenix], eatType[pub], food[French], priceRange[less than £20], customer rating[average], area[city centre], familyFriendly[no], near[Crowne Plaza Hotel]"	The phoenix is a french pub located in the city centre near the crowne plaza hotel. it is not family-friendly and has an average customer rating.
"name[The Phoenix], eatType[pub], food[French], priceRange[less than £20], customer rating[average], area[city centre], familyFriendly[yes], near[Crowne Plaza Hotel]"	The phoenix is a family-friendly pub located in the city centre near the crowne plaza hotel.
"name[The Phoenix], eatType[pub], food[French], priceRange[less than £20], customer rating[average], area[riverside], familyFriendly[no], near[Crowne Plaza Hotel]"	The phoenix is a french pub near the crowne plaza hotel in the riverside area. it is not family-friendly and has an average customer rating.
"name[The Phoenix], eatType[pub], food[French], priceRange[less than £20], customer rating[average], area[riverside], familyFriendly[yes], near[Crowne Plaza Hotel]"	The phoenix is a family friendly pub located near crowne plaza hotel.
"name[The Phoenix], eatType[pub], food[French], priceRange[less than £20], customer rating[low], area[city centre], familyFriendly[no], near[Crowne Plaza Hotel]"	The phoenix is a french pub located in the city centre near the crowne plaza hotel. it is not family-friendly and has a low customer rating.
"name[The Phoenix], eatType[pub], food[French], priceRange[less than £20], customer rating[low], area[city centre], familyFriendly[yes], near[Crowne Plaza Hotel]"	The phoenix is a family-friendly french pub located near crowne plaza hotel in the city centre with a low customer rating.
"name[The Phoenix], eatType[pub], food[French], priceRange[less than £20], customer rating[low], area[riverside], familyFriendly[no], near[Crowne Plaza Hotel]"	The phoenix is a pub that serves french food. it is located near crowne plaza hotel.
"name[The Phoenix], eatType[pub], food[French], priceRange[less than £20], customer rating[low], area[riverside], familyFriendly[yes], near[Crowne Plaza Hotel]"	The phoenix is a family friendly pub located near the crowne plaza hotel.
"name[The Phoenix], eatType[pub], food[French], priceRange[moderate], customer rating[1 out of 5], area[city centre], familyFriendly[no], near[Crowne Plaza Hotel]"	The phoenix is a pub serving french food in the moderate price range. it is located near the crowne plaza hotel in the city centre.
"name[The Phoenix], eatType[pub], food[French], priceRange[moderate], customer rating[1 out of 5], area[city centre], familyFriendly[yes], near[Crowne Plaza Hotel]"	The phoenix is a family-friendly pub located in the city centre near crowne plaza hotel. it serves french food and has a customer rating of 1 out of 5.
"name[The Phoenix], eatType[pub], food[French], priceRange[moderate], customer rating[1 out of 5], area[riverside], familyFriendly[no], near[Crowne Plaza Hotel]"	The phoenix is a pub that serves french food. it is located near the crowne plaza hotel.
"name[The Phoenix], eatType[pub], food[French], priceRange[moderate], customer rating[1 out of 5], area[riverside], familyFriendly[yes], near[Crowne Plaza Hotel]"	The phoenix is a kid friendly pub located near the crowne plaza hotel.
"name[The Phoenix], eatType[pub], food[French], priceRange[more than £30], customer rating[5 out of 5], area[city centre], familyFriendly[no], near[Crowne Plaza Hotel]"	The phoenix is a french pub in the more than £30 price range. it is located near crowne plaza hotel in the city centre.
"name[The Phoenix], eatType[pub], food[French], priceRange[more than £30], customer rating[5 out of 5], area[city centre], familyFriendly[yes], near[Crowne Plaza Hotel]"	The phoenix is a family-friendly pub located in the city centre near the crowne plaza hotel.
"name[The Phoenix], eatType[pub], food[French], priceRange[more than £30], customer rating[5 out of 5], area[riverside], familyFriendly[no], near[Crowne Plaza Hotel]"	The phoenix is a french pub in the more than £30 price range. it is located near the crowne plaza hotel.
"name[The Phoenix], eatType[pub], food[French], priceRange[more than £30], customer rating[5 out of 5], area[riverside], familyFriendly[yes], near[Crowne Plaza Hotel]"	The phoenix is a family friendly pub located near the crowne plaza hotel.
"name[The Phoenix], eatType[pub], food[French], priceRange[more than £30], customer rating[low], area[city centre], familyFriendly[no], near[Crowne Plaza Hotel]"	The phoenix is a french pub in the more than £30 price range. it is located in the city centre and is not family-friendly.
"name[The Phoenix], eatType[pub], food[French], priceRange[more than £30], customer rating[low], area[city centre], familyFriendly[yes], near[Crowne Plaza Hotel]"	The phoenix is a family-friendly french pub located in the city centre near the crowne plaza hotel.
"name[The Phoenix], eatType[pub], food[French], priceRange[more than £30], customer rating[low], area[riverside], familyFriendly[no], near[Crowne Plaza Hotel]"	The phoenix is a french pub located in the riverside area near crowne plaza hotel. it is not children friendly and has a low customer rating.
"name[The Phoenix], eatType[pub], food[French], priceRange[more than £30], customer rating[low], area[riverside], familyFriendly[yes], near[Crowne Plaza Hotel]"	The phoenix is a family friendly pub located near the crowne plaza hotel.
"name[The Phoenix], eatType[restaurant], food[Fast food], priceRange[cheap], area[riverside], familyFriendly[yes], near[Raja Indian Cuisine]"	The phoenix is a cheap fast food restaurant in the riverside area near raja indian cuisine.
"name[The Phoenix], eatType[restaurant], food[Fast food], priceRange[high], area[city centre], familyFriendly[no], near[Raja Indian Cuisine]"	The phoenix is a fast food restaurant located in the city centre near raja indian cuisine.
"name[The Phoenix], eatType[restaurant], food[Fast food], priceRange[high], area[city centre], familyFriendly[yes], near[Raja Indian Cuisine]"	The phoenix is a fast food restaurant in the city centre near raja indian cuisine.
"name[The Phoenix], eatType[restaurant], food[Fast food], priceRange[high], area[riverside], familyFriendly[no], near[Raja Indian Cuisine]"	The phoenix is a high priced fast food restaurant located near raja indian cuisine.
"name[The Phoenix], eatType[restaurant], food[Fast food], priceRange[high], area[riverside], familyFriendly[yes], near[Raja Indian Cuisine]"	The phoenix is a high priced fast food restaurant in the riverside area near raja indian cuisine.
"name[The Phoenix], eatType[restaurant], food[Fast food], priceRange[less than £20], area[city centre], familyFriendly[no], near[Raja Indian Cuisine]"	The phoenix is a fast food restaurant located in the city centre near raja indian cuisine.
"name[The Phoenix], eatType[restaurant], food[Fast food], priceRange[less than £20], area[city centre], familyFriendly[yes], near[Raja Indian Cuisine]"	The phoenix is a family-friendly fast food restaurant in the city centre near raja indian cuisine.
"name[The Phoenix], eatType[restaurant], food[Fast food], priceRange[less than £20], area[riverside], familyFriendly[no], near[Raja Indian Cuisine]"	The phoenix is a fast food restaurant located in the riverside area near raja indian cuisine.
"name[The Phoenix], eatType[restaurant], food[Fast food], priceRange[less than £20], area[riverside], familyFriendly[yes], near[Raja Indian Cuisine]"	The phoenix is a family friendly fast food restaurant in the riverside area near raja indian cuisine.
"name[The Phoenix], eatType[restaurant], food[Fast food], priceRange[moderate], area[city centre], familyFriendly[no], near[Raja Indian Cuisine]"	The phoenix is a moderately priced fast food restaurant in the city centre near raja indian cuisine.
"name[The Phoenix], eatType[restaurant], food[Fast food], priceRange[moderate], area[city centre], familyFriendly[yes], near[Raja Indian Cuisine]"	The phoenix is a moderately priced fast food restaurant in the city centre near raja indian cuisine.
"name[The Phoenix], eatType[restaurant], food[Fast food], priceRange[moderate], area[riverside], familyFriendly[no], near[Raja Indian Cuisine]"	The phoenix is a moderately priced fast food restaurant in the riverside area near raja indian cuisine.
"name[The Phoenix], eatType[restaurant], food[Fast food], priceRange[moderate], area[riverside], familyFriendly[yes], near[Raja Indian Cuisine]"	The phoenix is a moderately priced fast food restaurant in the riverside area near raja indian cuisine.
"name[The Phoenix], eatType[restaurant], food[Fast food], priceRange[more than £30], area[riverside], familyFriendly[yes], near[Raja Indian Cuisine]"	The phoenix is a children friendly fast food restaurant located near raja indian cuisine.
"name[The Phoenix], eatType[restaurant], food[French], priceRange[£20-25], area[riverside], familyFriendly[yes], near[Raja Indian Cuisine]"	The phoenix is a family friendly restaurant located near raja indian cuisine.
"name[The Phoenix], eatType[restaurant], food[French], priceRange[cheap], area[riverside], familyFriendly[yes], near[Raja Indian Cuisine]"	The phoenix is a cheap french restaurant in the riverside area near raja indian cuisine.
"name[The Phoenix], eatType[restaurant], food[French], priceRange[high], area[riverside], familyFriendly[yes], near[Raja Indian Cuisine]"	The phoenix is a children friendly french restaurant located in the riverside area near raja indian cuisine.
"name[The Phoenix], eatType[restaurant], food[Indian], priceRange[£20-25], customer rating[high], area[city centre], familyFriendly[no], near[Crowne Plaza Hotel]"	The phoenix is a restaurant providing indian food in the £20-25 price range. it is located in the city centre. its customer rating is high.
"name[The Phoenix], eatType[restaurant], food[Indian], priceRange[£20-25], customer rating[high], area[city centre], familyFriendly[yes], near[Crowne Plaza Hotel]"	The phoenix is a kid friendly indian restaurant located in the city centre near crowne plaza hotel.
"name[The Phoenix], eatType[restaurant], food[Indian], priceRange[£20-25], customer rating[high], area[riverside], familyFriendly[no], near[Crowne Plaza Hotel]"	The phoenix is a restaurant providing indian food in the £20-25 price range. it is located in the riverside. its customer rating is high.
"name[The Phoenix], eatType[restaurant], food[Indian], priceRange[£20-25], customer rating[high], area[riverside], familyFriendly[yes], near[Crowne Plaza Hotel]"	The phoenix is a restaurant providing indian food in the £20-25 price range. it is located in the riverside. its customer rating is high.
"name[The Phoenix], eatType[restaurant], food[Indian], priceRange[cheap], customer rating[5 out of 5], area[city centre], familyFriendly[no], near[Crowne Plaza Hotel]"	The phoenix is a cheap indian restaurant located in the city centre near crowne plaza hotel.
"name[The Phoenix], eatType[restaurant], food[Indian], priceRange[cheap], customer rating[5 out of 5], area[city centre], familyFriendly[yes], near[Crowne Plaza Hotel]"	The phoenix is a cheap indian restaurant in the city centre near the crowne plaza hotel.
"name[The Phoenix], eatType[restaurant], food[Indian], priceRange[cheap], customer rating[5 out of 5], area[riverside], familyFriendly[no], near[Crowne Plaza Hotel]"	The phoenix is a cheap indian restaurant in the riverside area near the crowne plaza hotel.
"name[The Phoenix], eatType[restaurant], food[Indian], priceRange[cheap], customer rating[5 out of 5], area[riverside], familyFriendly[no], near[Express by Holiday Inn]"	The phoenix is a cheap indian restaurant located in the riverside area near express by holiday inn.
"name[The Phoenix], eatType[restaurant], food[Indian], priceRange[cheap], customer rating[5 out of 5], area[riverside], familyFriendly[yes], near[Express by Holiday Inn]"	The phoenix is a cheap, family friendly indian restaurant in the riverside area near express by holiday inn.
"name[The Phoenix], eatType[restaurant], food[Indian], priceRange[cheap], customer rating[average], area[city centre], familyFriendly[no], near[Express by Holiday Inn]"	The phoenix is a cheap indian restaurant located in the city centre near express by holiday inn.
"name[The Plough], eatType[pub], food[Chinese], priceRange[£20-25], area[riverside], familyFriendly[yes], near[Raja Indian Cuisine]"	The plough is a pub that serves chinese food in the £20-25 price range. it is located in the riverside. it is near raja indian cuisine.
"name[The Plough], eatType[pub], food[Chinese], priceRange[cheap], area[riverside], familyFriendly[yes], near[Raja Indian Cuisine]"	The plough is a pub providing chinese food in the cheap price range. it is located in the riverside. it is near raja indian cuisine.
"name[The Plough], eatType[pub], food[Chinese], priceRange[high], area[city centre], familyFriendly[no], near[Raja Indian Cuisine]"	The plough is a pub providing chinese food in the high price range. it is located in the city centre. it is near raja indian cuisine.
"name[The Plough], eatType[pub], food[Chinese], priceRange[high], area[city centre], familyFriendly[yes], near[Raja Indian Cuisine]"	The plough is a pub providing chinese food in the high price range. it is located in the city centre. it is near raja indian cuisine.
"name[The Plough], eatType[pub], food[Chinese], priceRange[high], area[riverside], familyFriendly[no], near[Raja Indian Cuisine]"	The plough is a pub providing chinese food in the high price range. it is located in the riverside. it is near raja indian cuisine.
"name[The Plough], eatType[pub], food[Chinese], priceRange[high], area[riverside], familyFriendly[yes], near[Raja Indian Cuisine]"	The plough is a pub providing chinese food in the high price range. it is located in the riverside. it is near raja indian cuisine.
"name[The Plough], eatType[pub], food[Chinese], priceRange[less than £20], area[city centre], familyFriendly[no], near[Raja Indian Cuisine]"	The plough is a pub providing chinese food in the less than £20 price range. it is located in the city centre and is not family friendly.
"name[The Plough], eatType[restaurant], food[Chinese], priceRange[£20-25], area[riverside], familyFriendly[yes], near[Raja Indian Cuisine]"	The plough is a kid friendly chinese restaurant in the riverside area.
"name[The Plough], eatType[restaurant], food[Chinese], priceRange[cheap], area[riverside], familyFriendly[yes], near[Raja Indian Cuisine]"	The plough is a cheap, family friendly chinese restaurant in the riverside area.
"name[The Plough], eatType[restaurant], food[Chinese], priceRange[high], area[city centre], familyFriendly[no], near[Raja Indian Cuisine]"	The plough is a high priced chinese restaurant in the city centre near raja indian cuisine.
"name[The Plough], eatType[restaurant], food[Chinese], priceRange[high], area[city centre], familyFriendly[yes], near[Raja Indian Cuisine]"	The plough is a high priced chinese restaurant in the city centre near raja indian cuisine.
"name[The Plough], eatType[restaurant], food[Chinese], priceRange[high], area[riverside], familyFriendly[no], near[Raja Indian Cuisine]"	The plough is a high priced chinese restaurant in riverside near raja indian cuisine.
"name[The Plough], eatType[restaurant], food[Chinese], priceRange[high], area[riverside], familyFriendly[yes], near[Raja Indian Cuisine]"	The plough is a high priced chinese restaurant located near raja indian cuisine in the riverside area.
"name[The Plough], eatType[restaurant], food[Chinese], priceRange[less than £20], area[city centre], familyFriendly[no], near[Raja Indian Cuisine]"	The plough is a chinese restaurant located in the city centre near raja indian cuisine. it is not family friendly.
"name[The Punter], eatType[pub], food[Chinese], priceRange[less than £20], area[city centre], familyFriendly[yes], near[Raja Indian Cuisine]"	The punter is a pub providing chinese food in the less than £20 price range. it is located in the city centre.
"name[The Punter], eatType[pub], food[Chinese], priceRange[less than £20], area[riverside], familyFriendly[no], near[Raja Indian Cuisine]"	The punter is a pub providing chinese food in the less than £20 price range. it is located in the riverside. it is near raja indian cuisine.
"name[The Punter], eatType[pub], food[Chinese], priceRange[less than £20], area[riverside], familyFriendly[yes], near[Raja Indian Cuisine]"	The punter is a pub that serves chinese food in the less than £20 price range. it is located in the riverside. it is near raja indian cuisine.
"name[The Punter], eatType[pub], food[Chinese], priceRange[moderate], area[city centre], familyFriendly[no], near[Raja Indian Cuisine]"	The punter is a pub providing chinese food in the moderate price range. it is located in the city centre. it is near raja indian cuisine.
"name[The Punter], eatType[pub], food[Chinese], priceRange[moderate], area[city centre], familyFriendly[yes], near[Raja Indian Cuisine]"	The punter is a pub providing chinese food in the moderate price range. it is located in the city centre. it is near raja indian cuisine.
"name[The Punter], eatType[pub], food[Chinese], priceRange[moderate], area[riverside], familyFriendly[no], near[Raja Indian Cuisine]"	The punter is a pub that serves chinese food in the moderate price range. it is located in the riverside. it is near raja indian cuisine.
"name[The Punter], eatType[pub], food[Chinese], priceRange[moderate], area[riverside], familyFriendly[yes], near[Raja Indian Cuisine]"	The punter is a pub providing chinese food in the moderate price range. it is located in the riverside. it is near raja indian cuisine.
"name[The Punter], eatType[pub], food[Chinese], priceRange[more than £30], area[riverside], familyFriendly[yes], near[Raja Indian Cuisine]"	The punter is a pub providing chinese food in the more than £30 price range. it is located in the riverside. it is near raja indian cuisine.
"name[The Punter], eatType[pub], food[English], priceRange[£20-25], area[riverside], familyFriendly[yes], near[Raja Indian Cuisine]"	The punter is a kid friendly pub located near raja indian cuisine.
"name[The Punter], eatType[pub], food[English], priceRange[cheap], area[riverside], familyFriendly[yes], near[Raja Indian Cuisine]"	The punter is a cheap, family friendly pub located near raja raja indian cuisine.
"name[The Punter], eatType[pub], food[English], priceRange[high], area[city centre], familyFriendly[no], near[Raja Indian Cuisine]"	The punter is a high priced english pub located in the city centre near raja indian cuisine.
"name[The Punter], eatType[pub], food[English], priceRange[high], area[city centre], familyFriendly[yes], near[Raja Indian Cuisine]"	The punter is a high-priced english pub located in the city centre near raja indian cuisine.
"name[The Punter], eatType[pub], food[English], priceRange[high], area[riverside], familyFriendly[no], near[Raja Indian Cuisine]"	The punter is a pub providing english food in the high price range. it is located in the riverside area near raja indian cuisine.
"name[The Punter], eatType[pub], food[English], priceRange[high], area[riverside], familyFriendly[yes], near[Raja Indian Cuisine]"	The punter is a child friendly pub located near raja indian cuisine.
"name[The Punter], eatType[pub], food[Italian], priceRange[high], customer rating[average], area[city centre], familyFriendly[no], near[Rainbow Vegetarian Café]"	The punter is an italian pub located near rainbow vegetarian café in the city centre. it has an average customer rating and is not child friendly.
"name[The Punter], eatType[restaurant], food[Chinese], priceRange[less than £20], area[city centre], familyFriendly[yes], near[Raja Indian Cuisine]"	The punter is a family friendly chinese restaurant in the city centre near raja indian cuisine.
"name[The Punter], eatType[restaurant], food[Chinese], priceRange[less than £20], area[riverside], familyFriendly[no], near[Raja Indian Cuisine]"	The punter is a chinese restaurant located in the riverside area near raja indian cuisine.
"name[The Punter], eatType[restaurant], food[Chinese], priceRange[less than £20], area[riverside], familyFriendly[yes], near[Raja Indian Cuisine]"	The punter is a family friendly chinese restaurant in the riverside area.
"name[The Punter], eatType[restaurant], food[Chinese], priceRange[moderate], area[city centre], familyFriendly[no], near[Raja Indian Cuisine]"	The punter is a chinese restaurant located in the city centre near raja indian cuisine.
"name[The Punter], eatType[restaurant], food[Chinese], priceRange[moderate], area[city centre], familyFriendly[yes], near[Raja Indian Cuisine]"	The punter is a chinese restaurant in the city centre near raja indian cuisine.
"name[The Punter], eatType[restaurant], food[Chinese], priceRange[moderate], area[riverside], familyFriendly[no], near[Raja Indian Cuisine]"	The punter is a moderately priced chinese restaurant in the riverside area near raja indian cuisine.
"name[The Punter], eatType[restaurant], food[Chinese], priceRange[moderate], area[riverside], familyFriendly[yes], near[Raja Indian Cuisine]"	The punter is a moderately priced chinese restaurant in riverside near raja indian cuisine.
"name[The Punter], eatType[restaurant], food[Chinese], priceRange[more than £30], area[riverside], familyFriendly[yes], near[Raja Indian Cuisine]"	The punter is a children friendly chinese restaurant in the riverside area.
"name[The Punter], eatType[restaurant], food[English], priceRange[£20-25], area[riverside], familyFriendly[yes], near[Raja Indian Cuisine]"	The punter is a family friendly restaurant located near raja indian cuisine.
"name[The Punter], eatType[restaurant], food[English], priceRange[cheap], area[riverside], familyFriendly[yes], near[Raja Indian Cuisine]"	The punter is a cheap, family friendly restaurant in the riverside area near raja indian cuisine.
"name[The Punter], eatType[restaurant], food[English], priceRange[high], area[city centre], familyFriendly[no], near[Raja Indian Cuisine]"	The punter is a high priced english restaurant located in the city centre near raja indian cuisine.
"name[The Punter], eatType[restaurant], food[English], priceRange[high], area[city centre], familyFriendly[yes], near[Raja Indian Cuisine]"	The punter is a high priced english restaurant in the city centre near raja indian cuisine.
"name[The Punter], eatType[restaurant], food[English], priceRange[high], area[riverside], familyFriendly[no], near[Raja Indian Cuisine]"	The punter is a high priced english restaurant in the riverside area near raja indian cuisine.
"name[The Punter], eatType[restaurant], food[English], priceRange[high], area[riverside], familyFriendly[yes], near[Raja Indian Cuisine]"	The punter is a high priced english restaurant located in riverside near raja indian cuisine.
"name[The Punter], eatType[restaurant], food[Indian], priceRange[cheap], customer rating[average], area[city centre], familyFriendly[yes], near[Express by Holiday Inn]"	The punter is a cheap indian restaurant in the city centre near express by holiday inn.
"name[The Punter], eatType[restaurant], food[Indian], priceRange[cheap], customer rating[average], area[riverside], familyFriendly[no], near[Express by Holiday Inn]"	The punter is a cheap indian restaurant in riverside near express by holiday inn.
"name[The Punter], eatType[restaurant], food[Indian], priceRange[cheap], customer rating[average], area[riverside], familyFriendly[yes], near[Express by Holiday Inn]"	The punter is a cheap, family friendly restaurant located near express by holiday inn.
"name[The Punter], eatType[restaurant], food[Indian], priceRange[high], customer rating[1 out of 5], area[city centre], familyFriendly[no], near[Express by Holiday Inn]"	The punter is a restaurant providing indian food in the high price range. it is located in the city centre. it is near express by holiday inn. its customer rating is 1 out of 5.
"name[The Punter], eatType[restaurant], food[Indian], priceRange[high], customer rating[1 out of 5], area[city centre], familyFriendly[yes], near[Express by Holiday Inn]"	The punter is a restaurant providing indian food in the high price range. it is located in the city centre. it is near express by holiday inn. its customer rating is 1 out of 5.
"name[The Punter], eatType[restaurant], food[Indian], priceRange[high], customer rating[1 out of 5], area[riverside], familyFriendly[no], near[Express by Holiday Inn]"	The punter is a restaurant providing indian food in the high price range. it is located in the riverside. it is near express by holiday inn. its customer rating is 1 out of 5.
"name[The Punter], eatType[restaurant], food[Indian], priceRange[high], customer rating[1 out of 5], area[riverside], familyFriendly[yes], near[Express by Holiday Inn]"	The punter is a restaurant providing indian food in the high price range. it is located in the riverside. it is near express by holiday inn. its customer rating is 1 out of 5.
"name[The Punter], eatType[restaurant], food[Indian], priceRange[high], customer rating[average], area[city centre], familyFriendly[no], near[Express by Holiday Inn]"	The punter is a restaurant providing indian food in the high price range. it is located in the city centre. it is near express by holiday inn. its customer rating is average.
"name[The Punter], eatType[restaurant], food[Indian], priceRange[high], customer rating[average], area[city centre], familyFriendly[yes], near[Express by Holiday Inn]"	The punter is a restaurant providing indian food in the high price range. it is located in the city centre. it is near express by holiday inn. its customer rating is average.
"name[The Punter], eatType[restaurant], food[Indian], priceRange[high], customer rating[average], area[riverside], familyFriendly[no], near[Express by Holiday Inn]"	The punter is a restaurant providing indian food in the high price range. it is located in the riverside. it is near express by holiday inn. its customer rating is average.
"name[The Punter], eatType[restaurant], food[Indian], priceRange[high], customer rating[average], area[riverside], familyFriendly[yes], near[Express by Holiday Inn]"	The punter is a restaurant providing indian food in the high price range. it is located in the riverside. it is near express by holiday inn. its customer rating is average.
"name[The Punter], eatType[restaurant], food[Indian], priceRange[less than £20], customer rating[low], area[city centre], familyFriendly[no], near[Express by Holiday Inn]"	The punter is a restaurant providing indian food in the less than £20 price range. it is located in the city centre and is not family friendly.
"name[The Punter], eatType[restaurant], food[Indian], priceRange[less than £20], customer rating[low], area[city centre], familyFriendly[yes], near[Express by Holiday Inn]"	The punter is a family friendly indian restaurant located in the city centre near express by holiday inn.
"name[The Punter], eatType[restaurant], food[Indian], priceRange[less than £20], customer rating[low], area[riverside], familyFriendly[no], near[Express by Holiday Inn]"	The punter is a restaurant providing indian food in the less than £20 price range. it is located in the riverside. its customer rating is low.
"name[The Punter], eatType[restaurant], food[Indian], priceRange[less than £20], customer rating[low], area[riverside], familyFriendly[yes], near[Express by Holiday Inn]"	The punter is a family friendly indian restaurant in the riverside area near express by holiday inn.
"name[The Punter], eatType[restaurant], food[Indian], priceRange[moderate], customer rating[1 out of 5], area[city centre], familyFriendly[no], near[Express by Holiday Inn]"	The punter is a restaurant providing indian food in the moderate price range. it is located in the city centre. it is near express by holiday inn. its customer rating is 1 out of 5.
"name[The Punter], eatType[restaurant], food[Indian], priceRange[moderate], customer rating[1 out of 5], area[city centre], familyFriendly[yes], near[Express by Holiday Inn]"	The punter is a restaurant providing indian food in the moderate price range. it is located in the city centre. it is near express by holiday inn. its customer rating is 1 out of 5.
"name[The Punter], eatType[restaurant], food[Indian], priceRange[moderate], customer rating[1 out of 5], area[riverside], familyFriendly[no], near[Express by Holiday Inn]"	The punter is a restaurant providing indian food in the moderate price range. it is located in the riverside. it is near express by holiday inn. its customer rating is 1 out of 5.
"name[The Punter], eatType[restaurant], food[Indian], priceRange[moderate], customer rating[1 out of 5], area[riverside], familyFriendly[yes], near[Express by Holiday Inn]"	The punter is a restaurant providing indian food in the moderate price range. it is located in the riverside. it is near express by holiday inn. its customer rating is 1 out of 5.
"name[The Punter], eatType[restaurant], food[Indian], priceRange[moderate], customer rating[3 out of 5], area[city centre], familyFriendly[no], near[Express by Holiday Inn]"	The punter is a moderately priced indian restaurant located in the city centre near express by holiday inn.
"name[The Punter], eatType[restaurant], food[Indian], priceRange[moderate], customer rating[3 out of 5], area[city centre], familyFriendly[yes], near[Express by Holiday Inn]"	The punter is a moderately priced indian restaurant in the city centre near express by holiday inn.
"name[The Punter], eatType[restaurant], food[Indian], priceRange[moderate], customer rating[3 out of 5], area[riverside], familyFriendly[no], near[Express by Holiday Inn]"	The punter is a restaurant providing indian food in the moderate price range. it is located in the riverside. it is near express by holiday inn. its customer rating is 3 out of 5.
"name[The Punter], eatType[restaurant], food[Indian], priceRange[moderate], customer rating[3 out of 5], area[riverside], familyFriendly[yes], near[Express by Holiday Inn]"	The punter is a restaurant providing indian food in the moderate price range. it is located in the riverside. it is near express by holiday inn. its customer rating is 3 out of 5.
"name[The Punter], eatType[restaurant], food[Indian], priceRange[more than £30], customer rating[high], area[city centre], familyFriendly[no], near[Express by Holiday Inn]"	The punter is a restaurant providing indian food in the more than £30 price range. it is located in the city centre. it is near express by holiday inn.
"name[The Punter], eatType[restaurant], food[Indian], priceRange[more than £30], customer rating[high], area[city centre], familyFriendly[yes], near[Express by Holiday Inn]"	The punter is a children friendly indian restaurant in the more than £30 price range. it is located in the city centre.
"name[The Punter], eatType[restaurant], food[Indian], priceRange[more than £30], customer rating[high], area[riverside], familyFriendly[no], near[Express by Holiday Inn]"	The punter is a restaurant providing indian food in the more than £30 price range. it is located in the riverside. its customer rating is high.
"name[The Punter], eatType[restaurant], food[Indian], priceRange[more than £30], customer rating[high], area[riverside], familyFriendly[yes], near[Express by Holiday Inn]"	The punter is a restaurant providing indian food in the more than £30 price range. it is located in the riverside. its customer rating is high.
"name[The Punter], eatType[restaurant], food[Italian], priceRange[£20-25], customer rating[high], area[city centre], familyFriendly[no], near[Express by Holiday Inn]"	The punter is an italian restaurant located in the city centre near express by holiday inn.
"name[The Punter], eatType[restaurant], food[Italian], priceRange[£20-25], customer rating[high], area[city centre], familyFriendly[yes], near[Express by Holiday Inn]"	The punter is an italian restaurant in the city centre near express by holiday inn.
"name[The Punter], eatType[restaurant], food[Italian], priceRange[£20-25], customer rating[high], area[riverside], familyFriendly[no], near[Express by Holiday Inn]"	The punter is a highly rated italian restaurant located near express by holiday inn.
"name[The Punter], eatType[restaurant], food[Italian], priceRange[£20-25], customer rating[high], area[riverside], familyFriendly[yes], near[Express by Holiday Inn]"	The punter is a highly rated italian restaurant located near express by holiday inn.
"name[The Punter], eatType[restaurant], food[Italian], priceRange[cheap], customer rating[5 out of 5], area[city centre], familyFriendly[no], near[Express by Holiday Inn]"	The punter is a cheap italian restaurant located in the city centre near express by holiday inn. it is not family-friendly.
"name[The Punter], eatType[restaurant], food[Italian], priceRange[cheap], customer rating[5 out of 5], area[city centre], familyFriendly[no], near[Rainbow Vegetarian Café]"	The punter is a cheap italian restaurant located in the city centre near rainbow vegetarian café. it is not family-friendly.
"name[The Punter], eatType[restaurant], food[Italian], priceRange[cheap], customer rating[5 out of 5], area[city centre], familyFriendly[yes], near[Rainbow Vegetarian Café]"	The punter is a cheap, family-friendly italian restaurant located in the city centre near rainbow vegetarian café.
"name[The Punter], eatType[restaurant], food[Italian], priceRange[cheap], customer rating[5 out of 5], area[riverside], familyFriendly[no], near[Rainbow Vegetarian Café]"	The punter is a cheap italian restaurant located in the riverside area near rainbow vegetarian café.
"name[The Punter], eatType[restaurant], food[Italian], priceRange[cheap], customer rating[5 out of 5], area[riverside], familyFriendly[yes], near[Rainbow Vegetarian Café]"	The punter is a cheap, family friendly restaurant located near rainbow vegetarian café.
"name[The Punter], eatType[restaurant], food[Italian], priceRange[cheap], customer rating[average], area[city centre], familyFriendly[no], near[Rainbow Vegetarian Café]"	The punter is a cheap italian restaurant located in the city centre near rainbow vegetarian café. it is not family-friendly.
"name[The Punter], eatType[restaurant], food[Italian], priceRange[cheap], customer rating[average], area[city centre], familyFriendly[yes], near[Rainbow Vegetarian Café]"	The punter is a cheap italian restaurant located in the city centre near rainbow vegetarian café.
"name[The Punter], eatType[restaurant], food[Italian], priceRange[cheap], customer rating[average], area[riverside], familyFriendly[no], near[Rainbow Vegetarian Café]"	The punter is a cheap italian restaurant in the riverside area near rainbow vegetarian café. it is not family-friendly.
"name[The Punter], eatType[restaurant], food[Italian], priceRange[cheap], customer rating[average], area[riverside], familyFriendly[yes], near[Rainbow Vegetarian Café]"	The punter is a cheap, family friendly italian restaurant near rainbow vegetarian café.
"name[The Punter], eatType[restaurant], food[Italian], priceRange[high], customer rating[1 out of 5], area[city centre], familyFriendly[no], near[Rainbow Vegetarian Café]"	The punter is a high priced italian restaurant located in the city centre near rainbow vegetarian café.
"name[The Punter], eatType[restaurant], food[Italian], priceRange[high], customer rating[1 out of 5], area[city centre], familyFriendly[yes], near[Rainbow Vegetarian Café]"	The punter is a high priced italian restaurant in the city centre near rainbow vegetarian café.
"name[The Punter], eatType[restaurant], food[Italian], priceRange[high], customer rating[1 out of 5], area[riverside], familyFriendly[no], near[Rainbow Vegetarian Café]"	The punter is a high priced italian restaurant located in the riverside area near rainbow vegetarian café.
"name[The Punter], eatType[restaurant], food[Italian], priceRange[high], customer rating[1 out of 5], area[riverside], familyFriendly[yes], near[Rainbow Vegetarian Café]"	The punter is a family friendly restaurant located near rainbow vegetarian café.
"name[The Vaults], eatType[pub], food[French], priceRange[high], area[riverside], familyFriendly[yes], near[Raja Indian Cuisine]"	The vaults is a child friendly pub located near raja indian cuisine in riverside.
"name[The Vaults], eatType[pub], food[French], priceRange[less than £20], area[city centre], familyFriendly[no], near[Raja Indian Cuisine]"	The vaults is a french pub located in the city centre near raja indian cuisine. it is not family-friendly.
"name[The Vaults], eatType[pub], food[French], priceRange[less than £20], area[city centre], familyFriendly[yes], near[Raja Indian Cuisine]"	The vaults is a family-friendly french pub located in the city centre near raja indian cuisine.
"name[The Vaults], eatType[pub], food[French], priceRange[less than £20], area[riverside], familyFriendly[no], near[Raja Indian Cuisine]"	The vaults is a pub that serves french food in the less than £20 price range. it is located near raja indian cuisine.
"name[The Vaults], eatType[pub], food[French], priceRange[less than £20], area[riverside], familyFriendly[yes], near[Raja Indian Cuisine]"	The vaults is a family friendly pub located near raja indian cuisine.
"name[The Vaults], eatType[pub], food[French], priceRange[moderate], area[city centre], familyFriendly[no], near[Raja Indian Cuisine]"	The vaults is a moderately priced french pub located in the city centre near raja indian cuisine.
"name[The Vaults], eatType[pub], food[French], priceRange[moderate], area[city centre], familyFriendly[yes], near[Raja Indian Cuisine]"	The vaults is a moderately priced french pub located in the city centre near raja indian cuisine.
"name[The Vaults], eatType[pub], food[French], priceRange[moderate], area[riverside], familyFriendly[no], near[Raja Indian Cuisine]"	The vaults is a pub that serves french food in the moderate price range. it is located near raja indian cuisine.
"name[The Vaults], eatType[pub], food[French], priceRange[moderate], area[riverside], familyFriendly[yes], near[Raja Indian Cuisine]"	The vaults is a kid friendly pub located near raja indian cuisine in the riverside area.
"name[The Vaults], eatType[pub], food[French], priceRange[more than £30], area[city centre], familyFriendly[no], near[Raja Indian Cuisine]"	The vaults is a pub providing french food in the more than £30 price range. it is located near raja indian cuisine in the city centre.
"name[The Vaults], eatType[pub], food[French], priceRange[more than £30], area[city centre], familyFriendly[yes], near[Raja Indian Cuisine]"	The vaults is a french pub in the more than £30 price range. it is located in the city centre and is children friendly.
"name[The Vaults], eatType[pub], food[French], priceRange[more than £30], area[riverside], familyFriendly[no], near[Raja Indian Cuisine]"	The vaults is a pub that serves french food. it is located near raja indian cuisine.
"name[The Vaults], eatType[pub], food[French], priceRange[more than £30], area[riverside], familyFriendly[yes], near[Raja Indian Cuisine]"	The vaults is a family friendly pub located near raja indian cuisine.
"name[The Vaults], eatType[pub], food[Indian], priceRange[£20-25], area[riverside], familyFriendly[yes], near[Raja Indian Cuisine]"	The vaults is a pub that serves indian food in the £20-25 price range. it is located in the riverside. it is near raja indian cuisine.
"name[The Vaults], eatType[pub], food[Indian], priceRange[cheap], area[riverside], familyFriendly[yes], near[Raja Indian Cuisine]"	The vaults is a pub providing indian food in the cheap price range. it is located in the riverside. it is near raja indian cuisine.
"name[The Vaults], eatType[pub], food[Indian], priceRange[high], area[city centre], familyFriendly[no], near[Raja Indian Cuisine]"	The vaults is a pub providing indian food in the high price range. it is located in the city centre. it is near raja indian cuisine.
"name[The Vaults], eatType[pub], food[Indian], priceRange[high], area[city centre], familyFriendly[yes], near[Raja Indian Cuisine]"	The vaults is a pub providing indian food in the high price range. it is located in the city centre. it is near raja indian cuisine.
"name[The Vaults], eatType[pub], food[Italian], priceRange[high], customer rating[average], area[city centre], familyFriendly[no], near[Rainbow Vegetarian Café]"	The vaults is an italian pub located in the city centre near rainbow vegetarian café.
"name[The Vaults], eatType[pub], food[Italian], priceRange[high], customer rating[average], area[city centre], familyFriendly[yes], near[Rainbow Vegetarian Café]"	The vaults is a family-friendly pub located in the city centre near rainbow vegetarian café.
"name[The Vaults], eatType[pub], food[Italian], priceRange[high], customer rating[average], area[riverside], familyFriendly[no], near[Rainbow Vegetarian Café]"	The vaults is an italian pub located near rainbow vegetarian café in the riverside area.
"name[The Vaults], eatType[pub], food[Italian], priceRange[high], customer rating[average], area[riverside], familyFriendly[yes], near[Rainbow Vegetarian Café]"	The vaults is a family friendly pub located near rainbow vegetarian café.
"name[The Vaults], eatType[pub], food[Italian], priceRange[less than £20], customer rating[low], area[city centre], familyFriendly[no], near[Rainbow Vegetarian Café]"	The vaults is an italian pub located in the city centre near rainbow vegetarian café. it is not family-friendly and has a low customer rating.
"name[The Vaults], eatType[pub], food[Italian], priceRange[less than £20], customer rating[low], area[city centre], familyFriendly[yes], near[Rainbow Vegetarian Café]"	The vaults is a family-friendly italian pub located in the city centre near rainbow vegetarian café. it has a low customer rating.
"name[The Vaults], eatType[pub], food[Italian], priceRange[less than £20], customer rating[low], area[riverside], familyFriendly[no], near[Rainbow Vegetarian Café]"	The vaults is a pub located near rainbow vegetarian café.
"name[The Vaults], eatType[pub], food[Italian], priceRange[less than £20], customer rating[low], area[riverside], familyFriendly[yes], near[Rainbow Vegetarian Café]"	The vaults is a family friendly pub located near rainbow vegetarian café.
"name[The Vaults], eatType[pub], food[Italian], priceRange[moderate], customer rating[1 out of 5], area[city centre], familyFriendly[no], near[Rainbow Vegetarian Café]"	The vaults is a moderately priced italian pub located in the city centre near rainbow vegetarian café. it is not kid friendly.
"name[The Vaults], eatType[pub], food[Italian], priceRange[moderate], customer rating[1 out of 5], area[city centre], familyFriendly[yes], near[Rainbow Vegetarian Café]"	The vaults is a pub located in the city centre near rainbow vegetarian café.
"name[The Vaults], eatType[pub], food[Italian], priceRange[moderate], customer rating[1 out of 5], area[riverside], familyFriendly[no], near[Rainbow Vegetarian Café]"	The vaults is a pub located near rainbow vegetarian café.
"name[The Vaults], eatType[pub], food[Italian], priceRange[moderate], customer rating[1 out of 5], area[riverside], familyFriendly[yes], near[Rainbow Vegetarian Café]"	The vaults is a family friendly pub located near rainbow vegetarian café.
"name[The Vaults], eatType[pub], food[Italian], priceRange[moderate], customer rating[3 out of 5], area[city centre], familyFriendly[no], near[Rainbow Vegetarian Café]"	The vaults is a moderately priced italian pub located in the city centre near rainbow vegetarian café. it is not kid friendly.
"name[The Vaults], eatType[pub], food[Italian], priceRange[moderate], customer rating[3 out of 5], area[city centre], familyFriendly[yes], near[Rainbow Vegetarian Café]"	The vaults is a pub located in the city centre near rainbow vegetarian café.
"name[The Vaults], eatType[pub], food[Italian], priceRange[moderate], customer rating[3 out of 5], area[riverside], familyFriendly[no], near[Rainbow Vegetarian Café]"	The vaults is a pub located near rainbow vegetarian café.
"name[The Vaults], eatType[pub], food[Italian], priceRange[moderate], customer rating[3 out of 5], area[riverside], familyFriendly[yes], near[Rainbow Vegetarian Café]"	The vaults is a kid friendly pub in the riverside area near the rainbow vegetarian café.
"name[The Vaults], eatType[pub], food[Italian], priceRange[more than £30], customer rating[high], area[city centre], familyFriendly[no], near[Rainbow Vegetarian Café]"	The vaults is a pub located in the city centre near rainbow vegetarian café.
"name[The Vaults], eatType[pub], food[Italian], priceRange[more than £30], customer rating[high], area[city centre], familyFriendly[yes], near[Rainbow Vegetarian Café]"	The vaults is a family-friendly italian pub located in the city centre near rainbow vegetarian café.
"name[The Vaults], eatType[pub], food[Italian], priceRange[more than £30], customer rating[high], area[riverside], familyFriendly[no], near[Rainbow Vegetarian Café]"	The vaults is an italian pub near rainbow vegetarian café in riverside. it has a high customer rating and is not child friendly.
"name[The Vaults], eatType[pub], food[Italian], priceRange[more than £30], customer rating[high], area[riverside], familyFriendly[yes], near[Rainbow Vegetarian Café]"	The vaults is a children friendly pub located near rainbow vegetarian café.
"name[The Vaults], eatType[pub], food[Japanese], priceRange[£20-25], customer rating[3 out of 5], area[city centre], familyFriendly[no], near[Rainbow Vegetarian Café]"	The vaults is a pub located in the city centre near rainbow vegetarian café.
"name[The Vaults], eatType[pub], food[Japanese], priceRange[£20-25], customer rating[3 out of 5], area[city centre], familyFriendly[yes], near[Rainbow Vegetarian Café]"	The vaults is a pub located in the city centre near rainbow vegetarian café.
"name[The Vaults], eatType[pub], food[Japanese], priceRange[£20-25], customer rating[3 out of 5], area[riverside], familyFriendly[no], near[Rainbow Vegetarian Café]"	The vaults is a pub located near rainbow vegetarian café.
"name[The Vaults], eatType[pub], food[Japanese], priceRange[£20-25], customer rating[3 out of 5], area[riverside], familyFriendly[yes], near[Rainbow Vegetarian Café]"	The vaults is a pub located near rainbow vegetarian café.
"name[The Vaults], eatType[pub], food[Japanese], priceRange[£20-25], customer rating[high], area[city centre], familyFriendly[no], near[Rainbow Vegetarian Café]"	The vaults is a japanese pub located in the city centre near rainbow vegetarian café. it has a high customer rating and is not kid friendly.
"name[The Vaults], eatType[pub], food[Japanese], priceRange[£20-25], customer rating[high], area[city centre], familyFriendly[yes], near[Rainbow Vegetarian Café]"	The vaults is a pub located in the city centre near rainbow vegetarian café.
"name[The Vaults], eatType[pub], food[Japanese], priceRange[£20-25], customer rating[high], area[riverside], familyFriendly[no], near[Rainbow Vegetarian Café]"	The vaults is a pub located near rainbow vegetarian café.
"name[The Vaults], eatType[pub], food[Japanese], priceRange[£20-25], customer rating[high], area[riverside], familyFriendly[no], near[Raja Indian Cuisine]"	The vaults is a pub that serves japanese food. it is located near raja indian cuisine.
"name[The Vaults], eatType[pub], food[Japanese], priceRange[£20-25], customer rating[high], area[riverside], familyFriendly[yes], near[Raja Indian Cuisine]"	The vaults is a family friendly pub located near raja indian cuisine.
"name[The Vaults], eatType[pub], food[Japanese], priceRange[cheap], customer rating[5 out of 5], area[city centre], familyFriendly[no], near[Raja Indian Cuisine]"	The vaults is a cheap japanese pub located in the city centre near raja indian cuisine. it is not family-friendly.
"name[The Vaults], eatType[pub], food[Japanese], priceRange[cheap], customer rating[5 out of 5], area[city centre], familyFriendly[yes], near[Raja Indian Cuisine]"	The vaults is a cheap, family-friendly japanese pub located in the city centre near raja indian cuisine.
"name[The Vaults], eatType[pub], food[Japanese], priceRange[cheap], customer rating[5 out of 5], area[riverside], familyFriendly[no], near[Raja Indian Cuisine]"	The vaults is a cheap japanese pub near raja indian cuisine in riverside.
"name[The Vaults], eatType[pub], food[Japanese], priceRange[cheap], customer rating[5 out of 5], area[riverside], familyFriendly[yes], near[Raja Indian Cuisine]"	The vaults is a family friendly pub located near raja raja indian cuisine.
"name[The Vaults], eatType[pub], food[Japanese], priceRange[high], customer rating[3 out of 5], area[city centre], familyFriendly[no], near[Raja Indian Cuisine]"	The vaults is a pub providing japanese food in the high price range. it is located in the city centre and is not child friendly.
"name[The Vaults], eatType[pub], food[Japanese], priceRange[high], customer rating[3 out of 5], area[city centre], familyFriendly[yes], near[Raja Indian Cuisine]"	The vaults is a japanese pub in the high price range. it is located in the city centre and is children friendly.
"name[The Vaults], eatType[pub], food[Japanese], priceRange[high], customer rating[3 out of 5], area[riverside], familyFriendly[no], near[Raja Indian Cuisine]"	The vaults is a pub providing japanese food in the high price range. it is located near raja indian cuisine.
"name[The Vaults], eatType[pub], food[Japanese], priceRange[high], customer rating[3 out of 5], area[riverside], familyFriendly[yes], near[Raja Indian Cuisine]"	The vaults is a children friendly pub located near raja indian cuisine.
"name[The Vaults], eatType[pub], food[Japanese], priceRange[less than £20], customer rating[average], area[city centre], familyFriendly[no], near[Raja Indian Cuisine]"	The vaults is a japanese pub located in the city centre near raja indian cuisine. it is not family-friendly and has an average customer rating.
"name[The Vaults], eatType[pub], food[Japanese], priceRange[less than £20], customer rating[average], area[city centre], familyFriendly[yes], near[Raja Indian Cuisine]"	The vaults is a family-friendly japanese pub in the city centre near raja indian cuisine.
"name[The Vaults], eatType[pub], food[Japanese], priceRange[less than £20], customer rating[average], area[riverside], familyFriendly[no], near[Raja Indian Cuisine]"	The vaults is a pub providing japanese food in the less than £20 price range. it is located near raja indian cuisine.
"name[The Vaults], eatType[pub], food[Japanese], priceRange[less than £20], customer rating[average], area[riverside], familyFriendly[yes], near[Raja Indian Cuisine]"	The vaults is a family friendly japanese pub in the riverside area near raja indian cuisine.
"name[The Vaults], eatType[pub], food[Japanese], priceRange[less than £20], customer rating[low], area[city centre], familyFriendly[no], near[Raja Indian Cuisine]"	The vaults is a japanese pub located in the city centre near raja indian cuisine. it is not family-friendly and has a low customer rating.
"name[The Vaults], eatType[pub], food[Japanese], priceRange[less than £20], customer rating[low], area[city centre], familyFriendly[yes], near[Raja Indian Cuisine]"	The vaults is a family-friendly japanese pub located in the city centre near raja indian cuisine. it has a low customer rating.
"name[The Vaults], eatType[pub], food[Japanese], priceRange[less than £20], customer rating[low], area[riverside], familyFriendly[no], near[Raja Indian Cuisine]"	The vaults is a pub that serves japanese food in the less than £20 price range. it is located near raja indian cuisine. its customer rating is low.
"name[The Vaults], eatType[pub], food[Japanese], priceRange[less than £20], customer rating[low], area[riverside], familyFriendly[yes], near[Raja Indian Cuisine]"	The vaults is a family friendly japanese pub in the riverside area near raja indian cuisine.
"name[The Vaults], eatType[pub], food[Japanese], priceRange[moderate], customer rating[1 out of 5], area[city centre], familyFriendly[no], near[Raja Indian Cuisine]"	The vaults is a pub providing japanese food in the moderate price range. it is located near raja indian cuisine in the city centre. its customer rating is 1 out of 5.
"name[The Vaults], eatType[pub], food[Japanese], priceRange[moderate], customer rating[1 out of 5], area[city centre], familyFriendly[yes], near[Raja Indian Cuisine]"	The vaults is a pub that serves japanese food in the moderate price range. it is located in the city centre near raja indian cuisine.
"name[The Vaults], eatType[restaurant], food[French], priceRange[high], area[riverside], familyFriendly[yes], near[Raja Indian Cuisine]"	The vaults is a high priced french restaurant in riverside near raja indian cuisine.
"name[The Vaults], eatType[restaurant], food[French], priceRange[less than £20], area[city centre], familyFriendly[no], near[Raja Indian Cuisine]"	The vaults is a french restaurant located in the city centre near raja indian cuisine.
"name[The Vaults], eatType[restaurant], food[French], priceRange[less than £20], area[city centre], familyFriendly[yes], near[Raja Indian Cuisine]"	The vaults is a family-friendly french restaurant located in the city centre.
"name[The Vaults], eatType[restaurant], food[French], priceRange[less than £20], area[riverside], familyFriendly[no], near[Raja Indian Cuisine]"	The vaults is a french restaurant near raja indian cuisine in riverside.
"name[The Vaults], eatType[restaurant], food[French], priceRange[less than £20], area[riverside], familyFriendly[yes], near[Raja Indian Cuisine]"	The vaults is a family friendly french restaurant in the riverside area.
"name[The Vaults], eatType[restaurant], food[French], priceRange[moderate], area[city centre], familyFriendly[no], near[Raja Indian Cuisine]"	The vaults is a moderately priced french restaurant located in the city centre near raja indian cuisine.
"name[The Vaults], eatType[restaurant], food[French], priceRange[moderate], area[city centre], familyFriendly[yes], near[Raja Indian Cuisine]"	The vaults is a french restaurant in the city centre near raja indian cuisine.
"name[The Vaults], eatType[restaurant], food[French], priceRange[moderate], area[riverside], familyFriendly[no], near[Raja Indian Cuisine]"	The vaults is a french restaurant located in the riverside area near raja indian cuisine.
"name[The Vaults], eatType[restaurant], food[French], priceRange[moderate], area[riverside], familyFriendly[yes], near[Raja Indian Cuisine]"	The vaults is a moderately priced french restaurant in the riverside area near raja indian cuisine.
"name[The Vaults], eatType[restaurant], food[French], priceRange[more than £30], area[city centre], familyFriendly[no], near[Raja Indian Cuisine]"	The vaults is a french restaurant located in the city centre near raja indian cuisine.
"name[The Vaults], eatType[restaurant], food[French], priceRange[more than £30], area[city centre], familyFriendly[yes], near[Raja Indian Cuisine]"	The vaults is a family-friendly french restaurant located in the city centre.
"name[The Vaults], eatType[restaurant], food[French], priceRange[more than £30], area[riverside], familyFriendly[no], near[Raja Indian Cuisine]"	The vaults is a french restaurant near raja indian cuisine in riverside.
"name[The Vaults], eatType[restaurant], food[French], priceRange[more than £30], area[riverside], familyFriendly[yes], near[Raja Indian Cuisine]"	The vaults is a family friendly french restaurant located in the riverside area.
"name[The Vaults], eatType[restaurant], food[Indian], priceRange[£20-25], area[riverside], familyFriendly[yes], near[Raja Indian Cuisine]"	The vaults is a restaurant providing indian food in the £20-25 price range. it is located in the riverside.
"name[The Vaults], eatType[restaurant], food[Indian], priceRange[cheap], area[riverside], familyFriendly[yes], near[Raja Indian Cuisine]"	The vaults is a cheap, family friendly indian restaurant in the riverside area.
"name[The Vaults], eatType[restaurant], food[Indian], priceRange[high], area[city centre], familyFriendly[no], near[Raja Indian Cuisine]"	The vaults is a high priced indian restaurant in the city centre near raja indian cuisine.
"name[The Vaults], eatType[restaurant], food[Indian], priceRange[high], area[city centre], familyFriendly[yes], near[Raja Indian Cuisine]"	The vaults is a restaurant providing indian food in the high price range. it is located in the city centre.
"name[The Waterman], eatType[pub], food[Indian], priceRange[high], area[city centre], familyFriendly[yes], near[Raja Indian Cuisine]"	The waterman is a pub providing indian food in the high price range. it is located in the city centre. it is near raja indian cuisine.
"name[The Waterman], eatType[pub], food[Indian], priceRange[high], area[riverside], familyFriendly[no], near[Raja Indian Cuisine]"	The waterman is a pub providing indian food in the high price range. it is located in the riverside. it is near raja indian cuisine.
"name[The Waterman], eatType[pub], food[Indian], priceRange[high], area[riverside], familyFriendly[yes], near[Raja Indian Cuisine]"	The waterman is a pub providing indian food in the high price range. it is located in the riverside. it is near raja indian cuisine.
"name[The Waterman], eatType[pub], food[Indian], priceRange[less than £20], area[city centre], familyFriendly[no], near[Raja Indian Cuisine]"	The waterman is a pub providing indian food in the less than £20 price range. it is located in the city centre and is not family friendly.
"name[The Waterman], eatType[pub], food[Indian], priceRange[less than £20], area[city centre], familyFriendly[yes], near[Raja Indian Cuisine]"	The waterman is a pub providing indian food in the less than £20 price range. it is located in the city centre.
"name[The Waterman], eatType[pub], food[Indian], priceRange[less than £20], area[riverside], familyFriendly[no], near[Raja Indian Cuisine]"	The waterman is a pub providing indian food in the less than £20 price range. it is located in the riverside. it is near raja indian cuisine.
"name[The Waterman], eatType[pub], food[Indian], priceRange[less than £20], area[riverside], familyFriendly[yes], near[Raja Indian Cuisine]"	The waterman is a pub providing indian food in the less than £20 price range. it is located in the riverside. it is near raja indian cuisine.
"name[The Waterman], eatType[pub], food[Indian], priceRange[moderate], area[city centre], familyFriendly[no], near[Raja Indian Cuisine]"	The waterman is a pub providing indian food in the moderate price range. it is located in the city centre. it is near raja indian cuisine.
"name[The Waterman], eatType[pub], food[Indian], priceRange[moderate], area[city centre], familyFriendly[yes], near[Raja Indian Cuisine]"	The waterman is a pub providing indian food in the moderate price range. it is located in the city centre. it is near raja indian cuisine.
"name[The Waterman], eatType[pub], food[Indian], priceRange[moderate], area[riverside], familyFriendly[no], near[Raja Indian Cuisine]"	The waterman is a pub providing indian food in the moderate price range. it is located in the riverside. it is near raja indian cuisine.
"name[The Waterman], eatType[pub], food[Indian], priceRange[moderate], area[riverside], familyFriendly[yes], near[Raja Indian Cuisine]"	The waterman is a pub providing indian food in the moderate price range. it is located in the riverside. it is near raja indian cuisine.
"name[The Waterman], eatType[pub], food[Indian], priceRange[more than £30], area[riverside], familyFriendly[yes], near[Raja Indian Cuisine]"	The waterman is a pub providing indian food in the more than £30 price range. it is located in the riverside. it is near raja indian cuisine.
"name[The Waterman], eatType[pub], food[Italian], priceRange[£20-25], area[riverside], familyFriendly[yes], near[Raja Indian Cuisine]"	The waterman is a family friendly pub located near raja indian cuisine.
"name[The Waterman], eatType[pub], food[Italian], priceRange[cheap], area[riverside], familyFriendly[yes], near[Raja Indian Cuisine]"	The waterman is a cheap, family friendly pub located near raja raja indian cuisine.
"name[The Waterman], eatType[pub], food[Italian], priceRange[high], area[city centre], familyFriendly[no], near[Raja Indian Cuisine]"	The waterman is a high priced italian pub located in the city centre near raja indian cuisine.
"name[The Waterman], eatType[pub], food[Italian], priceRange[high], area[city centre], familyFriendly[yes], near[Raja Indian Cuisine]"	The waterman is a high priced italian pub located in the city centre near raja indian cuisine.
"name[The Waterman], eatType[pub], food[Italian], priceRange[high], area[riverside], familyFriendly[no], near[Raja Indian Cuisine]"	The waterman is a pub providing italian food in the high price range. it is located in the riverside area near raja indian cuisine.
"name[The Waterman], eatType[pub], food[Italian], priceRange[high], area[riverside], familyFriendly[yes], near[Raja Indian Cuisine]"	The waterman is a children friendly pub located near raja indian cuisine.
"name[The Waterman], eatType[pub], food[Italian], priceRange[less than £20], area[city centre], familyFriendly[no], near[Raja Indian Cuisine]"	The waterman is a pub providing italian food in the less than £20 price range. it is located near raja indian cuisine in the city centre.
"name[The Waterman], eatType[pub], food[Italian], priceRange[less than £20], area[city centre], familyFriendly[yes], near[Raja Indian Cuisine]"	The waterman is a family-friendly italian pub located in the city centre near raja indian cuisine.
"name[The Waterman], eatType[pub], food[Italian], priceRange[less than £20], area[riverside], familyFriendly[no], near[Raja Indian Cuisine]"	The waterman is an italian pub near raja indian cuisine in the riverside area.
"name[The Waterman], eatType[restaurant], food[Indian], priceRange[high], area[city centre], familyFriendly[yes], near[Raja Indian Cuisine]"	The waterman is a restaurant providing indian food in the high price range. it is located in the city centre.
"name[The Waterman], eatType[restaurant], food[Indian], priceRange[high], area[riverside], familyFriendly[no], near[Raja Indian Cuisine]"	The waterman is a high priced indian restaurant in riverside near raja indian cuisine.
"name[The Waterman], eatType[restaurant], food[Indian], priceRange[high], area[riverside], familyFriendly[yes], near[Raja Indian Cuisine]"	The waterman is a restaurant providing indian food in the high price range. it is located in the riverside. it is near raja indian cuisine.
"name[The Waterman], eatType[restaurant], food[Indian], priceRange[less than £20], area[city centre], familyFriendly[no], near[Raja Indian Cuisine]"	The waterman is a restaurant providing indian food in the less than £20 price range. it is located in the city centre.
"name[The Waterman], eatType[restaurant], food[Indian], priceRange[less than £20], area[city centre], familyFriendly[yes], near[Raja Indian Cuisine]"	The waterman is a restaurant providing indian food in the less than £20 price range. it is located in the city centre.
"name[The Waterman], eatType[restaurant], food[Indian], priceRange[less than £20], area[riverside], familyFriendly[no], near[Raja Indian Cuisine]"	The waterman is a restaurant providing indian food in the less than £20 price range. it is located in the riverside. it is near raja indian cuisine.
"name[The Waterman], eatType[restaurant], food[Indian], priceRange[less than £20], area[riverside], familyFriendly[yes], near[Raja Indian Cuisine]"	The waterman is a restaurant providing indian food in the less than £20 price range. it is located in the riverside.
"name[The Waterman], eatType[restaurant], food[Indian], priceRange[moderate], area[city centre], familyFriendly[no], near[Raja Indian Cuisine]"	The waterman is a moderately priced indian restaurant in the city centre near raja indian cuisine.
"name[The Waterman], eatType[restaurant], food[Indian], priceRange[moderate], area[city centre], familyFriendly[yes], near[Raja Indian Cuisine]"	The waterman is a restaurant providing indian food in the moderate price range. it is located in the city centre.
"name[The Waterman], eatType[restaurant], food[Indian], priceRange[moderate], area[riverside], familyFriendly[no], near[Raja Indian Cuisine]"	The waterman is a restaurant providing indian food in the moderate price range. it is located in the riverside. it is near raja indian cuisine.
"name[The Waterman], eatType[restaurant], food[Indian], priceRange[moderate], area[riverside], familyFriendly[yes], near[Raja Indian Cuisine]"	The waterman is a restaurant providing indian food in the moderate price range. it is located in the riverside. it is near raja indian cuisine.
"name[The Waterman], eatType[restaurant], food[Indian], priceRange[more than £30], area[riverside], familyFriendly[yes], near[Raja Indian Cuisine]"	The waterman is a restaurant providing indian food in the more than £30 price range. it is located in the riverside.
"name[The Waterman], eatType[restaurant], food[Italian], priceRange[£20-25], area[riverside], familyFriendly[yes], near[Raja Indian Cuisine]"	The waterman is a kid friendly italian restaurant in the riverside area near raja indian cuisine.
"name[The Waterman], eatType[restaurant], food[Italian], priceRange[cheap], area[riverside], familyFriendly[yes], near[Raja Indian Cuisine]"	The waterman is a cheap, family friendly restaurant located near raja indian cuisine.
"name[The Waterman], eatType[restaurant], food[Italian], priceRange[high], area[city centre], familyFriendly[no], near[Raja Indian Cuisine]"	The waterman is a high priced italian restaurant in the city centre near raja indian cuisine.
"name[The Waterman], eatType[restaurant], food[Italian], priceRange[high], area[city centre], familyFriendly[yes], near[Raja Indian Cuisine]"	The waterman is a high priced italian restaurant in the city centre near raja indian cuisine.
"name[The Waterman], eatType[restaurant], food[Italian], priceRange[high], area[riverside], familyFriendly[no], near[Raja Indian Cuisine]"	The waterman is a high priced italian restaurant located in riverside near raja indian cuisine.
"name[The Waterman], eatType[restaurant], food[Italian], priceRange[high], area[riverside], familyFriendly[yes], near[Raja Indian Cuisine]"	The waterman is a child friendly italian restaurant located near raja indian cuisine.
"name[The Waterman], eatType[restaurant], food[Italian], priceRange[less than £20], area[city centre], familyFriendly[no], near[Raja Indian Cuisine]"	The waterman is an italian restaurant located in the city centre near raja indian cuisine.
"name[The Waterman], eatType[restaurant], food[Italian], priceRange[less than £20], area[city centre], familyFriendly[yes], near[Raja Indian Cuisine]"	The waterman is a family-friendly italian restaurant located in the city centre near raja indian cuisine.
"name[The Waterman], eatType[restaurant], food[Italian], priceRange[less than £20], area[riverside], familyFriendly[no], near[Raja Indian Cuisine]"	The waterman is an italian restaurant located near raja indian cuisine in the riverside area.
"name[The Wrestlers], eatType[pub], food[Italian], priceRange[less than £20], area[riverside], familyFriendly[no], near[Raja Indian Cuisine]"	The wrestlers is a pub providing italian food in the less than £20 price range. it is located near raja indian cuisine.
"name[The Wrestlers], eatType[pub], food[Italian], priceRange[less than £20], area[riverside], familyFriendly[yes], near[Raja Indian Cuisine]"	The wrestlers is a family friendly italian pub located near raja indian cuisine in the riverside area.
"name[The Wrestlers], eatType[pub], food[Italian], priceRange[moderate], area[city centre], familyFriendly[no], near[Raja Indian Cuisine]"	The wrestlers is a moderately priced italian pub in the city centre near raja indian cuisine in the city centre.
"name[The Wrestlers], eatType[pub], food[Italian], priceRange[moderate], area[city centre], familyFriendly[yes], near[Raja Indian Cuisine]"	The wrestlers is a moderately priced italian pub located near raja indian cuisine in the city centre.
"name[The Wrestlers], eatType[pub], food[Italian], priceRange[moderate], area[riverside], familyFriendly[no], near[Raja Indian Cuisine]"	The wrestlers is a moderately priced italian pub in the riverside area near raja indian cuisine. it is not kid friendly.
"name[The Wrestlers], eatType[pub], food[Italian], priceRange[moderate], area[riverside], familyFriendly[yes], near[Raja Indian Cuisine]"	The wrestlers is a family friendly pub located near raja indian cuisine.
"name[The Wrestlers], eatType[pub], food[Italian], priceRange[more than £30], area[riverside], familyFriendly[yes], near[Raja Indian Cuisine]"	The wrestlers is a pub that serves italian food in the more than £30 price range. it is located in the riverside area near raja indian cuisine.
"name[The Wrestlers], eatType[pub], food[Japanese], priceRange[£20-25], area[riverside], familyFriendly[yes], near[Raja Indian Cuisine]"	The wrestlers is a kid friendly pub located near raja indian cuisine.
"name[The Wrestlers], eatType[pub], food[Japanese], priceRange[cheap], area[riverside], familyFriendly[yes], near[Raja Indian Cuisine]"	The wrestlers is a cheap, family friendly japanese pub near raja indian cuisine in the riverside area.
"name[The Wrestlers], eatType[pub], food[Japanese], priceRange[high], area[riverside], familyFriendly[yes], near[Raja Indian Cuisine]"	The wrestlers is a children friendly pub located near raja indian cuisine.
"name[The Wrestlers], eatType[pub], food[Japanese], priceRange[less than £20], area[city centre], familyFriendly[no], near[Raja Indian Cuisine]"	The wrestlers is a japanese pub located in the city centre near raja indian cuisine.
"name[The Wrestlers], eatType[pub], food[Japanese], priceRange[less than £20], area[city centre], familyFriendly[yes], near[Raja Indian Cuisine]"	The wrestlers is a family-friendly japanese pub located in the city centre near raja indian cuisine.
"name[The Wrestlers], eatType[pub], food[Japanese], priceRange[less than £20], area[riverside], familyFriendly[no], near[Raja Indian Cuisine]"	The wrestlers is a pub that serves japanese food in the less than £20 price range. it is located near raja indian cuisine.
"name[The Wrestlers], eatType[pub], food[Japanese], priceRange[less than £20], area[riverside], familyFriendly[yes], near[Raja Indian Cuisine]"	The wrestlers is a family friendly pub located near raja indian cuisine.
"name[The Wrestlers], eatType[pub], food[Japanese], priceRange[moderate], area[city centre], familyFriendly[no], near[Raja Indian Cuisine]"	The wrestlers is a pub providing japanese food in the moderate price range. it is located in the city centre near raja indian cuisine.
"name[The Wrestlers], eatType[pub], food[Japanese], priceRange[moderate], area[city centre], familyFriendly[yes], near[Raja Indian Cuisine]"	The wrestlers is a japanese pub in the moderate price range. it is located in the city centre near raja indian cuisine.
"name[The Wrestlers], eatType[pub], food[Japanese], priceRange[moderate], area[riverside], familyFriendly[no], near[Raja Indian Cuisine]"	The wrestlers is a moderately priced japanese pub located near raja indian cuisine in the riverside area.
"name[The Wrestlers], eatType[pub], food[Japanese], priceRange[moderate], area[riverside], familyFriendly[yes], near[Raja Indian Cuisine]"	The wrestlers is a kid friendly pub located near raja indian cuisine.
"name[The Wrestlers], eatType[pub], food[Japanese], priceRange[moderate], customer rating[1 out of 5], area[city centre], familyFriendly[yes], near[Raja Indian Cuisine]"	The wrestlers is a japanese pub located in the city centre near raja indian cuisine. it is kid friendly and has a customer rating of 1 out of 5.
"name[The Wrestlers], eatType[pub], food[Japanese], priceRange[moderate], customer rating[1 out of 5], area[riverside], familyFriendly[no], near[Raja Indian Cuisine]"	The wrestlers is a pub that serves japanese food in the moderate price range. it is located near raja indian cuisine. its customer rating is 1 out of 5.
"name[The Wrestlers], eatType[pub], food[Japanese], priceRange[moderate], customer rating[1 out of 5], area[riverside], familyFriendly[yes], near[Raja Indian Cuisine]"	The wrestlers is a pub that serves japanese food. it is located near raja indian cuisine.
"name[The Wrestlers], eatType[pub], food[Japanese], priceRange[more than £30], area[city centre], familyFriendly[no], near[Raja Indian Cuisine]"	The wrestlers is a pub providing japanese food in the more than £30 price range. it is located in the city centre near raja indian cuisine.
"name[The Wrestlers], eatType[pub], food[Japanese], priceRange[more than £30], area[city centre], familyFriendly[yes], near[Raja Indian Cuisine]"	The wrestlers is a family-friendly pub located in the city centre near raja indian cuisine.
"name[The Wrestlers], eatType[pub], food[Japanese], priceRange[more than £30], area[riverside], familyFriendly[no], near[Raja Indian Cuisine]"	The wrestlers is a pub that serves japanese food. it is located near raja indian cuisine.
"name[The Wrestlers], eatType[pub], food[Japanese], priceRange[more than £30], area[riverside], familyFriendly[yes], near[Raja Indian Cuisine]"	The wrestlers is a family friendly pub located near raja indian cuisine.
"name[The Wrestlers], eatType[pub], food[Japanese], priceRange[more than £30], customer rating[5 out of 5], area[city centre], familyFriendly[no], near[Raja Indian Cuisine]"	The wrestlers is a pub providing japanese food in the more than £30 price range. it is located in the city centre near raja indian cuisine.
"name[The Wrestlers], eatType[pub], food[Japanese], priceRange[more than £30], customer rating[5 out of 5], area[city centre], familyFriendly[yes], near[Raja Indian Cuisine]"	The wrestlers is a family-friendly japanese pub located in the city centre near raja indian cuisine.
"name[The Wrestlers], eatType[pub], food[Japanese], priceRange[more than £30], customer rating[5 out of 5], area[riverside], familyFriendly[no], near[Raja Indian Cuisine]"	The wrestlers is a pub providing japanese food in the more than £30 price range. it is located near raja indian cuisine.
"name[The Wrestlers], eatType[pub], food[Japanese], priceRange[more than £30], customer rating[5 out of 5], area[riverside], familyFriendly[yes], near[Raja Indian Cuisine]"	The wrestlers is a family friendly pub located near raja indian cuisine.
"name[The Wrestlers], eatType[pub], food[Japanese], priceRange[more than £30], customer rating[low], area[city centre], familyFriendly[no], near[Raja Indian Cuisine]"	The wrestlers is a pub providing japanese food in the more than £30 price range. it is located near raja indian cuisine in the city centre.
"name[The Wrestlers], eatType[pub], food[Japanese], priceRange[more than £30], customer rating[low], area[city centre], familyFriendly[yes], near[Raja Indian Cuisine]"	The wrestlers is a japanese pub in the more than £30 price range. it is located in the city centre and is children friendly.
"name[The Wrestlers], eatType[pub], food[Japanese], priceRange[more than £30], customer rating[low], area[riverside], familyFriendly[no], near[Raja Indian Cuisine]"	The wrestlers is a pub that serves japanese food. it is located near raja indian cuisine.
"name[The Wrestlers], eatType[pub], food[Japanese], priceRange[more than £30], customer rating[low], area[riverside], familyFriendly[yes], near[Raja Indian Cuisine]"	The wrestlers is a family friendly pub located near raja indian cuisine.
"name[The Wrestlers], eatType[restaurant], food[Italian], priceRange[less than £20], area[riverside], familyFriendly[no], near[Raja Indian Cuisine]"	The wrestlers is a cheap italian restaurant located in the riverside area near raja indian cuisine.
"name[The Wrestlers], eatType[restaurant], food[Italian], priceRange[less than £20], area[riverside], familyFriendly[yes], near[Raja Indian Cuisine]"	The wrestlers is a family friendly italian restaurant in the riverside area near raja indian cuisine.
"name[The Wrestlers], eatType[restaurant], food[Italian], priceRange[moderate], area[city centre], familyFriendly[no], near[Raja Indian Cuisine]"	The wrestlers is a moderately priced italian restaurant located in the city centre near raja indian cuisine.
"name[The Wrestlers], eatType[restaurant], food[Italian], priceRange[moderate], area[city centre], familyFriendly[yes], near[Raja Indian Cuisine]"	The wrestlers is a moderately priced italian restaurant in the city centre near raja indian cuisine.
"name[The Wrestlers], eatType[restaurant], food[Italian], priceRange[moderate], area[riverside], familyFriendly[no], near[Raja Indian Cuisine]"	The wrestlers is a moderately priced italian restaurant in the riverside area near raja indian cuisine.
"name[The Wrestlers], eatType[restaurant], food[Italian], priceRange[moderate], area[riverside], familyFriendly[yes], near[Raja Indian Cuisine]"	The wrestlers is a moderately priced italian restaurant in the riverside area near raja indian cuisine.
"name[The Wrestlers], eatType[restaurant], food[Italian], priceRange[more than £30], area[riverside], familyFriendly[yes], near[Raja Indian Cuisine]"	The wrestlers is a family friendly italian restaurant in the riverside area near raja indian cuisine.
"name[The Wrestlers], eatType[restaurant], food[Japanese], priceRange[£20-25], area[riverside], familyFriendly[yes], near[Raja Indian Cuisine]"	The wrestlers is a kid friendly japanese restaurant near raja indian cuisine in the riverside area.
"name[The Wrestlers], eatType[restaurant], food[Japanese], priceRange[cheap], area[riverside], familyFriendly[yes], near[Raja Indian Cuisine]"	The wrestlers is a family friendly japanese restaurant located near raja indian cuisine.
"name[The Wrestlers], eatType[restaurant], food[Japanese], priceRange[high], area[riverside], familyFriendly[yes], near[Raja Indian Cuisine]"	The wrestlers is a high priced japanese restaurant in riverside near raja raja indian cuisine.
"name[The Wrestlers], eatType[restaurant], food[Japanese], priceRange[less than £20], area[city centre], familyFriendly[no], near[Raja Indian Cuisine]"	The wrestlers is a cheap japanese restaurant located in the city centre near raja indian cuisine.
"name[The Wrestlers], eatType[restaurant], food[Japanese], priceRange[less than £20], area[city centre], familyFriendly[yes], near[Raja Indian Cuisine]"	The wrestlers is a family-friendly japanese restaurant located in the city centre near raja indian cuisine.
"name[The Wrestlers], eatType[restaurant], food[Japanese], priceRange[less than £20], area[riverside], familyFriendly[no], near[Raja Indian Cuisine]"	The wrestlers is a japanese restaurant near raja indian cuisine in riverside.
"name[The Wrestlers], eatType[restaurant], food[Japanese], priceRange[less than £20], area[riverside], familyFriendly[yes], near[Raja Indian Cuisine]"	The wrestlers is a family friendly japanese restaurant in the riverside area near raja indian cuisine.
"name[The Wrestlers], eatType[restaurant], food[Japanese], priceRange[moderate], area[city centre], familyFriendly[no], near[Raja Indian Cuisine]"	The wrestlers is a moderately priced japanese restaurant located in the city centre near raja indian cuisine.
"name[The Wrestlers], eatType[restaurant], food[Japanese], priceRange[moderate], area[city centre], familyFriendly[yes], near[Raja Indian Cuisine]"	The wrestlers is a moderately priced japanese restaurant in the city centre near raja indian cuisine.
"name[The Wrestlers], eatType[restaurant], food[Japanese], priceRange[moderate], area[riverside], familyFriendly[no], near[Raja Indian Cuisine]"	The wrestlers is a moderately priced japanese restaurant in the riverside area near raja indian cuisine.
"name[The Wrestlers], eatType[restaurant], food[Japanese], priceRange[moderate], area[riverside], familyFriendly[yes], near[Raja Indian Cuisine]"	The wrestlers is a moderately priced japanese restaurant in the riverside area near raja indian cuisine.
"name[The Wrestlers], eatType[restaurant], food[Japanese], priceRange[more than £30], area[city centre], familyFriendly[no], near[Raja Indian Cuisine]"	The wrestlers is a japanese restaurant in the city centre near raja indian cuisine.
"name[The Wrestlers], eatType[restaurant], food[Japanese], priceRange[more than £30], area[city centre], familyFriendly[yes], near[Raja Indian Cuisine]"	The wrestlers is a children friendly japanese restaurant located in the city centre near raja indian cuisine.
"name[The Wrestlers], eatType[restaurant], food[Japanese], priceRange[more than £30], area[riverside], familyFriendly[no], near[Raja Indian Cuisine]"	The wrestlers is a japanese restaurant near raja indian cuisine in the riverside area.
"name[The Wrestlers], eatType[restaurant], food[Japanese], priceRange[more than £30], area[riverside], familyFriendly[yes], near[Raja Indian Cuisine]"	The wrestlers is a family friendly japanese restaurant in the riverside area near raja indian cuisine.
"name[Wildwood], eatType[coffee shop], area[riverside]"	Wildwood is a coffee shop in the riverside area.
"name[Wildwood], eatType[pub], area[riverside]"	Wildwood is a pub in the riverside area.
"name[Wildwood], eatType[pub], food[French], area[riverside], familyFriendly[yes], near[Raja Indian Cuisine]"	Wildwood is a family friendly pub near raja indian cuisine in the riverside area.
"name[Wildwood], eatType[pub], food[Indian], area[city centre], familyFriendly[no], near[Raja Indian Cuisine]"	Wildwood is a pub providing indian food in the city centre near raja indian cuisine in the city centre.
"name[Wildwood], eatType[pub], food[Indian], area[city centre], familyFriendly[yes], near[Raja Indian Cuisine]"	Wildwood is a pub that serves indian food in the city centre near raja indian cuisine.
"name[Wildwood], eatType[pub], food[Indian], area[riverside], familyFriendly[no], near[Raja Indian Cuisine]"	Wildwood is a pub providing indian food in the riverside area near raja indian cuisine.
"name[Wildwood], eatType[pub], food[Indian], area[riverside], familyFriendly[yes], near[Raja Indian Cuisine]"	Wildwood is a family friendly pub located near raja indian cuisine.
"name[Wildwood], eatType[pub], food[Italian], area[city centre], familyFriendly[no], near[Raja Indian Cuisine]"	Wildwood is a pub located in the city centre near raja indian cuisine. it is not family-friendly.
"name[Wildwood], eatType[pub], food[Italian], area[city centre], familyFriendly[yes], near[Raja Indian Cuisine]"	Wildwood is a family-friendly pub in the city centre near raja indian cuisine.
"name[Wildwood], eatType[pub], food[Italian], area[riverside], familyFriendly[no], near[Raja Indian Cuisine]"	Wildwood is a pub near raja indian cuisine in riverside. it is not family-friendly.
"name[Wildwood], eatType[pub], food[Italian], area[riverside], familyFriendly[yes], near[Raja Indian Cuisine]"	Wildwood is a family friendly pub near raja indian cuisine.
"name[Wildwood], eatType[restaurant], food[French], area[riverside], familyFriendly[yes], near[Raja Indian Cuisine]"	Wildwood is a french restaurant in the riverside area near raja indian cuisine.
"name[Wildwood], eatType[restaurant], food[Indian], area[city centre], familyFriendly[no], near[Raja Indian Cuisine]"	Wildwood is a restaurant providing indian food in the city centre near raja indian cuisine.
"name[Wildwood], eatType[restaurant], food[Indian], area[city centre], familyFriendly[yes], near[Raja Indian Cuisine]"	Wildwood is a restaurant providing indian food in the city centre near raja indian cuisine.
"name[Wildwood], eatType[restaurant], food[Indian], area[riverside], familyFriendly[no], near[Raja Indian Cuisine]"	Wildwood is a restaurant providing indian food in the riverside area near raja indian cuisine.
"name[Wildwood], eatType[restaurant], food[Indian], area[riverside], familyFriendly[yes], near[Raja Indian Cuisine]"	Wildwood is a restaurant providing indian food in the riverside area near raja indian cuisine.
"name[Wildwood], eatType[restaurant], food[Italian], area[city centre], familyFriendly[no], near[Raja Indian Cuisine]"	Wildwood is a italian restaurant located in the city centre near raja indian.
"name[Wildwood], eatType[restaurant], food[Italian], area[city centre], familyFriendly[yes], near[Raja Indian Cuisine]"	Wildwood is a family-friendly italian restaurant in the city centre near raja indian cuisine.
"name[Wildwood], eatType[restaurant], food[Italian], area[riverside], familyFriendly[no], near[Raja Indian Cuisine]"	Wildwood is a italian restaurant located in the riverside area near raja indian cuisine.
"name[Wildwood], eatType[restaurant], food[Italian], area[riverside], familyFriendly[yes], near[Raja Indian Cuisine]"	Wildwood is a family friendly restaurant in the riverside area near raja indian cuisine.
"name[Zizzi], eatType[coffee shop], area[riverside]"	Zizzi is a coffee shop in riverside.
"name[Zizzi], eatType[coffee shop], customer rating[average], near[Burger King]"	Zizzi is a coffee shop located near burger king.
"name[Zizzi], eatType[coffee shop], customer rating[high], near[Burger King]"	Zizzi is a coffee shop near burger king with a high customer rating.
"name[Zizzi], eatType[coffee shop], near[The Sorrento]"	Zizzi is a coffee shop near the sorrento.
"name[Zizzi], eatType[pub], area[riverside]"	Zizzi is a pub in the riverside area.
"name[Zizzi], eatType[pub], customer rating[average], near[Burger King]"	Zizzi is a pub near burger king with an average customer rating.
"name[Zizzi], eatType[pub], customer rating[high], near[Burger King]"	Zizzi is a pub near burger king with a high customer rating.
"name[Zizzi], eatType[pub], near[The Sorrento]"	Zizzi is a pub near the sorrento.
