MR	output
name[Blue Spice], eatType[coffee shop], area[city centre]	There is a coffee shop Blue Spice in the city centre area.
name[Blue Spice], eatType[coffee shop], area[riverside]	In the riverside area, there is a coffee shop called Blue Spice.
name[Blue Spice], eatType[coffee shop], customer rating[5 out of 5], near[Crowne Plaza Hotel]	Near Crowne Plaza Hotel is Blue Spice coffee shop, with a customer rating of 5 out of 5.
name[Blue Spice], eatType[coffee shop], customer rating[average], near[Burger King]	Blue Spice is a coffee shop located near Burger King with an average customer rating.
name[Blue Spice], eatType[coffee shop], customer rating[average], near[Crowne Plaza Hotel]	There is an average-rated coffee shop called Blue Spice located near Crowne Plaza Hotel.
name[Blue Spice], eatType[pub], area[city centre]	Blue Spice is a city centre pub.
name[Blue Spice], eatType[pub], area[riverside]	Blue Spice is a pub located in the riverside.
name[Blue Spice], eatType[pub], customer rating[5 out of 5], near[Crowne Plaza Hotel]	Located near Crowne Plaza Hotel, Blue Spice pub has a customer rating of 5 out of 5.
name[Blue Spice], eatType[pub], customer rating[average], near[Burger King]	Near Burger King is Blue Spice pub. It has average customer ratings.
name[Blue Spice], eatType[pub], customer rating[average], near[Crowne Plaza Hotel]	Blue Spice pub has an average customer rating and is located near Crowne Plaza Hotel.
name[Blue Spice], eatType[pub], food[Chinese], area[city centre], familyFriendly[no], near[Rainbow Vegetarian Café]	Blue Spice is a pub providing Chinese food. It is located in the city centre area, near Rainbow Vegetarian Café.
name[Blue Spice], eatType[pub], food[Chinese], area[city centre], familyFriendly[yes], near[Rainbow Vegetarian Café]	Blue Spice is a Chinese pub near Rainbow Vegetarian Café in the city centre area. It is family-friendly.
name[Blue Spice], eatType[pub], food[Chinese], area[riverside], familyFriendly[no], near[Rainbow Vegetarian Café]	Blue Spice is a pub serving Chinese food. It is not family-friendly. It is based in the riverside area near Rainbow Vegetarian Café.
name[Blue Spice], eatType[pub], food[Chinese], area[riverside], familyFriendly[yes], near[Rainbow Vegetarian Café]	Blue Spice serves Chinese food that is kids-friendly. It is in the riverside area near Rainbow Vegetarian Café.
name[Blue Spice], eatType[pub], food[English], area[city centre], familyFriendly[no], near[Rainbow Vegetarian Café]	Blue Spice is a non family-friendly English pub, just a short distance from Rainbow Vegetarian Café in the city centre area.
name[Blue Spice], eatType[pub], food[English], area[city centre], familyFriendly[yes], near[Rainbow Vegetarian Café]	Blue Spice is a family-friendly English pub, just a short distance from Rainbow Vegetarian Café in the city centre area.
name[Blue Spice], eatType[pub], food[English], area[riverside], familyFriendly[no], near[Rainbow Vegetarian Café]	English food is available in a non children-friendly pub called Blue Spice, near Rainbow Vegetarian Café in the riverside area.
name[Blue Spice], eatType[pub], food[English], area[riverside], familyFriendly[yes], near[Rainbow Vegetarian Café]	Blue Spice is a family-friendly pub. They serve English food and are located near Rainbow Vegetarian Café in the riverside area.
name[Blue Spice], eatType[restaurant], food[Chinese], area[city centre], familyFriendly[no], near[Rainbow Vegetarian Café]	Blue Spice is a restaurant providing Chinese food. It is located in the city centre area, near Rainbow Vegetarian Café.
name[Blue Spice], eatType[restaurant], food[Chinese], area[city centre], familyFriendly[yes], near[Rainbow Vegetarian Café]	Blue Spice is a restaurant providing Chinese food. It is located in the city centre area, near Rainbow Vegetarian Café.
name[Blue Spice], eatType[restaurant], food[Chinese], area[riverside], familyFriendly[no], near[Rainbow Vegetarian Café]	Blue Spice is a restaurant serving Chinese food. It is not family-friendly. It is based in the riverside area near Rainbow Vegetarian Café.
name[Blue Spice], eatType[restaurant], food[Chinese], area[riverside], familyFriendly[yes], near[Rainbow Vegetarian Café]	Blue Spice is a Chinese restaurant near Rainbow Vegetarian Café in the riverside area. It is family-friendly.
name[Blue Spice], eatType[restaurant], food[English], area[city centre], familyFriendly[no], near[Rainbow Vegetarian Café]	Blue Spice is a non family-friendly English restaurant, just a short distance from Rainbow Vegetarian Café in the city centre area.
name[Blue Spice], eatType[restaurant], food[English], area[city centre], familyFriendly[yes], near[Rainbow Vegetarian Café]	Blue Spice serves English food that is kids-friendly. It is in the city centre area near Rainbow Vegetarian Café.
name[Blue Spice], eatType[restaurant], food[English], area[riverside], familyFriendly[no], near[Rainbow Vegetarian Café]	English food is available in a non children-friendly restaurant called Blue Spice, near Rainbow Vegetarian Café in the riverside area.
name[Blue Spice], eatType[restaurant], food[English], area[riverside], familyFriendly[yes], near[Rainbow Vegetarian Café]	Blue Spice is a family-friendly English restaurant, just a short distance from Rainbow Vegetarian Café in the riverside area.
name[Clowns], eatType[coffee shop], customer rating[3 out of 5], near[All Bar One]	Clowns is a coffee shop near All Bar One with a rating 3 out of 5.
name[Clowns], eatType[coffee shop], customer rating[5 out of 5], near[Crowne Plaza Hotel]	There is a 5 out of 5 stars coffee shop called Clowns located near Crowne Plaza Hotel.
name[Clowns], eatType[coffee shop], near[The Sorrento]	Clowns is a coffee shop near The Sorrento.
name[Clowns], eatType[pub], customer rating[3 out of 5], near[All Bar One]	Near All Bar One is Clowns pub, with a customer rating of 3 out of 5.
name[Clowns], eatType[pub], customer rating[5 out of 5], near[Crowne Plaza Hotel]	Located near Crowne Plaza Hotel, Clowns pub has a customer rating of 5 out of 5.
name[Clowns], eatType[pub], near[The Sorrento]	Clowns is a pub located a few steps of The Sorrento.
name[Cocum], eatType[coffee shop], customer rating[high], near[Burger King]	Cocum is a coffee shop located near Burger King with a high customer rating.
name[Cocum], eatType[coffee shop], customer rating[high], near[Café Sicilia]	There is a high-rated coffee shop called Cocum located near Café Sicilia.
name[Cocum], eatType[coffee shop], customer rating[low], near[Café Sicilia]	Near Café Sicilia is Cocum coffee shop. It has low customer ratings.
name[Cocum], eatType[coffee shop], customer rating[low], near[Express by Holiday Inn]	Cocum coffee shop has a low customer rating and is located near Express by Holiday Inn.
name[Cocum], eatType[coffee shop], near[The Rice Boat]	For a coffee shop near The Rice Boat, try Cocum.
name[Cocum], eatType[coffee shop], near[The Sorrento]	Cocum is a coffee shop found near The Sorrento.
name[Cocum], eatType[pub], customer rating[high], near[Burger King]	Cocum is a pub located near Burger King with a high customer rating.
name[Cocum], eatType[pub], customer rating[high], near[Café Sicilia]	There is a high-rated pub called Cocum located near Café Sicilia.
name[Cocum], eatType[pub], customer rating[low], near[Café Sicilia]	Near Café Sicilia is Cocum pub. It has low customer ratings.
name[Cocum], eatType[pub], customer rating[low], near[Express by Holiday Inn]	Cocum pub has a low customer rating and is located near Express by Holiday Inn.
name[Cocum], eatType[pub], near[The Rice Boat]	Cocum is a pub near The Rice Boat.
name[Cocum], eatType[pub], near[The Sorrento]	Cocum is a pub located a few steps of The Sorrento.
name[Cotto], eatType[coffee shop], near[The Bakers]	For a coffee shop near The Bakers, try Cotto.
name[Cotto], eatType[pub], near[The Bakers]	Cotto is a pub found near The Bakers.
name[Giraffe], eatType[coffee shop], near[The Bakers]	Giraffe is a coffee shop near The Bakers.
name[Giraffe], eatType[coffee shop], near[The Rice Boat]	Giraffe is a coffee shop located a few steps of The Rice Boat.
name[Giraffe], eatType[pub], food[English], area[riverside], familyFriendly[yes], near[Rainbow Vegetarian Café]	Giraffe is a family-friendly pub. They serve English food and are located near Rainbow Vegetarian Café in the riverside area.
name[Giraffe], eatType[pub], food[Fast food], area[city centre], familyFriendly[no], near[Rainbow Vegetarian Café]	Giraffe is a pub providing fast food. It is located in the city centre area, near Rainbow Vegetarian Café.
name[Giraffe], eatType[pub], food[Fast food], area[city centre], familyFriendly[yes], near[Rainbow Vegetarian Café]	Giraffe is a pub providing fast food. It is located in the city centre area, near Rainbow Vegetarian Café.
name[Giraffe], eatType[pub], food[Fast food], area[riverside], familyFriendly[no], near[Rainbow Vegetarian Café]	Giraffe is a pub serving fast food. It is not family-friendly. It is based in the riverside area near Rainbow Vegetarian Café.
name[Giraffe], eatType[pub], food[Fast food], area[riverside], familyFriendly[yes], near[Rainbow Vegetarian Café]	Giraffe is a Fast food pub near Rainbow Vegetarian Café in the riverside area. It is family-friendly.
name[Giraffe], eatType[pub], food[Fast food], area[riverside], familyFriendly[yes], near[Raja Indian Cuisine]	Giraffe serves fast food that is kids-friendly. It is in the riverside area near Raja Indian Cuisine.
name[Giraffe], eatType[pub], food[French], area[city centre], familyFriendly[no], near[Raja Indian Cuisine]	Giraffe is a non family-friendly French pub, just a short distance from Raja Indian Cuisine in the city centre area.
name[Giraffe], eatType[pub], food[French], area[city centre], familyFriendly[yes], near[Raja Indian Cuisine]	Giraffe is a family-friendly French pub, just a short distance from Raja Indian Cuisine in the city centre area.
name[Giraffe], eatType[pub], food[French], area[riverside], familyFriendly[no], near[Raja Indian Cuisine]	French food is available in a non children-friendly pub called Giraffe, near Raja Indian Cuisine in the riverside area.
name[Giraffe], eatType[pub], food[French], area[riverside], familyFriendly[yes], near[Raja Indian Cuisine]	Giraffe is a family-friendly pub. They serve French food and are located near Raja Indian Cuisine in the riverside area.
name[Giraffe], eatType[pub], near[The Bakers]	For a pub near The Bakers, try Giraffe.
name[Giraffe], eatType[pub], near[The Rice Boat]	Giraffe is a pub found near The Rice Boat.
name[Giraffe], eatType[restaurant], food[English], area[riverside], familyFriendly[yes], near[Rainbow Vegetarian Café]	Giraffe is a restaurant providing English food. It is located in the riverside area, near Rainbow Vegetarian Café.
name[Giraffe], eatType[restaurant], food[Fast food], area[city centre], familyFriendly[no], near[Rainbow Vegetarian Café]	Giraffe is a restaurant providing fast food. It is located in the city centre area, near Rainbow Vegetarian Café.
name[Giraffe], eatType[restaurant], food[Fast food], area[city centre], familyFriendly[yes], near[Rainbow Vegetarian Café]	Giraffe is a Fast food restaurant near Rainbow Vegetarian Café in the city centre area. It is family-friendly.
name[Giraffe], eatType[restaurant], food[Fast food], area[riverside], familyFriendly[no], near[Rainbow Vegetarian Café]	Giraffe is a restaurant serving fast food. It is not family-friendly. It is based in the riverside area near Rainbow Vegetarian Café.
name[Giraffe], eatType[restaurant], food[Fast food], area[riverside], familyFriendly[yes], near[Rainbow Vegetarian Café]	Giraffe serves fast food that is kids-friendly. It is in the riverside area near Rainbow Vegetarian Café.
name[Giraffe], eatType[restaurant], food[Fast food], area[riverside], familyFriendly[yes], near[Raja Indian Cuisine]	Giraffe is a family-friendly Fast food restaurant, just a short distance from Raja Indian Cuisine in the riverside area.
name[Giraffe], eatType[restaurant], food[French], area[city centre], familyFriendly[no], near[Raja Indian Cuisine]	Giraffe is a non family-friendly French restaurant, just a short distance from Raja Indian Cuisine in the city centre area.
name[Giraffe], eatType[restaurant], food[French], area[city centre], familyFriendly[yes], near[Raja Indian Cuisine]	Giraffe is a family-friendly restaurant. They serve French food and are located near Raja Indian Cuisine in the city centre area.
name[Giraffe], eatType[restaurant], food[French], area[riverside], familyFriendly[no], near[Raja Indian Cuisine]	French food is available in a non children-friendly restaurant called Giraffe, near Raja Indian Cuisine in the riverside area.
name[Giraffe], eatType[restaurant], food[French], area[riverside], familyFriendly[yes], near[Raja Indian Cuisine]	Giraffe is a restaurant providing French food. It is located in the riverside area, near Raja Indian Cuisine.
name[Green Man], eatType[coffee shop], customer rating[1 out of 5], near[All Bar One]	Green Man is a coffee shop near All Bar One with a rating 1 out of 5.
name[Green Man], eatType[coffee shop], customer rating[3 out of 5], near[All Bar One]	There is a 3 out of 5 stars coffee shop called Green Man located near All Bar One.
name[Green Man], eatType[pub], customer rating[1 out of 5], near[All Bar One]	Near All Bar One is Green Man pub, with a customer rating of 1 out of 5.
name[Green Man], eatType[pub], customer rating[3 out of 5], near[All Bar One]	Located near All Bar One, Green Man pub has a customer rating of 3 out of 5.
name[Green Man], eatType[pub], food[Italian], area[riverside], familyFriendly[yes], near[Express by Holiday Inn]	Green Man is a Italian pub near Express by Holiday Inn in the riverside area. It is family-friendly.
name[Green Man], eatType[pub], food[Italian], area[riverside], familyFriendly[yes], near[Raja Indian Cuisine]	Green Man serves Italian food that is kids-friendly. It is in the riverside area near Raja Indian Cuisine.
name[Green Man], eatType[pub], food[Japanese], area[city centre], familyFriendly[no], near[Express by Holiday Inn]	Green Man is a pub providing Japanese food. It is located in the city centre area, near Express by Holiday Inn.
name[Green Man], eatType[pub], food[Japanese], area[city centre], familyFriendly[yes], near[Express by Holiday Inn]	Green Man is a family-friendly Japanese pub, just a short distance from Express by Holiday Inn in the city centre area.
name[Green Man], eatType[pub], food[Japanese], area[riverside], familyFriendly[no], near[Express by Holiday Inn]	Green Man is a pub serving Japanese food. It is not family-friendly. It is based in the riverside area near Express by Holiday Inn.
name[Green Man], eatType[pub], food[Japanese], area[riverside], familyFriendly[yes], near[Express by Holiday Inn]	Green Man is a family-friendly pub. They serve Japanese food and are located near Express by Holiday Inn in the riverside area.
name[Green Man], eatType[restaurant], food[Italian], area[riverside], familyFriendly[yes], near[Express by Holiday Inn]	Green Man is a restaurant providing Italian food. It is located in the riverside area, near Express by Holiday Inn.
name[Green Man], eatType[restaurant], food[Italian], area[riverside], familyFriendly[yes], near[Raja Indian Cuisine]	Green Man is a Italian restaurant near Raja Indian Cuisine in the riverside area. It is family-friendly.
name[Green Man], eatType[restaurant], food[Japanese], area[city centre], familyFriendly[no], near[Express by Holiday Inn]	Green Man is a non family-friendly Japanese restaurant, just a short distance from Express by Holiday Inn in the city centre area.
name[Green Man], eatType[restaurant], food[Japanese], area[city centre], familyFriendly[yes], near[Express by Holiday Inn]	Green Man serves Japanese food that is kids-friendly. It is in the city centre area near Express by Holiday Inn.
name[Green Man], eatType[restaurant], food[Japanese], area[riverside], familyFriendly[no], near[Express by Holiday Inn]	Japanese food is available in a non children-friendly restaurant called Green Man, near Express by Holiday Inn in the riverside area.
name[Green Man], eatType[restaurant], food[Japanese], area[riverside], familyFriendly[yes], near[Express by Holiday Inn]	Green Man is a family-friendly Japanese restaurant, just a short distance from Express by Holiday Inn in the riverside area.
name[Loch Fyne], eatType[coffee shop], area[riverside]	There is a coffee shop Loch Fyne in the riverside area.
name[Loch Fyne], eatType[pub], area[riverside]	In the riverside area, there is a pub called Loch Fyne.
name[Strada], eatType[coffee shop], area[city centre]	A coffee shop called Strada is located in the city centre area.
name[Strada], eatType[coffee shop], customer rating[1 out of 5], near[All Bar One]	Strada is a coffee shop near All Bar One with a rating 1 out of 5.
name[Strada], eatType[coffee shop], customer rating[1 out of 5], near[Rainbow Vegetarian Café]	There is a 1 out of 5 stars coffee shop called Strada located near Rainbow Vegetarian Café.
name[Strada], eatType[coffee shop], customer rating[low], near[Express by Holiday Inn]	Strada is a coffee shop located near Express by Holiday Inn with a low customer rating.
name[Strada], eatType[pub], area[city centre]	Strada is a city centre pub.
name[Strada], eatType[pub], customer rating[1 out of 5], near[All Bar One]	Near All Bar One is Strada pub, with a customer rating of 1 out of 5.
name[Strada], eatType[pub], customer rating[1 out of 5], near[Rainbow Vegetarian Café]	Located near Rainbow Vegetarian Café, Strada pub has a customer rating of 1 out of 5.
name[Strada], eatType[pub], customer rating[low], near[Express by Holiday Inn]	There is a low-rated pub called Strada located near Express by Holiday Inn.
name[The Cricketers], eatType[coffee shop], customer rating[1 out of 5], familyFriendly[yes], near[Avalon]	The Cricketers is a coffee shop near Avalon. It has a rating of 1 out of 5 and is children-friendly.
name[The Cricketers], eatType[coffee shop], customer rating[3 out of 5], familyFriendly[yes], near[Avalon]	Family-friendly coffee shop The Cricketers is near Avalon and has a customer rating of 3 out of 5.
name[The Cricketers], eatType[coffee shop], customer rating[3 out of 5], familyFriendly[yes], near[Crowne Plaza Hotel]	The Cricketers is a coffee shop near Crowne Plaza Hotel. It has a rating of 3 out of 5 and is children-friendly.
name[The Cricketers], eatType[coffee shop], customer rating[5 out of 5], familyFriendly[no], near[Crowne Plaza Hotel]	The Cricketers is a coffee shop near Crowne Plaza Hotel. It has a rating of 5 out of 5 and is not children-friendly.
name[The Cricketers], eatType[coffee shop], customer rating[5 out of 5], familyFriendly[yes], near[Crowne Plaza Hotel]	Family-friendly coffee shop The Cricketers is near Crowne Plaza Hotel and has a customer rating of 5 out of 5.
name[The Cricketers], eatType[coffee shop], customer rating[average], familyFriendly[no], near[Café Sicilia]	The Cricketers is a children-friendly coffee shop near Café Sicilia with an average customer rating.
name[The Cricketers], eatType[coffee shop], customer rating[average], familyFriendly[no], near[Crowne Plaza Hotel]	The Cricketers is a coffee shop near Crowne Plaza Hotel. It has an average rating and is for adults only.
name[The Cricketers], eatType[coffee shop], customer rating[average], familyFriendly[yes], near[Café Sicilia]	Near Café Sicilia you will find a children-friendly coffee shop with an average customer rating called The Cricketers.
name[The Cricketers], eatType[coffee shop], customer rating[high], familyFriendly[yes], near[Café Sicilia]	The Cricketers is a family-friendly coffee shop near Café Sicilia. It has a high customer rating.
name[The Cricketers], eatType[coffee shop], customer rating[high], familyFriendly[yes], near[Express by Holiday Inn]	A family-friendly coffee shop known as The Cricketers is located near Express by Holiday Inn and has a high customer rating.
name[The Cricketers], eatType[coffee shop], customer rating[low], familyFriendly[no], near[Express by Holiday Inn]	The Cricketers is a children-friendly coffee shop near Express by Holiday Inn with a low customer rating.
name[The Cricketers], eatType[coffee shop], customer rating[low], familyFriendly[no], near[Ranch]	The Cricketers is a coffee shop near Ranch. It has a low rating and is for adults only.
name[The Cricketers], eatType[coffee shop], customer rating[low], familyFriendly[yes], near[Ranch]	The Cricketers is a children-friendly coffee shop near a Ranch with a low customer rating.
name[The Cricketers], eatType[restaurant], customer rating[1 out of 5], familyFriendly[yes], near[Avalon]	The Cricketers is a restaurant near Avalon. It has a rating of 1 out of 5 and is children-friendly.
name[The Cricketers], eatType[restaurant], customer rating[3 out of 5], familyFriendly[yes], near[Avalon]	Family-friendly restaurant The Cricketers is near Avalon and has a customer rating of 3 out of 5.
name[The Cricketers], eatType[restaurant], customer rating[3 out of 5], familyFriendly[yes], near[Crowne Plaza Hotel]	The Cricketers is a restaurant near Crowne Plaza Hotel. It has a rating of 3 out of 5 and is children-friendly.
name[The Cricketers], eatType[restaurant], customer rating[5 out of 5], familyFriendly[no], near[Crowne Plaza Hotel]	The Cricketers is a children-friendly restaurant near Crowne Plaza Hotel with a customer rating of 5 out of 5.
name[The Cricketers], eatType[restaurant], customer rating[5 out of 5], familyFriendly[yes], near[Crowne Plaza Hotel]	Family-friendly restaurant The Cricketers is near Crowne Plaza Hotel and has a customer rating of 5 out of 5.
name[The Cricketers], eatType[restaurant], customer rating[average], familyFriendly[no], near[Café Sicilia]	The Cricketers is a children-friendly restaurant near Café Sicilia with an average customer rating.
name[The Cricketers], eatType[restaurant], customer rating[average], familyFriendly[no], near[Crowne Plaza Hotel]	The Cricketers is a restaurant near Crowne Plaza Hotel. It has an average rating and is for adults only.
name[The Cricketers], eatType[restaurant], customer rating[average], familyFriendly[yes], near[Café Sicilia]	Near Café Sicilia you will find a children-friendly restaurant with an average customer rating called The Cricketers.
name[The Cricketers], eatType[restaurant], customer rating[high], familyFriendly[yes], near[Café Sicilia]	The Cricketers is a family-friendly restaurant near Café Sicilia. It has a high customer rating.
name[The Cricketers], eatType[restaurant], customer rating[high], familyFriendly[yes], near[Express by Holiday Inn]	A family-friendly restaurant known as The Cricketers is located near Express by Holiday Inn and has a high customer rating.
name[The Cricketers], eatType[restaurant], customer rating[low], familyFriendly[no], near[Express by Holiday Inn]	The Cricketers is a children-friendly restaurant near Express by Holiday Inn with a low customer rating.
name[The Cricketers], eatType[restaurant], customer rating[low], familyFriendly[no], near[Ranch]	The Cricketers is a restaurant near Ranch. It has a low rating and is for adults only.
name[The Cricketers], eatType[restaurant], customer rating[low], familyFriendly[yes], near[Ranch]	The Cricketers is a children-friendly restaurant near a Ranch with a low customer rating.
name[The Cricketers], eatType[restaurant], food[Chinese], priceRange[£20-25], customer rating[high], area[city centre], familyFriendly[no], near[All Bar One]	£20-25 Chinese food for adults can be found at The Cricketers restaurant, near All Bar One in the city centre area. High ratings.
name[The Cricketers], eatType[restaurant], food[Chinese], priceRange[£20-25], customer rating[high], area[city centre], familyFriendly[yes], near[All Bar One]	£20-25 Chinese food for all the family can be found at The Cricketers restaurant, near All Bar One, in the city centre area. High ratings.
name[The Cricketers], eatType[restaurant], food[Chinese], priceRange[£20-25], customer rating[high], area[riverside], familyFriendly[no], near[All Bar One]	The Cricketers, located near All Bar One in the riverside area, is a not kid-friendly restaurant. The Cricketers serves £20-25 Chinese food and has a high customer rating.
name[The Cricketers], eatType[restaurant], food[Chinese], priceRange[£20-25], customer rating[high], area[riverside], familyFriendly[yes], near[All Bar One]	For a child-friendly, high-rated restaurant serving Chinese, try The Cricketers, in the riverside area, near All Bar One.
name[The Cricketers], eatType[restaurant], food[Chinese], priceRange[cheap], customer rating[5 out of 5], area[city centre], familyFriendly[no], near[All Bar One]	The Cricketers is a cheap restaurant that serves Chinese food. It is not children-friendly and has a rating of 5 out of 5. It is located in the city centre area near All Bar One.
name[The Cricketers], eatType[restaurant], food[Chinese], priceRange[cheap], customer rating[5 out of 5], area[city centre], familyFriendly[yes], near[All Bar One]	There is a 5 out of 5 stars cheap family-friendly restaurant The Cricketers near All Bar One in the city centre area. It offers Chinese food.
name[The Cricketers], eatType[restaurant], food[Chinese], priceRange[cheap], customer rating[5 out of 5], area[riverside], familyFriendly[no], near[All Bar One]	The Cricketers, located near All Bar One in the riverside area, is a not kid-friendly restaurant. The Cricketers serves cheap Chinese food and has a customer rating of 5 out of 5.
name[The Cricketers], eatType[restaurant], food[Chinese], priceRange[cheap], customer rating[5 out of 5], area[riverside], familyFriendly[yes], near[All Bar One]	The Cricketers, located near All Bar One in the riverside area, is a kid-friendly restaurant. The Cricketers serves cheap Chinese food and has a customer rating of 5 out of 5.
name[The Cricketers], eatType[restaurant], food[Chinese], priceRange[cheap], customer rating[average], area[city centre], familyFriendly[no], near[All Bar One]	The Cricketers is a cheap restaurant that serves Chinese food. It is not children-friendly and has an average customer rating. It is located in the city centre area near All Bar One.
name[The Cricketers], eatType[restaurant], food[Chinese], priceRange[cheap], customer rating[average], area[city centre], familyFriendly[yes], near[All Bar One]	The Cricketers is a cheap restaurant that serves Chinese food. Yes it is kids-friendly. It has an average customer rating and is located in the city centre area near All Bar One.
name[The Cricketers], eatType[restaurant], food[Chinese], priceRange[cheap], customer rating[average], area[riverside], familyFriendly[no], near[All Bar One]	Cheap Chinese food for adults can be found at The Cricketers restaurant, near All Bar One in the riverside area. Average ratings.
name[The Cricketers], eatType[restaurant], food[Chinese], priceRange[cheap], customer rating[average], area[riverside], familyFriendly[yes], near[All Bar One]	Cheap Chinese food for all the family can be found at The Cricketers restaurant, near All Bar One, in the riverside area. Average ratings.
name[The Cricketers], eatType[restaurant], food[Chinese], priceRange[high], customer rating[1 out of 5], area[city centre], familyFriendly[no], near[All Bar One]	The Cricketers is by All Bar One, in the city centre area. With a 1 out of 5 rating and an adult-only environment, you can get Chinese food at this restaurant.
name[The Cricketers], eatType[restaurant], food[Chinese], priceRange[high], customer rating[1 out of 5], area[city centre], familyFriendly[yes], near[All Bar One]	The Cricketers is a high restaurant that serves Chinese food. Yes it is kids-friendly. Its customer rating is 1 out of 5. It is located in the city centre area near All Bar One.
name[The Cricketers], eatType[restaurant], food[Chinese], priceRange[high], customer rating[1 out of 5], area[riverside], familyFriendly[no], near[All Bar One]	The Cricketers is a high restaurant that serves Chinese food. It is not children-friendly and has a rating of 1 out of 5. It is located in the riverside area near All Bar One.
name[The Cricketers], eatType[restaurant], food[Chinese], priceRange[high], customer rating[1 out of 5], area[riverside], familyFriendly[yes], near[All Bar One]	There is a 1 out of 5 stars high family-friendly restaurant The Cricketers near All Bar One in the riverside area. It offers Chinese food.
name[The Cricketers], eatType[restaurant], food[Chinese], priceRange[high], customer rating[average], area[city centre], familyFriendly[no], near[All Bar One]	The Cricketers, located near All Bar One in the city centre area, is a not kid-friendly restaurant. The Cricketers serves high Chinese food and has an average customer rating.
name[The Cricketers], eatType[restaurant], food[Chinese], priceRange[high], customer rating[average], area[city centre], familyFriendly[yes], near[All Bar One]	For a child-friendly, average-rated restaurant serving Chinese, try The Cricketers, in the city centre area, near All Bar One.
name[The Cricketers], eatType[restaurant], food[Chinese], priceRange[high], customer rating[average], area[riverside], familyFriendly[no], near[All Bar One]	The Cricketers is a high restaurant that serves Chinese food. It is not children-friendly and has an average customer rating. It is located in the riverside area near All Bar One.
name[The Cricketers], eatType[restaurant], food[Chinese], priceRange[high], customer rating[average], area[riverside], familyFriendly[yes], near[All Bar One]	The Cricketers is a high restaurant that serves Chinese food. Yes it is kids-friendly. It has an average customer rating and is located in the riverside area near All Bar One.
name[The Cricketers], eatType[restaurant], food[Chinese], priceRange[less than £20], customer rating[low], area[city centre], familyFriendly[no], near[All Bar One]	Less than £20 Chinese food for adults can be found at The Cricketers restaurant, near All Bar One in the city centre area. Low ratings.
name[The Cricketers], eatType[restaurant], food[Chinese], priceRange[less than £20], customer rating[low], area[city centre], familyFriendly[yes], near[All Bar One]	Less than £20 Chinese food for all the family can be found at The Cricketers restaurant, near All Bar One, in the city centre area. Low ratings.
name[The Cricketers], eatType[restaurant], food[Chinese], priceRange[less than £20], customer rating[low], area[riverside], familyFriendly[no], near[All Bar One]	The Cricketers, located near All Bar One in the riverside area, is a not kid-friendly restaurant. The Cricketers serves less than £20 Chinese food and has a low customer rating.
name[The Cricketers], eatType[restaurant], food[Chinese], priceRange[less than £20], customer rating[low], area[riverside], familyFriendly[yes], near[All Bar One]	For a child-friendly, low-rated restaurant serving Chinese, try The Cricketers, in the riverside area, near All Bar One.
name[The Cricketers], eatType[restaurant], food[Chinese], priceRange[moderate], customer rating[1 out of 5], area[city centre], familyFriendly[no], near[All Bar One]	The Cricketers, located near All Bar One in the city centre area, is a not kid-friendly restaurant. The Cricketers serves moderate Chinese food and has a customer rating of 1 out of 5.
name[The Cricketers], eatType[restaurant], food[Chinese], priceRange[moderate], customer rating[1 out of 5], area[city centre], familyFriendly[yes], near[All Bar One]	The Cricketers, located near All Bar One in the city centre area, is a kid-friendly restaurant. The Cricketers serves moderate Chinese food and has a customer rating of 1 out of 5.
name[The Cricketers], eatType[restaurant], food[Chinese], priceRange[moderate], customer rating[1 out of 5], area[riverside], familyFriendly[no], near[All Bar One]	The Cricketers is by All Bar One, in the riverside area. With a 1 out of 5 rating and an adult-only environment, you can get Chinese food at this restaurant.
name[The Cricketers], eatType[restaurant], food[Chinese], priceRange[moderate], customer rating[1 out of 5], area[riverside], familyFriendly[yes], near[All Bar One]	The Cricketers is a moderate restaurant that serves Chinese food. Yes it is kids-friendly. Its customer rating is 1 out of 5. It is located in the riverside area near All Bar One.
name[The Cricketers], eatType[restaurant], food[Chinese], priceRange[moderate], customer rating[3 out of 5], area[city centre], familyFriendly[no], near[All Bar One]	The Cricketers is a moderate restaurant that serves Chinese food. It is not children-friendly and has a rating of 3 out of 5. It is located in the city centre area near All Bar One.
name[The Cricketers], eatType[restaurant], food[Chinese], priceRange[moderate], customer rating[3 out of 5], area[city centre], familyFriendly[yes], near[All Bar One]	There is a 3 out of 5 stars moderate family-friendly restaurant The Cricketers near All Bar One in the city centre area. It offers Chinese food.
name[The Cricketers], eatType[restaurant], food[Chinese], priceRange[moderate], customer rating[3 out of 5], area[riverside], familyFriendly[no], near[All Bar One]	The Cricketers, located near All Bar One in the riverside area, is a not kid-friendly restaurant. The Cricketers serves moderate Chinese food and has a customer rating of 3 out of 5.
name[The Cricketers], eatType[restaurant], food[Chinese], priceRange[moderate], customer rating[3 out of 5], area[riverside], familyFriendly[yes], near[All Bar One]	The Cricketers, located near All Bar One in the riverside area, is a kid-friendly restaurant. The Cricketers serves moderate Chinese food and has a customer rating of 3 out of 5.
name[The Cricketers], eatType[restaurant], food[Chinese], priceRange[more than £30], customer rating[high], area[city centre], familyFriendly[no], near[All Bar One]	The Cricketers is a more than £30 restaurant that serves Chinese food. It is not children-friendly and has a high customer rating. It is located in the city centre area near All Bar One.
name[The Cricketers], eatType[restaurant], food[Chinese], priceRange[more than £30], customer rating[high], area[city centre], familyFriendly[yes], near[All Bar One]	The Cricketers is a more than £30 restaurant that serves Chinese food. Yes it is kids-friendly. It has a high customer rating and is located in the city centre area near All Bar One.
name[The Cricketers], eatType[restaurant], food[Chinese], priceRange[more than £30], customer rating[high], area[riverside], familyFriendly[no], near[All Bar One]	More than £30 Chinese food for adults can be found at The Cricketers restaurant, near All Bar One in the riverside area. High ratings.
name[The Cricketers], eatType[restaurant], food[Chinese], priceRange[more than £30], customer rating[high], area[riverside], familyFriendly[yes], near[All Bar One]	More than £30 Chinese food for all the family can be found at The Cricketers restaurant, near All Bar One, in the riverside area. High ratings.
name[The Cricketers], eatType[restaurant], food[English], priceRange[£20-25], customer rating[high], area[city centre], familyFriendly[no], near[All Bar One]	The Cricketers, located near All Bar One in the city centre area, is a not kid-friendly restaurant. The Cricketers serves £20-25 English food and has a high customer rating.
name[The Cricketers], eatType[restaurant], food[English], priceRange[£20-25], customer rating[high], area[city centre], familyFriendly[yes], near[All Bar One]	For a child-friendly, high-rated restaurant serving English, try The Cricketers, in the city centre area, near All Bar One.
name[The Cricketers], eatType[restaurant], food[English], priceRange[£20-25], customer rating[high], area[riverside], familyFriendly[no], near[All Bar One]	The Cricketers is a £20-25 restaurant that serves English food. It is not children-friendly and has a high customer rating. It is located in the riverside area near All Bar One.
name[The Cricketers], eatType[restaurant], food[English], priceRange[£20-25], customer rating[high], area[riverside], familyFriendly[yes], near[All Bar One]	The Cricketers is a £20-25 restaurant that serves English food. Yes it is kids-friendly. It has a high customer rating and is located in the riverside area near All Bar One.
name[The Cricketers], eatType[restaurant], food[English], priceRange[cheap], customer rating[5 out of 5], area[city centre], familyFriendly[no], near[Café Rouge]	The Cricketers is by Café Rouge, in the city centre area. With a 5 out of 5 rating and an adult-only environment, you can get English food at this restaurant.
name[The Cricketers], eatType[restaurant], food[English], priceRange[cheap], customer rating[5 out of 5], area[city centre], familyFriendly[yes], near[Café Rouge]	The Cricketers is a cheap restaurant that serves English food. Yes it is kids-friendly. Its customer rating is 5 out of 5. It is located in the city centre area near Café Rouge.
name[The Cricketers], eatType[restaurant], food[English], priceRange[cheap], customer rating[5 out of 5], area[riverside], familyFriendly[no], near[Café Rouge]	The Cricketers is a cheap restaurant that serves English food. It is not children-friendly and has a rating of 5 out of 5. It is located in the riverside area near Café Rouge.
name[The Cricketers], eatType[restaurant], food[English], priceRange[cheap], customer rating[5 out of 5], area[riverside], familyFriendly[yes], near[Café Rouge]	There is a 5 out of 5 stars cheap family-friendly restaurant The Cricketers near Café Rouge in the riverside area. It offers English food.
name[The Cricketers], eatType[restaurant], food[English], priceRange[cheap], customer rating[average], area[city centre], familyFriendly[no], near[Café Rouge]	Cheap English food for adults can be found at The Cricketers restaurant, near Café Rouge in the city centre area. Average ratings.
name[The Cricketers], eatType[restaurant], food[English], priceRange[cheap], customer rating[average], area[city centre], familyFriendly[yes], near[Café Rouge]	Cheap English food for all the family can be found at The Cricketers restaurant, near Café Rouge, in the city centre area. Average ratings.
name[The Cricketers], eatType[restaurant], food[English], priceRange[cheap], customer rating[average], area[riverside], familyFriendly[no], near[Café Rouge]	The Cricketers, located near Café Rouge in the riverside area, is a not kid-friendly restaurant. The Cricketers serves cheap English food and has an average customer rating.
name[The Cricketers], eatType[restaurant], food[English], priceRange[cheap], customer rating[average], area[riverside], familyFriendly[yes], near[Café Rouge]	For a child-friendly, average-rated restaurant serving English, try The Cricketers, in the riverside area, near Café Rouge.
name[The Cricketers], eatType[restaurant], food[English], priceRange[high], customer rating[1 out of 5], area[city centre], familyFriendly[no], near[Café Rouge]	The Cricketers, located near Café Rouge in the city centre area, is a not kid-friendly restaurant. The Cricketers serves high English food and has a customer rating of 1 out of 5.
name[The Cricketers], eatType[restaurant], food[English], priceRange[high], customer rating[1 out of 5], area[city centre], familyFriendly[yes], near[Café Rouge]	The Cricketers, located near Café Rouge in the city centre area, is a kid-friendly restaurant. The Cricketers serves high English food and has a customer rating of 1 out of 5.
name[The Cricketers], eatType[restaurant], food[English], priceRange[high], customer rating[1 out of 5], area[riverside], familyFriendly[no], near[Café Rouge]	The Cricketers is by Café Rouge, in the riverside area. With a 1 out of 5 rating and an adult-only environment, you can get English food at this restaurant.
name[The Cricketers], eatType[restaurant], food[English], priceRange[high], customer rating[1 out of 5], area[riverside], familyFriendly[yes], near[Café Rouge]	The Cricketers is a high restaurant that serves English food. Yes it is kids-friendly. Its customer rating is 1 out of 5. It is located in the riverside area near Café Rouge.
name[The Cricketers], eatType[restaurant], food[English], priceRange[high], customer rating[average], area[city centre], familyFriendly[no], near[Café Rouge]	The Cricketers is a high restaurant that serves English food. It is not children-friendly and has an average customer rating. It is located in the city centre area near Café Rouge.
name[The Cricketers], eatType[restaurant], food[English], priceRange[high], customer rating[average], area[city centre], familyFriendly[yes], near[Café Rouge]	The Cricketers is a high restaurant that serves English food. Yes it is kids-friendly. It has an average customer rating and is located in the city centre area near Café Rouge.
name[The Cricketers], eatType[restaurant], food[English], priceRange[high], customer rating[average], area[riverside], familyFriendly[no], near[Café Rouge]	High English food for adults can be found at The Cricketers restaurant, near Café Rouge in the riverside area. Average ratings.
name[The Mill], eatType[pub], food[English], priceRange[high], area[riverside], familyFriendly[yes], near[Raja Indian Cuisine]	The Mill pub is a family-friendly place that provides English food. It is high and close to Raja Indian Cuisine.
name[The Mill], eatType[pub], food[English], priceRange[less than £20], area[city centre], familyFriendly[no], near[Raja Indian Cuisine]	In the city centre area, near Raja Indian Cuisine, is The Mill pub, which has less than £20 English and is not family-friendly.
name[The Mill], eatType[pub], food[English], priceRange[less than £20], area[city centre], familyFriendly[yes], near[Raja Indian Cuisine]	In the city centre area, near Raja Indian Cuisine, is The Mill pub, which has less than £20 English and is family-friendly.
name[The Mill], eatType[pub], food[English], priceRange[less than £20], area[riverside], familyFriendly[no], near[Raja Indian Cuisine]	The Mill pub is located near Raja Indian Cuisine, in the riverside area. It is less than £20 and not family-friendly.
name[The Mill], eatType[pub], food[English], priceRange[less than £20], area[riverside], familyFriendly[yes], near[Raja Indian Cuisine]	Family-friendly and less than £20, The Mill pub is located near Raja Indian Cuisine, in the riverside area.
name[The Mill], eatType[pub], food[English], priceRange[moderate], area[city centre], familyFriendly[no], near[Raja Indian Cuisine]	In the city centre area, near Raja Indian Cuisine, is The Mill pub, which has moderate English and is not family-friendly.
name[The Mill], eatType[pub], food[English], priceRange[moderate], area[city centre], familyFriendly[yes], near[Raja Indian Cuisine]	The Mill pub is a family-friendly place that provides English food. It is moderate and close to Raja Indian Cuisine.
name[The Mill], eatType[pub], food[English], priceRange[moderate], area[riverside], familyFriendly[no], near[Raja Indian Cuisine]	The Mill pub is located near Raja Indian Cuisine, in the riverside area. It is moderate and not family-friendly.
name[The Mill], eatType[pub], food[English], priceRange[moderate], area[riverside], familyFriendly[yes], near[Raja Indian Cuisine]	In the riverside area, near Raja Indian Cuisine, is The Mill pub, which has moderate English and is family-friendly.
name[The Mill], eatType[pub], food[English], priceRange[more than £30], area[riverside], familyFriendly[yes], near[Raja Indian Cuisine]	Family-friendly and more than £30, The Mill pub is located near Raja Indian Cuisine, in the riverside area.
name[The Mill], eatType[pub], food[Fast food], priceRange[£20-25], area[riverside], familyFriendly[yes], near[Raja Indian Cuisine]	The Mill pub is a family-friendly place that provides fast food. It is £20-25 and close to Raja Indian Cuisine.
name[The Mill], eatType[pub], food[Fast food], priceRange[£20-25], customer rating[high], area[city centre], familyFriendly[no], near[Café Rouge]	The Mill, located near Café Rouge in the city centre area, is a not kid-friendly pub. The Mill serves £20-25 fast food and has a high customer rating.
name[The Mill], eatType[pub], food[Fast food], priceRange[£20-25], customer rating[high], area[city centre], familyFriendly[yes], near[Café Rouge]	£20-25 fast food for all the family can be found at The Mill pub, near Café Rouge, in the city centre area. High ratings.
name[The Mill], eatType[pub], food[Fast food], priceRange[£20-25], customer rating[high], area[riverside], familyFriendly[no], near[Café Rouge]	The Mill is a £20-25 pub that serves fast food. It is not children-friendly and has a high customer rating. It is located in the riverside area near Café Rouge.
name[The Mill], eatType[pub], food[Fast food], priceRange[£20-25], customer rating[high], area[riverside], familyFriendly[yes], near[Café Rouge]	For a child-friendly, high-rated pub serving Fast food, try The Mill, in the riverside area, near Café Rouge.
name[The Mill], eatType[pub], food[Fast food], priceRange[£20-25], customer rating[high], area[riverside], familyFriendly[yes], near[Café Sicilia]	The Mill is a £20-25 pub that serves fast food. Yes it is kids-friendly. It has a high customer rating and is located in the riverside area near Café Sicilia.
name[The Mill], eatType[pub], food[Fast food], priceRange[cheap], area[riverside], familyFriendly[yes], near[Raja Indian Cuisine]	In the riverside area, near Raja Indian Cuisine, is The Mill pub, which has cheap Fast food and is family-friendly.
name[The Mill], eatType[pub], food[Fast food], priceRange[cheap], customer rating[5 out of 5], area[city centre], familyFriendly[no], near[Café Sicilia]	The Mill is a cheap pub that serves fast food. It is not children-friendly and has a rating of 5 out of 5. It is located in the city centre area near Café Sicilia.
name[The Mill], eatType[pub], food[Fast food], priceRange[cheap], customer rating[5 out of 5], area[city centre], familyFriendly[yes], near[Café Sicilia]	There is a 5 out of 5 stars cheap family-friendly pub The Mill near Café Sicilia in the city centre area. It offers fast food.
name[The Mill], eatType[pub], food[Fast food], priceRange[cheap], customer rating[5 out of 5], area[riverside], familyFriendly[no], near[Café Sicilia]	The Mill, located near Café Sicilia in the riverside area, is a not kid-friendly pub. The Mill serves cheap fast food and has a customer rating of 5 out of 5.
name[The Mill], eatType[pub], food[Fast food], priceRange[cheap], customer rating[5 out of 5], area[riverside], familyFriendly[yes], near[Café Sicilia]	The Mill, located near Café Sicilia in the riverside area, is a kid-friendly pub. The Mill serves cheap fast food and has a customer rating of 5 out of 5.
name[The Mill], eatType[pub], food[Fast food], priceRange[cheap], customer rating[average], area[city centre], familyFriendly[no], near[Café Sicilia]	Cheap fast food for adults can be found at The Mill pub, near Café Sicilia in the city centre area. Average ratings.
name[The Mill], eatType[pub], food[Fast food], priceRange[cheap], customer rating[average], area[city centre], familyFriendly[yes], near[Café Sicilia]	Cheap fast food for all the family can be found at The Mill pub, near Café Sicilia, in the city centre area. Average ratings.
name[The Mill], eatType[pub], food[Fast food], priceRange[cheap], customer rating[average], area[riverside], familyFriendly[no], near[Café Sicilia]	The Mill, located near Café Sicilia in the riverside area, is a not kid-friendly pub. The Mill serves cheap fast food and has an average customer rating.
name[The Mill], eatType[pub], food[Fast food], priceRange[cheap], customer rating[average], area[riverside], familyFriendly[yes], near[Café Sicilia]	For a child-friendly, average-rated pub serving Fast food, try The Mill, in the riverside area, near Café Sicilia.
name[The Mill], eatType[pub], food[Fast food], priceRange[high], customer rating[1 out of 5], area[city centre], familyFriendly[no], near[Café Sicilia]	The Mill is by Café Sicilia, in the city centre area. With a 1 out of 5 rating and an adult-only environment, you can get fast food at this pub.
name[The Mill], eatType[pub], food[Fast food], priceRange[high], customer rating[1 out of 5], area[city centre], familyFriendly[yes], near[Café Sicilia]	The Mill is a high pub that serves fast food. Yes it is kids-friendly. Its customer rating is 1 out of 5. It is located in the city centre area near Café Sicilia.
name[The Mill], eatType[pub], food[Fast food], priceRange[high], customer rating[1 out of 5], area[riverside], familyFriendly[no], near[Café Sicilia]	The Mill is a high pub that serves fast food. It is not children-friendly and has a rating of 1 out of 5. It is located in the riverside area near Café Sicilia.
name[The Mill], eatType[pub], food[Fast food], priceRange[high], customer rating[1 out of 5], area[riverside], familyFriendly[yes], near[Café Sicilia]	There is a 1 out of 5 stars high family-friendly pub The Mill near Café Sicilia in the riverside area. It offers fast food.
name[The Mill], eatType[pub], food[Fast food], priceRange[high], customer rating[average], area[city centre], familyFriendly[no], near[Café Sicilia]	The Mill is a high pub that serves fast food. It is not children-friendly and has an average customer rating. It is located in the city centre area near Café Sicilia.
name[The Mill], eatType[pub], food[Fast food], priceRange[high], customer rating[average], area[city centre], familyFriendly[yes], near[Café Sicilia]	The Mill is a high pub that serves fast food. Yes it is kids-friendly. It has an average customer rating and is located in the city centre area near Café Sicilia.
name[The Mill], eatType[pub], food[Fast food], priceRange[high], customer rating[average], area[riverside], familyFriendly[no], near[Café Sicilia]	High fast food for adults can be found at The Mill pub, near Café Sicilia in the riverside area. Average ratings.
name[The Mill], eatType[pub], food[Fast food], priceRange[high], customer rating[average], area[riverside], familyFriendly[yes], near[Café Sicilia]	High fast food for all the family can be found at The Mill pub, near Café Sicilia, in the riverside area. Average ratings.
name[The Mill], eatType[pub], food[Fast food], priceRange[less than £20], customer rating[low], area[city centre], familyFriendly[no], near[Café Sicilia]	The Mill, located near Café Sicilia in the city centre area, is a not kid-friendly pub. The Mill serves less than £20 fast food and has a low customer rating.
name[The Mill], eatType[pub], food[Fast food], priceRange[less than £20], customer rating[low], area[city centre], familyFriendly[yes], near[Café Sicilia]	For a child-friendly, low-rated pub serving Fast food, try The Mill, in the city centre area, near Café Sicilia.
name[The Mill], eatType[pub], food[Fast food], priceRange[less than £20], customer rating[low], area[riverside], familyFriendly[no], near[Café Sicilia]	The Mill is a less than £20 pub that serves fast food. It is not children-friendly and has a low customer rating. It is located in the riverside area near Café Sicilia.
name[The Mill], eatType[pub], food[Fast food], priceRange[less than £20], customer rating[low], area[riverside], familyFriendly[yes], near[Café Sicilia]	The Mill is a less than £20 pub that serves fast food. Yes it is kids-friendly. It has a low customer rating and is located in the riverside area near Café Sicilia.
name[The Mill], eatType[pub], food[Fast food], priceRange[moderate], customer rating[1 out of 5], area[city centre], familyFriendly[no], near[Café Sicilia]	The Mill, located near Café Sicilia in the city centre area, is a not kid-friendly pub. The Mill serves moderate fast food and has a customer rating of 1 out of 5.
name[The Mill], eatType[pub], food[Fast food], priceRange[moderate], customer rating[1 out of 5], area[city centre], familyFriendly[yes], near[Café Sicilia]	The Mill, located near Café Sicilia in the city centre area, is a kid-friendly pub. The Mill serves moderate fast food and has a customer rating of 1 out of 5.
name[The Mill], eatType[pub], food[Fast food], priceRange[moderate], customer rating[1 out of 5], area[riverside], familyFriendly[no], near[Café Sicilia]	The Mill is by Café Sicilia, in the riverside area. With a 1 out of 5 rating and an adult-only environment, you can get fast food at this pub.
name[The Mill], eatType[pub], food[Fast food], priceRange[moderate], customer rating[1 out of 5], area[riverside], familyFriendly[yes], near[Café Sicilia]	The Mill is a moderate pub that serves fast food. Yes it is kids-friendly. Its customer rating is 1 out of 5. It is located in the riverside area near Café Sicilia.
name[The Mill], eatType[pub], food[Fast food], priceRange[moderate], customer rating[3 out of 5], area[city centre], familyFriendly[no], near[Café Sicilia]	The Mill is a moderate pub that serves fast food. It is not children-friendly and has a rating of 3 out of 5. It is located in the city centre area near Café Sicilia.
name[The Mill], eatType[pub], food[Fast food], priceRange[moderate], customer rating[3 out of 5], area[city centre], familyFriendly[yes], near[Café Sicilia]	There is a 3 out of 5 stars moderate family-friendly pub The Mill near Café Sicilia in the city centre area. It offers fast food.
name[The Mill], eatType[pub], food[Fast food], priceRange[moderate], customer rating[3 out of 5], area[riverside], familyFriendly[no], near[Café Sicilia]	The Mill, located near Café Sicilia in the riverside area, is a not kid-friendly pub. The Mill serves moderate fast food and has a customer rating of 3 out of 5.
name[The Mill], eatType[pub], food[Fast food], priceRange[moderate], customer rating[3 out of 5], area[riverside], familyFriendly[yes], near[Café Sicilia]	The Mill, located near Café Sicilia in the riverside area, is a kid-friendly pub. The Mill serves moderate fast food and has a customer rating of 3 out of 5.
name[The Mill], eatType[restaurant], food[English], priceRange[high], area[riverside], familyFriendly[yes], near[Raja Indian Cuisine]	Family-friendly and high, The Mill restaurant is located near Raja Indian Cuisine, in the riverside area.
name[The Mill], eatType[restaurant], food[English], priceRange[high], customer rating[average], area[riverside], familyFriendly[yes], near[Café Rouge]	High English food for all the family can be found at The Mill restaurant, near Café Rouge, in the riverside area. Average ratings.
name[The Mill], eatType[restaurant], food[English], priceRange[less than £20], area[city centre], familyFriendly[no], near[Raja Indian Cuisine]	In the city centre area, near Raja Indian Cuisine, is The Mill restaurant, which has less than £20 English and is not family-friendly.
name[The Mill], eatType[restaurant], food[English], priceRange[less than £20], area[city centre], familyFriendly[yes], near[Raja Indian Cuisine]	The Mill restaurant is a family-friendly place that provides English food. It is less than £20 and close to Raja Indian Cuisine.
name[The Mill], eatType[restaurant], food[English], priceRange[less than £20], area[riverside], familyFriendly[no], near[Raja Indian Cuisine]	The Mill restaurant is located near Raja Indian Cuisine, in the riverside area. It is less than £20 and not family-friendly.
name[The Mill], eatType[restaurant], food[English], priceRange[less than £20], area[riverside], familyFriendly[yes], near[Raja Indian Cuisine]	In the riverside area, near Raja Indian Cuisine, is The Mill restaurant, which has less than £20 English and is family-friendly.
name[The Mill], eatType[restaurant], food[English], priceRange[less than £20], customer rating[low], area[city centre], familyFriendly[no], near[Café Rouge]	Less than £20 English food for adults can be found at The Mill restaurant, near Café Rouge in the city centre area. Low ratings.
name[The Mill], eatType[restaurant], food[English], priceRange[less than £20], customer rating[low], area[city centre], familyFriendly[yes], near[Café Rouge]	For a child-friendly, low-rated restaurant serving English, try The Mill, in the city centre area, near Café Rouge.
name[The Mill], eatType[restaurant], food[English], priceRange[less than £20], customer rating[low], area[riverside], familyFriendly[no], near[Café Rouge]	The Mill, located near Café Rouge in the riverside area, is a not kid-friendly restaurant. The Mill serves less than £20 English food and has a low customer rating.
name[The Mill], eatType[restaurant], food[English], priceRange[less than £20], customer rating[low], area[riverside], familyFriendly[yes], near[Café Rouge]	The Mill is a less than £20 restaurant that serves English food. Yes it is kids-friendly. It has a low customer rating and is located in the riverside area near Café Rouge.
name[The Mill], eatType[restaurant], food[English], priceRange[moderate], area[city centre], familyFriendly[no], near[Raja Indian Cuisine]	In the city centre area, near Raja Indian Cuisine, is The Mill restaurant, which has moderate English and is not family-friendly.
name[The Mill], eatType[restaurant], food[English], priceRange[moderate], area[city centre], familyFriendly[yes], near[Raja Indian Cuisine]	Family-friendly and moderate, The Mill restaurant is located near Raja Indian Cuisine, in the city centre area.
name[The Mill], eatType[restaurant], food[English], priceRange[moderate], area[riverside], familyFriendly[no], near[Raja Indian Cuisine]	The Mill restaurant is located near Raja Indian Cuisine, in the riverside area. It is moderate and not family-friendly.
name[The Mill], eatType[restaurant], food[English], priceRange[moderate], area[riverside], familyFriendly[yes], near[Raja Indian Cuisine]	The Mill restaurant is a family-friendly place that provides English food. It is moderate and close to Raja Indian Cuisine.
name[The Mill], eatType[restaurant], food[English], priceRange[moderate], customer rating[1 out of 5], area[city centre], familyFriendly[no], near[Café Rouge]	The Mill is by Café Rouge, in the city centre area. With a 1 out of 5 rating and an adult-only environment, you can get English food at this restaurant.
name[The Mill], eatType[restaurant], food[English], priceRange[moderate], customer rating[1 out of 5], area[city centre], familyFriendly[yes], near[Café Rouge]	The Mill is a moderate restaurant that serves English food. Yes it is kids-friendly. Its customer rating is 1 out of 5. It is located in the city centre area near Café Rouge.
name[The Mill], eatType[restaurant], food[English], priceRange[moderate], customer rating[1 out of 5], area[riverside], familyFriendly[no], near[Café Rouge]	The Mill is a moderate restaurant that serves English food. It is not children-friendly and has a rating of 1 out of 5. It is located in the riverside area near Café Rouge.
name[The Mill], eatType[restaurant], food[English], priceRange[moderate], customer rating[1 out of 5], area[riverside], familyFriendly[yes], near[Café Rouge]	There is a 1 out of 5 stars moderate family-friendly restaurant The Mill near Café Rouge in the riverside area. It offers English food.
name[The Mill], eatType[restaurant], food[English], priceRange[moderate], customer rating[3 out of 5], area[city centre], familyFriendly[no], near[Café Rouge]	The Mill, located near Café Rouge in the city centre area, is a not kid-friendly restaurant. The Mill serves moderate English food and has a customer rating of 3 out of 5.
name[The Mill], eatType[restaurant], food[English], priceRange[moderate], customer rating[3 out of 5], area[city centre], familyFriendly[yes], near[Café Rouge]	The Mill, located near Café Rouge in the city centre area, is a kid-friendly restaurant. The Mill serves moderate English food and has a customer rating of 3 out of 5.
name[The Mill], eatType[restaurant], food[English], priceRange[moderate], customer rating[3 out of 5], area[riverside], familyFriendly[no], near[Café Rouge]	The Mill is by Café Rouge, in the riverside area. With a 3 out of 5 rating and an adult-only environment, you can get English food at this restaurant.
name[The Mill], eatType[restaurant], food[English], priceRange[moderate], customer rating[3 out of 5], area[riverside], familyFriendly[yes], near[Café Rouge]	The Mill is a moderate restaurant that serves English food. Yes it is kids-friendly. Its customer rating is 3 out of 5. It is located in the riverside area near Café Rouge.
name[The Mill], eatType[restaurant], food[English], priceRange[more than £30], area[riverside], familyFriendly[yes], near[Raja Indian Cuisine]	In the riverside area, near Raja Indian Cuisine, is The Mill restaurant, which has more than £30 English and is family-friendly.
name[The Mill], eatType[restaurant], food[English], priceRange[more than £30], customer rating[high], area[city centre], familyFriendly[no], near[Café Rouge]	The Mill is a more than £30 restaurant that serves English food. It is not children-friendly and has a high customer rating. It is located in the city centre area near Café Rouge.
name[The Mill], eatType[restaurant], food[English], priceRange[more than £30], customer rating[high], area[city centre], familyFriendly[yes], near[Café Rouge]	More than £30 English food for all the family can be found at The Mill restaurant, near Café Rouge, in the city centre area. High ratings.
name[The Mill], eatType[restaurant], food[English], priceRange[more than £30], customer rating[high], area[riverside], familyFriendly[no], near[Café Rouge]	More than £30 English food for adults can be found at The Mill restaurant, near Café Rouge in the riverside area. High ratings.
name[The Mill], eatType[restaurant], food[English], priceRange[more than £30], customer rating[high], area[riverside], familyFriendly[yes], near[Café Rouge]	For a child-friendly, high-rated restaurant serving English, try The Mill, in the riverside area, near Café Rouge.
name[The Mill], eatType[restaurant], food[Fast food], priceRange[£20-25], area[riverside], familyFriendly[yes], near[Raja Indian Cuisine]	Family-friendly and £20-25, The Mill restaurant is located near Raja Indian Cuisine, in the riverside area.
name[The Mill], eatType[restaurant], food[Fast food], priceRange[cheap], area[riverside], familyFriendly[yes], near[Raja Indian Cuisine]	The Mill restaurant is a family-friendly place that provides fast food. It is cheap and close to Raja Indian Cuisine.
name[The Phoenix], eatType[pub], food[Fast food], priceRange[cheap], area[riverside], familyFriendly[yes], near[Raja Indian Cuisine]	In the riverside area, near Raja Indian Cuisine, is The Phoenix pub, which has cheap Fast food and is family-friendly.
name[The Phoenix], eatType[pub], food[Fast food], priceRange[high], area[city centre], familyFriendly[no], near[Raja Indian Cuisine]	In the city centre area, near Raja Indian Cuisine, is The Phoenix pub, which has high Fast food and is not family-friendly.
name[The Phoenix], eatType[pub], food[Fast food], priceRange[high], area[city centre], familyFriendly[yes], near[Raja Indian Cuisine]	Family-friendly and high, The Phoenix pub is located near Raja Indian Cuisine, in the city centre area.
name[The Phoenix], eatType[pub], food[Fast food], priceRange[high], area[riverside], familyFriendly[no], near[Raja Indian Cuisine]	The Phoenix pub is located near Raja Indian Cuisine, in the riverside area. It is high and not family-friendly.
name[The Phoenix], eatType[pub], food[Fast food], priceRange[high], area[riverside], familyFriendly[yes], near[Raja Indian Cuisine]	The Phoenix pub is a family-friendly place that provides fast food. It is high and close to Raja Indian Cuisine.
name[The Phoenix], eatType[pub], food[Fast food], priceRange[less than £20], area[city centre], familyFriendly[no], near[Raja Indian Cuisine]	In the city centre area, near Raja Indian Cuisine, is The Phoenix pub, which has less than £20 Fast food and is not family-friendly.
name[The Phoenix], eatType[pub], food[Fast food], priceRange[less than £20], area[city centre], familyFriendly[yes], near[Raja Indian Cuisine]	In the city centre area, near Raja Indian Cuisine, is The Phoenix pub, which has less than £20 Fast food and is family-friendly.
name[The Phoenix], eatType[pub], food[Fast food], priceRange[less than £20], area[riverside], familyFriendly[no], near[Raja Indian Cuisine]	The Phoenix pub is located near Raja Indian Cuisine, in the riverside area. It is less than £20 and not family-friendly.
name[The Phoenix], eatType[pub], food[Fast food], priceRange[less than £20], area[riverside], familyFriendly[yes], near[Raja Indian Cuisine]	Family-friendly and less than £20, The Phoenix pub is located near Raja Indian Cuisine, in the riverside area.
name[The Phoenix], eatType[pub], food[Fast food], priceRange[moderate], area[city centre], familyFriendly[no], near[Raja Indian Cuisine]	In the city centre area, near Raja Indian Cuisine, is The Phoenix pub, which has moderate Fast food and is not family-friendly.
name[The Phoenix], eatType[pub], food[Fast food], priceRange[moderate], area[city centre], familyFriendly[yes], near[Raja Indian Cuisine]	The Phoenix pub is a family-friendly place that provides fast food. It is moderate and close to Raja Indian Cuisine.
name[The Phoenix], eatType[pub], food[Fast food], priceRange[moderate], area[riverside], familyFriendly[no], near[Raja Indian Cuisine]	The Phoenix pub is located near Raja Indian Cuisine, in the riverside area. It is moderate and not family-friendly.
name[The Phoenix], eatType[pub], food[Fast food], priceRange[moderate], area[riverside], familyFriendly[yes], near[Raja Indian Cuisine]	In the riverside area, near Raja Indian Cuisine, is The Phoenix pub, which has moderate Fast food and is family-friendly.
name[The Phoenix], eatType[pub], food[Fast food], priceRange[moderate], customer rating[3 out of 5], area[riverside], familyFriendly[yes], near[Café Sicilia]	There is a 3 out of 5 stars moderate family-friendly pub The Phoenix near Café Sicilia in the riverside area. It offers fast food.
name[The Phoenix], eatType[pub], food[Fast food], priceRange[more than £30], area[riverside], familyFriendly[yes], near[Raja Indian Cuisine]	Family-friendly and more than £30, The Phoenix pub is located near Raja Indian Cuisine, in the riverside area.
name[The Phoenix], eatType[pub], food[Fast food], priceRange[more than £30], customer rating[high], area[city centre], familyFriendly[no], near[Café Sicilia]	The Phoenix, located near Café Sicilia in the city centre area, is a not kid-friendly pub. The Phoenix serves more than £30 fast food and has a high customer rating.
name[The Phoenix], eatType[pub], food[Fast food], priceRange[more than £30], customer rating[high], area[city centre], familyFriendly[yes], near[Café Sicilia]	The Phoenix is a more than £30 pub that serves fast food. Yes it is kids-friendly. It has a high customer rating and is located in the city centre area near Café Sicilia.
name[The Phoenix], eatType[pub], food[Fast food], priceRange[more than £30], customer rating[high], area[riverside], familyFriendly[no], near[Café Sicilia]	The Phoenix is a more than £30 pub that serves fast food. It is not children-friendly and has a high customer rating. It is located in the riverside area near Café Sicilia.
name[The Phoenix], eatType[pub], food[Fast food], priceRange[more than £30], customer rating[high], area[riverside], familyFriendly[yes], near[Café Sicilia]	More than £30 fast food for all the family can be found at The Phoenix pub, near Café Sicilia, in the riverside area. High ratings.
name[The Phoenix], eatType[pub], food[French], priceRange[£20-25], area[riverside], familyFriendly[yes], near[Raja Indian Cuisine]	The Phoenix pub is a family-friendly place that provides French food. It is £20-25 and close to Raja Indian Cuisine.
name[The Phoenix], eatType[pub], food[French], priceRange[£20-25], customer rating[3 out of 5], area[city centre], familyFriendly[no], near[Café Sicilia]	The Phoenix is a £20-25 pub that serves French food. It is not children-friendly and has a rating of 3 out of 5. It is located in the city centre area near Café Sicilia.
name[The Phoenix], eatType[pub], food[French], priceRange[£20-25], customer rating[3 out of 5], area[city centre], familyFriendly[yes], near[Café Sicilia]	The Phoenix, located near Café Sicilia in the city centre area, is a kid-friendly pub. The Phoenix serves £20-25 French food and has a customer rating of 3 out of 5.
name[The Phoenix], eatType[pub], food[French], priceRange[£20-25], customer rating[3 out of 5], area[riverside], familyFriendly[no], near[Café Sicilia]	The Phoenix, located near Café Sicilia in the riverside area, is a not kid-friendly pub. The Phoenix serves £20-25 French food and has a customer rating of 3 out of 5.
name[The Phoenix], eatType[pub], food[French], priceRange[£20-25], customer rating[3 out of 5], area[riverside], familyFriendly[yes], near[Café Sicilia]	The Phoenix is a £20-25 pub that serves French food. Yes it is kids-friendly. Its customer rating is 3 out of 5. It is located in the riverside area near Café Sicilia.
name[The Phoenix], eatType[pub], food[French], priceRange[£20-25], customer rating[3 out of 5], area[riverside], familyFriendly[yes], near[Crowne Plaza Hotel]	There is a 3 out of 5 stars £20-25 family-friendly pub The Phoenix near Crowne Plaza Hotel in the riverside area. It offers French food.
name[The Phoenix], eatType[pub], food[French], priceRange[£20-25], customer rating[high], area[city centre], familyFriendly[no], near[Crowne Plaza Hotel]	£20-25 French food for adults can be found at The Phoenix pub, near Crowne Plaza Hotel in the city centre area. High ratings.
name[The Phoenix], eatType[pub], food[French], priceRange[£20-25], customer rating[high], area[city centre], familyFriendly[yes], near[Crowne Plaza Hotel]	For a child-friendly, high-rated pub serving French, try The Phoenix, in the city centre area, near Crowne Plaza Hotel.
name[The Phoenix], eatType[pub], food[French], priceRange[£20-25], customer rating[high], area[riverside], familyFriendly[no], near[Crowne Plaza Hotel]	The Phoenix, located near Crowne Plaza Hotel in the riverside area, is a not kid-friendly pub. The Phoenix serves £20-25 French food and has a high customer rating.
name[The Phoenix], eatType[pub], food[French], priceRange[£20-25], customer rating[high], area[riverside], familyFriendly[yes], near[Crowne Plaza Hotel]	The Phoenix is a £20-25 pub that serves French food. Yes it is kids-friendly. It has a high customer rating and is located in the riverside area near Crowne Plaza Hotel.
name[The Phoenix], eatType[pub], food[French], priceRange[cheap], area[riverside], familyFriendly[yes], near[Raja Indian Cuisine]	In the riverside area, near Raja Indian Cuisine, is The Phoenix pub, which has cheap French and is family-friendly.
name[The Phoenix], eatType[pub], food[French], priceRange[cheap], customer rating[5 out of 5], area[city centre], familyFriendly[no], near[Crowne Plaza Hotel]	The Phoenix is by Crowne Plaza Hotel, in the city centre area. With a 5 out of 5 rating and an adult-only environment, you can get French food at this pub.
name[The Phoenix], eatType[pub], food[French], priceRange[cheap], customer rating[5 out of 5], area[city centre], familyFriendly[yes], near[Crowne Plaza Hotel]	The Phoenix, located near Crowne Plaza Hotel in the city centre area, is a kid-friendly pub. The Phoenix serves cheap French food and has a customer rating of 5 out of 5.
name[The Phoenix], eatType[pub], food[French], priceRange[cheap], customer rating[5 out of 5], area[riverside], familyFriendly[no], near[Crowne Plaza Hotel]	The Phoenix is a cheap pub that serves French food. It is not children-friendly and has a rating of 5 out of 5. It is located in the riverside area near Crowne Plaza Hotel.
name[The Phoenix], eatType[pub], food[French], priceRange[cheap], customer rating[5 out of 5], area[riverside], familyFriendly[yes], near[Crowne Plaza Hotel]	The Phoenix is a cheap pub that serves French food. Yes it is kids-friendly. Its customer rating is 5 out of 5. It is located in the riverside area near Crowne Plaza Hotel.
name[The Phoenix], eatType[pub], food[French], priceRange[high], area[riverside], familyFriendly[yes], near[Raja Indian Cuisine]	Family-friendly and high, The Phoenix pub is located near Raja Indian Cuisine, in the riverside area.
name[The Phoenix], eatType[pub], food[French], priceRange[high], customer rating[3 out of 5], area[city centre], familyFriendly[no], near[Crowne Plaza Hotel]	The Phoenix, located near Crowne Plaza Hotel in the city centre area, is a not kid-friendly pub. The Phoenix serves high French food and has a customer rating of 3 out of 5.
name[The Phoenix], eatType[pub], food[French], priceRange[high], customer rating[3 out of 5], area[city centre], familyFriendly[yes], near[Crowne Plaza Hotel]	There is a 3 out of 5 stars high family-friendly pub The Phoenix near Crowne Plaza Hotel in the city centre area. It offers French food.
name[The Phoenix], eatType[pub], food[French], priceRange[high], customer rating[3 out of 5], area[riverside], familyFriendly[no], near[Crowne Plaza Hotel]	The Phoenix is by Crowne Plaza Hotel, in the riverside area. With a 3 out of 5 rating and an adult-only environment, you can get French food at this pub.
name[The Phoenix], eatType[pub], food[French], priceRange[high], customer rating[3 out of 5], area[riverside], familyFriendly[yes], near[Crowne Plaza Hotel]	The Phoenix, located near Crowne Plaza Hotel in the riverside area, is a kid-friendly pub. The Phoenix serves high French food and has a customer rating of 3 out of 5.
name[The Phoenix], eatType[pub], food[French], priceRange[less than £20], customer rating[average], area[city centre], familyFriendly[no], near[Crowne Plaza Hotel]	The Phoenix is a less than £20 pub that serves French food. It is not children-friendly and has an average customer rating. It is located in the city centre area near Crowne Plaza Hotel.
name[The Phoenix], eatType[pub], food[French], priceRange[less than £20], customer rating[average], area[city centre], familyFriendly[yes], near[Crowne Plaza Hotel]	Less than £20 French food for all the family can be found at The Phoenix pub, near Crowne Plaza Hotel, in the city centre area. Average ratings.
name[The Phoenix], eatType[pub], food[French], priceRange[less than £20], customer rating[average], area[riverside], familyFriendly[no], near[Crowne Plaza Hotel]	Less than £20 French food for adults can be found at The Phoenix pub, near Crowne Plaza Hotel in the riverside area. Average ratings.
name[The Phoenix], eatType[pub], food[French], priceRange[less than £20], customer rating[average], area[riverside], familyFriendly[yes], near[Crowne Plaza Hotel]	For a child-friendly, average-rated pub serving French, try The Phoenix, in the riverside area, near Crowne Plaza Hotel.
name[The Phoenix], eatType[pub], food[French], priceRange[less than £20], customer rating[low], area[city centre], familyFriendly[no], near[Crowne Plaza Hotel]	The Phoenix, located near Crowne Plaza Hotel in the city centre area, is a not kid-friendly pub. The Phoenix serves less than £20 French food and has a low customer rating.
name[The Phoenix], eatType[pub], food[French], priceRange[less than £20], customer rating[low], area[city centre], familyFriendly[yes], near[Crowne Plaza Hotel]	The Phoenix is a less than £20 pub that serves French food. Yes it is kids-friendly. It has a low customer rating and is located in the city centre area near Crowne Plaza Hotel.
name[The Phoenix], eatType[pub], food[French], priceRange[less than £20], customer rating[low], area[riverside], familyFriendly[no], near[Crowne Plaza Hotel]	The Phoenix is a less than £20 pub that serves French food. It is not children-friendly and has a low customer rating. It is located in the riverside area near Crowne Plaza Hotel.
name[The Phoenix], eatType[pub], food[French], priceRange[less than £20], customer rating[low], area[riverside], familyFriendly[yes], near[Crowne Plaza Hotel]	Less than £20 French food for all the family can be found at The Phoenix pub, near Crowne Plaza Hotel, in the riverside area. Low ratings.
name[The Phoenix], eatType[pub], food[French], priceRange[moderate], customer rating[1 out of 5], area[city centre], familyFriendly[no], near[Crowne Plaza Hotel]	The Phoenix is a moderate pub that serves French food. It is not children-friendly and has a rating of 1 out of 5. It is located in the city centre area near Crowne Plaza Hotel.
name[The Phoenix], eatType[pub], food[French], priceRange[moderate], customer rating[1 out of 5], area[city centre], familyFriendly[yes], near[Crowne Plaza Hotel]	The Phoenix is a moderate pub that serves French food. Yes it is kids-friendly. Its customer rating is 1 out of 5. It is located in the city centre area near Crowne Plaza Hotel.
name[The Phoenix], eatType[pub], food[French], priceRange[moderate], customer rating[1 out of 5], area[riverside], familyFriendly[no], near[Crowne Plaza Hotel]	The Phoenix, located near Crowne Plaza Hotel in the riverside area, is a not kid-friendly pub. The Phoenix serves moderate French food and has a customer rating of 1 out of 5.
name[The Phoenix], eatType[pub], food[French], priceRange[moderate], customer rating[1 out of 5], area[riverside], familyFriendly[yes], near[Crowne Plaza Hotel]	There is a 1 out of 5 stars moderate family-friendly pub The Phoenix near Crowne Plaza Hotel in the riverside area. It offers French food.
name[The Phoenix], eatType[pub], food[French], priceRange[more than £30], customer rating[5 out of 5], area[city centre], familyFriendly[no], near[Crowne Plaza Hotel]	The Phoenix is by Crowne Plaza Hotel, in the city centre area. With a 5 out of 5 rating and an adult-only environment, you can get French food at this pub.
name[The Phoenix], eatType[pub], food[French], priceRange[more than £30], customer rating[5 out of 5], area[city centre], familyFriendly[yes], near[Crowne Plaza Hotel]	The Phoenix, located near Crowne Plaza Hotel in the city centre area, is a kid-friendly pub. The Phoenix serves more than £30 French food and has a customer rating of 5 out of 5.
name[The Phoenix], eatType[pub], food[French], priceRange[more than £30], customer rating[5 out of 5], area[riverside], familyFriendly[no], near[Crowne Plaza Hotel]	The Phoenix is a more than £30 pub that serves French food. It is not children-friendly and has a rating of 5 out of 5. It is located in the riverside area near Crowne Plaza Hotel.
name[The Phoenix], eatType[pub], food[French], priceRange[more than £30], customer rating[5 out of 5], area[riverside], familyFriendly[yes], near[Crowne Plaza Hotel]	The Phoenix is a more than £30 pub that serves French food. Yes it is kids-friendly. Its customer rating is 5 out of 5. It is located in the riverside area near Crowne Plaza Hotel.
name[The Phoenix], eatType[pub], food[French], priceRange[more than £30], customer rating[low], area[city centre], familyFriendly[no], near[Crowne Plaza Hotel]	More than £30 French food for adults can be found at The Phoenix pub, near Crowne Plaza Hotel in the city centre area. Low ratings.
name[The Phoenix], eatType[pub], food[French], priceRange[more than £30], customer rating[low], area[city centre], familyFriendly[yes], near[Crowne Plaza Hotel]	For a child-friendly, low-rated pub serving French, try The Phoenix, in the city centre area, near Crowne Plaza Hotel.
name[The Phoenix], eatType[pub], food[French], priceRange[more than £30], customer rating[low], area[riverside], familyFriendly[no], near[Crowne Plaza Hotel]	The Phoenix, located near Crowne Plaza Hotel in the riverside area, is a not kid-friendly pub. The Phoenix serves more than £30 French food and has a low customer rating.
name[The Phoenix], eatType[pub], food[French], priceRange[more than £30], customer rating[low], area[riverside], familyFriendly[yes], near[Crowne Plaza Hotel]	The Phoenix is a more than £30 pub that serves French food. Yes it is kids-friendly. It has a low customer rating and is located in the riverside area near Crowne Plaza Hotel.
name[The Phoenix], eatType[restaurant], food[Fast food], priceRange[cheap], area[riverside], familyFriendly[yes], near[Raja Indian Cuisine]	The Phoenix restaurant is a family-friendly place that provides fast food. It is cheap and close to Raja Indian Cuisine.
name[The Phoenix], eatType[restaurant], food[Fast food], priceRange[high], area[city centre], familyFriendly[no], near[Raja Indian Cuisine]	In the city centre area, near Raja Indian Cuisine, is The Phoenix restaurant, which has high Fast food and is not family-friendly.
name[The Phoenix], eatType[restaurant], food[Fast food], priceRange[high], area[city centre], familyFriendly[yes], near[Raja Indian Cuisine]	In the city centre area, near Raja Indian Cuisine, is The Phoenix restaurant, which has high Fast food and is family-friendly.
name[The Phoenix], eatType[restaurant], food[Fast food], priceRange[high], area[riverside], familyFriendly[no], near[Raja Indian Cuisine]	The Phoenix restaurant is located near Raja Indian Cuisine, in the riverside area. It is high and not family-friendly.
name[The Phoenix], eatType[restaurant], food[Fast food], priceRange[high], area[riverside], familyFriendly[yes], near[Raja Indian Cuisine]	Family-friendly and high, The Phoenix restaurant is located near Raja Indian Cuisine, in the riverside area.
name[The Phoenix], eatType[restaurant], food[Fast food], priceRange[less than £20], area[city centre], familyFriendly[no], near[Raja Indian Cuisine]	In the city centre area, near Raja Indian Cuisine, is The Phoenix restaurant, which has less than £20 Fast food and is not family-friendly.
name[The Phoenix], eatType[restaurant], food[Fast food], priceRange[less than £20], area[city centre], familyFriendly[yes], near[Raja Indian Cuisine]	The Phoenix restaurant is a family-friendly place that provides fast food. It is less than £20 and close to Raja Indian Cuisine.
name[The Phoenix], eatType[restaurant], food[Fast food], priceRange[less than £20], area[riverside], familyFriendly[no], near[Raja Indian Cuisine]	The Phoenix restaurant is located near Raja Indian Cuisine, in the riverside area. It is less than £20 and not family-friendly.
name[The Phoenix], eatType[restaurant], food[Fast food], priceRange[less than £20], area[riverside], familyFriendly[yes], near[Raja Indian Cuisine]	In the riverside area, near Raja Indian Cuisine, is The Phoenix restaurant, which has less than £20 Fast food and is family-friendly.
name[The Phoenix], eatType[restaurant], food[Fast food], priceRange[moderate], area[city centre], familyFriendly[no], near[Raja Indian Cuisine]	In the city centre area, near Raja Indian Cuisine, is The Phoenix restaurant, which has moderate Fast food and is not family-friendly.
name[The Phoenix], eatType[restaurant], food[Fast food], priceRange[moderate], area[city centre], familyFriendly[yes], near[Raja Indian Cuisine]	Family-friendly and moderate, The Phoenix restaurant is located near Raja Indian Cuisine, in the city centre area.
name[The Phoenix], eatType[restaurant], food[Fast food], priceRange[moderate], area[riverside], familyFriendly[no], near[Raja Indian Cuisine]	The Phoenix restaurant is located near Raja Indian Cuisine, in the riverside area. It is moderate and not family-friendly.
name[The Phoenix], eatType[restaurant], food[Fast food], priceRange[moderate], area[riverside], familyFriendly[yes], near[Raja Indian Cuisine]	The Phoenix restaurant is a family-friendly place that provides fast food. It is moderate and close to Raja Indian Cuisine.
name[The Phoenix], eatType[restaurant], food[Fast food], priceRange[more than £30], area[riverside], familyFriendly[yes], near[Raja Indian Cuisine]	In the riverside area, near Raja Indian Cuisine, is The Phoenix restaurant, which has more than £30 Fast food and is family-friendly.
name[The Phoenix], eatType[restaurant], food[French], priceRange[£20-25], area[riverside], familyFriendly[yes], near[Raja Indian Cuisine]	Family-friendly and £20-25, The Phoenix restaurant is located near Raja Indian Cuisine, in the riverside area.
name[The Phoenix], eatType[restaurant], food[French], priceRange[cheap], area[riverside], familyFriendly[yes], near[Raja Indian Cuisine]	The Phoenix restaurant is a family-friendly place that provides French food. It is cheap and close to Raja Indian Cuisine.
name[The Phoenix], eatType[restaurant], food[French], priceRange[high], area[riverside], familyFriendly[yes], near[Raja Indian Cuisine]	In the riverside area, near Raja Indian Cuisine, is The Phoenix restaurant, which has high French and is family-friendly.
name[The Phoenix], eatType[restaurant], food[Indian], priceRange[£20-25], customer rating[high], area[city centre], familyFriendly[no], near[Crowne Plaza Hotel]	The Phoenix is a £20-25 restaurant that serves Indian food. It is not children-friendly and has a high customer rating. It is located in the city centre area near Crowne Plaza Hotel.
name[The Phoenix], eatType[restaurant], food[Indian], priceRange[£20-25], customer rating[high], area[city centre], familyFriendly[yes], near[Crowne Plaza Hotel]	£20-25 Indian food for all the family can be found at The Phoenix restaurant, near Crowne Plaza Hotel, in the city centre area. High ratings.
name[The Phoenix], eatType[restaurant], food[Indian], priceRange[£20-25], customer rating[high], area[riverside], familyFriendly[no], near[Crowne Plaza Hotel]	£20-25 Indian food for adults can be found at The Phoenix restaurant, near Crowne Plaza Hotel in the riverside area. High ratings.
name[The Phoenix], eatType[restaurant], food[Indian], priceRange[£20-25], customer rating[high], area[riverside], familyFriendly[yes], near[Crowne Plaza Hotel]	For a child-friendly, high-rated restaurant serving Indian, try The Phoenix, in the riverside area, near Crowne Plaza Hotel.
name[The Phoenix], eatType[restaurant], food[Indian], priceRange[cheap], customer rating[5 out of 5], area[city centre], familyFriendly[no], near[Crowne Plaza Hotel]	The Phoenix, located near Crowne Plaza Hotel in the city centre area, is a not kid-friendly restaurant. The Phoenix serves cheap Indian food and has a customer rating of 5 out of 5.
name[The Phoenix], eatType[restaurant], food[Indian], priceRange[cheap], customer rating[5 out of 5], area[city centre], familyFriendly[yes], near[Crowne Plaza Hotel]	There is a 5 out of 5 stars cheap family-friendly restaurant The Phoenix near Crowne Plaza Hotel in the city centre area. It offers Indian food.
name[The Phoenix], eatType[restaurant], food[Indian], priceRange[cheap], customer rating[5 out of 5], area[riverside], familyFriendly[no], near[Crowne Plaza Hotel]	The Phoenix is by Crowne Plaza Hotel, in the riverside area. With a 5 out of 5 rating and an adult-only environment, you can get Indian food at this restaurant.
name[The Phoenix], eatType[restaurant], food[Indian], priceRange[cheap], customer rating[5 out of 5], area[riverside], familyFriendly[no], near[Express by Holiday Inn]	The Phoenix is a cheap restaurant that serves Indian food. It is not children-friendly and has a rating of 5 out of 5. It is located in the riverside area near Express by Holiday Inn.
name[The Phoenix], eatType[restaurant], food[Indian], priceRange[cheap], customer rating[5 out of 5], area[riverside], familyFriendly[yes], near[Express by Holiday Inn]	The Phoenix, located near Express by Holiday Inn in the riverside area, is a kid-friendly restaurant. The Phoenix serves cheap Indian food and has a customer rating of 5 out of 5.
name[The Phoenix], eatType[restaurant], food[Indian], priceRange[cheap], customer rating[average], area[city centre], familyFriendly[no], near[Express by Holiday Inn]	The Phoenix, located near Express by Holiday Inn in the city centre area, is a not kid-friendly restaurant. The Phoenix serves cheap Indian food and has an average customer rating.
name[The Plough], eatType[pub], food[Chinese], priceRange[£20-25], area[riverside], familyFriendly[yes], near[Raja Indian Cuisine]	Family-friendly and £20-25, The Plough pub is located near Raja Indian Cuisine, in the riverside area.
name[The Plough], eatType[pub], food[Chinese], priceRange[cheap], area[riverside], familyFriendly[yes], near[Raja Indian Cuisine]	The Plough pub is a family-friendly place that provides Chinese food. It is cheap and close to Raja Indian Cuisine.
name[The Plough], eatType[pub], food[Chinese], priceRange[high], area[city centre], familyFriendly[no], near[Raja Indian Cuisine]	In the city centre area, near Raja Indian Cuisine, is The Plough pub, which has high Chinese and is not family-friendly.
name[The Plough], eatType[pub], food[Chinese], priceRange[high], area[city centre], familyFriendly[yes], near[Raja Indian Cuisine]	In the city centre area, near Raja Indian Cuisine, is The Plough pub, which has high Chinese and is family-friendly.
name[The Plough], eatType[pub], food[Chinese], priceRange[high], area[riverside], familyFriendly[no], near[Raja Indian Cuisine]	The Plough pub is located near Raja Indian Cuisine, in the riverside area. It is high and not family-friendly.
name[The Plough], eatType[pub], food[Chinese], priceRange[high], area[riverside], familyFriendly[yes], near[Raja Indian Cuisine]	Family-friendly and high, The Plough pub is located near Raja Indian Cuisine, in the riverside area.
name[The Plough], eatType[pub], food[Chinese], priceRange[less than £20], area[city centre], familyFriendly[no], near[Raja Indian Cuisine]	In the city centre area, near Raja Indian Cuisine, is The Plough pub, which has less than £20 Chinese and is not family-friendly.
name[The Plough], eatType[restaurant], food[Chinese], priceRange[£20-25], area[riverside], familyFriendly[yes], near[Raja Indian Cuisine]	The Plough restaurant is a family-friendly place that provides Chinese food. It is £20-25 and close to Raja Indian Cuisine.
name[The Plough], eatType[restaurant], food[Chinese], priceRange[cheap], area[riverside], familyFriendly[yes], near[Raja Indian Cuisine]	In the riverside area, near Raja Indian Cuisine, is The Plough restaurant, which has cheap Chinese and is family-friendly.
name[The Plough], eatType[restaurant], food[Chinese], priceRange[high], area[city centre], familyFriendly[no], near[Raja Indian Cuisine]	The Plough restaurant is located near Raja Indian Cuisine, in the city centre area. It is high and not family-friendly.
name[The Plough], eatType[restaurant], food[Chinese], priceRange[high], area[city centre], familyFriendly[yes], near[Raja Indian Cuisine]	Family-friendly and high, The Plough restaurant is located near Raja Indian Cuisine, in the city centre area.
name[The Plough], eatType[restaurant], food[Chinese], priceRange[high], area[riverside], familyFriendly[no], near[Raja Indian Cuisine]	In the riverside area, near Raja Indian Cuisine, is The Plough restaurant, which has high Chinese and is not family-friendly.
name[The Plough], eatType[restaurant], food[Chinese], priceRange[high], area[riverside], familyFriendly[yes], near[Raja Indian Cuisine]	The Plough restaurant is a family-friendly place that provides Chinese food. It is high and close to Raja Indian Cuisine.
name[The Plough], eatType[restaurant], food[Chinese], priceRange[less than £20], area[city centre], familyFriendly[no], near[Raja Indian Cuisine]	The Plough restaurant is located near Raja Indian Cuisine, in the city centre area. It is less than £20 and not family-friendly.
name[The Punter], eatType[pub], food[Chinese], priceRange[less than £20], area[city centre], familyFriendly[yes], near[Raja Indian Cuisine]	In the city centre area, near Raja Indian Cuisine, is The Punter pub, which has less than £20 Chinese and is family-friendly.
name[The Punter], eatType[pub], food[Chinese], priceRange[less than £20], area[riverside], familyFriendly[no], near[Raja Indian Cuisine]	In the riverside area, near Raja Indian Cuisine, is The Punter pub, which has less than £20 Chinese and is not family-friendly.
name[The Punter], eatType[pub], food[Chinese], priceRange[less than £20], area[riverside], familyFriendly[yes], near[Raja Indian Cuisine]	Family-friendly and less than £20, The Punter pub is located near Raja Indian Cuisine, in the riverside area.
name[The Punter], eatType[pub], food[Chinese], priceRange[moderate], area[city centre], familyFriendly[no], near[Raja Indian Cuisine]	The Punter pub is located near Raja Indian Cuisine, in the city centre area. It is moderate and not family-friendly.
name[The Punter], eatType[pub], food[Chinese], priceRange[moderate], area[city centre], familyFriendly[yes], near[Raja Indian Cuisine]	The Punter pub is a family-friendly place that provides Chinese food. It is moderate and close to Raja Indian Cuisine.
name[The Punter], eatType[pub], food[Chinese], priceRange[moderate], area[riverside], familyFriendly[no], near[Raja Indian Cuisine]	In the riverside area, near Raja Indian Cuisine, is The Punter pub, which has moderate Chinese and is not family-friendly.
name[The Punter], eatType[pub], food[Chinese], priceRange[moderate], area[riverside], familyFriendly[yes], near[Raja Indian Cuisine]	In the riverside area, near Raja Indian Cuisine, is The Punter pub, which has moderate Chinese and is family-friendly.
name[The Punter], eatType[pub], food[Chinese], priceRange[more than £30], area[riverside], familyFriendly[yes], near[Raja Indian Cuisine]	Family-friendly and more than £30, The Punter pub is located near Raja Indian Cuisine, in the riverside area.
name[The Punter], eatType[pub], food[English], priceRange[£20-25], area[riverside], familyFriendly[yes], near[Raja Indian Cuisine]	The Punter pub is a family-friendly place that provides English food. It is £20-25 and close to Raja Indian Cuisine.
name[The Punter], eatType[pub], food[English], priceRange[cheap], area[riverside], familyFriendly[yes], near[Raja Indian Cuisine]	In the riverside area, near Raja Indian Cuisine, is The Punter pub, which has cheap English and is family-friendly.
name[The Punter], eatType[pub], food[English], priceRange[high], area[city centre], familyFriendly[no], near[Raja Indian Cuisine]	The Punter pub is located near Raja Indian Cuisine, in the city centre area. It is high and not family-friendly.
name[The Punter], eatType[pub], food[English], priceRange[high], area[city centre], familyFriendly[yes], near[Raja Indian Cuisine]	Family-friendly and high, The Punter pub is located near Raja Indian Cuisine, in the city centre area.
name[The Punter], eatType[pub], food[English], priceRange[high], area[riverside], familyFriendly[no], near[Raja Indian Cuisine]	In the riverside area, near Raja Indian Cuisine, is The Punter pub, which has high English and is not family-friendly.
name[The Punter], eatType[pub], food[English], priceRange[high], area[riverside], familyFriendly[yes], near[Raja Indian Cuisine]	The Punter pub is a family-friendly place that provides English food. It is high and close to Raja Indian Cuisine.
name[The Punter], eatType[pub], food[Italian], priceRange[high], customer rating[average], area[city centre], familyFriendly[no], near[Rainbow Vegetarian Café]	The Punter is a high pub that serves Italian food. It is not children-friendly and has an average customer rating. It is located in the city centre area near Rainbow Vegetarian Café.
name[The Punter], eatType[restaurant], food[Chinese], priceRange[less than £20], area[city centre], familyFriendly[yes], near[Raja Indian Cuisine]	In the city centre area, near Raja Indian Cuisine, is The Punter restaurant, which has less than £20 Chinese and is family-friendly.
name[The Punter], eatType[restaurant], food[Chinese], priceRange[less than £20], area[riverside], familyFriendly[no], near[Raja Indian Cuisine]	The Punter restaurant is located near Raja Indian Cuisine, in the riverside area. It is less than £20 and not family-friendly.
name[The Punter], eatType[restaurant], food[Chinese], priceRange[less than £20], area[riverside], familyFriendly[yes], near[Raja Indian Cuisine]	Family-friendly and less than £20, The Punter restaurant is located near Raja Indian Cuisine, in the riverside area.
name[The Punter], eatType[restaurant], food[Chinese], priceRange[moderate], area[city centre], familyFriendly[no], near[Raja Indian Cuisine]	In the city centre area, near Raja Indian Cuisine, is The Punter restaurant, which has moderate Chinese and is not family-friendly.
name[The Punter], eatType[restaurant], food[Chinese], priceRange[moderate], area[city centre], familyFriendly[yes], near[Raja Indian Cuisine]	The Punter restaurant is a family-friendly place that provides Chinese food. It is moderate and close to Raja Indian Cuisine.
name[The Punter], eatType[restaurant], food[Chinese], priceRange[moderate], area[riverside], familyFriendly[no], near[Raja Indian Cuisine]	The Punter restaurant is located near Raja Indian Cuisine, in the riverside area. It is moderate and not family-friendly.
name[The Punter], eatType[restaurant], food[Chinese], priceRange[moderate], area[riverside], familyFriendly[yes], near[Raja Indian Cuisine]	In the riverside area, near Raja Indian Cuisine, is The Punter restaurant, which has moderate Chinese and is family-friendly.
name[The Punter], eatType[restaurant], food[Chinese], priceRange[more than £30], area[riverside], familyFriendly[yes], near[Raja Indian Cuisine]	Family-friendly and more than £30, The Punter restaurant is located near Raja Indian Cuisine, in the riverside area.
name[The Punter], eatType[restaurant], food[English], priceRange[£20-25], area[riverside], familyFriendly[yes], near[Raja Indian Cuisine]	The Punter restaurant is a family-friendly place that provides English food. It is £20-25 and close to Raja Indian Cuisine.
name[The Punter], eatType[restaurant], food[English], priceRange[cheap], area[riverside], familyFriendly[yes], near[Raja Indian Cuisine]	In the riverside area, near Raja Indian Cuisine, is The Punter restaurant, which has cheap English and is family-friendly.
name[The Punter], eatType[restaurant], food[English], priceRange[high], area[city centre], familyFriendly[no], near[Raja Indian Cuisine]	In the city centre area, near Raja Indian Cuisine, is The Punter restaurant, which has high English and is not family-friendly.
name[The Punter], eatType[restaurant], food[English], priceRange[high], area[city centre], familyFriendly[yes], near[Raja Indian Cuisine]	Family-friendly and high, The Punter restaurant is located near Raja Indian Cuisine, in the city centre area.
name[The Punter], eatType[restaurant], food[English], priceRange[high], area[riverside], familyFriendly[no], near[Raja Indian Cuisine]	The Punter restaurant is located near Raja Indian Cuisine, in the riverside area. It is high and not family-friendly.
name[The Punter], eatType[restaurant], food[English], priceRange[high], area[riverside], familyFriendly[yes], near[Raja Indian Cuisine]	The Punter restaurant is a family-friendly place that provides English food. It is high and close to Raja Indian Cuisine.
name[The Punter], eatType[restaurant], food[Indian], priceRange[cheap], customer rating[average], area[city centre], familyFriendly[yes], near[Express by Holiday Inn]	The Punter is a cheap restaurant that serves Indian food. Yes it is kids-friendly. It has an average customer rating and is located in the city centre area near Express by Holiday Inn.
name[The Punter], eatType[restaurant], food[Indian], priceRange[cheap], customer rating[average], area[riverside], familyFriendly[no], near[Express by Holiday Inn]	Cheap Indian food for adults can be found at The Punter restaurant, near Express by Holiday Inn in the riverside area. Average ratings.
name[The Punter], eatType[restaurant], food[Indian], priceRange[cheap], customer rating[average], area[riverside], familyFriendly[yes], near[Express by Holiday Inn]	Cheap Indian food for all the family can be found at The Punter restaurant, near Express by Holiday Inn, in the riverside area. Average ratings.
name[The Punter], eatType[restaurant], food[Indian], priceRange[high], customer rating[1 out of 5], area[city centre], familyFriendly[no], near[Express by Holiday Inn]	The Punter, located near Express by Holiday Inn in the city centre area, is a not kid-friendly restaurant. The Punter serves high Indian food and has a customer rating of 1 out of 5.
name[The Punter], eatType[restaurant], food[Indian], priceRange[high], customer rating[1 out of 5], area[city centre], familyFriendly[yes], near[Express by Holiday Inn]	The Punter is a high restaurant that serves Indian food. Yes it is kids-friendly. Its customer rating is 1 out of 5. It is located in the city centre area near Express by Holiday Inn.
name[The Punter], eatType[restaurant], food[Indian], priceRange[high], customer rating[1 out of 5], area[riverside], familyFriendly[no], near[Express by Holiday Inn]	The Punter is by Express by Holiday Inn, in the riverside area. With a 1 out of 5 rating and an adult-only environment, you can get Indian food at this restaurant.
name[The Punter], eatType[restaurant], food[Indian], priceRange[high], customer rating[1 out of 5], area[riverside], familyFriendly[yes], near[Express by Holiday Inn]	There is a 1 out of 5 stars high family-friendly restaurant The Punter near Express by Holiday Inn in the riverside area. It offers Indian food.
name[The Punter], eatType[restaurant], food[Indian], priceRange[high], customer rating[average], area[city centre], familyFriendly[no], near[Express by Holiday Inn]	The Punter, located near Express by Holiday Inn in the city centre area, is a not kid-friendly restaurant. The Punter serves high Indian food and has an average customer rating.
name[The Punter], eatType[restaurant], food[Indian], priceRange[high], customer rating[average], area[city centre], familyFriendly[yes], near[Express by Holiday Inn]	For a child-friendly, average-rated restaurant serving Indian, try The Punter, in the city centre area, near Express by Holiday Inn.
name[The Punter], eatType[restaurant], food[Indian], priceRange[high], customer rating[average], area[riverside], familyFriendly[no], near[Express by Holiday Inn]	The Punter is a high restaurant that serves Indian food. It is not children-friendly and has an average customer rating. It is located in the riverside area near Express by Holiday Inn.
name[The Punter], eatType[restaurant], food[Indian], priceRange[high], customer rating[average], area[riverside], familyFriendly[yes], near[Express by Holiday Inn]	The Punter is a high restaurant that serves Indian food. Yes it is kids-friendly. It has an average customer rating and is located in the riverside area near Express by Holiday Inn.
name[The Punter], eatType[restaurant], food[Indian], priceRange[less than £20], customer rating[low], area[city centre], familyFriendly[no], near[Express by Holiday Inn]	Less than £20 Indian food for adults can be found at The Punter restaurant, near Express by Holiday Inn in the city centre area. Low ratings.
name[The Punter], eatType[restaurant], food[Indian], priceRange[less than £20], customer rating[low], area[city centre], familyFriendly[yes], near[Express by Holiday Inn]	Less than £20 Indian food for all the family can be found at The Punter restaurant, near Express by Holiday Inn, in the city centre area. Low ratings.
name[The Punter], eatType[restaurant], food[Indian], priceRange[less than £20], customer rating[low], area[riverside], familyFriendly[no], near[Express by Holiday Inn]	The Punter, located near Express by Holiday Inn in the riverside area, is a not kid-friendly restaurant. The Punter serves less than £20 Indian food and has a low customer rating.
name[The Punter], eatType[restaurant], food[Indian], priceRange[less than £20], customer rating[low], area[riverside], familyFriendly[yes], near[Express by Holiday Inn]	For a child-friendly, low-rated restaurant serving Indian, try The Punter, in the riverside area, near Express by Holiday Inn.
name[The Punter], eatType[restaurant], food[Indian], priceRange[moderate], customer rating[1 out of 5], area[city centre], familyFriendly[no], near[Express by Holiday Inn]	The Punter is a moderate restaurant that serves Indian food. It is not children-friendly and has a rating of 1 out of 5. It is located in the city centre area near Express by Holiday Inn.
name[The Punter], eatType[restaurant], food[Indian], priceRange[moderate], customer rating[1 out of 5], area[city centre], familyFriendly[yes], near[Express by Holiday Inn]	The Punter, located near Express by Holiday Inn in the city centre area, is a kid-friendly restaurant. The Punter serves moderate Indian food and has a customer rating of 1 out of 5.
name[The Punter], eatType[restaurant], food[Indian], priceRange[moderate], customer rating[1 out of 5], area[riverside], familyFriendly[no], near[Express by Holiday Inn]	The Punter, located near Express by Holiday Inn in the riverside area, is a not kid-friendly restaurant. The Punter serves moderate Indian food and has a customer rating of 1 out of 5.
name[The Punter], eatType[restaurant], food[Indian], priceRange[moderate], customer rating[1 out of 5], area[riverside], familyFriendly[yes], near[Express by Holiday Inn]	The Punter is a moderate restaurant that serves Indian food. Yes it is kids-friendly. Its customer rating is 1 out of 5. It is located in the riverside area near Express by Holiday Inn.
name[The Punter], eatType[restaurant], food[Indian], priceRange[moderate], customer rating[3 out of 5], area[city centre], familyFriendly[no], near[Express by Holiday Inn]	The Punter is by Express by Holiday Inn, in the city centre area. With a 3 out of 5 rating and an adult-only environment, you can get Indian food at this restaurant.
name[The Punter], eatType[restaurant], food[Indian], priceRange[moderate], customer rating[3 out of 5], area[city centre], familyFriendly[yes], near[Express by Holiday Inn]	There is a 3 out of 5 stars moderate family-friendly restaurant The Punter near Express by Holiday Inn in the city centre area. It offers Indian food.
name[The Punter], eatType[restaurant], food[Indian], priceRange[moderate], customer rating[3 out of 5], area[riverside], familyFriendly[no], near[Express by Holiday Inn]	The Punter is a moderate restaurant that serves Indian food. It is not children-friendly and has a rating of 3 out of 5. It is located in the riverside area near Express by Holiday Inn.
name[The Punter], eatType[restaurant], food[Indian], priceRange[moderate], customer rating[3 out of 5], area[riverside], familyFriendly[yes], near[Express by Holiday Inn]	The Punter, located near Express by Holiday Inn in the riverside area, is a kid-friendly restaurant. The Punter serves moderate Indian food and has a customer rating of 3 out of 5.
name[The Punter], eatType[restaurant], food[Indian], priceRange[more than £30], customer rating[high], area[city centre], familyFriendly[no], near[Express by Holiday Inn]	The Punter is a more than £30 restaurant that serves Indian food. It is not children-friendly and has a high customer rating. It is located in the city centre area near Express by Holiday Inn.
name[The Punter], eatType[restaurant], food[Indian], priceRange[more than £30], customer rating[high], area[city centre], familyFriendly[yes], near[Express by Holiday Inn]	The Punter is a more than £30 restaurant that serves Indian food. Yes it is kids-friendly. It has a high customer rating and is located in the city centre area near Express by Holiday Inn.
name[The Punter], eatType[restaurant], food[Indian], priceRange[more than £30], customer rating[high], area[riverside], familyFriendly[no], near[Express by Holiday Inn]	More than £30 Indian food for adults can be found at The Punter restaurant, near Express by Holiday Inn in the riverside area. High ratings.
name[The Punter], eatType[restaurant], food[Indian], priceRange[more than £30], customer rating[high], area[riverside], familyFriendly[yes], near[Express by Holiday Inn]	More than £30 Indian food for all the family can be found at The Punter restaurant, near Express by Holiday Inn, in the riverside area. High ratings.
name[The Punter], eatType[restaurant], food[Italian], priceRange[£20-25], customer rating[high], area[city centre], familyFriendly[no], near[Express by Holiday Inn]	The Punter, located near Express by Holiday Inn in the city centre area, is a not kid-friendly restaurant. The Punter serves £20-25 Italian food and has a high customer rating.
name[The Punter], eatType[restaurant], food[Italian], priceRange[£20-25], customer rating[high], area[city centre], familyFriendly[yes], near[Express by Holiday Inn]	For a child-friendly, high-rated restaurant serving Italian, try The Punter, in the city centre area, near Express by Holiday Inn.
name[The Punter], eatType[restaurant], food[Italian], priceRange[£20-25], customer rating[high], area[riverside], familyFriendly[no], near[Express by Holiday Inn]	The Punter is a £20-25 restaurant that serves Italian food. It is not children-friendly and has a high customer rating. It is located in the riverside area near Express by Holiday Inn.
name[The Punter], eatType[restaurant], food[Italian], priceRange[£20-25], customer rating[high], area[riverside], familyFriendly[yes], near[Express by Holiday Inn]	The Punter is a £20-25 restaurant that serves Italian food. Yes it is kids-friendly. It has a high customer rating and is located in the riverside area near Express by Holiday Inn.
name[The Punter], eatType[restaurant], food[Italian], priceRange[cheap], customer rating[5 out of 5], area[city centre], familyFriendly[no], near[Express by Holiday Inn]	The Punter, located near Express by Holiday Inn in the city centre area, is a not kid-friendly restaurant. The Punter serves cheap Italian food and has a customer rating of 5 out of 5.
name[The Punter], eatType[restaurant], food[Italian], priceRange[cheap], customer rating[5 out of 5], area[city centre], familyFriendly[no], near[Rainbow Vegetarian Café]	The Punter is by Rainbow Vegetarian Café, in the city centre area. With a 5 out of 5 rating and an adult-only environment, you can get Italian food at this restaurant.
name[The Punter], eatType[restaurant], food[Italian], priceRange[cheap], customer rating[5 out of 5], area[city centre], familyFriendly[yes], near[Rainbow Vegetarian Café]	The Punter is a cheap restaurant that serves Italian food. Yes it is kids-friendly. Its customer rating is 5 out of 5. It is located in the city centre area near Rainbow Vegetarian Café.
name[The Punter], eatType[restaurant], food[Italian], priceRange[cheap], customer rating[5 out of 5], area[riverside], familyFriendly[no], near[Rainbow Vegetarian Café]	The Punter is a cheap restaurant that serves Italian food. It is not children-friendly and has a rating of 5 out of 5. It is located in the riverside area near Rainbow Vegetarian Café.
name[The Punter], eatType[restaurant], food[Italian], priceRange[cheap], customer rating[5 out of 5], area[riverside], familyFriendly[yes], near[Rainbow Vegetarian Café]	There is a 5 out of 5 stars cheap family-friendly restaurant The Punter near Rainbow Vegetarian Café in the riverside area. It offers Italian food.
name[The Punter], eatType[restaurant], food[Italian], priceRange[cheap], customer rating[average], area[city centre], familyFriendly[no], near[Rainbow Vegetarian Café]	Cheap Italian food for adults can be found at The Punter restaurant, near Rainbow Vegetarian Café in the city centre area. Average ratings.
name[The Punter], eatType[restaurant], food[Italian], priceRange[cheap], customer rating[average], area[city centre], familyFriendly[yes], near[Rainbow Vegetarian Café]	Cheap Italian food for all the family can be found at The Punter restaurant, near Rainbow Vegetarian Café, in the city centre area. Average ratings.
name[The Punter], eatType[restaurant], food[Italian], priceRange[cheap], customer rating[average], area[riverside], familyFriendly[no], near[Rainbow Vegetarian Café]	The Punter, located near Rainbow Vegetarian Café in the riverside area, is a not kid-friendly restaurant. The Punter serves cheap Italian food and has an average customer rating.
name[The Punter], eatType[restaurant], food[Italian], priceRange[cheap], customer rating[average], area[riverside], familyFriendly[yes], near[Rainbow Vegetarian Café]	For a child-friendly, average-rated restaurant serving Italian, try The Punter, in the riverside area, near Rainbow Vegetarian Café.
name[The Punter], eatType[restaurant], food[Italian], priceRange[high], customer rating[1 out of 5], area[city centre], familyFriendly[no], near[Rainbow Vegetarian Café]	The Punter, located near Rainbow Vegetarian Café in the city centre area, is a not kid-friendly restaurant. The Punter serves high Italian food and has a customer rating of 1 out of 5.
name[The Punter], eatType[restaurant], food[Italian], priceRange[high], customer rating[1 out of 5], area[city centre], familyFriendly[yes], near[Rainbow Vegetarian Café]	The Punter, located near Rainbow Vegetarian Café in the city centre area, is a kid-friendly restaurant. The Punter serves high Italian food and has a customer rating of 1 out of 5.
name[The Punter], eatType[restaurant], food[Italian], priceRange[high], customer rating[1 out of 5], area[riverside], familyFriendly[no], near[Rainbow Vegetarian Café]	The Punter is by Rainbow Vegetarian Café, in the riverside area. With a 1 out of 5 rating and an adult-only environment, you can get Italian food at this restaurant.
name[The Punter], eatType[restaurant], food[Italian], priceRange[high], customer rating[1 out of 5], area[riverside], familyFriendly[yes], near[Rainbow Vegetarian Café]	The Punter is a high restaurant that serves Italian food. Yes it is kids-friendly. Its customer rating is 1 out of 5. It is located in the riverside area near Rainbow Vegetarian Café.
name[The Vaults], eatType[pub], food[French], priceRange[high], area[riverside], familyFriendly[yes], near[Raja Indian Cuisine]	In the riverside area, near Raja Indian Cuisine, is The Vaults pub, which has high French and is family-friendly.
name[The Vaults], eatType[pub], food[French], priceRange[less than £20], area[city centre], familyFriendly[no], near[Raja Indian Cuisine]	In the city centre area, near Raja Indian Cuisine, is The Vaults pub, which has less than £20 French and is not family-friendly.
name[The Vaults], eatType[pub], food[French], priceRange[less than £20], area[city centre], familyFriendly[yes], near[Raja Indian Cuisine]	Family-friendly and less than £20, The Vaults pub is located near Raja Indian Cuisine, in the city centre area.
name[The Vaults], eatType[pub], food[French], priceRange[less than £20], area[riverside], familyFriendly[no], near[Raja Indian Cuisine]	The Vaults pub is located near Raja Indian Cuisine, in the riverside area. It is less than £20 and not family-friendly.
name[The Vaults], eatType[pub], food[French], priceRange[less than £20], area[riverside], familyFriendly[yes], near[Raja Indian Cuisine]	The Vaults pub is a family-friendly place that provides French food. It is less than £20 and close to Raja Indian Cuisine.
name[The Vaults], eatType[pub], food[French], priceRange[moderate], area[city centre], familyFriendly[no], near[Raja Indian Cuisine]	In the city centre area, near Raja Indian Cuisine, is The Vaults pub, which has moderate French and is not family-friendly.
name[The Vaults], eatType[pub], food[French], priceRange[moderate], area[city centre], familyFriendly[yes], near[Raja Indian Cuisine]	In the city centre area, near Raja Indian Cuisine, is The Vaults pub, which has moderate French and is family-friendly.
name[The Vaults], eatType[pub], food[French], priceRange[moderate], area[riverside], familyFriendly[no], near[Raja Indian Cuisine]	The Vaults pub is located near Raja Indian Cuisine, in the riverside area. It is moderate and not family-friendly.
name[The Vaults], eatType[pub], food[French], priceRange[moderate], area[riverside], familyFriendly[yes], near[Raja Indian Cuisine]	Family-friendly and moderate, The Vaults pub is located near Raja Indian Cuisine, in the riverside area.
name[The Vaults], eatType[pub], food[French], priceRange[more than £30], area[city centre], familyFriendly[no], near[Raja Indian Cuisine]	In the city centre area, near Raja Indian Cuisine, is The Vaults pub, which has more than £30 French and is not family-friendly.
name[The Vaults], eatType[pub], food[French], priceRange[more than £30], area[city centre], familyFriendly[yes], near[Raja Indian Cuisine]	The Vaults pub is a family-friendly place that provides French food. It is more than £30 and close to Raja Indian Cuisine.
name[The Vaults], eatType[pub], food[French], priceRange[more than £30], area[riverside], familyFriendly[no], near[Raja Indian Cuisine]	The Vaults pub is located near Raja Indian Cuisine, in the riverside area. It is more than £30 and not family-friendly.
name[The Vaults], eatType[pub], food[French], priceRange[more than £30], area[riverside], familyFriendly[yes], near[Raja Indian Cuisine]	In the riverside area, near Raja Indian Cuisine, is The Vaults pub, which has more than £30 French and is family-friendly.
name[The Vaults], eatType[pub], food[Indian], priceRange[£20-25], area[riverside], familyFriendly[yes], near[Raja Indian Cuisine]	Family-friendly and £20-25, The Vaults pub is located near Raja Indian Cuisine, in the riverside area.
name[The Vaults], eatType[pub], food[Indian], priceRange[cheap], area[riverside], familyFriendly[yes], near[Raja Indian Cuisine]	The Vaults pub is a family-friendly place that provides Indian food. It is cheap and close to Raja Indian Cuisine.
name[The Vaults], eatType[pub], food[Indian], priceRange[high], area[city centre], familyFriendly[no], near[Raja Indian Cuisine]	In the city centre area, near Raja Indian Cuisine, is The Vaults pub, which has high Indian and is not family-friendly.
name[The Vaults], eatType[pub], food[Indian], priceRange[high], area[city centre], familyFriendly[yes], near[Raja Indian Cuisine]	In the city centre area, near Raja Indian Cuisine, is The Vaults pub, which has high Indian and is family-friendly.
name[The Vaults], eatType[pub], food[Italian], priceRange[high], customer rating[average], area[city centre], familyFriendly[no], near[Rainbow Vegetarian Café]	The Vaults is a high pub that serves Italian food. It is not children-friendly and has an average customer rating. It is located in the city centre area near Rainbow Vegetarian Café.
name[The Vaults], eatType[pub], food[Italian], priceRange[high], customer rating[average], area[city centre], familyFriendly[yes], near[Rainbow Vegetarian Café]	The Vaults is a high pub that serves Italian food. Yes it is kids-friendly. It has an average customer rating and is located in the city centre area near Rainbow Vegetarian Café.
name[The Vaults], eatType[pub], food[Italian], priceRange[high], customer rating[average], area[riverside], familyFriendly[no], near[Rainbow Vegetarian Café]	High Italian food for adults can be found at The Vaults pub, near Rainbow Vegetarian Café in the riverside area. Average ratings.
name[The Vaults], eatType[pub], food[Italian], priceRange[high], customer rating[average], area[riverside], familyFriendly[yes], near[Rainbow Vegetarian Café]	High Italian food for all the family can be found at The Vaults pub, near Rainbow Vegetarian Café, in the riverside area. Average ratings.
name[The Vaults], eatType[pub], food[Italian], priceRange[less than £20], customer rating[low], area[city centre], familyFriendly[no], near[Rainbow Vegetarian Café]	The Vaults, located near Rainbow Vegetarian Café in the city centre area, is a not kid-friendly pub. The Vaults serves less than £20 Italian food and has a low customer rating.
name[The Vaults], eatType[pub], food[Italian], priceRange[less than £20], customer rating[low], area[city centre], familyFriendly[yes], near[Rainbow Vegetarian Café]	For a child-friendly, low-rated pub serving Italian, try The Vaults, in the city centre area, near Rainbow Vegetarian Café.
name[The Vaults], eatType[pub], food[Italian], priceRange[less than £20], customer rating[low], area[riverside], familyFriendly[no], near[Rainbow Vegetarian Café]	The Vaults is a less than £20 pub that serves Italian food. It is not children-friendly and has a low customer rating. It is located in the riverside area near Rainbow Vegetarian Café.
name[The Vaults], eatType[pub], food[Italian], priceRange[less than £20], customer rating[low], area[riverside], familyFriendly[yes], near[Rainbow Vegetarian Café]	The Vaults is a less than £20 pub that serves Italian food. Yes it is kids-friendly. It has a low customer rating and is located in the riverside area near Rainbow Vegetarian Café.
name[The Vaults], eatType[pub], food[Italian], priceRange[moderate], customer rating[1 out of 5], area[city centre], familyFriendly[no], near[Rainbow Vegetarian Café]	The Vaults is a moderate pub that serves Italian food. It is not children-friendly and has a rating of 1 out of 5. It is located in the city centre area near Rainbow Vegetarian Café.
name[The Vaults], eatType[pub], food[Italian], priceRange[moderate], customer rating[1 out of 5], area[city centre], familyFriendly[yes], near[Rainbow Vegetarian Café]	There is a 1 out of 5 stars moderate family-friendly pub The Vaults near Rainbow Vegetarian Café in the city centre area. It offers Italian food.
name[The Vaults], eatType[pub], food[Italian], priceRange[moderate], customer rating[1 out of 5], area[riverside], familyFriendly[no], near[Rainbow Vegetarian Café]	The Vaults, located near Rainbow Vegetarian Café in the riverside area, is a not kid-friendly pub. The Vaults serves moderate Italian food and has a customer rating of 1 out of 5.
name[The Vaults], eatType[pub], food[Italian], priceRange[moderate], customer rating[1 out of 5], area[riverside], familyFriendly[yes], near[Rainbow Vegetarian Café]	The Vaults, located near Rainbow Vegetarian Café in the riverside area, is a kid-friendly pub. The Vaults serves moderate Italian food and has a customer rating of 1 out of 5.
name[The Vaults], eatType[pub], food[Italian], priceRange[moderate], customer rating[3 out of 5], area[city centre], familyFriendly[no], near[Rainbow Vegetarian Café]	The Vaults is by Rainbow Vegetarian Café, in the city centre area. With a 3 out of 5 rating and an adult-only environment, you can get Italian food at this pub.
name[The Vaults], eatType[pub], food[Italian], priceRange[moderate], customer rating[3 out of 5], area[city centre], familyFriendly[yes], near[Rainbow Vegetarian Café]	The Vaults is a moderate pub that serves Italian food. Yes it is kids-friendly. Its customer rating is 3 out of 5. It is located in the city centre area near Rainbow Vegetarian Café.
name[The Vaults], eatType[pub], food[Italian], priceRange[moderate], customer rating[3 out of 5], area[riverside], familyFriendly[no], near[Rainbow Vegetarian Café]	The Vaults is a moderate pub that serves Italian food. It is not children-friendly and has a rating of 3 out of 5. It is located in the riverside area near Rainbow Vegetarian Café.
name[The Vaults], eatType[pub], food[Italian], priceRange[moderate], customer rating[3 out of 5], area[riverside], familyFriendly[yes], near[Rainbow Vegetarian Café]	There is a 3 out of 5 stars moderate family-friendly pub The Vaults near Rainbow Vegetarian Café in the riverside area. It offers Italian food.
name[The Vaults], eatType[pub], food[Italian], priceRange[more than £30], customer rating[high], area[city centre], familyFriendly[no], near[Rainbow Vegetarian Café]	More than £30 Italian food for adults can be found at The Vaults pub, near Rainbow Vegetarian Café in the city centre area. High ratings.
name[The Vaults], eatType[pub], food[Italian], priceRange[more than £30], customer rating[high], area[city centre], familyFriendly[yes], near[Rainbow Vegetarian Café]	More than £30 Italian food for all the family can be found at The Vaults pub, near Rainbow Vegetarian Café, in the city centre area. High ratings.
name[The Vaults], eatType[pub], food[Italian], priceRange[more than £30], customer rating[high], area[riverside], familyFriendly[no], near[Rainbow Vegetarian Café]	The Vaults, located near Rainbow Vegetarian Café in the riverside area, is a not kid-friendly pub. The Vaults serves more than £30 Italian food and has a high customer rating.
name[The Vaults], eatType[pub], food[Italian], priceRange[more than £30], customer rating[high], area[riverside], familyFriendly[yes], near[Rainbow Vegetarian Café]	For a child-friendly, high-rated pub serving Italian, try The Vaults, in the riverside area, near Rainbow Vegetarian Café.
name[The Vaults], eatType[pub], food[Japanese], priceRange[£20-25], customer rating[3 out of 5], area[city centre], familyFriendly[no], near[Rainbow Vegetarian Café]	The Vaults, located near Rainbow Vegetarian Café in the city centre area, is a not kid-friendly pub. The Vaults serves £20-25 Japanese food and has a customer rating of 3 out of 5.
name[The Vaults], eatType[pub], food[Japanese], priceRange[£20-25], customer rating[3 out of 5], area[city centre], familyFriendly[yes], near[Rainbow Vegetarian Café]	The Vaults, located near Rainbow Vegetarian Café in the city centre area, is a kid-friendly pub. The Vaults serves £20-25 Japanese food and has a customer rating of 3 out of 5.
name[The Vaults], eatType[pub], food[Japanese], priceRange[£20-25], customer rating[3 out of 5], area[riverside], familyFriendly[no], near[Rainbow Vegetarian Café]	The Vaults is by Rainbow Vegetarian Café, in the riverside area. With a 3 out of 5 rating and an adult-only environment, you can get Japanese food at this pub.
name[The Vaults], eatType[pub], food[Japanese], priceRange[£20-25], customer rating[3 out of 5], area[riverside], familyFriendly[yes], near[Rainbow Vegetarian Café]	The Vaults is a £20-25 pub that serves Japanese food. Yes it is kids-friendly. Its customer rating is 3 out of 5. It is located in the riverside area near Rainbow Vegetarian Café.
name[The Vaults], eatType[pub], food[Japanese], priceRange[£20-25], customer rating[high], area[city centre], familyFriendly[no], near[Rainbow Vegetarian Café]	The Vaults is a £20-25 pub that serves Japanese food. It is not children-friendly and has a high customer rating. It is located in the city centre area near Rainbow Vegetarian Café.
name[The Vaults], eatType[pub], food[Japanese], priceRange[£20-25], customer rating[high], area[city centre], familyFriendly[yes], near[Rainbow Vegetarian Café]	The Vaults is a £20-25 pub that serves Japanese food. Yes it is kids-friendly. It has a high customer rating and is located in the city centre area near Rainbow Vegetarian Café.
name[The Vaults], eatType[pub], food[Japanese], priceRange[£20-25], customer rating[high], area[riverside], familyFriendly[no], near[Rainbow Vegetarian Café]	£20-25 Japanese food for adults can be found at The Vaults pub, near Rainbow Vegetarian Café in the riverside area. High ratings.
name[The Vaults], eatType[pub], food[Japanese], priceRange[£20-25], customer rating[high], area[riverside], familyFriendly[no], near[Raja Indian Cuisine]	The Vaults, located near Raja Indian Cuisine in the riverside area, is a not kid-friendly pub. The Vaults serves £20-25 Japanese food and has a high customer rating.
name[The Vaults], eatType[pub], food[Japanese], priceRange[£20-25], customer rating[high], area[riverside], familyFriendly[yes], near[Raja Indian Cuisine]	£20-25 Japanese food for all the family can be found at The Vaults pub, near Raja Indian Cuisine, in the riverside area. High ratings.
name[The Vaults], eatType[pub], food[Japanese], priceRange[cheap], customer rating[5 out of 5], area[city centre], familyFriendly[no], near[Raja Indian Cuisine]	The Vaults is a cheap pub that serves Japanese food. It is not children-friendly and has a rating of 5 out of 5. It is located in the city centre area near Raja Indian Cuisine.
name[The Vaults], eatType[pub], food[Japanese], priceRange[cheap], customer rating[5 out of 5], area[city centre], familyFriendly[yes], near[Raja Indian Cuisine]	There is a 5 out of 5 stars cheap family-friendly pub The Vaults near Raja Indian Cuisine in the city centre area. It offers Japanese food.
name[The Vaults], eatType[pub], food[Japanese], priceRange[cheap], customer rating[5 out of 5], area[riverside], familyFriendly[no], near[Raja Indian Cuisine]	The Vaults, located near Raja Indian Cuisine in the riverside area, is a not kid-friendly pub. The Vaults serves cheap Japanese food and has a customer rating of 5 out of 5.
name[The Vaults], eatType[pub], food[Japanese], priceRange[cheap], customer rating[5 out of 5], area[riverside], familyFriendly[yes], near[Raja Indian Cuisine]	The Vaults, located near Raja Indian Cuisine in the riverside area, is a kid-friendly pub. The Vaults serves cheap Japanese food and has a customer rating of 5 out of 5.
name[The Vaults], eatType[pub], food[Japanese], priceRange[high], customer rating[3 out of 5], area[city centre], familyFriendly[no], near[Raja Indian Cuisine]	The Vaults is by Raja Indian Cuisine, in the city centre area. With a 3 out of 5 rating and an adult-only environment, you can get Japanese food at this pub.
name[The Vaults], eatType[pub], food[Japanese], priceRange[high], customer rating[3 out of 5], area[city centre], familyFriendly[yes], near[Raja Indian Cuisine]	The Vaults is a high pub that serves Japanese food. Yes it is kids-friendly. Its customer rating is 3 out of 5. It is located in the city centre area near Raja Indian Cuisine.
name[The Vaults], eatType[pub], food[Japanese], priceRange[high], customer rating[3 out of 5], area[riverside], familyFriendly[no], near[Raja Indian Cuisine]	The Vaults is a high pub that serves Japanese food. It is not children-friendly and has a rating of 3 out of 5. It is located in the riverside area near Raja Indian Cuisine.
name[The Vaults], eatType[pub], food[Japanese], priceRange[high], customer rating[3 out of 5], area[riverside], familyFriendly[yes], near[Raja Indian Cuisine]	There is a 3 out of 5 stars high family-friendly pub The Vaults near Raja Indian Cuisine in the riverside area. It offers Japanese food.
name[The Vaults], eatType[pub], food[Japanese], priceRange[less than £20], customer rating[average], area[city centre], familyFriendly[no], near[Raja Indian Cuisine]	The Vaults is a less than £20 pub that serves Japanese food. It is not children-friendly and has an average customer rating. It is located in the city centre area near Raja Indian Cuisine.
name[The Vaults], eatType[pub], food[Japanese], priceRange[less than £20], customer rating[average], area[city centre], familyFriendly[yes], near[Raja Indian Cuisine]	For a child-friendly, average-rated pub serving Japanese, try The Vaults, in the city centre area, near Raja Indian Cuisine.
name[The Vaults], eatType[pub], food[Japanese], priceRange[less than £20], customer rating[average], area[riverside], familyFriendly[no], near[Raja Indian Cuisine]	Less than £20 Japanese food for adults can be found at The Vaults pub, near Raja Indian Cuisine in the riverside area. Average ratings.
name[The Vaults], eatType[pub], food[Japanese], priceRange[less than £20], customer rating[average], area[riverside], familyFriendly[yes], near[Raja Indian Cuisine]	The Vaults is a less than £20 pub that serves Japanese food. Yes it is kids-friendly. It has an average customer rating and is located in the riverside area near Raja Indian Cuisine.
name[The Vaults], eatType[pub], food[Japanese], priceRange[less than £20], customer rating[low], area[city centre], familyFriendly[no], near[Raja Indian Cuisine]	The Vaults, located near Raja Indian Cuisine in the city centre area, is a not kid-friendly pub. The Vaults serves less than £20 Japanese food and has a low customer rating.
name[The Vaults], eatType[pub], food[Japanese], priceRange[less than £20], customer rating[low], area[city centre], familyFriendly[yes], near[Raja Indian Cuisine]	Less than £20 Japanese food for all the family can be found at The Vaults pub, near Raja Indian Cuisine, in the city centre area. Low ratings.
name[The Vaults], eatType[pub], food[Japanese], priceRange[less than £20], customer rating[low], area[riverside], familyFriendly[no], near[Raja Indian Cuisine]	The Vaults is a less than £20 pub that serves Japanese food. It is not children-friendly and has a low customer rating. It is located in the riverside area near Raja Indian Cuisine.
name[The Vaults], eatType[pub], food[Japanese], priceRange[less than £20], customer rating[low], area[riverside], familyFriendly[yes], near[Raja Indian Cuisine]	For a child-friendly, low-rated pub serving Japanese, try The Vaults, in the riverside area, near Raja Indian Cuisine.
name[The Vaults], eatType[pub], food[Japanese], priceRange[moderate], customer rating[1 out of 5], area[city centre], familyFriendly[no], near[Raja Indian Cuisine]	The Vaults, located near Raja Indian Cuisine in the city centre area, is a not kid-friendly pub. The Vaults serves moderate Japanese food and has a customer rating of 1 out of 5.
name[The Vaults], eatType[pub], food[Japanese], priceRange[moderate], customer rating[1 out of 5], area[city centre], familyFriendly[yes], near[Raja Indian Cuisine]	The Vaults, located near Raja Indian Cuisine in the city centre area, is a kid-friendly pub. The Vaults serves moderate Japanese food and has a customer rating of 1 out of 5.
name[The Vaults], eatType[restaurant], food[French], priceRange[high], area[riverside], familyFriendly[yes], near[Raja Indian Cuisine]	Family-friendly and high, The Vaults restaurant is located near Raja Indian Cuisine, in the riverside area.
name[The Vaults], eatType[restaurant], food[French], priceRange[less than £20], area[city centre], familyFriendly[no], near[Raja Indian Cuisine]	The Vaults restaurant is located near Raja Indian Cuisine, in the city centre area. It is less than £20 and not family-friendly.
name[The Vaults], eatType[restaurant], food[French], priceRange[less than £20], area[city centre], familyFriendly[yes], near[Raja Indian Cuisine]	The Vaults restaurant is a family-friendly place that provides French food. It is less than £20 and close to Raja Indian Cuisine.
name[The Vaults], eatType[restaurant], food[French], priceRange[less than £20], area[riverside], familyFriendly[no], near[Raja Indian Cuisine]	In the riverside area, near Raja Indian Cuisine, is The Vaults restaurant, which has less than £20 French and is not family-friendly.
name[The Vaults], eatType[restaurant], food[French], priceRange[less than £20], area[riverside], familyFriendly[yes], near[Raja Indian Cuisine]	In the riverside area, near Raja Indian Cuisine, is The Vaults restaurant, which has less than £20 French and is family-friendly.
name[The Vaults], eatType[restaurant], food[French], priceRange[moderate], area[city centre], familyFriendly[no], near[Raja Indian Cuisine]	The Vaults restaurant is located near Raja Indian Cuisine, in the city centre area. It is moderate and not family-friendly.
name[The Vaults], eatType[restaurant], food[French], priceRange[moderate], area[city centre], familyFriendly[yes], near[Raja Indian Cuisine]	Family-friendly and moderate, The Vaults restaurant is located near Raja Indian Cuisine, in the city centre area.
name[The Vaults], eatType[restaurant], food[French], priceRange[moderate], area[riverside], familyFriendly[no], near[Raja Indian Cuisine]	In the riverside area, near Raja Indian Cuisine, is The Vaults restaurant, which has moderate French and is not family-friendly.
name[The Vaults], eatType[restaurant], food[French], priceRange[moderate], area[riverside], familyFriendly[yes], near[Raja Indian Cuisine]	The Vaults restaurant is a family-friendly place that provides French food. It is moderate and close to Raja Indian Cuisine.
name[The Vaults], eatType[restaurant], food[French], priceRange[more than £30], area[city centre], familyFriendly[no], near[Raja Indian Cuisine]	The Vaults restaurant is located near Raja Indian Cuisine, in the city centre area. It is more than £30 and not family-friendly.
name[The Vaults], eatType[restaurant], food[French], priceRange[more than £30], area[city centre], familyFriendly[yes], near[Raja Indian Cuisine]	In the city centre area, near Raja Indian Cuisine, is The Vaults restaurant, which has more than £30 French and is family-friendly.
name[The Vaults], eatType[restaurant], food[French], priceRange[more than £30], area[riverside], familyFriendly[no], near[Raja Indian Cuisine]	In the riverside area, near Raja Indian Cuisine, is The Vaults restaurant, which has more than £30 French and is not family-friendly.
name[The Vaults], eatType[restaurant], food[French], priceRange[more than £30], area[riverside], familyFriendly[yes], near[Raja Indian Cuisine]	Family-friendly and more than £30, The Vaults restaurant is located near Raja Indian Cuisine, in the riverside area.
name[The Vaults], eatType[restaurant], food[Indian], priceRange[£20-25], area[riverside], familyFriendly[yes], near[Raja Indian Cuisine]	The Vaults restaurant is a family-friendly place that provides Indian food. It is £20-25 and close to Raja Indian Cuisine.
name[The Vaults], eatType[restaurant], food[Indian], priceRange[cheap], area[riverside], familyFriendly[yes], near[Raja Indian Cuisine]	In the riverside area, near Raja Indian Cuisine, is The Vaults restaurant, which has cheap Indian and is family-friendly.
name[The Vaults], eatType[restaurant], food[Indian], priceRange[high], area[city centre], familyFriendly[no], near[Raja Indian Cuisine]	The Vaults restaurant is located near Raja Indian Cuisine, in the city centre area. It is high and not family-friendly.
name[The Vaults], eatType[restaurant], food[Indian], priceRange[high], area[city centre], familyFriendly[yes], near[Raja Indian Cuisine]	Family-friendly and high, The Vaults restaurant is located near Raja Indian Cuisine, in the city centre area.
name[The Waterman], eatType[pub], food[Indian], priceRange[high], area[city centre], familyFriendly[yes], near[Raja Indian Cuisine]	The Waterman pub is a family-friendly place that provides Indian food. It is high and close to Raja Indian Cuisine.
name[The Waterman], eatType[pub], food[Indian], priceRange[high], area[riverside], familyFriendly[no], near[Raja Indian Cuisine]	In the riverside area, near Raja Indian Cuisine, is The Waterman pub, which has high Indian and is not family-friendly.
name[The Waterman], eatType[pub], food[Indian], priceRange[high], area[riverside], familyFriendly[yes], near[Raja Indian Cuisine]	In the riverside area, near Raja Indian Cuisine, is The Waterman pub, which has high Indian and is family-friendly.
name[The Waterman], eatType[pub], food[Indian], priceRange[less than £20], area[city centre], familyFriendly[no], near[Raja Indian Cuisine]	The Waterman pub is located near Raja Indian Cuisine, in the city centre area. It is less than £20 and not family-friendly.
name[The Waterman], eatType[pub], food[Indian], priceRange[less than £20], area[city centre], familyFriendly[yes], near[Raja Indian Cuisine]	Family-friendly and less than £20, The Waterman pub is located near Raja Indian Cuisine, in the city centre area.
name[The Waterman], eatType[pub], food[Indian], priceRange[less than £20], area[riverside], familyFriendly[no], near[Raja Indian Cuisine]	In the riverside area, near Raja Indian Cuisine, is The Waterman pub, which has less than £20 Indian and is not family-friendly.
name[The Waterman], eatType[pub], food[Indian], priceRange[less than £20], area[riverside], familyFriendly[yes], near[Raja Indian Cuisine]	The Waterman pub is a family-friendly place that provides Indian food. It is less than £20 and close to Raja Indian Cuisine.
name[The Waterman], eatType[pub], food[Indian], priceRange[moderate], area[city centre], familyFriendly[no], near[Raja Indian Cuisine]	The Waterman pub is located near Raja Indian Cuisine, in the city centre area. It is moderate and not family-friendly.
name[The Waterman], eatType[pub], food[Indian], priceRange[moderate], area[city centre], familyFriendly[yes], near[Raja Indian Cuisine]	In the city centre area, near Raja Indian Cuisine, is The Waterman pub, which has moderate Indian and is family-friendly.
name[The Waterman], eatType[pub], food[Indian], priceRange[moderate], area[riverside], familyFriendly[no], near[Raja Indian Cuisine]	In the riverside area, near Raja Indian Cuisine, is The Waterman pub, which has moderate Indian and is not family-friendly.
name[The Waterman], eatType[pub], food[Indian], priceRange[moderate], area[riverside], familyFriendly[yes], near[Raja Indian Cuisine]	Family-friendly and moderate, The Waterman pub is located near Raja Indian Cuisine, in the riverside area.
name[The Waterman], eatType[pub], food[Indian], priceRange[more than £30], area[riverside], familyFriendly[yes], near[Raja Indian Cuisine]	The Waterman pub is a family-friendly place that provides Indian food. It is more than £30 and close to Raja Indian Cuisine.
name[The Waterman], eatType[pub], food[Italian], priceRange[£20-25], area[riverside], familyFriendly[yes], near[Raja Indian Cuisine]	In the riverside area, near Raja Indian Cuisine, is The Waterman pub, which has £20-25 Italian and is family-friendly.
name[The Waterman], eatType[pub], food[Italian], priceRange[cheap], area[riverside], familyFriendly[yes], near[Raja Indian Cuisine]	Family-friendly and cheap, The Waterman pub is located near Raja Indian Cuisine, in the riverside area.
name[The Waterman], eatType[pub], food[Italian], priceRange[high], area[city centre], familyFriendly[no], near[Raja Indian Cuisine]	The Waterman pub is located near Raja Indian Cuisine, in the city centre area. It is high and not family-friendly.
name[The Waterman], eatType[pub], food[Italian], priceRange[high], area[city centre], familyFriendly[yes], near[Raja Indian Cuisine]	The Waterman pub is a family-friendly place that provides Italian food. It is high and close to Raja Indian Cuisine.
name[The Waterman], eatType[pub], food[Italian], priceRange[high], area[riverside], familyFriendly[no], near[Raja Indian Cuisine]	In the riverside area, near Raja Indian Cuisine, is The Waterman pub, which has high Italian and is not family-friendly.
name[The Waterman], eatType[pub], food[Italian], priceRange[high], area[riverside], familyFriendly[yes], near[Raja Indian Cuisine]	In the riverside area, near Raja Indian Cuisine, is The Waterman pub, which has high Italian and is family-friendly.
name[The Waterman], eatType[pub], food[Italian], priceRange[less than £20], area[city centre], familyFriendly[no], near[Raja Indian Cuisine]	The Waterman pub is located near Raja Indian Cuisine, in the city centre area. It is less than £20 and not family-friendly.
name[The Waterman], eatType[pub], food[Italian], priceRange[less than £20], area[city centre], familyFriendly[yes], near[Raja Indian Cuisine]	Family-friendly and less than £20, The Waterman pub is located near Raja Indian Cuisine, in the city centre area.
name[The Waterman], eatType[pub], food[Italian], priceRange[less than £20], area[riverside], familyFriendly[no], near[Raja Indian Cuisine]	In the riverside area, near Raja Indian Cuisine, is The Waterman pub, which has less than £20 Italian and is not family-friendly.
name[The Waterman], eatType[restaurant], food[Indian], priceRange[high], area[city centre], familyFriendly[yes], near[Raja Indian Cuisine]	The Waterman restaurant is a family-friendly place that provides Indian food. It is high and close to Raja Indian Cuisine.
name[The Waterman], eatType[restaurant], food[Indian], priceRange[high], area[riverside], familyFriendly[no], near[Raja Indian Cuisine]	The Waterman restaurant is located near Raja Indian Cuisine, in the riverside area. It is high and not family-friendly.
name[The Waterman], eatType[restaurant], food[Indian], priceRange[high], area[riverside], familyFriendly[yes], near[Raja Indian Cuisine]	In the riverside area, near Raja Indian Cuisine, is The Waterman restaurant, which has high Indian and is family-friendly.
name[The Waterman], eatType[restaurant], food[Indian], priceRange[less than £20], area[city centre], familyFriendly[no], near[Raja Indian Cuisine]	In the city centre area, near Raja Indian Cuisine, is The Waterman restaurant, which has less than £20 Indian and is not family-friendly.
name[The Waterman], eatType[restaurant], food[Indian], priceRange[less than £20], area[city centre], familyFriendly[yes], near[Raja Indian Cuisine]	Family-friendly and less than £20, The Waterman restaurant is located near Raja Indian Cuisine, in the city centre area.
name[The Waterman], eatType[restaurant], food[Indian], priceRange[less than £20], area[riverside], familyFriendly[no], near[Raja Indian Cuisine]	The Waterman restaurant is located near Raja Indian Cuisine, in the riverside area. It is less than £20 and not family-friendly.
name[The Waterman], eatType[restaurant], food[Indian], priceRange[less than £20], area[riverside], familyFriendly[yes], near[Raja Indian Cuisine]	The Waterman restaurant is a family-friendly place that provides Indian food. It is less than £20 and close to Raja Indian Cuisine.
name[The Waterman], eatType[restaurant], food[Indian], priceRange[moderate], area[city centre], familyFriendly[no], near[Raja Indian Cuisine]	In the city centre area, near Raja Indian Cuisine, is The Waterman restaurant, which has moderate Indian and is not family-friendly.
name[The Waterman], eatType[restaurant], food[Indian], priceRange[moderate], area[city centre], familyFriendly[yes], near[Raja Indian Cuisine]	In the city centre area, near Raja Indian Cuisine, is The Waterman restaurant, which has moderate Indian and is family-friendly.
name[The Waterman], eatType[restaurant], food[Indian], priceRange[moderate], area[riverside], familyFriendly[no], near[Raja Indian Cuisine]	The Waterman restaurant is located near Raja Indian Cuisine, in the riverside area. It is moderate and not family-friendly.
name[The Waterman], eatType[restaurant], food[Indian], priceRange[moderate], area[riverside], familyFriendly[yes], near[Raja Indian Cuisine]	Family-friendly and moderate, The Waterman restaurant is located near Raja Indian Cuisine, in the riverside area.
name[The Waterman], eatType[restaurant], food[Indian], priceRange[more than £30], area[riverside], familyFriendly[yes], near[Raja Indian Cuisine]	The Waterman restaurant is a family-friendly place that provides Indian food. It is more than £30 and close to Raja Indian Cuisine.
name[The Waterman], eatType[restaurant], food[Italian], priceRange[£20-25], area[riverside], familyFriendly[yes], near[Raja Indian Cuisine]	In the riverside area, near Raja Indian Cuisine, is The Waterman restaurant, which has £20-25 Italian and is family-friendly.
name[The Waterman], eatType[restaurant], food[Italian], priceRange[cheap], area[riverside], familyFriendly[yes], near[Raja Indian Cuisine]	Family-friendly and cheap, The Waterman restaurant is located near Raja Indian Cuisine, in the riverside area.
name[The Waterman], eatType[restaurant], food[Italian], priceRange[high], area[city centre], familyFriendly[no], near[Raja Indian Cuisine]	In the city centre area, near Raja Indian Cuisine, is The Waterman restaurant, which has high Italian and is not family-friendly.
name[The Waterman], eatType[restaurant], food[Italian], priceRange[high], area[city centre], familyFriendly[yes], near[Raja Indian Cuisine]	The Waterman restaurant is a family-friendly place that provides Italian food. It is high and close to Raja Indian Cuisine.
name[The Waterman], eatType[restaurant], food[Italian], priceRange[high], area[riverside], familyFriendly[no], near[Raja Indian Cuisine]	The Waterman restaurant is located near Raja Indian Cuisine, in the riverside area. It is high and not family-friendly.
name[The Waterman], eatType[restaurant], food[Italian], priceRange[high], area[riverside], familyFriendly[yes], near[Raja Indian Cuisine]	In the riverside area, near Raja Indian Cuisine, is The Waterman restaurant, which has high Italian and is family-friendly.
name[The Waterman], eatType[restaurant], food[Italian], priceRange[less than £20], area[city centre], familyFriendly[no], near[Raja Indian Cuisine]	In the city centre area, near Raja Indian Cuisine, is The Waterman restaurant, which has less than £20 Italian and is not family-friendly.
name[The Waterman], eatType[restaurant], food[Italian], priceRange[less than £20], area[city centre], familyFriendly[yes], near[Raja Indian Cuisine]	Family-friendly and less than £20, The Waterman restaurant is located near Raja Indian Cuisine, in the city centre area.
name[The Waterman], eatType[restaurant], food[Italian], priceRange[less than £20], area[riverside], familyFriendly[no], near[Raja Indian Cuisine]	The Waterman restaurant is located near Raja Indian Cuisine, in the riverside area. It is less than £20 and not family-friendly.
name[The Wrestlers], eatType[pub], food[Italian], priceRange[less than £20], area[riverside], familyFriendly[no], near[Raja Indian Cuisine]	In the riverside area, near Raja Indian Cuisine, is The Wrestlers pub, which has less than £20 Italian and is not family-friendly.
name[The Wrestlers], eatType[pub], food[Italian], priceRange[less than £20], area[riverside], familyFriendly[yes], near[Raja Indian Cuisine]	The Wrestlers pub is a family-friendly place that provides Italian food. It is less than £20 and close to Raja Indian Cuisine.
name[The Wrestlers], eatType[pub], food[Italian], priceRange[moderate], area[city centre], familyFriendly[no], near[Raja Indian Cuisine]	The Wrestlers pub is located near Raja Indian Cuisine, in the city centre area. It is moderate and not family-friendly.
name[The Wrestlers], eatType[pub], food[Italian], priceRange[moderate], area[city centre], familyFriendly[yes], near[Raja Indian Cuisine]	In the city centre area, near Raja Indian Cuisine, is The Wrestlers pub, which has moderate Italian and is family-friendly.
name[The Wrestlers], eatType[pub], food[Italian], priceRange[moderate], area[riverside], familyFriendly[no], near[Raja Indian Cuisine]	In the riverside area, near Raja Indian Cuisine, is The Wrestlers pub, which has moderate Italian and is not family-friendly.
name[The Wrestlers], eatType[pub], food[Italian], priceRange[moderate], area[riverside], familyFriendly[yes], near[Raja Indian Cuisine]	Family-friendly and moderate, The Wrestlers pub is located near Raja Indian Cuisine, in the riverside area.
name[The Wrestlers], eatType[pub], food[Italian], priceRange[more than £30], area[riverside], familyFriendly[yes], near[Raja Indian Cuisine]	The Wrestlers pub is a family-friendly place that provides Italian food. It is more than £30 and close to Raja Indian Cuisine.
name[The Wrestlers], eatType[pub], food[Japanese], priceRange[£20-25], area[riverside], familyFriendly[yes], near[Raja Indian Cuisine]	In the riverside area, near Raja Indian Cuisine, is The Wrestlers pub, which has £20-25 Japanese and is family-friendly.
name[The Wrestlers], eatType[pub], food[Japanese], priceRange[cheap], area[riverside], familyFriendly[yes], near[Raja Indian Cuisine]	Family-friendly and cheap, The Wrestlers pub is located near Raja Indian Cuisine, in the riverside area.
name[The Wrestlers], eatType[pub], food[Japanese], priceRange[high], area[riverside], familyFriendly[yes], near[Raja Indian Cuisine]	The Wrestlers pub is a family-friendly place that provides Japanese food. It is high and close to Raja Indian Cuisine.
name[The Wrestlers], eatType[pub], food[Japanese], priceRange[less than £20], area[city centre], familyFriendly[no], near[Raja Indian Cuisine]	The Wrestlers pub is located near Raja Indian Cuisine, in the city centre area. It is less than £20 and not family-friendly.
name[The Wrestlers], eatType[pub], food[Japanese], priceRange[less than £20], area[city centre], familyFriendly[yes], near[Raja Indian Cuisine]	In the city centre area, near Raja Indian Cuisine, is The Wrestlers pub, which has less than £20 Japanese and is family-friendly.
name[The Wrestlers], eatType[pub], food[Japanese], priceRange[less than £20], area[riverside], familyFriendly[no], near[Raja Indian Cuisine]	In the riverside area, near Raja Indian Cuisine, is The Wrestlers pub, which has less than £20 Japanese and is not family-friendly.
name[The Wrestlers], eatType[pub], food[Japanese], priceRange[less than £20], area[riverside], familyFriendly[yes], near[Raja Indian Cuisine]	Family-friendly and less than £20, The Wrestlers pub is located near Raja Indian Cuisine, in the riverside area.
name[The Wrestlers], eatType[pub], food[Japanese], priceRange[moderate], area[city centre], familyFriendly[no], near[Raja Indian Cuisine]	The Wrestlers pub is located near Raja Indian Cuisine, in the city centre area. It is moderate and not family-friendly.
name[The Wrestlers], eatType[pub], food[Japanese], priceRange[moderate], area[city centre], familyFriendly[yes], near[Raja Indian Cuisine]	The Wrestlers pub is a family-friendly place that provides Japanese food. It is moderate and close to Raja Indian Cuisine.
name[The Wrestlers], eatType[pub], food[Japanese], priceRange[moderate], area[riverside], familyFriendly[no], near[Raja Indian Cuisine]	In the riverside area, near Raja Indian Cuisine, is The Wrestlers pub, which has moderate Japanese and is not family-friendly.
name[The Wrestlers], eatType[pub], food[Japanese], priceRange[moderate], area[riverside], familyFriendly[yes], near[Raja Indian Cuisine]	In the riverside area, near Raja Indian Cuisine, is The Wrestlers pub, which has moderate Japanese and is family-friendly.
name[The Wrestlers], eatType[pub], food[Japanese], priceRange[moderate], customer rating[1 out of 5], area[city centre], familyFriendly[yes], near[Raja Indian Cuisine]	The Wrestlers is a moderate pub that serves Japanese food. Yes it is kids-friendly. Its customer rating is 1 out of 5. It is located in the city centre area near Raja Indian Cuisine.
name[The Wrestlers], eatType[pub], food[Japanese], priceRange[moderate], customer rating[1 out of 5], area[riverside], familyFriendly[no], near[Raja Indian Cuisine]	The Wrestlers is by Raja Indian Cuisine, in the riverside area. With a 1 out of 5 rating and an adult-only environment, you can get Japanese food at this pub.
name[The Wrestlers], eatType[pub], food[Japanese], priceRange[moderate], customer rating[1 out of 5], area[riverside], familyFriendly[yes], near[Raja Indian Cuisine]	There is a 1 out of 5 stars moderate family-friendly pub The Wrestlers near Raja Indian Cuisine in the riverside area. It offers Japanese food.
name[The Wrestlers], eatType[pub], food[Japanese], priceRange[more than £30], area[city centre], familyFriendly[no], near[Raja Indian Cuisine]	The Wrestlers pub is located near Raja Indian Cuisine, in the city centre area. It is more than £30 and not family-friendly.
name[The Wrestlers], eatType[pub], food[Japanese], priceRange[more than £30], area[city centre], familyFriendly[yes], near[Raja Indian Cuisine]	Family-friendly and more than £30, The Wrestlers pub is located near Raja Indian Cuisine, in the city centre area.
name[The Wrestlers], eatType[pub], food[Japanese], priceRange[more than £30], area[riverside], familyFriendly[no], near[Raja Indian Cuisine]	In the riverside area, near Raja Indian Cuisine, is The Wrestlers pub, which has more than £30 Japanese and is not family-friendly.
name[The Wrestlers], eatType[pub], food[Japanese], priceRange[more than £30], area[riverside], familyFriendly[yes], near[Raja Indian Cuisine]	The Wrestlers pub is a family-friendly place that provides Japanese food. It is more than £30 and close to Raja Indian Cuisine.
name[The Wrestlers], eatType[pub], food[Japanese], priceRange[more than £30], customer rating[5 out of 5], area[city centre], familyFriendly[no], near[Raja Indian Cuisine]	The Wrestlers is a more than £30 pub that serves Japanese food. It is not children-friendly and has a rating of 5 out of 5. It is located in the city centre area near Raja Indian Cuisine.
name[The Wrestlers], eatType[pub], food[Japanese], priceRange[more than £30], customer rating[5 out of 5], area[city centre], familyFriendly[yes], near[Raja Indian Cuisine]	The Wrestlers, located near Raja Indian Cuisine in the city centre area, is a kid-friendly pub. The Wrestlers serves more than £30 Japanese food and has a customer rating of 5 out of 5.
name[The Wrestlers], eatType[pub], food[Japanese], priceRange[more than £30], customer rating[5 out of 5], area[riverside], familyFriendly[no], near[Raja Indian Cuisine]	The Wrestlers, located near Raja Indian Cuisine in the riverside area, is a not kid-friendly pub. The Wrestlers serves more than £30 Japanese food and has a customer rating of 5 out of 5.
name[The Wrestlers], eatType[pub], food[Japanese], priceRange[more than £30], customer rating[5 out of 5], area[riverside], familyFriendly[yes], near[Raja Indian Cuisine]	The Wrestlers is a more than £30 pub that serves Japanese food. Yes it is kids-friendly. Its customer rating is 5 out of 5. It is located in the riverside area near Raja Indian Cuisine.
name[The Wrestlers], eatType[pub], food[Japanese], priceRange[more than £30], customer rating[low], area[city centre], familyFriendly[no], near[Raja Indian Cuisine]	More than £30 Japanese food for adults can be found at The Wrestlers pub, near Raja Indian Cuisine in the city centre area. Low ratings.
name[The Wrestlers], eatType[pub], food[Japanese], priceRange[more than £30], customer rating[low], area[city centre], familyFriendly[yes], near[Raja Indian Cuisine]	The Wrestlers is a more than £30 pub that serves Japanese food. Yes it is kids-friendly. It has a low customer rating and is located in the city centre area near Raja Indian Cuisine.
name[The Wrestlers], eatType[pub], food[Japanese], priceRange[more than £30], customer rating[low], area[riverside], familyFriendly[no], near[Raja Indian Cuisine]	The Wrestlers, located near Raja Indian Cuisine in the riverside area, is a not kid-friendly pub. The Wrestlers serves more than £30 Japanese food and has a low customer rating.
name[The Wrestlers], eatType[pub], food[Japanese], priceRange[more than £30], customer rating[low], area[riverside], familyFriendly[yes], near[Raja Indian Cuisine]	More than £30 Japanese food for all the family can be found at The Wrestlers pub, near Raja Indian Cuisine, in the riverside area. Low ratings.
name[The Wrestlers], eatType[restaurant], food[Italian], priceRange[less than £20], area[riverside], familyFriendly[no], near[Raja Indian Cuisine]	The Wrestlers restaurant is located near Raja Indian Cuisine, in the riverside area. It is less than £20 and not family-friendly.
name[The Wrestlers], eatType[restaurant], food[Italian], priceRange[less than £20], area[riverside], familyFriendly[yes], near[Raja Indian Cuisine]	In the riverside area, near Raja Indian Cuisine, is The Wrestlers restaurant, which has less than £20 Italian and is family-friendly.
name[The Wrestlers], eatType[restaurant], food[Italian], priceRange[moderate], area[city centre], familyFriendly[no], near[Raja Indian Cuisine]	In the city centre area, near Raja Indian Cuisine, is The Wrestlers restaurant, which has moderate Italian and is not family-friendly.
name[The Wrestlers], eatType[restaurant], food[Italian], priceRange[moderate], area[city centre], familyFriendly[yes], near[Raja Indian Cuisine]	Family-friendly and moderate, The Wrestlers restaurant is located near Raja Indian Cuisine, in the city centre area.
name[The Wrestlers], eatType[restaurant], food[Italian], priceRange[moderate], area[riverside], familyFriendly[no], near[Raja Indian Cuisine]	The Wrestlers restaurant is located near Raja Indian Cuisine, in the riverside area. It is moderate and not family-friendly.
name[The Wrestlers], eatType[restaurant], food[Italian], priceRange[moderate], area[riverside], familyFriendly[yes], near[Raja Indian Cuisine]	The Wrestlers restaurant is a family-friendly place that provides Italian food. It is moderate and close to Raja Indian Cuisine.
name[The Wrestlers], eatType[restaurant], food[Italian], priceRange[more than £30], area[riverside], familyFriendly[yes], near[Raja Indian Cuisine]	In the riverside area, near Raja Indian Cuisine, is The Wrestlers restaurant, which has more than £30 Italian and is family-friendly.
name[The Wrestlers], eatType[restaurant], food[Japanese], priceRange[£20-25], area[riverside], familyFriendly[yes], near[Raja Indian Cuisine]	Family-friendly and £20-25, The Wrestlers restaurant is located near Raja Indian Cuisine, in the riverside area.
name[The Wrestlers], eatType[restaurant], food[Japanese], priceRange[cheap], area[riverside], familyFriendly[yes], near[Raja Indian Cuisine]	The Wrestlers restaurant is a family-friendly place that provides Japanese food. It is cheap and close to Raja Indian Cuisine.
name[The Wrestlers], eatType[restaurant], food[Japanese], priceRange[high], area[riverside], familyFriendly[yes], near[Raja Indian Cuisine]	In the riverside area, near Raja Indian Cuisine, is The Wrestlers restaurant, which has high Japanese and is family-friendly.
name[The Wrestlers], eatType[restaurant], food[Japanese], priceRange[less than £20], area[city centre], familyFriendly[no], near[Raja Indian Cuisine]	In the city centre area, near Raja Indian Cuisine, is The Wrestlers restaurant, which has less than £20 Japanese and is not family-friendly.
name[The Wrestlers], eatType[restaurant], food[Japanese], priceRange[less than £20], area[city centre], familyFriendly[yes], near[Raja Indian Cuisine]	Family-friendly and less than £20, The Wrestlers restaurant is located near Raja Indian Cuisine, in the city centre area.
name[The Wrestlers], eatType[restaurant], food[Japanese], priceRange[less than £20], area[riverside], familyFriendly[no], near[Raja Indian Cuisine]	The Wrestlers restaurant is located near Raja Indian Cuisine, in the riverside area. It is less than £20 and not family-friendly.
name[The Wrestlers], eatType[restaurant], food[Japanese], priceRange[less than £20], area[riverside], familyFriendly[yes], near[Raja Indian Cuisine]	The Wrestlers restaurant is a family-friendly place that provides Japanese food. It is less than £20 and close to Raja Indian Cuisine.
name[The Wrestlers], eatType[restaurant], food[Japanese], priceRange[moderate], area[city centre], familyFriendly[no], near[Raja Indian Cuisine]	In the city centre area, near Raja Indian Cuisine, is The Wrestlers restaurant, which has moderate Japanese and is not family-friendly.
name[The Wrestlers], eatType[restaurant], food[Japanese], priceRange[moderate], area[city centre], familyFriendly[yes], near[Raja Indian Cuisine]	In the city centre area, near Raja Indian Cuisine, is The Wrestlers restaurant, which has moderate Japanese and is family-friendly.
name[The Wrestlers], eatType[restaurant], food[Japanese], priceRange[moderate], area[riverside], familyFriendly[no], near[Raja Indian Cuisine]	The Wrestlers restaurant is located near Raja Indian Cuisine, in the riverside area. It is moderate and not family-friendly.
name[The Wrestlers], eatType[restaurant], food[Japanese], priceRange[moderate], area[riverside], familyFriendly[yes], near[Raja Indian Cuisine]	Family-friendly and moderate, The Wrestlers restaurant is located near Raja Indian Cuisine, in the riverside area.
name[The Wrestlers], eatType[restaurant], food[Japanese], priceRange[more than £30], area[city centre], familyFriendly[no], near[Raja Indian Cuisine]	In the city centre area, near Raja Indian Cuisine, is The Wrestlers restaurant, which has more than £30 Japanese and is not family-friendly.
name[The Wrestlers], eatType[restaurant], food[Japanese], priceRange[more than £30], area[city centre], familyFriendly[yes], near[Raja Indian Cuisine]	The Wrestlers restaurant is a family-friendly place that provides Japanese food. It is more than £30 and close to Raja Indian Cuisine.
name[The Wrestlers], eatType[restaurant], food[Japanese], priceRange[more than £30], area[riverside], familyFriendly[no], near[Raja Indian Cuisine]	The Wrestlers restaurant is located near Raja Indian Cuisine, in the riverside area. It is more than £30 and not family-friendly.
name[The Wrestlers], eatType[restaurant], food[Japanese], priceRange[more than £30], area[riverside], familyFriendly[yes], near[Raja Indian Cuisine]	In the riverside area, near Raja Indian Cuisine, is The Wrestlers restaurant, which has more than £30 Japanese and is family-friendly.
name[Wildwood], eatType[coffee shop], area[riverside]	Wildwood is a coffee shop located in the riverside.
name[Wildwood], eatType[pub], area[riverside]	There is a pub Wildwood in the riverside area.
name[Wildwood], eatType[pub], food[French], area[riverside], familyFriendly[yes], near[Raja Indian Cuisine]	Wildwood is a family-friendly pub. They serve French food and are located near Raja Indian Cuisine in the riverside area.
name[Wildwood], eatType[pub], food[Indian], area[city centre], familyFriendly[no], near[Raja Indian Cuisine]	Wildwood is a pub providing Indian food. It is located in the city centre area, near Raja Indian Cuisine.
name[Wildwood], eatType[pub], food[Indian], area[city centre], familyFriendly[yes], near[Raja Indian Cuisine]	Wildwood is a pub providing Indian food. It is located in the city centre area, near Raja Indian Cuisine.
name[Wildwood], eatType[pub], food[Indian], area[riverside], familyFriendly[no], near[Raja Indian Cuisine]	Wildwood is a pub serving Indian food. It is not family-friendly. It is based in the riverside area near Raja Indian Cuisine.
name[Wildwood], eatType[pub], food[Indian], area[riverside], familyFriendly[yes], near[Raja Indian Cuisine]	Wildwood is a Indian pub near Raja Indian Cuisine in the riverside area. It is family-friendly.
name[Wildwood], eatType[pub], food[Italian], area[city centre], familyFriendly[no], near[Raja Indian Cuisine]	Wildwood is a non family-friendly Italian pub, just a short distance from Raja Indian Cuisine in the city centre area.
name[Wildwood], eatType[pub], food[Italian], area[city centre], familyFriendly[yes], near[Raja Indian Cuisine]	Wildwood serves Italian food that is kids-friendly. It is in the city centre area near Raja Indian Cuisine.
name[Wildwood], eatType[pub], food[Italian], area[riverside], familyFriendly[no], near[Raja Indian Cuisine]	Italian food is available in a non children-friendly pub called Wildwood, near Raja Indian Cuisine in the riverside area.
name[Wildwood], eatType[pub], food[Italian], area[riverside], familyFriendly[yes], near[Raja Indian Cuisine]	Wildwood is a family-friendly Italian pub, just a short distance from Raja Indian Cuisine in the riverside area.
name[Wildwood], eatType[restaurant], food[French], area[riverside], familyFriendly[yes], near[Raja Indian Cuisine]	Wildwood is a family-friendly restaurant. They serve French food and are located near Raja Indian Cuisine in the riverside area.
name[Wildwood], eatType[restaurant], food[Indian], area[city centre], familyFriendly[no], near[Raja Indian Cuisine]	Wildwood is a restaurant providing Indian food. It is located in the city centre area, near Raja Indian Cuisine.
name[Wildwood], eatType[restaurant], food[Indian], area[city centre], familyFriendly[yes], near[Raja Indian Cuisine]	Wildwood is a restaurant providing Indian food. It is located in the city centre area, near Raja Indian Cuisine.
name[Wildwood], eatType[restaurant], food[Indian], area[riverside], familyFriendly[no], near[Raja Indian Cuisine]	Wildwood is a restaurant serving Indian food. It is not family-friendly. It is based in the riverside area near Raja Indian Cuisine.
name[Wildwood], eatType[restaurant], food[Indian], area[riverside], familyFriendly[yes], near[Raja Indian Cuisine]	Wildwood is a Indian restaurant near Raja Indian Cuisine in the riverside area. It is family-friendly.
name[Wildwood], eatType[restaurant], food[Italian], area[city centre], familyFriendly[no], near[Raja Indian Cuisine]	Wildwood is a non family-friendly Italian restaurant, just a short distance from Raja Indian Cuisine in the city centre area.
name[Wildwood], eatType[restaurant], food[Italian], area[city centre], familyFriendly[yes], near[Raja Indian Cuisine]	Wildwood serves Italian food that is kids-friendly. It is in the city centre area near Raja Indian Cuisine.
name[Wildwood], eatType[restaurant], food[Italian], area[riverside], familyFriendly[no], near[Raja Indian Cuisine]	Italian food is available in a non children-friendly restaurant called Wildwood, near Raja Indian Cuisine in the riverside area.
name[Wildwood], eatType[restaurant], food[Italian], area[riverside], familyFriendly[yes], near[Raja Indian Cuisine]	Wildwood is a family-friendly Italian restaurant, just a short distance from Raja Indian Cuisine in the riverside area.
name[Zizzi], eatType[coffee shop], area[riverside]	In the riverside area, there is a coffee shop called Zizzi.
name[Zizzi], eatType[coffee shop], customer rating[average], near[Burger King]	Near Burger King is Zizzi coffee shop. It has average customer ratings.
name[Zizzi], eatType[coffee shop], customer rating[high], near[Burger King]	Zizzi coffee shop has a high customer rating and is located near Burger King.
name[Zizzi], eatType[coffee shop], near[The Sorrento]	Zizzi is a coffee shop near The Sorrento.
name[Zizzi], eatType[pub], area[riverside]	A pub called Zizzi is located in the riverside area.
name[Zizzi], eatType[pub], customer rating[average], near[Burger King]	Zizzi is a pub located near Burger King with an average customer rating.
name[Zizzi], eatType[pub], customer rating[high], near[Burger King]	There is a high-rated pub called Zizzi located near Burger King.
name[Zizzi], eatType[pub], near[The Sorrento]	Zizzi is a pub located a few steps of The Sorrento.
