MR	output
name[Blue Spice], eatType[coffee shop], area[city centre]	The coffee shop Blue Spice is located in the city centre.
name[Blue Spice], eatType[coffee shop], area[riverside]	The coffee shop Blue Spice is located in the riverside area.
name[Blue Spice], eatType[coffee shop], customer rating[5 out of 5], near[Crowne Plaza Hotel]	The coffee shop Blue Spice is near Crowne Plaza Hotel. It has a customer rating of 5 out of 5.
name[Blue Spice], eatType[coffee shop], customer rating[average], near[Burger King]	The coffee shop Blue Spice is by Burger King. It has an average customer rating.
name[Blue Spice], eatType[coffee shop], customer rating[average], near[Crowne Plaza Hotel]	The coffee shop Blue Spice is located near Crowne Plaza Hotel. It has an average customer rating.
name[Blue Spice], eatType[pub], area[city centre]	The pub Blue Spice is in city centre.
name[Blue Spice], eatType[pub], area[riverside]	The pub Blue Spice is in the riverside area.
name[Blue Spice], eatType[pub], customer rating[5 out of 5], near[Crowne Plaza Hotel]	The pub Blue Spice can be found near Crowne Plaza Hotel. Customers rate it 5 out of 5.
name[Blue Spice], eatType[pub], customer rating[average], near[Burger King]	The pub Blue Spice is near Burger King. It has an average customer rating.
name[Blue Spice], eatType[pub], customer rating[average], near[Crowne Plaza Hotel]	The pub Blue Spice is by Crowne Plaza Hotel. It has an average customer rating.
name[Blue Spice], eatType[pub], food[Chinese], area[city centre], familyFriendly[no], near[Rainbow Vegetarian Café]	Blue Spice, which is located in the city centre near Rainbow Vegetarian Café, is a non-family-friendly pub serving Chinese food.
name[Blue Spice], eatType[pub], food[Chinese], area[city centre], familyFriendly[yes], near[Rainbow Vegetarian Café]	Blue Spice is a family-friendly pub serving Chinese cuisine. It is located in the city centre area and can be found near Rainbow Vegetarian Café.
name[Blue Spice], eatType[pub], food[Chinese], area[riverside], familyFriendly[no], near[Rainbow Vegetarian Café]	Blue Spice, which is in riverside near Rainbow Vegetarian Café, is a non-child-friendly pub offering Chinese food.
name[Blue Spice], eatType[pub], food[Chinese], area[riverside], familyFriendly[yes], near[Rainbow Vegetarian Café]	Blue Spice, which is in the riverside area by Rainbow Vegetarian Café, is a child-friendly pub offering Chinese cuisine.
name[Blue Spice], eatType[pub], food[English], area[city centre], familyFriendly[no], near[Rainbow Vegetarian Café]	Blue Spice, which is located in the city centre near Rainbow Vegetarian Café, is a non-kid-friendly pub serving English food.
name[Blue Spice], eatType[pub], food[English], area[city centre], familyFriendly[yes], near[Rainbow Vegetarian Café]	Blue Spice is a kid-friendly pub serving English cuisine. It is located in the city centre area and can be found near Rainbow Vegetarian Café.
name[Blue Spice], eatType[pub], food[English], area[riverside], familyFriendly[no], near[Rainbow Vegetarian Café]	The pub Blue Spice is in riverside. It offers English food. Blue Spice, which is near Rainbow Vegetarian Café, does not welcome children.
name[Blue Spice], eatType[pub], food[English], area[riverside], familyFriendly[yes], near[Rainbow Vegetarian Café]	The pub Blue Spice is in the riverside area. It offers English cuisine. Blue Spice, which is by Rainbow Vegetarian Café, welcomes children.
name[Blue Spice], eatType[restaurant], food[Chinese], area[city centre], familyFriendly[no], near[Rainbow Vegetarian Café]	The restaurant Blue Spice is located in the city centre near Rainbow Vegetarian Café. It serves Chinese food. Kids are not welcome.
name[Blue Spice], eatType[restaurant], food[Chinese], area[city centre], familyFriendly[yes], near[Rainbow Vegetarian Café]	The restaurant Blue Spice is located in the city centre area. It serves Chinese cuisine. Blue Spice which can be found near Rainbow Vegetarian Café welcomes kids.
name[Blue Spice], eatType[restaurant], food[Chinese], area[riverside], familyFriendly[no], near[Rainbow Vegetarian Café]	Blue Spice, which is in riverside near Rainbow Vegetarian Café, is a non-family-friendly restaurant that offers Chinese food.
name[Blue Spice], eatType[restaurant], food[Chinese], area[riverside], familyFriendly[yes], near[Rainbow Vegetarian Café]	The restaurant Blue Spice is in the riverside area. It offers Chinese cuisine. Blue Spice, which is by Rainbow Vegetarian Café, welcomes families.
name[Blue Spice], eatType[restaurant], food[English], area[city centre], familyFriendly[no], near[Rainbow Vegetarian Café]	Blue Spice, which is located in the city centre near Rainbow Vegetarian Café, is a non-child-friendly restaurant that serves English food.
name[Blue Spice], eatType[restaurant], food[English], area[city centre], familyFriendly[yes], near[Rainbow Vegetarian Café]	Blue Spice is a family-friendly restaurant that serves English cuisine. It is located in the city centre area and can be found near Rainbow Vegetarian Café.
name[Blue Spice], eatType[restaurant], food[English], area[riverside], familyFriendly[no], near[Rainbow Vegetarian Café]	Blue Spice, which is in riverside near Rainbow Vegetarian Café, is a non-kid-friendly restaurant that offers English food.
name[Blue Spice], eatType[restaurant], food[English], area[riverside], familyFriendly[yes], near[Rainbow Vegetarian Café]	Blue Spice, which is in the riverside area by Rainbow Vegetarian Café, is a child-friendly restaurant that offers English cuisine.
name[Clowns], eatType[coffee shop], customer rating[3 out of 5], near[All Bar One]	The coffee shop Clowns is located near All Bar One. It has a customer rating of 3 out of 5.
name[Clowns], eatType[coffee shop], customer rating[5 out of 5], near[Crowne Plaza Hotel]	The coffee shop Clowns can be found near Crowne Plaza Hotel. Customers rate it 5 out of 5.
name[Clowns], eatType[coffee shop], near[The Sorrento]	The coffee shop Clowns is near The Sorrento.
name[Clowns], eatType[pub], customer rating[3 out of 5], near[All Bar One]	The pub Clowns is by All Bar One. It has a customer rating of 3 out of 5.
name[Clowns], eatType[pub], customer rating[5 out of 5], near[Crowne Plaza Hotel]	The pub Clowns is located near Crowne Plaza Hotel. Customers rate it 5 out of 5.
name[Clowns], eatType[pub], near[The Sorrento]	The pub Clowns can be found near The Sorrento.
name[Cocum], eatType[coffee shop], customer rating[high], near[Burger King]	The coffee shop Cocum is near Burger King. It has a high customer rating.
name[Cocum], eatType[coffee shop], customer rating[high], near[Café Sicilia]	The coffee shop Cocum is by Café Sicilia. It has a high customer rating.
name[Cocum], eatType[coffee shop], customer rating[low], near[Café Sicilia]	The coffee shop Cocum is located near Café Sicilia. It has a low customer rating.
name[Cocum], eatType[coffee shop], customer rating[low], near[Express by Holiday Inn]	The coffee shop Cocum can be found near Express by Holiday Inn. It has a low customer rating.
name[Cocum], eatType[coffee shop], near[The Rice Boat]	The coffee shop Cocum is near The Rice Boat.
name[Cocum], eatType[coffee shop], near[The Sorrento]	The coffee shop Cocum is by The Sorrento.
name[Cocum], eatType[pub], customer rating[high], near[Burger King]	The pub Cocum is located near Burger King. It has a high customer rating.
name[Cocum], eatType[pub], customer rating[high], near[Café Sicilia]	The pub Cocum can be found near Café Sicilia. It has a high customer rating.
name[Cocum], eatType[pub], customer rating[low], near[Café Sicilia]	The pub Cocum is near Café Sicilia. It has a low customer rating.
name[Cocum], eatType[pub], customer rating[low], near[Express by Holiday Inn]	The pub Cocum is by Express by Holiday Inn. It has a low customer rating.
name[Cocum], eatType[pub], near[The Rice Boat]	The pub Cocum is located near The Rice Boat.
name[Cocum], eatType[pub], near[The Sorrento]	The pub Cocum can be found near The Sorrento.
name[Cotto], eatType[coffee shop], near[The Bakers]	The coffee shop Cotto is near The Bakers.
name[Cotto], eatType[pub], near[The Bakers]	The pub Cotto is by The Bakers.
name[Giraffe], eatType[coffee shop], near[The Bakers]	The coffee shop Giraffe is located near The Bakers.
name[Giraffe], eatType[coffee shop], near[The Rice Boat]	The coffee shop Giraffe can be found near The Rice Boat.
name[Giraffe], eatType[pub], food[English], area[riverside], familyFriendly[yes], near[Rainbow Vegetarian Café]	Giraffe, which is located in the riverside near Rainbow Vegetarian Café, is a kid-friendly pub that serves English food.
name[Giraffe], eatType[pub], food[Fast food], area[city centre], familyFriendly[no], near[Rainbow Vegetarian Café]	The pub Giraffe is located in the city centre area. It serves fast food. Giraffe, which is by Rainbow Vegetarian Café, does not welcome children.
name[Giraffe], eatType[pub], food[Fast food], area[city centre], familyFriendly[yes], near[Rainbow Vegetarian Café]	The pub Giraffe is in city centre. It offers fast food. Giraffe, which is located near Rainbow Vegetarian Café, welcomes children.
name[Giraffe], eatType[pub], food[Fast food], area[riverside], familyFriendly[no], near[Rainbow Vegetarian Café]	The pub Giraffe is in the riverside area. It offers fast food. Giraffe which can be found near Rainbow Vegetarian Café does not welcome kids.
name[Giraffe], eatType[pub], food[Fast food], area[riverside], familyFriendly[yes], near[Rainbow Vegetarian Café]	The pub Giraffe is located in the riverside. It serves fast food. Giraffe, which is near Rainbow Vegetarian Café, welcomes kids.
name[Giraffe], eatType[pub], food[Fast food], area[riverside], familyFriendly[yes], near[Raja Indian Cuisine]	The pub Giraffe is located in the riverside area. It serves fast food. Giraffe, which is by Raja Indian Cuisine, welcomes families.
name[Giraffe], eatType[pub], food[French], area[city centre], familyFriendly[no], near[Raja Indian Cuisine]	Giraffe is a non-family-friendly pub that offers French food. It is in city centre and is located near Raja Indian Cuisine.
name[Giraffe], eatType[pub], food[French], area[city centre], familyFriendly[yes], near[Raja Indian Cuisine]	Giraffe is a family-friendly pub offering French cuisine. It is in the city centre area and can be found near Raja Indian Cuisine.
name[Giraffe], eatType[pub], food[French], area[riverside], familyFriendly[no], near[Raja Indian Cuisine]	Giraffe, which is located in the riverside near Raja Indian Cuisine, is a non-child-friendly pub that serves French food.
name[Giraffe], eatType[pub], food[French], area[riverside], familyFriendly[yes], near[Raja Indian Cuisine]	Giraffe, which is located in the riverside area by Raja Indian Cuisine, is a child-friendly pub that serves French cuisine.
name[Giraffe], eatType[pub], near[The Bakers]	The pub Giraffe is located near The Bakers.
name[Giraffe], eatType[pub], near[The Rice Boat]	The pub Giraffe can be found near The Rice Boat.
name[Giraffe], eatType[restaurant], food[English], area[riverside], familyFriendly[yes], near[Rainbow Vegetarian Café]	Giraffe, which is in riverside near Rainbow Vegetarian Café, is a kid-friendly restaurant that offers English food.
name[Giraffe], eatType[restaurant], food[Fast food], area[city centre], familyFriendly[no], near[Rainbow Vegetarian Café]	Giraffe, which offers fast food, is a non-kid-friendly restaurant. It is in the city centre area by Rainbow Vegetarian Café.
name[Giraffe], eatType[restaurant], food[Fast food], area[city centre], familyFriendly[yes], near[Rainbow Vegetarian Café]	The restaurant Giraffe is located in the city centre near Rainbow Vegetarian Café. It serves fast food. Children are welcome.
name[Giraffe], eatType[restaurant], food[Fast food], area[riverside], familyFriendly[no], near[Rainbow Vegetarian Café]	The restaurant Giraffe is located in the riverside area. It serves fast food. Giraffe which can be found near Rainbow Vegetarian Café does not welcome children.
name[Giraffe], eatType[restaurant], food[Fast food], area[riverside], familyFriendly[yes], near[Rainbow Vegetarian Café]	The restaurant Giraffe is in riverside. It offers fast food. Giraffe, which is near Rainbow Vegetarian Café, welcomes kids.
name[Giraffe], eatType[restaurant], food[Fast food], area[riverside], familyFriendly[yes], near[Raja Indian Cuisine]	The restaurant Giraffe is in the riverside area. It offers fast food. Giraffe, which is by Raja Indian Cuisine, welcomes families.
name[Giraffe], eatType[restaurant], food[French], area[city centre], familyFriendly[no], near[Raja Indian Cuisine]	The restaurant Giraffe is located in the city centre near Raja Indian Cuisine. It serves French food. Kids are not welcome.
name[Giraffe], eatType[restaurant], food[French], area[city centre], familyFriendly[yes], near[Raja Indian Cuisine]	Giraffe is a family-friendly restaurant serving French cuisine. It is located in the city centre area and can be found near Raja Indian Cuisine.
name[Giraffe], eatType[restaurant], food[French], area[riverside], familyFriendly[no], near[Raja Indian Cuisine]	Giraffe, which is in riverside near Raja Indian Cuisine, is a non-family-friendly restaurant offering French food.
name[Giraffe], eatType[restaurant], food[French], area[riverside], familyFriendly[yes], near[Raja Indian Cuisine]	Giraffe, which is in the riverside area by Raja Indian Cuisine, is a child-friendly restaurant that offers French cuisine.
name[Green Man], eatType[coffee shop], customer rating[1 out of 5], near[All Bar One]	The coffee shop Green Man is located near All Bar One. It has a customer rating of 1 out of 5.
name[Green Man], eatType[coffee shop], customer rating[3 out of 5], near[All Bar One]	The coffee shop Green Man can be found near All Bar One. Customers rate it 3 out of 5.
name[Green Man], eatType[pub], customer rating[1 out of 5], near[All Bar One]	The pub Green Man is near All Bar One. It has a customer rating of 1 out of 5.
name[Green Man], eatType[pub], customer rating[3 out of 5], near[All Bar One]	The pub Green Man is by All Bar One. Customers rate it 3 out of 5.
name[Green Man], eatType[pub], food[Italian], area[riverside], familyFriendly[yes], near[Express by Holiday Inn]	Green Man, which is located in the riverside near Express by Holiday Inn, is a kid-friendly pub that serves Italian food.
name[Green Man], eatType[pub], food[Italian], area[riverside], familyFriendly[yes], near[Raja Indian Cuisine]	The pub Green Man is located in the riverside area. It serves Italian cuisine. Green Man which can be found near Raja Indian Cuisine welcomes children.
name[Green Man], eatType[pub], food[Japanese], area[city centre], familyFriendly[no], near[Express by Holiday Inn]	Green Man, which is in city centre near Express by Holiday Inn, is a non-child-friendly pub that offers Japanese food.
name[Green Man], eatType[pub], food[Japanese], area[city centre], familyFriendly[yes], near[Express by Holiday Inn]	The pub Green Man is in the city centre area. It offers Japanese cuisine. Green Man, which is by Express by Holiday Inn, welcomes kids.
name[Green Man], eatType[pub], food[Japanese], area[riverside], familyFriendly[no], near[Express by Holiday Inn]	Green Man, which is located in the riverside near Express by Holiday Inn, is a non-kid-friendly pub serving Japanese food.
name[Green Man], eatType[pub], food[Japanese], area[riverside], familyFriendly[yes], near[Express by Holiday Inn]	The pub Green Man is located in the riverside area. It serves Japanese cuisine. Green Man which can be found near Express by Holiday Inn welcomes families.
name[Green Man], eatType[restaurant], food[Italian], area[riverside], familyFriendly[yes], near[Express by Holiday Inn]	Green Man, which is in riverside near Express by Holiday Inn, is a family-friendly restaurant offering Italian food.
name[Green Man], eatType[restaurant], food[Italian], area[riverside], familyFriendly[yes], near[Raja Indian Cuisine]	Green Man, which is in the riverside area by Raja Indian Cuisine, is a child-friendly restaurant that offers Italian cuisine.
name[Green Man], eatType[restaurant], food[Japanese], area[city centre], familyFriendly[no], near[Express by Holiday Inn]	The restaurant Green Man is located in the city centre near Express by Holiday Inn. It serves Japanese food. Children are not welcome.
name[Green Man], eatType[restaurant], food[Japanese], area[city centre], familyFriendly[yes], near[Express by Holiday Inn]	Green Man is a kid-friendly restaurant serving Japanese cuisine. It is located in the city centre area and can be found near Express by Holiday Inn.
name[Green Man], eatType[restaurant], food[Japanese], area[riverside], familyFriendly[no], near[Express by Holiday Inn]	The restaurant Green Man is in riverside. It offers Japanese food. Green Man, which is near Express by Holiday Inn, does not welcome kids.
name[Green Man], eatType[restaurant], food[Japanese], area[riverside], familyFriendly[yes], near[Express by Holiday Inn]	The restaurant Green Man is in the riverside area. It offers Japanese cuisine. Green Man, which is by Express by Holiday Inn, welcomes children.
name[Loch Fyne], eatType[coffee shop], area[riverside]	The coffee shop Loch Fyne is located in the riverside.
name[Loch Fyne], eatType[pub], area[riverside]	The pub Loch Fyne is located in the riverside area.
name[Strada], eatType[coffee shop], area[city centre]	The coffee shop Strada is in city centre.
name[Strada], eatType[coffee shop], customer rating[1 out of 5], near[All Bar One]	The coffee shop Strada is located near All Bar One. It has a customer rating of 1 out of 5.
name[Strada], eatType[coffee shop], customer rating[1 out of 5], near[Rainbow Vegetarian Café]	The coffee shop Strada can be found near Rainbow Vegetarian Café. Customers rate it 1 out of 5.
name[Strada], eatType[coffee shop], customer rating[low], near[Express by Holiday Inn]	The coffee shop Strada is near Express by Holiday Inn. It has a low customer rating.
name[Strada], eatType[pub], area[city centre]	The pub Strada is in the city centre area.
name[Strada], eatType[pub], customer rating[1 out of 5], near[All Bar One]	The pub Strada is by All Bar One. It has a customer rating of 1 out of 5.
name[Strada], eatType[pub], customer rating[1 out of 5], near[Rainbow Vegetarian Café]	The pub Strada is located near Rainbow Vegetarian Café. Customers rate it 1 out of 5.
name[Strada], eatType[pub], customer rating[low], near[Express by Holiday Inn]	The pub Strada can be found near Express by Holiday Inn. It has a low customer rating.
name[The Cricketers], eatType[coffee shop], customer rating[1 out of 5], familyFriendly[yes], near[Avalon]	The coffee shop The Cricketers is near Avalon. The Cricketers, which welcomes kids, has a customer rating of 1 out of 5.
name[The Cricketers], eatType[coffee shop], customer rating[3 out of 5], familyFriendly[yes], near[Avalon]	The coffee shop The Cricketers is by Avalon. Customers rate The Cricketers, which welcomes families, 3 out of 5.
name[The Cricketers], eatType[coffee shop], customer rating[3 out of 5], familyFriendly[yes], near[Crowne Plaza Hotel]	The Cricketers, which has a customer rating of 3 out of 5, is a family-friendly coffee shop. It is located near Crowne Plaza Hotel.
name[The Cricketers], eatType[coffee shop], customer rating[5 out of 5], familyFriendly[no], near[Crowne Plaza Hotel]	The Cricketers, which customers rate 5 out of 5, is a non-family-friendly coffee shop. It can be found near Crowne Plaza Hotel.
name[The Cricketers], eatType[coffee shop], customer rating[5 out of 5], familyFriendly[yes], near[Crowne Plaza Hotel]	The Cricketers, which has a customer rating of 5 out of 5, is a child-friendly coffee shop. It is near Crowne Plaza Hotel.
name[The Cricketers], eatType[coffee shop], customer rating[average], familyFriendly[no], near[Café Sicilia]	The Cricketers, which has an average customer rating, is a non-child-friendly coffee shop. It is by Café Sicilia.
name[The Cricketers], eatType[coffee shop], customer rating[average], familyFriendly[no], near[Crowne Plaza Hotel]	The Cricketers, which has an average customer rating, is a non-kid-friendly coffee shop. It is located near Crowne Plaza Hotel.
name[The Cricketers], eatType[coffee shop], customer rating[average], familyFriendly[yes], near[Café Sicilia]	The Cricketers, which has an average customer rating, is a kid-friendly coffee shop. It can be found near Café Sicilia.
name[The Cricketers], eatType[coffee shop], customer rating[high], familyFriendly[yes], near[Café Sicilia]	The coffee shop The Cricketers is near Café Sicilia. The Cricketers, which welcomes children, has a high customer rating.
name[The Cricketers], eatType[coffee shop], customer rating[high], familyFriendly[yes], near[Express by Holiday Inn]	The coffee shop The Cricketers is by Express by Holiday Inn. The Cricketers, which welcomes kids, has a high customer rating.
name[The Cricketers], eatType[coffee shop], customer rating[low], familyFriendly[no], near[Express by Holiday Inn]	The coffee shop The Cricketers is located near Express by Holiday Inn. The Cricketers, which does not welcome children, has a low customer rating.
name[The Cricketers], eatType[coffee shop], customer rating[low], familyFriendly[no], near[Ranch]	The coffee shop The Cricketers can be found near Ranch. The Cricketers, which does not welcome kids, has a low customer rating.
name[The Cricketers], eatType[coffee shop], customer rating[low], familyFriendly[yes], near[Ranch]	The coffee shop The Cricketers is near Ranch. The Cricketers, which welcomes families, has a low customer rating.
name[The Cricketers], eatType[restaurant], customer rating[1 out of 5], familyFriendly[yes], near[Avalon]	The Cricketers, which customers rate 1 out of 5, is a family-friendly restaurant. It is by Avalon.
name[The Cricketers], eatType[restaurant], customer rating[3 out of 5], familyFriendly[yes], near[Avalon]	The Cricketers, which has a customer rating of 3 out of 5, is a child-friendly restaurant. It is located near Avalon.
name[The Cricketers], eatType[restaurant], customer rating[3 out of 5], familyFriendly[yes], near[Crowne Plaza Hotel]	The Cricketers, which customers rate 3 out of 5, is a kid-friendly restaurant. It can be found near Crowne Plaza Hotel.
name[The Cricketers], eatType[restaurant], customer rating[5 out of 5], familyFriendly[no], near[Crowne Plaza Hotel]	The Cricketers, which has a customer rating of 5 out of 5, is a non-family-friendly restaurant. It is near Crowne Plaza Hotel.
name[The Cricketers], eatType[restaurant], customer rating[5 out of 5], familyFriendly[yes], near[Crowne Plaza Hotel]	The restaurant The Cricketers is by Crowne Plaza Hotel. Customers rate The Cricketers, which welcomes children, 5 out of 5.
name[The Cricketers], eatType[restaurant], customer rating[average], familyFriendly[no], near[Café Sicilia]	The Cricketers, which has an average customer rating, is a non-child-friendly restaurant. It is located near Café Sicilia.
name[The Cricketers], eatType[restaurant], customer rating[average], familyFriendly[no], near[Crowne Plaza Hotel]	The Cricketers, which has an average customer rating, is a non-kid-friendly restaurant. It can be found near Crowne Plaza Hotel.
name[The Cricketers], eatType[restaurant], customer rating[average], familyFriendly[yes], near[Café Sicilia]	The restaurant The Cricketers is near Café Sicilia. The Cricketers, which welcomes kids, has an average customer rating.
name[The Cricketers], eatType[restaurant], customer rating[high], familyFriendly[yes], near[Café Sicilia]	The restaurant The Cricketers is by Café Sicilia. The Cricketers, which welcomes families, has a high customer rating.
name[The Cricketers], eatType[restaurant], customer rating[high], familyFriendly[yes], near[Express by Holiday Inn]	The Cricketers, which has a high customer rating, is a family-friendly restaurant. It is located near Express by Holiday Inn.
name[The Cricketers], eatType[restaurant], customer rating[low], familyFriendly[no], near[Express by Holiday Inn]	The restaurant The Cricketers can be found near Express by Holiday Inn. The Cricketers, which does not welcome children, has a low customer rating.
name[The Cricketers], eatType[restaurant], customer rating[low], familyFriendly[no], near[Ranch]	The restaurant The Cricketers is near Ranch. The Cricketers, which does not welcome kids, has a low customer rating.
name[The Cricketers], eatType[restaurant], customer rating[low], familyFriendly[yes], near[Ranch]	The Cricketers, which has a low customer rating, is a child-friendly restaurant. It is by Ranch.
name[The Cricketers], eatType[restaurant], food[Chinese], priceRange[£20-25], customer rating[high], area[city centre], familyFriendly[no], near[All Bar One]	The Cricketers, which has a high customer rating, is a mid-priced restaurant serving Chinese food. Non-family-friendly The Cricketers is located in the city centre near All Bar One.
name[The Cricketers], eatType[restaurant], food[Chinese], priceRange[£20-25], customer rating[high], area[city centre], familyFriendly[yes], near[All Bar One]	The Cricketers, which has a high customer rating, is an average-priced restaurant that serves Chinese cuisine. It is located in the city centre area and can be found near All Bar One. It is kid-friendly.
name[The Cricketers], eatType[restaurant], food[Chinese], priceRange[£20-25], customer rating[high], area[riverside], familyFriendly[no], near[All Bar One]	Moderately priced The Cricketers is a restaurant offering Chinese food. It has a high customer rating. It is in riverside near All Bar One. It is not child-friendly.
name[The Cricketers], eatType[restaurant], food[Chinese], priceRange[£20-25], customer rating[high], area[riverside], familyFriendly[yes], near[All Bar One]	The Cricketers, which has a high customer rating, is a mid-priced restaurant that offers Chinese cuisine. It is in the riverside area by All Bar One. Children are welcome.
name[The Cricketers], eatType[restaurant], food[Chinese], priceRange[cheap], customer rating[5 out of 5], area[city centre], familyFriendly[no], near[All Bar One]	The Cricketers, which has a customer rating of 5 out of 5, is a cheap restaurant that serves Chinese food. Non-kid-friendly The Cricketers is located in the city centre near All Bar One.
name[The Cricketers], eatType[restaurant], food[Chinese], priceRange[cheap], customer rating[5 out of 5], area[city centre], familyFriendly[yes], near[All Bar One]	The Cricketers, which customers rate 5 out of 5, is a low-priced restaurant serving Chinese cuisine. It is located in the city centre area and can be found near All Bar One. Kids are welcome.
name[The Cricketers], eatType[restaurant], food[Chinese], priceRange[cheap], customer rating[5 out of 5], area[riverside], familyFriendly[no], near[All Bar One]	The Cricketers, which has a customer rating of 5 out of 5, is a cheap restaurant that offers Chinese food. It is in riverside near All Bar One. Children are not welcome.
name[The Cricketers], eatType[restaurant], food[Chinese], priceRange[cheap], customer rating[5 out of 5], area[riverside], familyFriendly[yes], near[All Bar One]	The Cricketers, which customers rate 5 out of 5, is a low-priced restaurant offering Chinese cuisine. It is in the riverside area by All Bar One. Families are welcome.
name[The Cricketers], eatType[restaurant], food[Chinese], priceRange[cheap], customer rating[average], area[city centre], familyFriendly[no], near[All Bar One]	The Cricketers, which has an average customer rating, is a cheap restaurant serving Chinese food. The Cricketers, which does not welcome kids, is located in the city centre near All Bar One.
name[The Cricketers], eatType[restaurant], food[Chinese], priceRange[cheap], customer rating[average], area[city centre], familyFriendly[yes], near[All Bar One]	The Cricketers, which has an average customer rating, is a low-priced restaurant serving Chinese cuisine. It is located in the city centre area and can be found near All Bar One. It is family-friendly.
name[The Cricketers], eatType[restaurant], food[Chinese], priceRange[cheap], customer rating[average], area[riverside], familyFriendly[no], near[All Bar One]	The Cricketers, which has an average customer rating, is a cheap restaurant offering Chinese food. It is in riverside near All Bar One. It is not family-friendly.
name[The Cricketers], eatType[restaurant], food[Chinese], priceRange[cheap], customer rating[average], area[riverside], familyFriendly[yes], near[All Bar One]	The Cricketers, which has an average customer rating, is a low-priced restaurant offering Chinese cuisine. It is in the riverside area by All Bar One. It is child-friendly.
name[The Cricketers], eatType[restaurant], food[Chinese], priceRange[high], customer rating[1 out of 5], area[city centre], familyFriendly[no], near[All Bar One]	The Cricketers, which has a customer rating of 1 out of 5, is an expensive restaurant that serves Chinese food. Non-child-friendly The Cricketers is located in the city centre near All Bar One.
name[The Cricketers], eatType[restaurant], food[Chinese], priceRange[high], customer rating[1 out of 5], area[city centre], familyFriendly[yes], near[All Bar One]	The Cricketers, which customers rate 1 out of 5, is a high-priced restaurant serving Chinese cuisine. It is located in the city centre area and can be found near All Bar One. It is kid-friendly.
name[The Cricketers], eatType[restaurant], food[Chinese], priceRange[high], customer rating[1 out of 5], area[riverside], familyFriendly[no], near[All Bar One]	The Cricketers, which has a customer rating of 1 out of 5, is an expensive restaurant offering Chinese food. It is in riverside near All Bar One. It is not kid-friendly.
name[The Cricketers], eatType[restaurant], food[Chinese], priceRange[high], customer rating[1 out of 5], area[riverside], familyFriendly[yes], near[All Bar One]	The Cricketers, which customers rate 1 out of 5, is a high-priced restaurant that offers Chinese cuisine. It is in the riverside area by All Bar One. Children are welcome.
name[The Cricketers], eatType[restaurant], food[Chinese], priceRange[high], customer rating[average], area[city centre], familyFriendly[no], near[All Bar One]	The Cricketers, which has an average customer rating, is an expensive restaurant serving Chinese food. The Cricketers, which does not welcome children, is located in the city centre near All Bar One.
name[The Cricketers], eatType[restaurant], food[Chinese], priceRange[high], customer rating[average], area[city centre], familyFriendly[yes], near[All Bar One]	The Cricketers, which has an average customer rating, is a high-priced restaurant serving Chinese cuisine. It is located in the city centre area and can be found near All Bar One. Kids are welcome.
name[The Cricketers], eatType[restaurant], food[Chinese], priceRange[high], customer rating[average], area[riverside], familyFriendly[no], near[All Bar One]	The Cricketers, which has an average customer rating, is an expensive restaurant offering Chinese food. It is in riverside near All Bar One. Kids are not welcome.
name[The Cricketers], eatType[restaurant], food[Chinese], priceRange[high], customer rating[average], area[riverside], familyFriendly[yes], near[All Bar One]	The Cricketers, which has an average customer rating, is a high-priced restaurant that offers Chinese cuisine. It is in the riverside area by All Bar One. Families are welcome.
name[The Cricketers], eatType[restaurant], food[Chinese], priceRange[less than £20], customer rating[low], area[city centre], familyFriendly[no], near[All Bar One]	The Cricketers, which has a low customer rating, is a cheap restaurant that serves Chinese food. Non-family-friendly The Cricketers is located in the city centre near All Bar One.
name[The Cricketers], eatType[restaurant], food[Chinese], priceRange[less than £20], customer rating[low], area[city centre], familyFriendly[yes], near[All Bar One]	The Cricketers, which has a low customer rating, is a low-priced restaurant that serves Chinese cuisine. It is located in the city centre area and can be found near All Bar One. It is family-friendly.
name[The Cricketers], eatType[restaurant], food[Chinese], priceRange[less than £20], customer rating[low], area[riverside], familyFriendly[no], near[All Bar One]	The Cricketers, which has a low customer rating, is a cheap restaurant offering Chinese food. It is in riverside near All Bar One. It is not child-friendly.
name[The Cricketers], eatType[restaurant], food[Chinese], priceRange[less than £20], customer rating[low], area[riverside], familyFriendly[yes], near[All Bar One]	The Cricketers, which has a low customer rating, is a low-priced restaurant offering Chinese cuisine. It is in the riverside area by All Bar One. It is child-friendly.
name[The Cricketers], eatType[restaurant], food[Chinese], priceRange[moderate], customer rating[1 out of 5], area[city centre], familyFriendly[no], near[All Bar One]	The Cricketers, which has a customer rating of 1 out of 5, is an average-priced restaurant that serves Chinese food. Non-kid-friendly The Cricketers is located in the city centre near All Bar One.
name[The Cricketers], eatType[restaurant], food[Chinese], priceRange[moderate], customer rating[1 out of 5], area[city centre], familyFriendly[yes], near[All Bar One]	Moderately priced The Cricketers is a restaurant serving Chinese cuisine. Customers rate kid-friendly The Cricketers 1 out of 5. It is located in the city centre area and can be found near All Bar One.
name[The Cricketers], eatType[restaurant], food[Chinese], priceRange[moderate], customer rating[1 out of 5], area[riverside], familyFriendly[no], near[All Bar One]	The Cricketers, which has a customer rating of 1 out of 5, is a mid-priced restaurant that offers Chinese food. It is in riverside near All Bar One. Children are not welcome.
name[The Cricketers], eatType[restaurant], food[Chinese], priceRange[moderate], customer rating[1 out of 5], area[riverside], familyFriendly[yes], near[All Bar One]	The Cricketers, which customers rate 1 out of 5, is an average-priced restaurant offering Chinese cuisine. It is in the riverside area by All Bar One. Children are welcome.
name[The Cricketers], eatType[restaurant], food[Chinese], priceRange[moderate], customer rating[3 out of 5], area[city centre], familyFriendly[no], near[All Bar One]	Moderately priced The Cricketers is a restaurant serving Chinese food. It has a customer rating of 3 out of 5. The Cricketers, which does not welcome kids, is located in the city centre near All Bar One.
name[The Cricketers], eatType[restaurant], food[Chinese], priceRange[moderate], customer rating[3 out of 5], area[city centre], familyFriendly[yes], near[All Bar One]	The Cricketers, which customers rate 3 out of 5, is a mid-priced restaurant serving Chinese cuisine. It is located in the city centre area and can be found near All Bar One. Kids are welcome.
name[The Cricketers], eatType[restaurant], food[Chinese], priceRange[moderate], customer rating[3 out of 5], area[riverside], familyFriendly[no], near[All Bar One]	The Cricketers, which has a customer rating of 3 out of 5, is an average-priced restaurant offering Chinese food. It is in riverside near All Bar One. It is not family-friendly.
name[The Cricketers], eatType[restaurant], food[Chinese], priceRange[moderate], customer rating[3 out of 5], area[riverside], familyFriendly[yes], near[All Bar One]	Moderately priced The Cricketers is a restaurant that offers Chinese cuisine. Customers rate The Cricketers, which is in the riverside area by All Bar One, 3 out of 5. Families are welcome.
name[The Cricketers], eatType[restaurant], food[Chinese], priceRange[more than £30], customer rating[high], area[city centre], familyFriendly[no], near[All Bar One]	The Cricketers, which has a high customer rating, is an expensive restaurant that serves Chinese food. Non-child-friendly The Cricketers is located in the city centre near All Bar One.
name[The Cricketers], eatType[restaurant], food[Chinese], priceRange[more than £30], customer rating[high], area[city centre], familyFriendly[yes], near[All Bar One]	The Cricketers, which has a high customer rating, is a high-priced restaurant serving Chinese cuisine. It is located in the city centre area and can be found near All Bar One. It is family-friendly.
name[The Cricketers], eatType[restaurant], food[Chinese], priceRange[more than £30], customer rating[high], area[riverside], familyFriendly[no], near[All Bar One]	The Cricketers, which has a high customer rating, is an expensive restaurant that offers Chinese food. It is in riverside near All Bar One. It is not kid-friendly.
name[The Cricketers], eatType[restaurant], food[Chinese], priceRange[more than £30], customer rating[high], area[riverside], familyFriendly[yes], near[All Bar One]	The Cricketers, which has a high customer rating, is a high-priced restaurant offering Chinese cuisine. It is in the riverside area by All Bar One. It is child-friendly.
name[The Cricketers], eatType[restaurant], food[English], priceRange[£20-25], customer rating[high], area[city centre], familyFriendly[no], near[All Bar One]	The Cricketers, which has a high customer rating, is a mid-priced restaurant serving English food. The Cricketers, which does not welcome children, is located in the city centre near All Bar One.
name[The Cricketers], eatType[restaurant], food[English], priceRange[£20-25], customer rating[high], area[city centre], familyFriendly[yes], near[All Bar One]	The Cricketers, which has a high customer rating, is an average-priced restaurant that serves English cuisine. It is located in the city centre area and can be found near All Bar One. It is kid-friendly.
name[The Cricketers], eatType[restaurant], food[English], priceRange[£20-25], customer rating[high], area[riverside], familyFriendly[no], near[All Bar One]	Moderately priced The Cricketers is a restaurant offering English food. It has a high customer rating. It is in riverside near All Bar One. Kids are not welcome.
name[The Cricketers], eatType[restaurant], food[English], priceRange[£20-25], customer rating[high], area[riverside], familyFriendly[yes], near[All Bar One]	The Cricketers, which has a high customer rating, is a mid-priced restaurant that offers English cuisine. It is in the riverside area by All Bar One. Children are welcome.
name[The Cricketers], eatType[restaurant], food[English], priceRange[cheap], customer rating[5 out of 5], area[city centre], familyFriendly[no], near[Café Rouge]	The Cricketers, which has a customer rating of 5 out of 5, is a cheap restaurant that serves English food. Non-family-friendly The Cricketers is located in the city centre near Café Rouge.
name[The Cricketers], eatType[restaurant], food[English], priceRange[cheap], customer rating[5 out of 5], area[city centre], familyFriendly[yes], near[Café Rouge]	The Cricketers, which customers rate 5 out of 5, is a low-priced restaurant serving English cuisine. It is located in the city centre area and can be found near Café Rouge. Kids are welcome.
name[The Cricketers], eatType[restaurant], food[English], priceRange[cheap], customer rating[5 out of 5], area[riverside], familyFriendly[no], near[Café Rouge]	The Cricketers, which has a customer rating of 5 out of 5, is a cheap restaurant offering English food. It is in riverside near Café Rouge. It is not child-friendly.
name[The Cricketers], eatType[restaurant], food[English], priceRange[cheap], customer rating[5 out of 5], area[riverside], familyFriendly[yes], near[Café Rouge]	The Cricketers, which customers rate 5 out of 5, is a low-priced restaurant that offers English cuisine. It is in the riverside area by Café Rouge. Families are welcome.
name[The Cricketers], eatType[restaurant], food[English], priceRange[cheap], customer rating[average], area[city centre], familyFriendly[no], near[Café Rouge]	The Cricketers, which has an average customer rating, is a cheap restaurant that serves English food. Non-kid-friendly The Cricketers is located in the city centre near Café Rouge.
name[The Cricketers], eatType[restaurant], food[English], priceRange[cheap], customer rating[average], area[city centre], familyFriendly[yes], near[Café Rouge]	The Cricketers, which has an average customer rating, is a low-priced restaurant that serves English cuisine. It is located in the city centre area and can be found near Café Rouge. It is family-friendly.
name[The Cricketers], eatType[restaurant], food[English], priceRange[cheap], customer rating[average], area[riverside], familyFriendly[no], near[Café Rouge]	The Cricketers, which has an average customer rating, is a cheap restaurant offering English food. It is in riverside near Café Rouge. Children are not welcome.
name[The Cricketers], eatType[restaurant], food[English], priceRange[cheap], customer rating[average], area[riverside], familyFriendly[yes], near[Café Rouge]	The Cricketers, which has an average customer rating, is a low-priced restaurant offering English cuisine. It is in the riverside area by Café Rouge. It is child-friendly.
name[The Cricketers], eatType[restaurant], food[English], priceRange[high], customer rating[1 out of 5], area[city centre], familyFriendly[no], near[Café Rouge]	The Cricketers, which has a customer rating of 1 out of 5, is an expensive restaurant serving English food. The Cricketers, which does not welcome kids, is located in the city centre near Café Rouge.
name[The Cricketers], eatType[restaurant], food[English], priceRange[high], customer rating[1 out of 5], area[city centre], familyFriendly[yes], near[Café Rouge]	The Cricketers, which customers rate 1 out of 5, is a high-priced restaurant that serves English cuisine. It is located in the city centre area and can be found near Café Rouge. It is kid-friendly.
name[The Cricketers], eatType[restaurant], food[English], priceRange[high], customer rating[1 out of 5], area[riverside], familyFriendly[no], near[Café Rouge]	The Cricketers, which has a customer rating of 1 out of 5, is an expensive restaurant that offers English food. It is in riverside near Café Rouge. It is not family-friendly.
name[The Cricketers], eatType[restaurant], food[English], priceRange[high], customer rating[1 out of 5], area[riverside], familyFriendly[yes], near[Café Rouge]	The Cricketers, which customers rate 1 out of 5, is a high-priced restaurant offering English cuisine. It is in the riverside area by Café Rouge. Children are welcome.
name[The Cricketers], eatType[restaurant], food[English], priceRange[high], customer rating[average], area[city centre], familyFriendly[no], near[Café Rouge]	The Cricketers, which has an average customer rating, is an expensive restaurant serving English food. Non-child-friendly The Cricketers is located in the city centre near Café Rouge.
name[The Cricketers], eatType[restaurant], food[English], priceRange[high], customer rating[average], area[city centre], familyFriendly[yes], near[Café Rouge]	The Cricketers, which has an average customer rating, is a high-priced restaurant that serves English cuisine. It is located in the city centre area and can be found near Café Rouge. Kids are welcome.
name[The Cricketers], eatType[restaurant], food[English], priceRange[high], customer rating[average], area[riverside], familyFriendly[no], near[Café Rouge]	The Cricketers, which has an average customer rating, is an expensive restaurant offering English food. It is in riverside near Café Rouge. It is not kid-friendly.
name[The Mill], eatType[pub], food[English], priceRange[high], area[riverside], familyFriendly[yes], near[Raja Indian Cuisine]	The Mill, which is in the riverside area by Raja Indian Cuisine, is a high-priced pub offering English cuisine. Families are welcome.
name[The Mill], eatType[pub], food[English], priceRange[less than £20], area[city centre], familyFriendly[no], near[Raja Indian Cuisine]	The Mill, which is located in the city centre near Raja Indian Cuisine, is a cheap pub serving English food. Children are not welcome.
name[The Mill], eatType[pub], food[English], priceRange[less than £20], area[city centre], familyFriendly[yes], near[Raja Indian Cuisine]	Family-friendly The Mill is a low-priced pub serving English cuisine. It is located in the city centre area and can be found near Raja Indian Cuisine.
name[The Mill], eatType[pub], food[English], priceRange[less than £20], area[riverside], familyFriendly[no], near[Raja Indian Cuisine]	The Mill, which is in riverside near Raja Indian Cuisine, is a cheap pub that offers English food. Kids are not welcome.
name[The Mill], eatType[pub], food[English], priceRange[less than £20], area[riverside], familyFriendly[yes], near[Raja Indian Cuisine]	The Mill, which is in the riverside area by Raja Indian Cuisine, is a low-priced pub offering English cuisine. It is child-friendly.
name[The Mill], eatType[pub], food[English], priceRange[moderate], area[city centre], familyFriendly[no], near[Raja Indian Cuisine]	The Mill, which is located in the city centre near Raja Indian Cuisine, is an average-priced pub serving English food. It is not family-friendly.
name[The Mill], eatType[pub], food[English], priceRange[moderate], area[city centre], familyFriendly[yes], near[Raja Indian Cuisine]	Moderately priced The Mill is a pub serving English cuisine. It is located in the city centre area and can be found near Raja Indian Cuisine. It is kid-friendly.
name[The Mill], eatType[pub], food[English], priceRange[moderate], area[riverside], familyFriendly[no], near[Raja Indian Cuisine]	The Mill, which is in riverside near Raja Indian Cuisine, is a mid-priced pub that offers English food. It is not child-friendly.
name[The Mill], eatType[pub], food[English], priceRange[moderate], area[riverside], familyFriendly[yes], near[Raja Indian Cuisine]	The Mill, which is in the riverside area by Raja Indian Cuisine, is an average-priced pub that offers English cuisine. Children are welcome.
name[The Mill], eatType[pub], food[English], priceRange[more than £30], area[riverside], familyFriendly[yes], near[Raja Indian Cuisine]	The Mill, which is located in the riverside near Raja Indian Cuisine, is an expensive pub that serves English food. Kids are welcome.
name[The Mill], eatType[pub], food[Fast food], priceRange[£20-25], area[riverside], familyFriendly[yes], near[Raja Indian Cuisine]	The Mill, which serves fast food, is a pub. It is moderately priced. It is located in the riverside area and can be found near Raja Indian Cuisine. Families are welcome.
name[The Mill], eatType[pub], food[Fast food], priceRange[£20-25], customer rating[high], area[city centre], familyFriendly[no], near[Café Rouge]	The Mill, which offers fast food, is a mid-priced pub. It has a high customer rating. It is in city centre near Café Rouge. It is not kid-friendly.
name[The Mill], eatType[pub], food[Fast food], priceRange[£20-25], customer rating[high], area[city centre], familyFriendly[yes], near[Café Rouge]	The Mill, which offers fast food, is an average-priced pub. It has a high customer rating. It is in the city centre area by Café Rouge. It is family-friendly.
name[The Mill], eatType[pub], food[Fast food], priceRange[£20-25], customer rating[high], area[riverside], familyFriendly[no], near[Café Rouge]	The Mill, which serves fast food, is a pub. It is moderately priced. It has a high customer rating. The Mill, which does not welcome children, is located in the riverside near Café Rouge.
name[The Mill], eatType[pub], food[Fast food], priceRange[£20-25], customer rating[high], area[riverside], familyFriendly[yes], near[Café Rouge]	The Mill, which serves fast food, is a mid-priced pub. It has a high customer rating. It is located in the riverside area and can be found near Café Rouge. It is child-friendly.
name[The Mill], eatType[pub], food[Fast food], priceRange[£20-25], customer rating[high], area[riverside], familyFriendly[yes], near[Café Sicilia]	The Mill, which offers fast food, is an average-priced pub. It has a high customer rating. It is in riverside near Café Sicilia. It is kid-friendly.
name[The Mill], eatType[pub], food[Fast food], priceRange[cheap], area[riverside], familyFriendly[yes], near[Raja Indian Cuisine]	The Mill, which offers fast food, is a cheap pub. It is in the riverside area by Raja Indian Cuisine. Children are welcome.
name[The Mill], eatType[pub], food[Fast food], priceRange[cheap], customer rating[5 out of 5], area[city centre], familyFriendly[no], near[Café Sicilia]	The Mill, which serves fast food, is a low-priced pub. It has a customer rating of 5 out of 5. The Mill, which does not welcome kids, is located in the city centre near Café Sicilia.
name[The Mill], eatType[pub], food[Fast food], priceRange[cheap], customer rating[5 out of 5], area[city centre], familyFriendly[yes], near[Café Sicilia]	The Mill, which serves fast food, is a cheap pub. Customers rate The Mill, which welcomes kids, 5 out of 5. It is located in the city centre area and can be found near Café Sicilia.
name[The Mill], eatType[pub], food[Fast food], priceRange[cheap], customer rating[5 out of 5], area[riverside], familyFriendly[no], near[Café Sicilia]	The Mill, which offers fast food, is a low-priced pub. It has a customer rating of 5 out of 5. It is in riverside near Café Sicilia. It is not family-friendly.
name[The Mill], eatType[pub], food[Fast food], priceRange[cheap], customer rating[5 out of 5], area[riverside], familyFriendly[yes], near[Café Sicilia]	The Mill, which offers fast food, is a cheap pub. Customers rate The Mill, which is in the riverside area by Café Sicilia, 5 out of 5. Families are welcome.
name[The Mill], eatType[pub], food[Fast food], priceRange[cheap], customer rating[average], area[city centre], familyFriendly[no], near[Café Sicilia]	The Mill, which serves fast food, is a low-priced pub. It has an average customer rating. Non-child-friendly The Mill is located in the city centre near Café Sicilia.
name[The Mill], eatType[pub], food[Fast food], priceRange[cheap], customer rating[average], area[city centre], familyFriendly[yes], near[Café Sicilia]	The Mill, which serves fast food, is a cheap pub. It has an average customer rating. It is located in the city centre area and can be found near Café Sicilia. It is family-friendly.
name[The Mill], eatType[pub], food[Fast food], priceRange[cheap], customer rating[average], area[riverside], familyFriendly[no], near[Café Sicilia]	The Mill, which offers fast food, is a low-priced pub. It has an average customer rating. It is in riverside near Café Sicilia. It is not kid-friendly.
name[The Mill], eatType[pub], food[Fast food], priceRange[cheap], customer rating[average], area[riverside], familyFriendly[yes], near[Café Sicilia]	The Mill, which offers fast food, is a cheap pub. It has an average customer rating. It is in the riverside area by Café Sicilia. It is child-friendly.
name[The Mill], eatType[pub], food[Fast food], priceRange[high], customer rating[1 out of 5], area[city centre], familyFriendly[no], near[Café Sicilia]	The Mill, which serves fast food, is a high-priced pub. It has a customer rating of 1 out of 5. The Mill, which does not welcome children, is located in the city centre near Café Sicilia.
name[The Mill], eatType[pub], food[Fast food], priceRange[high], customer rating[1 out of 5], area[city centre], familyFriendly[yes], near[Café Sicilia]	The Mill, which serves fast food, is an expensive pub. Customers rate kid-friendly The Mill 1 out of 5. It is located in the city centre area and can be found near Café Sicilia.
name[The Mill], eatType[pub], food[Fast food], priceRange[high], customer rating[1 out of 5], area[riverside], familyFriendly[no], near[Café Sicilia]	The Mill, which offers fast food, is a high-priced pub. It has a customer rating of 1 out of 5. It is in riverside near Café Sicilia. Kids are not welcome.
name[The Mill], eatType[pub], food[Fast food], priceRange[high], customer rating[1 out of 5], area[riverside], familyFriendly[yes], near[Café Sicilia]	The Mill, which offers fast food, is an expensive pub. Customers rate The Mill, which is in the riverside area by Café Sicilia, 1 out of 5. Children are welcome.
name[The Mill], eatType[pub], food[Fast food], priceRange[high], customer rating[average], area[city centre], familyFriendly[no], near[Café Sicilia]	The Mill, which serves fast food, is a high-priced pub. It has an average customer rating. Non-family-friendly The Mill is located in the city centre near Café Sicilia.
name[The Mill], eatType[pub], food[Fast food], priceRange[high], customer rating[average], area[city centre], familyFriendly[yes], near[Café Sicilia]	The Mill, which serves fast food, is an expensive pub. It has an average customer rating. It is located in the city centre area and can be found near Café Sicilia. Kids are welcome.
name[The Mill], eatType[pub], food[Fast food], priceRange[high], customer rating[average], area[riverside], familyFriendly[no], near[Café Sicilia]	The Mill, which offers fast food, is a high-priced pub. It has an average customer rating. It is in riverside near Café Sicilia. It is not child-friendly.
name[The Mill], eatType[pub], food[Fast food], priceRange[high], customer rating[average], area[riverside], familyFriendly[yes], near[Café Sicilia]	The Mill, which offers fast food, is an expensive pub. It has an average customer rating. It is in the riverside area by Café Sicilia. Families are welcome.
name[The Mill], eatType[pub], food[Fast food], priceRange[less than £20], customer rating[low], area[city centre], familyFriendly[no], near[Café Sicilia]	The Mill, which serves fast food, is a low-priced pub. It has a low customer rating. Non-kid-friendly The Mill is located in the city centre near Café Sicilia.
name[The Mill], eatType[pub], food[Fast food], priceRange[less than £20], customer rating[low], area[city centre], familyFriendly[yes], near[Café Sicilia]	The Mill, which serves fast food, is a cheap pub. It has a low customer rating. It is located in the city centre area and can be found near Café Sicilia. It is family-friendly.
name[The Mill], eatType[pub], food[Fast food], priceRange[less than £20], customer rating[low], area[riverside], familyFriendly[no], near[Café Sicilia]	The Mill, which offers fast food, is a low-priced pub. It has a low customer rating. It is in riverside near Café Sicilia. Children are not welcome.
name[The Mill], eatType[pub], food[Fast food], priceRange[less than £20], customer rating[low], area[riverside], familyFriendly[yes], near[Café Sicilia]	The Mill, which offers fast food, is a cheap pub. It has a low customer rating. It is in the riverside area by Café Sicilia. It is child-friendly.
name[The Mill], eatType[pub], food[Fast food], priceRange[moderate], customer rating[1 out of 5], area[city centre], familyFriendly[no], near[Café Sicilia]	The Mill, which serves fast food, is a pub. It is moderately priced. It has a customer rating of 1 out of 5. The Mill, which does not welcome kids, is located in the city centre near Café Sicilia.
name[The Mill], eatType[pub], food[Fast food], priceRange[moderate], customer rating[1 out of 5], area[city centre], familyFriendly[yes], near[Café Sicilia]	The Mill, which serves fast food, is a mid-priced pub. Customers rate kid-friendly The Mill 1 out of 5. It is located in the city centre area and can be found near Café Sicilia.
name[The Mill], eatType[pub], food[Fast food], priceRange[moderate], customer rating[1 out of 5], area[riverside], familyFriendly[no], near[Café Sicilia]	The Mill, which offers fast food, is an average-priced pub. It has a customer rating of 1 out of 5. It is in riverside near Café Sicilia. It is not family-friendly.
name[The Mill], eatType[pub], food[Fast food], priceRange[moderate], customer rating[1 out of 5], area[riverside], familyFriendly[yes], near[Café Sicilia]	The Mill, which offers fast food, is a pub. It is moderately priced. Customers rate The Mill, which is in the riverside area by Café Sicilia, 1 out of 5. Children are welcome.
name[The Mill], eatType[pub], food[Fast food], priceRange[moderate], customer rating[3 out of 5], area[city centre], familyFriendly[no], near[Café Sicilia]	The Mill, which serves fast food, is a mid-priced pub. It has a customer rating of 3 out of 5. Non-child-friendly The Mill is located in the city centre near Café Sicilia.
name[The Mill], eatType[pub], food[Fast food], priceRange[moderate], customer rating[3 out of 5], area[city centre], familyFriendly[yes], near[Café Sicilia]	The Mill, which serves fast food, is an average-priced pub. Customers rate The Mill, which welcomes kids, 3 out of 5. It is located in the city centre area and can be found near Café Sicilia.
name[The Mill], eatType[pub], food[Fast food], priceRange[moderate], customer rating[3 out of 5], area[riverside], familyFriendly[no], near[Café Sicilia]	The Mill, which offers fast food, is a pub. It is moderately priced. It has a customer rating of 3 out of 5. It is in riverside near Café Sicilia. It is not kid-friendly.
name[The Mill], eatType[pub], food[Fast food], priceRange[moderate], customer rating[3 out of 5], area[riverside], familyFriendly[yes], near[Café Sicilia]	The Mill, which offers fast food, is a mid-priced pub. Customers rate The Mill, which is in the riverside area by Café Sicilia, 3 out of 5. Families are welcome.
name[The Mill], eatType[restaurant], food[English], priceRange[high], area[riverside], familyFriendly[yes], near[Raja Indian Cuisine]	The Mill, which is located in the riverside near Raja Indian Cuisine, is a high-priced restaurant that serves English food. It is family-friendly.
name[The Mill], eatType[restaurant], food[English], priceRange[high], customer rating[average], area[riverside], familyFriendly[yes], near[Café Rouge]	The Mill, which has an average customer rating, is an expensive restaurant that serves English cuisine. It is located in the riverside area and can be found near Café Rouge. It is child-friendly.
name[The Mill], eatType[restaurant], food[English], priceRange[less than £20], area[city centre], familyFriendly[no], near[Raja Indian Cuisine]	The Mill, which is in city centre near Raja Indian Cuisine, is a low-priced restaurant offering English food. Children are not welcome.
name[The Mill], eatType[restaurant], food[English], priceRange[less than £20], area[city centre], familyFriendly[yes], near[Raja Indian Cuisine]	The Mill, which is in the city centre area by Raja Indian Cuisine, is a cheap restaurant offering English cuisine. It is kid-friendly.
name[The Mill], eatType[restaurant], food[English], priceRange[less than £20], area[riverside], familyFriendly[no], near[Raja Indian Cuisine]	The Mill, which is located in the riverside near Raja Indian Cuisine, is a low-priced restaurant serving English food. Kids are not welcome.
name[The Mill], eatType[restaurant], food[English], priceRange[less than £20], area[riverside], familyFriendly[yes], near[Raja Indian Cuisine]	The Mill, which welcomes children, is a cheap restaurant that serves English cuisine. It is located in the riverside area and can be found near Raja Indian Cuisine.
name[The Mill], eatType[restaurant], food[English], priceRange[less than £20], customer rating[low], area[city centre], familyFriendly[no], near[Café Rouge]	The Mill, which has a low customer rating, is a low-priced restaurant offering English food. It is in city centre near Café Rouge. It is not family-friendly.
name[The Mill], eatType[restaurant], food[English], priceRange[less than £20], customer rating[low], area[city centre], familyFriendly[yes], near[Café Rouge]	The Mill, which has a low customer rating, is a cheap restaurant offering English cuisine. It is in the city centre area by Café Rouge. Kids are welcome.
name[The Mill], eatType[restaurant], food[English], priceRange[less than £20], customer rating[low], area[riverside], familyFriendly[no], near[Café Rouge]	The Mill, which has a low customer rating, is a low-priced restaurant serving English food. Non-child-friendly The Mill is located in the riverside near Café Rouge.
name[The Mill], eatType[restaurant], food[English], priceRange[less than £20], customer rating[low], area[riverside], familyFriendly[yes], near[Café Rouge]	The Mill, which has a low customer rating, is a cheap restaurant serving English cuisine. It is located in the riverside area and can be found near Café Rouge. Families are welcome.
name[The Mill], eatType[restaurant], food[English], priceRange[moderate], area[city centre], familyFriendly[no], near[Raja Indian Cuisine]	The Mill, which is in city centre near Raja Indian Cuisine, is an average-priced restaurant offering English food. It is not kid-friendly.
name[The Mill], eatType[restaurant], food[English], priceRange[moderate], area[city centre], familyFriendly[yes], near[Raja Indian Cuisine]	Moderately priced The Mill is a restaurant that offers English cuisine. It is in the city centre area by Raja Indian Cuisine. It is family-friendly.
name[The Mill], eatType[restaurant], food[English], priceRange[moderate], area[riverside], familyFriendly[no], near[Raja Indian Cuisine]	The Mill, which is located in the riverside near Raja Indian Cuisine, is a mid-priced restaurant serving English food. Children are not welcome.
name[The Mill], eatType[restaurant], food[English], priceRange[moderate], area[riverside], familyFriendly[yes], near[Raja Indian Cuisine]	Child-friendly The Mill is an average-priced restaurant that serves English cuisine. It is located in the riverside area and can be found near Raja Indian Cuisine.
name[The Mill], eatType[restaurant], food[English], priceRange[moderate], customer rating[1 out of 5], area[city centre], familyFriendly[no], near[Café Rouge]	Moderately priced The Mill is a restaurant offering English food. It has a customer rating of 1 out of 5. It is in city centre near Café Rouge. Kids are not welcome.
name[The Mill], eatType[restaurant], food[English], priceRange[moderate], customer rating[1 out of 5], area[city centre], familyFriendly[yes], near[Café Rouge]	The Mill, which customers rate 1 out of 5, is a mid-priced restaurant offering English cuisine. It is in the city centre area by Café Rouge. It is kid-friendly.
name[The Mill], eatType[restaurant], food[English], priceRange[moderate], customer rating[1 out of 5], area[riverside], familyFriendly[no], near[Café Rouge]	The Mill, which has a customer rating of 1 out of 5, is an average-priced restaurant serving English food. Non-family-friendly The Mill is located in the riverside near Café Rouge.
name[The Mill], eatType[restaurant], food[English], priceRange[moderate], customer rating[1 out of 5], area[riverside], familyFriendly[yes], near[Café Rouge]	Moderately priced The Mill is a restaurant serving English cuisine. Customers rate The Mill, which welcomes children, 1 out of 5. It is located in the riverside area and can be found near Café Rouge.
name[The Mill], eatType[restaurant], food[English], priceRange[moderate], customer rating[3 out of 5], area[city centre], familyFriendly[no], near[Café Rouge]	The Mill, which has a customer rating of 3 out of 5, is a mid-priced restaurant that offers English food. It is in city centre near Café Rouge. It is not child-friendly.
name[The Mill], eatType[restaurant], food[English], priceRange[moderate], customer rating[3 out of 5], area[city centre], familyFriendly[yes], near[Café Rouge]	The Mill, which customers rate 3 out of 5, is an average-priced restaurant offering English cuisine. It is in the city centre area by Café Rouge. Kids are welcome.
name[The Mill], eatType[restaurant], food[English], priceRange[moderate], customer rating[3 out of 5], area[riverside], familyFriendly[no], near[Café Rouge]	Moderately priced The Mill is a restaurant that serves English food. It has a customer rating of 3 out of 5. Non-kid-friendly The Mill is located in the riverside near Café Rouge.
name[The Mill], eatType[restaurant], food[English], priceRange[moderate], customer rating[3 out of 5], area[riverside], familyFriendly[yes], near[Café Rouge]	The Mill, which customers rate 3 out of 5, is a mid-priced restaurant that serves English cuisine. It is located in the riverside area and can be found near Café Rouge. Families are welcome.
name[The Mill], eatType[restaurant], food[English], priceRange[more than £30], area[riverside], familyFriendly[yes], near[Raja Indian Cuisine]	The Mill, which is in riverside near Raja Indian Cuisine, is a high-priced restaurant that offers English food. It is family-friendly.
name[The Mill], eatType[restaurant], food[English], priceRange[more than £30], customer rating[high], area[city centre], familyFriendly[no], near[Café Rouge]	The Mill, which has a high customer rating, is an expensive restaurant offering English cuisine. It is in the city centre area by Café Rouge. Children are not welcome.
name[The Mill], eatType[restaurant], food[English], priceRange[more than £30], customer rating[high], area[city centre], familyFriendly[yes], near[Café Rouge]	The Mill, which has a high customer rating, is a high-priced restaurant that serves English food. Child-friendly The Mill is located in the city centre near Café Rouge.
name[The Mill], eatType[restaurant], food[English], priceRange[more than £30], customer rating[high], area[riverside], familyFriendly[no], near[Café Rouge]	The Mill, which has a high customer rating, is an expensive restaurant that serves English cuisine. It is located in the riverside area and can be found near Café Rouge. Kids are not welcome.
name[The Mill], eatType[restaurant], food[English], priceRange[more than £30], customer rating[high], area[riverside], familyFriendly[yes], near[Café Rouge]	The Mill, which has a high customer rating, is a high-priced restaurant that offers English food. It is in riverside near Café Rouge. It is kid-friendly.
name[The Mill], eatType[restaurant], food[Fast food], priceRange[£20-25], area[riverside], familyFriendly[yes], near[Raja Indian Cuisine]	The Mill, which offers fast food, is an average-priced restaurant. It is in the riverside area by Raja Indian Cuisine. Children are welcome.
name[The Mill], eatType[restaurant], food[Fast food], priceRange[cheap], area[riverside], familyFriendly[yes], near[Raja Indian Cuisine]	The Mill, which serves fast food, is a low-priced restaurant. The Mill, which welcomes kids, is located in the riverside near Raja Indian Cuisine.
name[The Phoenix], eatType[pub], food[Fast food], priceRange[cheap], area[riverside], familyFriendly[yes], near[Raja Indian Cuisine]	The Phoenix, which serves fast food, is a cheap pub. It is located in the riverside area and can be found near Raja Indian Cuisine. Families are welcome.
name[The Phoenix], eatType[pub], food[Fast food], priceRange[high], area[city centre], familyFriendly[no], near[Raja Indian Cuisine]	The Phoenix, which offers fast food, is an expensive pub. It is in city centre near Raja Indian Cuisine. It is not family-friendly.
name[The Phoenix], eatType[pub], food[Fast food], priceRange[high], area[city centre], familyFriendly[yes], near[Raja Indian Cuisine]	The Phoenix, which offers fast food, is a high-priced pub. It is in the city centre area by Raja Indian Cuisine. It is family-friendly.
name[The Phoenix], eatType[pub], food[Fast food], priceRange[high], area[riverside], familyFriendly[no], near[Raja Indian Cuisine]	The Phoenix, which serves fast food, is an expensive pub. Non-child-friendly The Phoenix is located in the riverside near Raja Indian Cuisine.
name[The Phoenix], eatType[pub], food[Fast food], priceRange[high], area[riverside], familyFriendly[yes], near[Raja Indian Cuisine]	The Phoenix, which serves fast food, is a high-priced pub. It is located in the riverside area and can be found near Raja Indian Cuisine. It is child-friendly.
name[The Phoenix], eatType[pub], food[Fast food], priceRange[less than £20], area[city centre], familyFriendly[no], near[Raja Indian Cuisine]	The Phoenix, which offers fast food, is a low-priced pub. It is in city centre near Raja Indian Cuisine. It is not kid-friendly.
name[The Phoenix], eatType[pub], food[Fast food], priceRange[less than £20], area[city centre], familyFriendly[yes], near[Raja Indian Cuisine]	The Phoenix, which offers fast food, is a cheap pub. It is in the city centre area by Raja Indian Cuisine. It is kid-friendly.
name[The Phoenix], eatType[pub], food[Fast food], priceRange[less than £20], area[riverside], familyFriendly[no], near[Raja Indian Cuisine]	The Phoenix, which serves fast food, is a low-priced pub. The Phoenix, which does not welcome children, is located in the riverside near Raja Indian Cuisine.
name[The Phoenix], eatType[pub], food[Fast food], priceRange[less than £20], area[riverside], familyFriendly[yes], near[Raja Indian Cuisine]	The Phoenix, which serves fast food, is a cheap pub. It is located in the riverside area and can be found near Raja Indian Cuisine. Children are welcome.
name[The Phoenix], eatType[pub], food[Fast food], priceRange[moderate], area[city centre], familyFriendly[no], near[Raja Indian Cuisine]	The Phoenix, which offers fast food, is a pub. It is moderately priced. It is in city centre near Raja Indian Cuisine. Kids are not welcome.
name[The Phoenix], eatType[pub], food[Fast food], priceRange[moderate], area[city centre], familyFriendly[yes], near[Raja Indian Cuisine]	The Phoenix, which offers fast food, is a mid-priced pub. It is in the city centre area by Raja Indian Cuisine. Kids are welcome.
name[The Phoenix], eatType[pub], food[Fast food], priceRange[moderate], area[riverside], familyFriendly[no], near[Raja Indian Cuisine]	The Phoenix, which serves fast food, is an average-priced pub. Non-family-friendly The Phoenix is located in the riverside near Raja Indian Cuisine.
name[The Phoenix], eatType[pub], food[Fast food], priceRange[moderate], area[riverside], familyFriendly[yes], near[Raja Indian Cuisine]	The Phoenix, which serves fast food, is a pub. It is moderately priced. It is located in the riverside area and can be found near Raja Indian Cuisine. Families are welcome.
name[The Phoenix], eatType[pub], food[Fast food], priceRange[moderate], customer rating[3 out of 5], area[riverside], familyFriendly[yes], near[Café Sicilia]	The Phoenix, which offers fast food, is a mid-priced pub. It has a customer rating of 3 out of 5. It is in riverside near Café Sicilia. It is family-friendly.
name[The Phoenix], eatType[pub], food[Fast food], priceRange[more than £30], area[riverside], familyFriendly[yes], near[Raja Indian Cuisine]	The Phoenix, which offers fast food, is an expensive pub. It is in the riverside area by Raja Indian Cuisine. It is child-friendly.
name[The Phoenix], eatType[pub], food[Fast food], priceRange[more than £30], customer rating[high], area[city centre], familyFriendly[no], near[Café Sicilia]	The Phoenix, which serves fast food, is a high-priced pub. It has a high customer rating. Non-child-friendly The Phoenix is located in the city centre near Café Sicilia.
name[The Phoenix], eatType[pub], food[Fast food], priceRange[more than £30], customer rating[high], area[city centre], familyFriendly[yes], near[Café Sicilia]	The Phoenix, which serves fast food, is an expensive pub. It has a high customer rating. It is located in the city centre area and can be found near Café Sicilia. It is kid-friendly.
name[The Phoenix], eatType[pub], food[Fast food], priceRange[more than £30], customer rating[high], area[riverside], familyFriendly[no], near[Café Sicilia]	The Phoenix, which offers fast food, is a high-priced pub. It has a high customer rating. It is in riverside near Café Sicilia. It is not kid-friendly.
name[The Phoenix], eatType[pub], food[Fast food], priceRange[more than £30], customer rating[high], area[riverside], familyFriendly[yes], near[Café Sicilia]	The Phoenix, which offers fast food, is an expensive pub. It has a high customer rating. It is in the riverside area by Café Sicilia. Children are welcome.
name[The Phoenix], eatType[pub], food[French], priceRange[£20-25], area[riverside], familyFriendly[yes], near[Raja Indian Cuisine]	The Phoenix, which is located in the riverside near Raja Indian Cuisine, is an average-priced pub serving French food. Kids are welcome.
name[The Phoenix], eatType[pub], food[French], priceRange[£20-25], customer rating[3 out of 5], area[city centre], familyFriendly[no], near[Café Sicilia]	Moderately priced The Phoenix is a pub serving French cuisine. Customers rate The Phoenix, which does not welcome children, 3 out of 5. It is located in the city centre area and can be found near Café Sicilia.
name[The Phoenix], eatType[pub], food[French], priceRange[£20-25], customer rating[3 out of 5], area[city centre], familyFriendly[yes], near[Café Sicilia]	The Phoenix, which has a customer rating of 3 out of 5, is a mid-priced pub offering French food. It is in city centre near Café Sicilia. Families are welcome.
name[The Phoenix], eatType[pub], food[French], priceRange[£20-25], customer rating[3 out of 5], area[riverside], familyFriendly[no], near[Café Sicilia]	The Phoenix, which customers rate 3 out of 5, is an average-priced pub that offers French cuisine. It is in the riverside area by Café Sicilia. Kids are not welcome.
name[The Phoenix], eatType[pub], food[French], priceRange[£20-25], customer rating[3 out of 5], area[riverside], familyFriendly[yes], near[Café Sicilia]	Moderately priced The Phoenix is a pub serving French food. It has a customer rating of 3 out of 5. Family-friendly The Phoenix is located in the riverside near Café Sicilia.
name[The Phoenix], eatType[pub], food[French], priceRange[£20-25], customer rating[3 out of 5], area[riverside], familyFriendly[yes], near[Crowne Plaza Hotel]	The Phoenix, which customers rate 3 out of 5, is a mid-priced pub that serves French cuisine. It is located in the riverside area and can be found near Crowne Plaza Hotel. It is child-friendly.
name[The Phoenix], eatType[pub], food[French], priceRange[£20-25], customer rating[high], area[city centre], familyFriendly[no], near[Crowne Plaza Hotel]	The Phoenix, which has a high customer rating, is an average-priced pub that offers French food. It is in city centre near Crowne Plaza Hotel. It is not family-friendly.
name[The Phoenix], eatType[pub], food[French], priceRange[£20-25], customer rating[high], area[city centre], familyFriendly[yes], near[Crowne Plaza Hotel]	Moderately priced The Phoenix is a pub offering French cuisine. It has a high customer rating. It is in the city centre area by Crowne Plaza Hotel. It is kid-friendly.
name[The Phoenix], eatType[pub], food[French], priceRange[£20-25], customer rating[high], area[riverside], familyFriendly[no], near[Crowne Plaza Hotel]	The Phoenix, which has a high customer rating, is a mid-priced pub that serves French food. Non-child-friendly The Phoenix is located in the riverside near Crowne Plaza Hotel.
name[The Phoenix], eatType[pub], food[French], priceRange[£20-25], customer rating[high], area[riverside], familyFriendly[yes], near[Crowne Plaza Hotel]	The Phoenix, which has a high customer rating, is an average-priced pub serving French cuisine. It is located in the riverside area and can be found near Crowne Plaza Hotel. Children are welcome.
name[The Phoenix], eatType[pub], food[French], priceRange[cheap], area[riverside], familyFriendly[yes], near[Raja Indian Cuisine]	The Phoenix, which is in riverside near Raja Indian Cuisine, is a low-priced pub offering French food. Kids are welcome.
name[The Phoenix], eatType[pub], food[French], priceRange[cheap], customer rating[5 out of 5], area[city centre], familyFriendly[no], near[Crowne Plaza Hotel]	The Phoenix, which has a customer rating of 5 out of 5, is a cheap pub that offers French cuisine. It is in the city centre area by Crowne Plaza Hotel. It is not kid-friendly.
name[The Phoenix], eatType[pub], food[French], priceRange[cheap], customer rating[5 out of 5], area[city centre], familyFriendly[yes], near[Crowne Plaza Hotel]	The Phoenix, which customers rate 5 out of 5, is a low-priced pub serving French food. It is located in the city centre near Crowne Plaza Hotel. Families are welcome.
name[The Phoenix], eatType[pub], food[French], priceRange[cheap], customer rating[5 out of 5], area[riverside], familyFriendly[no], near[Crowne Plaza Hotel]	The Phoenix, which has a customer rating of 5 out of 5, is a cheap pub serving French cuisine. It is located in the riverside area and can be found near Crowne Plaza Hotel. Children are not welcome.
name[The Phoenix], eatType[pub], food[French], priceRange[cheap], customer rating[5 out of 5], area[riverside], familyFriendly[yes], near[Crowne Plaza Hotel]	The Phoenix, which customers rate 5 out of 5, is a low-priced pub that offers French food. It is in riverside near Crowne Plaza Hotel. It is family-friendly.
name[The Phoenix], eatType[pub], food[French], priceRange[high], area[riverside], familyFriendly[yes], near[Raja Indian Cuisine]	The Phoenix, which is in the riverside area by Raja Indian Cuisine, is a high-priced pub that offers French cuisine. It is child-friendly.
name[The Phoenix], eatType[pub], food[French], priceRange[high], customer rating[3 out of 5], area[city centre], familyFriendly[no], near[Crowne Plaza Hotel]	The Phoenix, which has a customer rating of 3 out of 5, is an expensive pub serving French food. The Phoenix, which does not welcome kids, is located in the city centre near Crowne Plaza Hotel.
name[The Phoenix], eatType[pub], food[French], priceRange[high], customer rating[3 out of 5], area[city centre], familyFriendly[yes], near[Crowne Plaza Hotel]	The Phoenix, which customers rate 3 out of 5, is a high-priced pub that serves French cuisine. It is located in the city centre area and can be found near Crowne Plaza Hotel. It is kid-friendly.
name[The Phoenix], eatType[pub], food[French], priceRange[high], customer rating[3 out of 5], area[riverside], familyFriendly[no], near[Crowne Plaza Hotel]	The Phoenix, which has a customer rating of 3 out of 5, is an expensive pub that offers French food. It is in riverside near Crowne Plaza Hotel. It is not family-friendly.
name[The Phoenix], eatType[pub], food[French], priceRange[high], customer rating[3 out of 5], area[riverside], familyFriendly[yes], near[Crowne Plaza Hotel]	The Phoenix, which customers rate 3 out of 5, is a high-priced pub offering French cuisine. It is in the riverside area by Crowne Plaza Hotel. Children are welcome.
name[The Phoenix], eatType[pub], food[French], priceRange[less than £20], customer rating[average], area[city centre], familyFriendly[no], near[Crowne Plaza Hotel]	The Phoenix, which has an average customer rating, is a cheap pub serving French food. Non-child-friendly The Phoenix is located in the city centre near Crowne Plaza Hotel.
name[The Phoenix], eatType[pub], food[French], priceRange[less than £20], customer rating[average], area[city centre], familyFriendly[yes], near[Crowne Plaza Hotel]	The Phoenix, which has an average customer rating, is a low-priced pub serving French cuisine. It is located in the city centre area and can be found near Crowne Plaza Hotel. Kids are welcome.
name[The Phoenix], eatType[pub], food[French], priceRange[less than £20], customer rating[average], area[riverside], familyFriendly[no], near[Crowne Plaza Hotel]	The Phoenix, which has an average customer rating, is a cheap pub that offers French food. It is in riverside near Crowne Plaza Hotel. It is not kid-friendly.
name[The Phoenix], eatType[pub], food[French], priceRange[less than £20], customer rating[average], area[riverside], familyFriendly[yes], near[Crowne Plaza Hotel]	The Phoenix, which has an average customer rating, is a low-priced pub that offers French cuisine. It is in the riverside area by Crowne Plaza Hotel. Families are welcome.
name[The Phoenix], eatType[pub], food[French], priceRange[less than £20], customer rating[low], area[city centre], familyFriendly[no], near[Crowne Plaza Hotel]	The Phoenix, which has a low customer rating, is a cheap pub that serves French food. The Phoenix, which does not welcome children, is located in the city centre near Crowne Plaza Hotel.
name[The Phoenix], eatType[pub], food[French], priceRange[less than £20], customer rating[low], area[city centre], familyFriendly[yes], near[Crowne Plaza Hotel]	The Phoenix, which has a low customer rating, is a low-priced pub serving French cuisine. It is located in the city centre area and can be found near Crowne Plaza Hotel. It is family-friendly.
name[The Phoenix], eatType[pub], food[French], priceRange[less than £20], customer rating[low], area[riverside], familyFriendly[no], near[Crowne Plaza Hotel]	The Phoenix, which has a low customer rating, is a cheap pub offering French food. It is in riverside near Crowne Plaza Hotel. Kids are not welcome.
name[The Phoenix], eatType[pub], food[French], priceRange[less than £20], customer rating[low], area[riverside], familyFriendly[yes], near[Crowne Plaza Hotel]	The Phoenix, which has a low customer rating, is a low-priced pub that offers French cuisine. It is in the riverside area by Crowne Plaza Hotel. It is child-friendly.
name[The Phoenix], eatType[pub], food[French], priceRange[moderate], customer rating[1 out of 5], area[city centre], familyFriendly[no], near[Crowne Plaza Hotel]	Moderately priced The Phoenix is a pub that serves French food. It has a customer rating of 1 out of 5. Non-family-friendly The Phoenix is located in the city centre near Crowne Plaza Hotel.
name[The Phoenix], eatType[pub], food[French], priceRange[moderate], customer rating[1 out of 5], area[city centre], familyFriendly[yes], near[Crowne Plaza Hotel]	The Phoenix, which customers rate 1 out of 5, is a mid-priced pub that serves French cuisine. It is located in the city centre area and can be found near Crowne Plaza Hotel. It is kid-friendly.
name[The Phoenix], eatType[pub], food[French], priceRange[moderate], customer rating[1 out of 5], area[riverside], familyFriendly[no], near[Crowne Plaza Hotel]	The Phoenix, which has a customer rating of 1 out of 5, is an average-priced pub offering French food. It is in riverside near Crowne Plaza Hotel. It is not child-friendly.
name[The Phoenix], eatType[pub], food[French], priceRange[moderate], customer rating[1 out of 5], area[riverside], familyFriendly[yes], near[Crowne Plaza Hotel]	Moderately priced The Phoenix is a pub that offers French cuisine. Customers rate The Phoenix, which is in the riverside area by Crowne Plaza Hotel, 1 out of 5. Children are welcome.
name[The Phoenix], eatType[pub], food[French], priceRange[more than £30], customer rating[5 out of 5], area[city centre], familyFriendly[no], near[Crowne Plaza Hotel]	The Phoenix, which has a customer rating of 5 out of 5, is an expensive pub serving French food. Non-kid-friendly The Phoenix is located in the city centre near Crowne Plaza Hotel.
name[The Phoenix], eatType[pub], food[French], priceRange[more than £30], customer rating[5 out of 5], area[city centre], familyFriendly[yes], near[Crowne Plaza Hotel]	The Phoenix, which customers rate 5 out of 5, is a high-priced pub serving French cuisine. It is located in the city centre area and can be found near Crowne Plaza Hotel. Kids are welcome.
name[The Phoenix], eatType[pub], food[French], priceRange[more than £30], customer rating[5 out of 5], area[riverside], familyFriendly[no], near[Crowne Plaza Hotel]	The Phoenix, which has a customer rating of 5 out of 5, is an expensive pub offering French food. It is in riverside near Crowne Plaza Hotel. Children are not welcome.
name[The Phoenix], eatType[pub], food[French], priceRange[more than £30], customer rating[5 out of 5], area[riverside], familyFriendly[yes], near[Crowne Plaza Hotel]	The Phoenix, which customers rate 5 out of 5, is a high-priced pub that offers French cuisine. It is in the riverside area by Crowne Plaza Hotel. Families are welcome.
name[The Phoenix], eatType[pub], food[French], priceRange[more than £30], customer rating[low], area[city centre], familyFriendly[no], near[Crowne Plaza Hotel]	The Phoenix, which has a low customer rating, is an expensive pub serving French food. The Phoenix, which does not welcome kids, is located in the city centre near Crowne Plaza Hotel.
name[The Phoenix], eatType[pub], food[French], priceRange[more than £30], customer rating[low], area[city centre], familyFriendly[yes], near[Crowne Plaza Hotel]	The Phoenix, which has a low customer rating, is a high-priced pub that serves French cuisine. It is located in the city centre area and can be found near Crowne Plaza Hotel. It is family-friendly.
name[The Phoenix], eatType[pub], food[French], priceRange[more than £30], customer rating[low], area[riverside], familyFriendly[no], near[Crowne Plaza Hotel]	The Phoenix, which has a low customer rating, is an expensive pub offering French food. It is in riverside near Crowne Plaza Hotel. It is not family-friendly.
name[The Phoenix], eatType[pub], food[French], priceRange[more than £30], customer rating[low], area[riverside], familyFriendly[yes], near[Crowne Plaza Hotel]	The Phoenix, which has a low customer rating, is a high-priced pub offering French cuisine. It is in the riverside area by Crowne Plaza Hotel. It is child-friendly.
name[The Phoenix], eatType[restaurant], food[Fast food], priceRange[cheap], area[riverside], familyFriendly[yes], near[Raja Indian Cuisine]	The Phoenix, which serves fast food, is a cheap restaurant. Kid-friendly The Phoenix is located in the riverside near Raja Indian Cuisine.
name[The Phoenix], eatType[restaurant], food[Fast food], priceRange[high], area[city centre], familyFriendly[no], near[Raja Indian Cuisine]	The Phoenix, which serves fast food, is an expensive restaurant. It is located in the city centre area and can be found near Raja Indian Cuisine. It is not child-friendly.
name[The Phoenix], eatType[restaurant], food[Fast food], priceRange[high], area[city centre], familyFriendly[yes], near[Raja Indian Cuisine]	The Phoenix, which offers fast food, is a high-priced restaurant. It is in city centre near Raja Indian Cuisine. Children are welcome.
name[The Phoenix], eatType[restaurant], food[Fast food], priceRange[high], area[riverside], familyFriendly[no], near[Raja Indian Cuisine]	The Phoenix, which offers fast food, is an expensive restaurant. It is in the riverside area by Raja Indian Cuisine. It is not kid-friendly.
name[The Phoenix], eatType[restaurant], food[Fast food], priceRange[high], area[riverside], familyFriendly[yes], near[Raja Indian Cuisine]	The Phoenix, which serves fast food, is a high-priced restaurant. The Phoenix, which welcomes kids, is located in the riverside near Raja Indian Cuisine.
name[The Phoenix], eatType[restaurant], food[Fast food], priceRange[less than £20], area[city centre], familyFriendly[no], near[Raja Indian Cuisine]	The Phoenix, which serves fast food, is a low-priced restaurant. It is located in the city centre area and can be found near Raja Indian Cuisine. Children are not welcome.
name[The Phoenix], eatType[restaurant], food[Fast food], priceRange[less than £20], area[city centre], familyFriendly[yes], near[Raja Indian Cuisine]	The Phoenix, which offers fast food, is a cheap restaurant. It is in city centre near Raja Indian Cuisine. Families are welcome.
name[The Phoenix], eatType[restaurant], food[Fast food], priceRange[less than £20], area[riverside], familyFriendly[no], near[Raja Indian Cuisine]	The Phoenix, which offers fast food, is a low-priced restaurant. It is in the riverside area by Raja Indian Cuisine. Kids are not welcome.
name[The Phoenix], eatType[restaurant], food[Fast food], priceRange[less than £20], area[riverside], familyFriendly[yes], near[Raja Indian Cuisine]	The Phoenix, which serves fast food, is a cheap restaurant. Family-friendly The Phoenix is located in the riverside near Raja Indian Cuisine.
name[The Phoenix], eatType[restaurant], food[Fast food], priceRange[moderate], area[city centre], familyFriendly[no], near[Raja Indian Cuisine]	The Phoenix, which serves fast food, is a mid-priced restaurant. It is located in the city centre area and can be found near Raja Indian Cuisine. It is not family-friendly.
name[The Phoenix], eatType[restaurant], food[Fast food], priceRange[moderate], area[city centre], familyFriendly[yes], near[Raja Indian Cuisine]	The Phoenix, which offers fast food, is an average-priced restaurant. It is in city centre near Raja Indian Cuisine. It is child-friendly.
name[The Phoenix], eatType[restaurant], food[Fast food], priceRange[moderate], area[riverside], familyFriendly[no], near[Raja Indian Cuisine]	The Phoenix, which offers fast food, is a restaurant. It is moderately priced. It is in the riverside area by Raja Indian Cuisine. It is not child-friendly.
name[The Phoenix], eatType[restaurant], food[Fast food], priceRange[moderate], area[riverside], familyFriendly[yes], near[Raja Indian Cuisine]	The Phoenix, which serves fast food, is a mid-priced restaurant. Kid-friendly The Phoenix is located in the riverside near Raja Indian Cuisine.
name[The Phoenix], eatType[restaurant], food[Fast food], priceRange[more than £30], area[riverside], familyFriendly[yes], near[Raja Indian Cuisine]	The Phoenix, which serves fast food, is an expensive restaurant. It is located in the riverside area and can be found near Raja Indian Cuisine. Children are welcome.
name[The Phoenix], eatType[restaurant], food[French], priceRange[£20-25], area[riverside], familyFriendly[yes], near[Raja Indian Cuisine]	The Phoenix, which is in riverside near Raja Indian Cuisine, is an average-priced restaurant offering French food. Kids are welcome.
name[The Phoenix], eatType[restaurant], food[French], priceRange[cheap], area[riverside], familyFriendly[yes], near[Raja Indian Cuisine]	The Phoenix, which is in the riverside area by Raja Indian Cuisine, is a low-priced restaurant that offers French cuisine. Families are welcome.
name[The Phoenix], eatType[restaurant], food[French], priceRange[high], area[riverside], familyFriendly[yes], near[Raja Indian Cuisine]	The Phoenix, which is located in the riverside near Raja Indian Cuisine, is a high-priced restaurant serving French food. It is family-friendly.
name[The Phoenix], eatType[restaurant], food[Indian], priceRange[£20-25], customer rating[high], area[city centre], familyFriendly[no], near[Crowne Plaza Hotel]	Moderately priced The Phoenix is a restaurant that serves Indian cuisine. It has a high customer rating. It is located in the city centre area and can be found near Crowne Plaza Hotel. It is not kid-friendly.
name[The Phoenix], eatType[restaurant], food[Indian], priceRange[£20-25], customer rating[high], area[city centre], familyFriendly[yes], near[Crowne Plaza Hotel]	The Phoenix, which has a high customer rating, is a mid-priced restaurant that offers Indian food. It is in city centre near Crowne Plaza Hotel. It is child-friendly.
name[The Phoenix], eatType[restaurant], food[Indian], priceRange[£20-25], customer rating[high], area[riverside], familyFriendly[no], near[Crowne Plaza Hotel]	The Phoenix, which has a high customer rating, is an average-priced restaurant offering Indian cuisine. It is in the riverside area by Crowne Plaza Hotel. Children are not welcome.
name[The Phoenix], eatType[restaurant], food[Indian], priceRange[£20-25], customer rating[high], area[riverside], familyFriendly[yes], near[Crowne Plaza Hotel]	Moderately priced The Phoenix is a restaurant that serves Indian food. It has a high customer rating. Kid-friendly The Phoenix is located in the riverside near Crowne Plaza Hotel.
name[The Phoenix], eatType[restaurant], food[Indian], priceRange[cheap], customer rating[5 out of 5], area[city centre], familyFriendly[no], near[Crowne Plaza Hotel]	The Phoenix, which has a customer rating of 5 out of 5, is a cheap restaurant serving Indian cuisine. It is located in the city centre area and can be found near Crowne Plaza Hotel. Kids are not welcome.
name[The Phoenix], eatType[restaurant], food[Indian], priceRange[cheap], customer rating[5 out of 5], area[city centre], familyFriendly[yes], near[Crowne Plaza Hotel]	The Phoenix, which customers rate 5 out of 5, is a low-priced restaurant offering Indian food. It is in city centre near Crowne Plaza Hotel. Children are welcome.
name[The Phoenix], eatType[restaurant], food[Indian], priceRange[cheap], customer rating[5 out of 5], area[riverside], familyFriendly[no], near[Crowne Plaza Hotel]	The Phoenix, which has a customer rating of 5 out of 5, is a cheap restaurant offering Indian cuisine. It is in the riverside area by Crowne Plaza Hotel. It is not family-friendly.
name[The Phoenix], eatType[restaurant], food[Indian], priceRange[cheap], customer rating[5 out of 5], area[riverside], familyFriendly[no], near[Express by Holiday Inn]	The Phoenix, which customers rate 5 out of 5, is a low-priced restaurant that serves Indian food. It is located in the riverside near Express by Holiday Inn. It is not child-friendly.
name[The Phoenix], eatType[restaurant], food[Indian], priceRange[cheap], customer rating[5 out of 5], area[riverside], familyFriendly[yes], near[Express by Holiday Inn]	The Phoenix, which has a customer rating of 5 out of 5, is a cheap restaurant serving Indian cuisine. It is located in the riverside area and can be found near Express by Holiday Inn. Kids are welcome.
name[The Phoenix], eatType[restaurant], food[Indian], priceRange[cheap], customer rating[average], area[city centre], familyFriendly[no], near[Express by Holiday Inn]	The Phoenix, which has an average customer rating, is a low-priced restaurant that offers Indian food. It is in city centre near Express by Holiday Inn. It is not kid-friendly.
name[The Plough], eatType[pub], food[Chinese], priceRange[£20-25], area[riverside], familyFriendly[yes], near[Raja Indian Cuisine]	The Plough, which is in the riverside area by Raja Indian Cuisine, is a mid-priced pub that offers Chinese cuisine. Families are welcome.
name[The Plough], eatType[pub], food[Chinese], priceRange[cheap], area[riverside], familyFriendly[yes], near[Raja Indian Cuisine]	The Plough, which is located in the riverside near Raja Indian Cuisine, is a cheap pub that serves Chinese food. It is family-friendly.
name[The Plough], eatType[pub], food[Chinese], priceRange[high], area[city centre], familyFriendly[no], near[Raja Indian Cuisine]	The Plough, which does not welcome children, is an expensive pub serving Chinese cuisine. It is located in the city centre area and can be found near Raja Indian Cuisine.
name[The Plough], eatType[pub], food[Chinese], priceRange[high], area[city centre], familyFriendly[yes], near[Raja Indian Cuisine]	The Plough, which is in city centre near Raja Indian Cuisine, is a high-priced pub offering Chinese food. It is child-friendly.
name[The Plough], eatType[pub], food[Chinese], priceRange[high], area[riverside], familyFriendly[no], near[Raja Indian Cuisine]	The Plough, which is in the riverside area by Raja Indian Cuisine, is an expensive pub offering Chinese cuisine. Kids are not welcome.
name[The Plough], eatType[pub], food[Chinese], priceRange[high], area[riverside], familyFriendly[yes], near[Raja Indian Cuisine]	The Plough, which is located in the riverside near Raja Indian Cuisine, is a high-priced pub serving Chinese food. It is kid-friendly.
name[The Plough], eatType[pub], food[Chinese], priceRange[less than £20], area[city centre], familyFriendly[no], near[Raja Indian Cuisine]	Non-family-friendly The Plough is a low-priced pub serving Chinese cuisine. It is located in the city centre area and can be found near Raja Indian Cuisine.
name[The Plough], eatType[restaurant], food[Chinese], priceRange[£20-25], area[riverside], familyFriendly[yes], near[Raja Indian Cuisine]	The Plough, which is in riverside near Raja Indian Cuisine, is an average-priced restaurant offering Chinese food. Children are welcome.
name[The Plough], eatType[restaurant], food[Chinese], priceRange[cheap], area[riverside], familyFriendly[yes], near[Raja Indian Cuisine]	The Plough, which is in the riverside area by Raja Indian Cuisine, is a cheap restaurant that offers Chinese cuisine. Kids are welcome.
name[The Plough], eatType[restaurant], food[Chinese], priceRange[high], area[city centre], familyFriendly[no], near[Raja Indian Cuisine]	The Plough, which is located in the city centre near Raja Indian Cuisine, is an expensive restaurant serving Chinese food. It is not child-friendly.
name[The Plough], eatType[restaurant], food[Chinese], priceRange[high], area[city centre], familyFriendly[yes], near[Raja Indian Cuisine]	The Plough, which welcomes families, is a high-priced restaurant that serves Chinese cuisine. It is located in the city centre area and can be found near Raja Indian Cuisine.
name[The Plough], eatType[restaurant], food[Chinese], priceRange[high], area[riverside], familyFriendly[no], near[Raja Indian Cuisine]	The Plough, which is in riverside near Raja Indian Cuisine, is an expensive restaurant offering Chinese food. It is not kid-friendly.
name[The Plough], eatType[restaurant], food[Chinese], priceRange[high], area[riverside], familyFriendly[yes], near[Raja Indian Cuisine]	The Plough, which is in the riverside area by Raja Indian Cuisine, is a high-priced restaurant that offers Chinese cuisine. It is family-friendly.
name[The Plough], eatType[restaurant], food[Chinese], priceRange[less than £20], area[city centre], familyFriendly[no], near[Raja Indian Cuisine]	The Plough, which is located in the city centre near Raja Indian Cuisine, is a low-priced restaurant serving Chinese food. Children are not welcome.
name[The Punter], eatType[pub], food[Chinese], priceRange[less than £20], area[city centre], familyFriendly[yes], near[Raja Indian Cuisine]	Child-friendly The Punter is a cheap pub serving Chinese cuisine. It is located in the city centre area and can be found near Raja Indian Cuisine.
name[The Punter], eatType[pub], food[Chinese], priceRange[less than £20], area[riverside], familyFriendly[no], near[Raja Indian Cuisine]	The Punter, which is in riverside near Raja Indian Cuisine, is a low-priced pub that offers Chinese food. Kids are not welcome.
name[The Punter], eatType[pub], food[Chinese], priceRange[less than £20], area[riverside], familyFriendly[yes], near[Raja Indian Cuisine]	The Punter, which is in the riverside area by Raja Indian Cuisine, is a cheap pub offering Chinese cuisine. It is kid-friendly.
name[The Punter], eatType[pub], food[Chinese], priceRange[moderate], area[city centre], familyFriendly[no], near[Raja Indian Cuisine]	Moderately priced The Punter is a pub serving Chinese food. Non-family-friendly The Punter is located in the city centre near Raja Indian Cuisine.
name[The Punter], eatType[pub], food[Chinese], priceRange[moderate], area[city centre], familyFriendly[yes], near[Raja Indian Cuisine]	The Punter, which welcomes children, is a mid-priced pub serving Chinese cuisine. It is located in the city centre area and can be found near Raja Indian Cuisine.
name[The Punter], eatType[pub], food[Chinese], priceRange[moderate], area[riverside], familyFriendly[no], near[Raja Indian Cuisine]	The Punter, which is in riverside near Raja Indian Cuisine, is an average-priced pub that offers Chinese food. It is not child-friendly.
name[The Punter], eatType[pub], food[Chinese], priceRange[moderate], area[riverside], familyFriendly[yes], near[Raja Indian Cuisine]	Moderately priced The Punter is a pub that offers Chinese cuisine. It is in the riverside area by Raja Indian Cuisine. Kids are welcome.
name[The Punter], eatType[pub], food[Chinese], priceRange[more than £30], area[riverside], familyFriendly[yes], near[Raja Indian Cuisine]	The Punter, which is located in the riverside near Raja Indian Cuisine, is an expensive pub that serves Chinese food. Families are welcome.
name[The Punter], eatType[pub], food[English], priceRange[£20-25], area[riverside], familyFriendly[yes], near[Raja Indian Cuisine]	Family-friendly The Punter is a mid-priced pub that serves English cuisine. It is located in the riverside area and can be found near Raja Indian Cuisine.
name[The Punter], eatType[pub], food[English], priceRange[cheap], area[riverside], familyFriendly[yes], near[Raja Indian Cuisine]	The Punter, which is in riverside near Raja Indian Cuisine, is a low-priced pub that offers English food. It is child-friendly.
name[The Punter], eatType[pub], food[English], priceRange[high], area[city centre], familyFriendly[no], near[Raja Indian Cuisine]	The Punter, which is in the city centre area by Raja Indian Cuisine, is a high-priced pub offering English cuisine. It is not kid-friendly.
name[The Punter], eatType[pub], food[English], priceRange[high], area[city centre], familyFriendly[yes], near[Raja Indian Cuisine]	The Punter, which is located in the city centre near Raja Indian Cuisine, is an expensive pub that serves English food. It is kid-friendly.
name[The Punter], eatType[pub], food[English], priceRange[high], area[riverside], familyFriendly[no], near[Raja Indian Cuisine]	The Punter, which does not welcome children, is a high-priced pub that serves English cuisine. It is located in the riverside area and can be found near Raja Indian Cuisine.
name[The Punter], eatType[pub], food[English], priceRange[high], area[riverside], familyFriendly[yes], near[Raja Indian Cuisine]	The Punter, which is in riverside near Raja Indian Cuisine, is an expensive pub that offers English food. Children are welcome.
name[The Punter], eatType[pub], food[Italian], priceRange[high], customer rating[average], area[city centre], familyFriendly[no], near[Rainbow Vegetarian Café]	The Punter, which has an average customer rating, is a high-priced pub offering Italian cuisine. It is in the city centre area by Rainbow Vegetarian Café. Kids are not welcome.
name[The Punter], eatType[restaurant], food[Chinese], priceRange[less than £20], area[city centre], familyFriendly[yes], near[Raja Indian Cuisine]	The Punter, which is located in the city centre near Raja Indian Cuisine, is a cheap restaurant serving Chinese food. Kids are welcome.
name[The Punter], eatType[restaurant], food[Chinese], priceRange[less than £20], area[riverside], familyFriendly[no], near[Raja Indian Cuisine]	Non-family-friendly The Punter is a low-priced restaurant that serves Chinese cuisine. It is located in the riverside area and can be found near Raja Indian Cuisine.
name[The Punter], eatType[restaurant], food[Chinese], priceRange[less than £20], area[riverside], familyFriendly[yes], near[Raja Indian Cuisine]	The Punter, which is in riverside near Raja Indian Cuisine, is a cheap restaurant offering Chinese food. Families are welcome.
name[The Punter], eatType[restaurant], food[Chinese], priceRange[moderate], area[city centre], familyFriendly[no], near[Raja Indian Cuisine]	The Punter, which is in the city centre area by Raja Indian Cuisine, is an average-priced restaurant offering Chinese cuisine. It is not child-friendly.
name[The Punter], eatType[restaurant], food[Chinese], priceRange[moderate], area[city centre], familyFriendly[yes], near[Raja Indian Cuisine]	Moderately priced The Punter is a restaurant serving Chinese food. Family-friendly The Punter is located in the city centre near Raja Indian Cuisine.
name[The Punter], eatType[restaurant], food[Chinese], priceRange[moderate], area[riverside], familyFriendly[no], near[Raja Indian Cuisine]	Non-kid-friendly The Punter is a mid-priced restaurant that serves Chinese cuisine. It is located in the riverside area and can be found near Raja Indian Cuisine.
name[The Punter], eatType[restaurant], food[Chinese], priceRange[moderate], area[riverside], familyFriendly[yes], near[Raja Indian Cuisine]	The Punter, which is in riverside near Raja Indian Cuisine, is an average-priced restaurant that offers Chinese food. It is child-friendly.
name[The Punter], eatType[restaurant], food[Chinese], priceRange[more than £30], area[riverside], familyFriendly[yes], near[Raja Indian Cuisine]	The Punter, which is in the riverside area by Raja Indian Cuisine, is an expensive restaurant that offers Chinese cuisine. It is kid-friendly.
name[The Punter], eatType[restaurant], food[English], priceRange[£20-25], area[riverside], familyFriendly[yes], near[Raja Indian Cuisine]	Moderately priced The Punter is a restaurant that serves English food. The Punter, which welcomes children, is located in the riverside near Raja Indian Cuisine.
name[The Punter], eatType[restaurant], food[English], priceRange[cheap], area[riverside], familyFriendly[yes], near[Raja Indian Cuisine]	The Punter, which welcomes kids, is a low-priced restaurant serving English cuisine. It is located in the riverside area and can be found near Raja Indian Cuisine.
name[The Punter], eatType[restaurant], food[English], priceRange[high], area[city centre], familyFriendly[no], near[Raja Indian Cuisine]	The Punter, which is in city centre near Raja Indian Cuisine, is a high-priced restaurant offering English food. Children are not welcome.
name[The Punter], eatType[restaurant], food[English], priceRange[high], area[city centre], familyFriendly[yes], near[Raja Indian Cuisine]	The Punter, which is in the city centre area by Raja Indian Cuisine, is an expensive restaurant that offers English cuisine. Families are welcome.
name[The Punter], eatType[restaurant], food[English], priceRange[high], area[riverside], familyFriendly[no], near[Raja Indian Cuisine]	The Punter, which is located in the riverside near Raja Indian Cuisine, is a high-priced restaurant serving English food. Kids are not welcome.
name[The Punter], eatType[restaurant], food[English], priceRange[high], area[riverside], familyFriendly[yes], near[Raja Indian Cuisine]	Family-friendly The Punter is an expensive restaurant that serves English cuisine. It is located in the riverside area and can be found near Raja Indian Cuisine.
name[The Punter], eatType[restaurant], food[Indian], priceRange[cheap], customer rating[average], area[city centre], familyFriendly[yes], near[Express by Holiday Inn]	The Punter, which has an average customer rating, is a cheap restaurant that offers Indian food. It is in city centre near Express by Holiday Inn. It is child-friendly.
name[The Punter], eatType[restaurant], food[Indian], priceRange[cheap], customer rating[average], area[riverside], familyFriendly[no], near[Express by Holiday Inn]	The Punter, which has an average customer rating, is a low-priced restaurant that offers Indian cuisine. It is in the riverside area by Express by Holiday Inn. It is not family-friendly.
name[The Punter], eatType[restaurant], food[Indian], priceRange[cheap], customer rating[average], area[riverside], familyFriendly[yes], near[Express by Holiday Inn]	The Punter, which has an average customer rating, is a cheap restaurant serving Indian food. Kid-friendly The Punter is located in the riverside near Express by Holiday Inn.
name[The Punter], eatType[restaurant], food[Indian], priceRange[high], customer rating[1 out of 5], area[city centre], familyFriendly[no], near[Express by Holiday Inn]	The Punter, which customers rate 1 out of 5, is a high-priced restaurant that serves Indian cuisine. It is located in the city centre area and can be found near Express by Holiday Inn. It is not child-friendly.
name[The Punter], eatType[restaurant], food[Indian], priceRange[high], customer rating[1 out of 5], area[city centre], familyFriendly[yes], near[Express by Holiday Inn]	The Punter, which has a customer rating of 1 out of 5, is an expensive restaurant offering Indian food. It is in city centre near Express by Holiday Inn. Children are welcome.
name[The Punter], eatType[restaurant], food[Indian], priceRange[high], customer rating[1 out of 5], area[riverside], familyFriendly[no], near[Express by Holiday Inn]	The Punter, which customers rate 1 out of 5, is a high-priced restaurant offering Indian cuisine. It is in the riverside area by Express by Holiday Inn. It is not kid-friendly.
name[The Punter], eatType[restaurant], food[Indian], priceRange[high], customer rating[1 out of 5], area[riverside], familyFriendly[yes], near[Express by Holiday Inn]	The Punter, which has a customer rating of 1 out of 5, is an expensive restaurant serving Indian food. The Punter, which welcomes kids, is located in the riverside near Express by Holiday Inn.
name[The Punter], eatType[restaurant], food[Indian], priceRange[high], customer rating[average], area[city centre], familyFriendly[no], near[Express by Holiday Inn]	The Punter, which has an average customer rating, is a high-priced restaurant serving Indian cuisine. It is located in the city centre area and can be found near Express by Holiday Inn. Children are not welcome.
name[The Punter], eatType[restaurant], food[Indian], priceRange[high], customer rating[average], area[city centre], familyFriendly[yes], near[Express by Holiday Inn]	The Punter, which has an average customer rating, is an expensive restaurant that offers Indian food. It is in city centre near Express by Holiday Inn. Families are welcome.
name[The Punter], eatType[restaurant], food[Indian], priceRange[high], customer rating[average], area[riverside], familyFriendly[no], near[Express by Holiday Inn]	The Punter, which has an average customer rating, is a high-priced restaurant that offers Indian cuisine. It is in the riverside area by Express by Holiday Inn. Kids are not welcome.
name[The Punter], eatType[restaurant], food[Indian], priceRange[high], customer rating[average], area[riverside], familyFriendly[yes], near[Express by Holiday Inn]	The Punter, which has an average customer rating, is an expensive restaurant serving Indian food. Family-friendly The Punter is located in the riverside near Express by Holiday Inn.
name[The Punter], eatType[restaurant], food[Indian], priceRange[less than £20], customer rating[low], area[city centre], familyFriendly[no], near[Express by Holiday Inn]	The Punter, which has a low customer rating, is a low-priced restaurant serving Indian cuisine. It is located in the city centre area and can be found near Express by Holiday Inn. It is not family-friendly.
name[The Punter], eatType[restaurant], food[Indian], priceRange[less than £20], customer rating[low], area[city centre], familyFriendly[yes], near[Express by Holiday Inn]	The Punter, which has a low customer rating, is a cheap restaurant that offers Indian food. It is in city centre near Express by Holiday Inn. It is child-friendly.
name[The Punter], eatType[restaurant], food[Indian], priceRange[less than £20], customer rating[low], area[riverside], familyFriendly[no], near[Express by Holiday Inn]	The Punter, which has a low customer rating, is a low-priced restaurant offering Indian cuisine. It is in the riverside area by Express by Holiday Inn. It is not child-friendly.
name[The Punter], eatType[restaurant], food[Indian], priceRange[less than £20], customer rating[low], area[riverside], familyFriendly[yes], near[Express by Holiday Inn]	The Punter, which has a low customer rating, is a cheap restaurant serving Indian food. Kid-friendly The Punter is located in the riverside near Express by Holiday Inn.
name[The Punter], eatType[restaurant], food[Indian], priceRange[moderate], customer rating[1 out of 5], area[city centre], familyFriendly[no], near[Express by Holiday Inn]	The Punter, which customers rate 1 out of 5, is a mid-priced restaurant that serves Indian cuisine. It is located in the city centre area and can be found near Express by Holiday Inn. It is not kid-friendly.
name[The Punter], eatType[restaurant], food[Indian], priceRange[moderate], customer rating[1 out of 5], area[city centre], familyFriendly[yes], near[Express by Holiday Inn]	The Punter, which has a customer rating of 1 out of 5, is an average-priced restaurant offering Indian food. It is in city centre near Express by Holiday Inn. Children are welcome.
name[The Punter], eatType[restaurant], food[Indian], priceRange[moderate], customer rating[1 out of 5], area[riverside], familyFriendly[no], near[Express by Holiday Inn]	Moderately priced The Punter is a restaurant that offers Indian cuisine. Customers rate The Punter, which is in the riverside area by Express by Holiday Inn, 1 out of 5. Children are not welcome.
name[The Punter], eatType[restaurant], food[Indian], priceRange[moderate], customer rating[1 out of 5], area[riverside], familyFriendly[yes], near[Express by Holiday Inn]	The Punter, which has a customer rating of 1 out of 5, is a mid-priced restaurant that serves Indian food. The Punter, which welcomes kids, is located in the riverside near Express by Holiday Inn.
name[The Punter], eatType[restaurant], food[Indian], priceRange[moderate], customer rating[3 out of 5], area[city centre], familyFriendly[no], near[Express by Holiday Inn]	The Punter, which customers rate 3 out of 5, is an average-priced restaurant that serves Indian cuisine. It is located in the city centre area and can be found near Express by Holiday Inn. Kids are not welcome.
name[The Punter], eatType[restaurant], food[Indian], priceRange[moderate], customer rating[3 out of 5], area[city centre], familyFriendly[yes], near[Express by Holiday Inn]	Moderately priced The Punter is a restaurant offering Indian food. It has a customer rating of 3 out of 5. It is in city centre near Express by Holiday Inn. Families are welcome.
name[The Punter], eatType[restaurant], food[Indian], priceRange[moderate], customer rating[3 out of 5], area[riverside], familyFriendly[no], near[Express by Holiday Inn]	The Punter, which customers rate 3 out of 5, is a mid-priced restaurant that offers Indian cuisine. It is in the riverside area by Express by Holiday Inn. It is not family-friendly.
name[The Punter], eatType[restaurant], food[Indian], priceRange[moderate], customer rating[3 out of 5], area[riverside], familyFriendly[yes], near[Express by Holiday Inn]	The Punter, which has a customer rating of 3 out of 5, is an average-priced restaurant that serves Indian food. Family-friendly The Punter is located in the riverside near Express by Holiday Inn.
name[The Punter], eatType[restaurant], food[Indian], priceRange[more than £30], customer rating[high], area[city centre], familyFriendly[no], near[Express by Holiday Inn]	The Punter, which has a high customer rating, is a high-priced restaurant that serves Indian cuisine. It is located in the city centre area and can be found near Express by Holiday Inn. It is not child-friendly.
name[The Punter], eatType[restaurant], food[Indian], priceRange[more than £30], customer rating[high], area[city centre], familyFriendly[yes], near[Express by Holiday Inn]	The Punter, which has a high customer rating, is an expensive restaurant that offers Indian food. It is in city centre near Express by Holiday Inn. It is child-friendly.
name[The Punter], eatType[restaurant], food[Indian], priceRange[more than £30], customer rating[high], area[riverside], familyFriendly[no], near[Express by Holiday Inn]	The Punter, which has a high customer rating, is a high-priced restaurant offering Indian cuisine. It is in the riverside area by Express by Holiday Inn. It is not kid-friendly.
name[The Punter], eatType[restaurant], food[Indian], priceRange[more than £30], customer rating[high], area[riverside], familyFriendly[yes], near[Express by Holiday Inn]	The Punter, which has a high customer rating, is an expensive restaurant serving Indian food. Kid-friendly The Punter is located in the riverside near Express by Holiday Inn.
name[The Punter], eatType[restaurant], food[Italian], priceRange[£20-25], customer rating[high], area[city centre], familyFriendly[no], near[Express by Holiday Inn]	Moderately priced The Punter is a restaurant serving Italian cuisine. It has a high customer rating. It is located in the city centre area and can be found near Express by Holiday Inn. Children are not welcome.
name[The Punter], eatType[restaurant], food[Italian], priceRange[£20-25], customer rating[high], area[city centre], familyFriendly[yes], near[Express by Holiday Inn]	The Punter, which has a high customer rating, is a mid-priced restaurant that offers Italian food. It is in city centre near Express by Holiday Inn. Children are welcome.
name[The Punter], eatType[restaurant], food[Italian], priceRange[£20-25], customer rating[high], area[riverside], familyFriendly[no], near[Express by Holiday Inn]	The Punter, which has a high customer rating, is an average-priced restaurant that offers Italian cuisine. It is in the riverside area by Express by Holiday Inn. Kids are not welcome.
name[The Punter], eatType[restaurant], food[Italian], priceRange[£20-25], customer rating[high], area[riverside], familyFriendly[yes], near[Express by Holiday Inn]	Moderately priced The Punter is a restaurant serving Italian food. It has a high customer rating. The Punter, which welcomes kids, is located in the riverside near Express by Holiday Inn.
name[The Punter], eatType[restaurant], food[Italian], priceRange[cheap], customer rating[5 out of 5], area[city centre], familyFriendly[no], near[Express by Holiday Inn]	The Punter, which customers rate 5 out of 5, is a low-priced restaurant that serves Italian cuisine. It is located in the city centre area and can be found near Express by Holiday Inn. It is not family-friendly.
name[The Punter], eatType[restaurant], food[Italian], priceRange[cheap], customer rating[5 out of 5], area[city centre], familyFriendly[no], near[Rainbow Vegetarian Café]	The Punter, which has a customer rating of 5 out of 5, is a cheap restaurant that offers Italian food. It is in city centre near Rainbow Vegetarian Café. It is not child-friendly.
name[The Punter], eatType[restaurant], food[Italian], priceRange[cheap], customer rating[5 out of 5], area[city centre], familyFriendly[yes], near[Rainbow Vegetarian Café]	The Punter, which customers rate 5 out of 5, is a low-priced restaurant offering Italian cuisine. It is in the city centre area by Rainbow Vegetarian Café. Families are welcome.
name[The Punter], eatType[restaurant], food[Italian], priceRange[cheap], customer rating[5 out of 5], area[riverside], familyFriendly[no], near[Rainbow Vegetarian Café]	The Punter, which has a customer rating of 5 out of 5, is a cheap restaurant that serves Italian food. Non-kid-friendly The Punter is located in the riverside near Rainbow Vegetarian Café.
name[The Punter], eatType[restaurant], food[Italian], priceRange[cheap], customer rating[5 out of 5], area[riverside], familyFriendly[yes], near[Rainbow Vegetarian Café]	The Punter, which customers rate 5 out of 5, is a low-priced restaurant that serves Italian cuisine. It is located in the riverside area and can be found near Rainbow Vegetarian Café. It is family-friendly.
name[The Punter], eatType[restaurant], food[Italian], priceRange[cheap], customer rating[average], area[city centre], familyFriendly[no], near[Rainbow Vegetarian Café]	The Punter, which has an average customer rating, is a cheap restaurant offering Italian food. It is in city centre near Rainbow Vegetarian Café. Children are not welcome.
name[The Punter], eatType[restaurant], food[Italian], priceRange[cheap], customer rating[average], area[city centre], familyFriendly[yes], near[Rainbow Vegetarian Café]	The Punter, which has an average customer rating, is a low-priced restaurant offering Italian cuisine. It is in the city centre area by Rainbow Vegetarian Café. It is child-friendly.
name[The Punter], eatType[restaurant], food[Italian], priceRange[cheap], customer rating[average], area[riverside], familyFriendly[no], near[Rainbow Vegetarian Café]	The Punter, which has an average customer rating, is a cheap restaurant serving Italian food. The Punter, which does not welcome kids, is located in the riverside near Rainbow Vegetarian Café.
name[The Punter], eatType[restaurant], food[Italian], priceRange[cheap], customer rating[average], area[riverside], familyFriendly[yes], near[Rainbow Vegetarian Café]	The Punter, which has an average customer rating, is a low-priced restaurant serving Italian cuisine. It is located in the riverside area and can be found near Rainbow Vegetarian Café. It is kid-friendly.
name[The Punter], eatType[restaurant], food[Italian], priceRange[high], customer rating[1 out of 5], area[city centre], familyFriendly[no], near[Rainbow Vegetarian Café]	The Punter, which has a customer rating of 1 out of 5, is a high-priced restaurant that offers Italian food. It is in city centre near Rainbow Vegetarian Café. It is not family-friendly.
name[The Punter], eatType[restaurant], food[Italian], priceRange[high], customer rating[1 out of 5], area[city centre], familyFriendly[yes], near[Rainbow Vegetarian Café]	The Punter, which customers rate 1 out of 5, is an expensive restaurant that offers Italian cuisine. It is in the city centre area by Rainbow Vegetarian Café. Children are welcome.
name[The Punter], eatType[restaurant], food[Italian], priceRange[high], customer rating[1 out of 5], area[riverside], familyFriendly[no], near[Rainbow Vegetarian Café]	The Punter, which has a customer rating of 1 out of 5, is a high-priced restaurant that serves Italian food. Non-child-friendly The Punter is located in the riverside near Rainbow Vegetarian Café.
name[The Punter], eatType[restaurant], food[Italian], priceRange[high], customer rating[1 out of 5], area[riverside], familyFriendly[yes], near[Rainbow Vegetarian Café]	The Punter, which customers rate 1 out of 5, is an expensive restaurant that serves Italian cuisine. It is located in the riverside area and can be found near Rainbow Vegetarian Café. Kids are welcome.
name[The Vaults], eatType[pub], food[French], priceRange[high], area[riverside], familyFriendly[yes], near[Raja Indian Cuisine]	The Vaults, which is in riverside near Raja Indian Cuisine, is a high-priced pub that offers French food. Families are welcome.
name[The Vaults], eatType[pub], food[French], priceRange[less than £20], area[city centre], familyFriendly[no], near[Raja Indian Cuisine]	The Vaults, which is in the city centre area by Raja Indian Cuisine, is a cheap pub that offers French cuisine. It is not kid-friendly.
name[The Vaults], eatType[pub], food[French], priceRange[less than £20], area[city centre], familyFriendly[yes], near[Raja Indian Cuisine]	The Vaults, which is located in the city centre near Raja Indian Cuisine, is a low-priced pub serving French food. It is family-friendly.
name[The Vaults], eatType[pub], food[French], priceRange[less than £20], area[riverside], familyFriendly[no], near[Raja Indian Cuisine]	The Vaults, which does not welcome children, is a cheap pub serving French cuisine. It is located in the riverside area and can be found near Raja Indian Cuisine.
name[The Vaults], eatType[pub], food[French], priceRange[less than £20], area[riverside], familyFriendly[yes], near[Raja Indian Cuisine]	The Vaults, which is in riverside near Raja Indian Cuisine, is a low-priced pub that offers French food. It is child-friendly.
name[The Vaults], eatType[pub], food[French], priceRange[moderate], area[city centre], familyFriendly[no], near[Raja Indian Cuisine]	The Vaults, which is in the city centre area by Raja Indian Cuisine, is a mid-priced pub that offers French cuisine. Kids are not welcome.
name[The Vaults], eatType[pub], food[French], priceRange[moderate], area[city centre], familyFriendly[yes], near[Raja Indian Cuisine]	The Vaults, which is located in the city centre near Raja Indian Cuisine, is an average-priced pub that serves French food. It is kid-friendly.
name[The Vaults], eatType[pub], food[French], priceRange[moderate], area[riverside], familyFriendly[no], near[Raja Indian Cuisine]	Moderately priced The Vaults is a pub that serves French cuisine. It is located in the riverside area and can be found near Raja Indian Cuisine. It is not family-friendly.
name[The Vaults], eatType[pub], food[French], priceRange[moderate], area[riverside], familyFriendly[yes], near[Raja Indian Cuisine]	The Vaults, which is in riverside near Raja Indian Cuisine, is a mid-priced pub that offers French food. Children are welcome.
name[The Vaults], eatType[pub], food[French], priceRange[more than £30], area[city centre], familyFriendly[no], near[Raja Indian Cuisine]	The Vaults, which is in the city centre area by Raja Indian Cuisine, is an expensive pub offering French cuisine. It is not child-friendly.
name[The Vaults], eatType[pub], food[French], priceRange[more than £30], area[city centre], familyFriendly[yes], near[Raja Indian Cuisine]	The Vaults, which is located in the city centre near Raja Indian Cuisine, is a high-priced pub that serves French food. Kids are welcome.
name[The Vaults], eatType[pub], food[French], priceRange[more than £30], area[riverside], familyFriendly[no], near[Raja Indian Cuisine]	Non-kid-friendly The Vaults is an expensive pub that serves French cuisine. It is located in the riverside area and can be found near Raja Indian Cuisine.
name[The Vaults], eatType[pub], food[French], priceRange[more than £30], area[riverside], familyFriendly[yes], near[Raja Indian Cuisine]	The Vaults, which is in riverside near Raja Indian Cuisine, is a high-priced pub offering French food. Families are welcome.
name[The Vaults], eatType[pub], food[Indian], priceRange[£20-25], area[riverside], familyFriendly[yes], near[Raja Indian Cuisine]	The Vaults, which is in the riverside area by Raja Indian Cuisine, is an average-priced pub that offers Indian cuisine. It is family-friendly.
name[The Vaults], eatType[pub], food[Indian], priceRange[cheap], area[riverside], familyFriendly[yes], near[Raja Indian Cuisine]	The Vaults, which is located in the riverside near Raja Indian Cuisine, is a cheap pub that serves Indian food. It is child-friendly.
name[The Vaults], eatType[pub], food[Indian], priceRange[high], area[city centre], familyFriendly[no], near[Raja Indian Cuisine]	The Vaults, which does not welcome children, is an expensive pub that serves Indian cuisine. It is located in the city centre area and can be found near Raja Indian Cuisine.
name[The Vaults], eatType[pub], food[Indian], priceRange[high], area[city centre], familyFriendly[yes], near[Raja Indian Cuisine]	The Vaults, which is in city centre near Raja Indian Cuisine, is a high-priced pub that offers Indian food. It is kid-friendly.
name[The Vaults], eatType[pub], food[Italian], priceRange[high], customer rating[average], area[city centre], familyFriendly[no], near[Rainbow Vegetarian Café]	The Vaults, which has an average customer rating, is an expensive pub offering Italian cuisine. It is in the city centre area by Rainbow Vegetarian Café. Kids are not welcome.
name[The Vaults], eatType[pub], food[Italian], priceRange[high], customer rating[average], area[city centre], familyFriendly[yes], near[Rainbow Vegetarian Café]	The Vaults, which has an average customer rating, is a high-priced pub serving Italian food. The Vaults, which welcomes children, is located in the city centre near Rainbow Vegetarian Café.
name[The Vaults], eatType[pub], food[Italian], priceRange[high], customer rating[average], area[riverside], familyFriendly[no], near[Rainbow Vegetarian Café]	The Vaults, which has an average customer rating, is an expensive pub that serves Italian cuisine. It is located in the riverside area and can be found near Rainbow Vegetarian Café. It is not family-friendly.
name[The Vaults], eatType[pub], food[Italian], priceRange[high], customer rating[average], area[riverside], familyFriendly[yes], near[Rainbow Vegetarian Café]	The Vaults, which has an average customer rating, is a high-priced pub offering Italian food. It is in riverside near Rainbow Vegetarian Café. Kids are welcome.
name[The Vaults], eatType[pub], food[Italian], priceRange[less than £20], customer rating[low], area[city centre], familyFriendly[no], near[Rainbow Vegetarian Café]	The Vaults, which has a low customer rating, is a low-priced pub offering Italian cuisine. It is in the city centre area by Rainbow Vegetarian Café. It is not child-friendly.
name[The Vaults], eatType[pub], food[Italian], priceRange[less than £20], customer rating[low], area[city centre], familyFriendly[yes], near[Rainbow Vegetarian Café]	The Vaults, which has a low customer rating, is a cheap pub serving Italian food. The Vaults, which welcomes families, is located in the city centre near Rainbow Vegetarian Café.
name[The Vaults], eatType[pub], food[Italian], priceRange[less than £20], customer rating[low], area[riverside], familyFriendly[no], near[Rainbow Vegetarian Café]	The Vaults, which has a low customer rating, is a low-priced pub serving Italian cuisine. It is located in the riverside area and can be found near Rainbow Vegetarian Café. It is not kid-friendly.
name[The Vaults], eatType[pub], food[Italian], priceRange[less than £20], customer rating[low], area[riverside], familyFriendly[yes], near[Rainbow Vegetarian Café]	The Vaults, which has a low customer rating, is a cheap pub offering Italian food. It is in riverside near Rainbow Vegetarian Café. It is family-friendly.
name[The Vaults], eatType[pub], food[Italian], priceRange[moderate], customer rating[1 out of 5], area[city centre], familyFriendly[no], near[Rainbow Vegetarian Café]	Moderately priced The Vaults is a pub that offers Italian cuisine. It has a customer rating of 1 out of 5. It is in the city centre area by Rainbow Vegetarian Café. Children are not welcome.
name[The Vaults], eatType[pub], food[Italian], priceRange[moderate], customer rating[1 out of 5], area[city centre], familyFriendly[yes], near[Rainbow Vegetarian Café]	The Vaults, which customers rate 1 out of 5, is a mid-priced pub that serves Italian food. It is located in the city centre near Rainbow Vegetarian Café. It is child-friendly.
name[The Vaults], eatType[pub], food[Italian], priceRange[moderate], customer rating[1 out of 5], area[riverside], familyFriendly[no], near[Rainbow Vegetarian Café]	The Vaults, which has a customer rating of 1 out of 5, is an average-priced pub serving Italian cuisine. It is located in the riverside area and can be found near Rainbow Vegetarian Café. Kids are not welcome.
name[The Vaults], eatType[pub], food[Italian], priceRange[moderate], customer rating[1 out of 5], area[riverside], familyFriendly[yes], near[Rainbow Vegetarian Café]	Moderately priced The Vaults is a pub that offers Italian food. Customers rate The Vaults, which is in riverside near Rainbow Vegetarian Café, 1 out of 5. It is kid-friendly.
name[The Vaults], eatType[pub], food[Italian], priceRange[moderate], customer rating[3 out of 5], area[city centre], familyFriendly[no], near[Rainbow Vegetarian Café]	The Vaults, which has a customer rating of 3 out of 5, is a mid-priced pub offering Italian cuisine. It is in the city centre area by Rainbow Vegetarian Café. It is not family-friendly.
name[The Vaults], eatType[pub], food[Italian], priceRange[moderate], customer rating[3 out of 5], area[city centre], familyFriendly[yes], near[Rainbow Vegetarian Café]	The Vaults, which customers rate 3 out of 5, is an average-priced pub serving Italian food. It is located in the city centre near Rainbow Vegetarian Café. Children are welcome.
name[The Vaults], eatType[pub], food[Italian], priceRange[moderate], customer rating[3 out of 5], area[riverside], familyFriendly[no], near[Rainbow Vegetarian Café]	Moderately priced The Vaults is a pub that serves Italian cuisine. It has a customer rating of 3 out of 5. It is located in the riverside area and can be found near Rainbow Vegetarian Café. It is not child-friendly.
name[The Vaults], eatType[pub], food[Italian], priceRange[moderate], customer rating[3 out of 5], area[riverside], familyFriendly[yes], near[Rainbow Vegetarian Café]	The Vaults, which customers rate 3 out of 5, is a mid-priced pub that offers Italian food. It is in riverside near Rainbow Vegetarian Café. Kids are welcome.
name[The Vaults], eatType[pub], food[Italian], priceRange[more than £30], customer rating[high], area[city centre], familyFriendly[no], near[Rainbow Vegetarian Café]	The Vaults, which has a high customer rating, is an expensive pub that offers Italian cuisine. It is in the city centre area by Rainbow Vegetarian Café. It is not kid-friendly.
name[The Vaults], eatType[pub], food[Italian], priceRange[more than £30], customer rating[high], area[city centre], familyFriendly[yes], near[Rainbow Vegetarian Café]	The Vaults, which has a high customer rating, is a high-priced pub serving Italian food. The Vaults, which welcomes families, is located in the city centre near Rainbow Vegetarian Café.
name[The Vaults], eatType[pub], food[Italian], priceRange[more than £30], customer rating[high], area[riverside], familyFriendly[no], near[Rainbow Vegetarian Café]	The Vaults, which has a high customer rating, is an expensive pub serving Italian cuisine. It is located in the riverside area and can be found near Rainbow Vegetarian Café. Children are not welcome.
name[The Vaults], eatType[pub], food[Italian], priceRange[more than £30], customer rating[high], area[riverside], familyFriendly[yes], near[Rainbow Vegetarian Café]	The Vaults, which has a high customer rating, is a high-priced pub offering Italian food. It is in riverside near Rainbow Vegetarian Café. It is family-friendly.
name[The Vaults], eatType[pub], food[Japanese], priceRange[£20-25], customer rating[3 out of 5], area[city centre], familyFriendly[no], near[Rainbow Vegetarian Café]	The Vaults, which has a customer rating of 3 out of 5, is an average-priced pub offering Japanese cuisine. It is in the city centre area by Rainbow Vegetarian Café. Kids are not welcome.
name[The Vaults], eatType[pub], food[Japanese], priceRange[£20-25], customer rating[3 out of 5], area[city centre], familyFriendly[yes], near[Rainbow Vegetarian Café]	Moderately priced The Vaults is a pub that serves Japanese food. Customers rate The Vaults, which is located in the city centre near Rainbow Vegetarian Café, 3 out of 5. It is child-friendly.
name[The Vaults], eatType[pub], food[Japanese], priceRange[£20-25], customer rating[3 out of 5], area[riverside], familyFriendly[no], near[Rainbow Vegetarian Café]	The Vaults, which has a customer rating of 3 out of 5, is a mid-priced pub serving Japanese cuisine. It is located in the riverside area and can be found near Rainbow Vegetarian Café. It is not family-friendly.
name[The Vaults], eatType[pub], food[Japanese], priceRange[£20-25], customer rating[3 out of 5], area[riverside], familyFriendly[yes], near[Rainbow Vegetarian Café]	The Vaults, which customers rate 3 out of 5, is an average-priced pub offering Japanese food. It is in riverside near Rainbow Vegetarian Café. It is kid-friendly.
name[The Vaults], eatType[pub], food[Japanese], priceRange[£20-25], customer rating[high], area[city centre], familyFriendly[no], near[Rainbow Vegetarian Café]	Moderately priced The Vaults is a pub that offers Japanese cuisine. It has a high customer rating. It is in the city centre area by Rainbow Vegetarian Café. It is not child-friendly.
name[The Vaults], eatType[pub], food[Japanese], priceRange[£20-25], customer rating[high], area[city centre], familyFriendly[yes], near[Rainbow Vegetarian Café]	The Vaults, which has a high customer rating, is a mid-priced pub that serves Japanese food. The Vaults, which welcomes children, is located in the city centre near Rainbow Vegetarian Café.
name[The Vaults], eatType[pub], food[Japanese], priceRange[£20-25], customer rating[high], area[riverside], familyFriendly[no], near[Rainbow Vegetarian Café]	The Vaults, which has a high customer rating, is an average-priced pub that serves Japanese cuisine. It is located in the riverside area and can be found near Rainbow Vegetarian Café. It is not kid-friendly.
name[The Vaults], eatType[pub], food[Japanese], priceRange[£20-25], customer rating[high], area[riverside], familyFriendly[no], near[Raja Indian Cuisine]	Moderately priced The Vaults is a pub that offers Japanese food. It has a high customer rating. It is in riverside near Raja Indian Cuisine. Children are not welcome.
name[The Vaults], eatType[pub], food[Japanese], priceRange[£20-25], customer rating[high], area[riverside], familyFriendly[yes], near[Raja Indian Cuisine]	The Vaults, which has a high customer rating, is a mid-priced pub that offers Japanese cuisine. It is in the riverside area by Raja Indian Cuisine. Kids are welcome.
name[The Vaults], eatType[pub], food[Japanese], priceRange[cheap], customer rating[5 out of 5], area[city centre], familyFriendly[no], near[Raja Indian Cuisine]	The Vaults, which has a customer rating of 5 out of 5, is a low-priced pub serving Japanese food. The Vaults, which does not welcome kids, is located in the city centre near Raja Indian Cuisine.
name[The Vaults], eatType[pub], food[Japanese], priceRange[cheap], customer rating[5 out of 5], area[city centre], familyFriendly[yes], near[Raja Indian Cuisine]	The Vaults, which customers rate 5 out of 5, is a cheap pub that serves Japanese cuisine. It is located in the city centre area and can be found near Raja Indian Cuisine. Families are welcome.
name[The Vaults], eatType[pub], food[Japanese], priceRange[cheap], customer rating[5 out of 5], area[riverside], familyFriendly[no], near[Raja Indian Cuisine]	The Vaults, which has a customer rating of 5 out of 5, is a low-priced pub that offers Japanese food. It is in riverside near Raja Indian Cuisine. It is not family-friendly.
name[The Vaults], eatType[pub], food[Japanese], priceRange[cheap], customer rating[5 out of 5], area[riverside], familyFriendly[yes], near[Raja Indian Cuisine]	The Vaults, which customers rate 5 out of 5, is a cheap pub that offers Japanese cuisine. It is in the riverside area by Raja Indian Cuisine. It is family-friendly.
name[The Vaults], eatType[pub], food[Japanese], priceRange[high], customer rating[3 out of 5], area[city centre], familyFriendly[no], near[Raja Indian Cuisine]	The Vaults, which has a customer rating of 3 out of 5, is an expensive pub that serves Japanese food. Non-child-friendly The Vaults is located in the city centre near Raja Indian Cuisine.
name[The Vaults], eatType[pub], food[Japanese], priceRange[high], customer rating[3 out of 5], area[city centre], familyFriendly[yes], near[Raja Indian Cuisine]	The Vaults, which customers rate 3 out of 5, is a high-priced pub serving Japanese cuisine. It is located in the city centre area and can be found near Raja Indian Cuisine. It is child-friendly.
name[The Vaults], eatType[pub], food[Japanese], priceRange[high], customer rating[3 out of 5], area[riverside], familyFriendly[no], near[Raja Indian Cuisine]	The Vaults, which has a customer rating of 3 out of 5, is an expensive pub offering Japanese food. It is in riverside near Raja Indian Cuisine. It is not kid-friendly.
name[The Vaults], eatType[pub], food[Japanese], priceRange[high], customer rating[3 out of 5], area[riverside], familyFriendly[yes], near[Raja Indian Cuisine]	The Vaults, which customers rate 3 out of 5, is a high-priced pub that offers Japanese cuisine. It is in the riverside area by Raja Indian Cuisine. It is kid-friendly.
name[The Vaults], eatType[pub], food[Japanese], priceRange[less than £20], customer rating[average], area[city centre], familyFriendly[no], near[Raja Indian Cuisine]	The Vaults, which has an average customer rating, is a low-priced pub that serves Japanese food. The Vaults, which does not welcome children, is located in the city centre near Raja Indian Cuisine.
name[The Vaults], eatType[pub], food[Japanese], priceRange[less than £20], customer rating[average], area[city centre], familyFriendly[yes], near[Raja Indian Cuisine]	The Vaults, which has an average customer rating, is a cheap pub that serves Japanese cuisine. It is located in the city centre area and can be found near Raja Indian Cuisine. Children are welcome.
name[The Vaults], eatType[pub], food[Japanese], priceRange[less than £20], customer rating[average], area[riverside], familyFriendly[no], near[Raja Indian Cuisine]	The Vaults, which has an average customer rating, is a low-priced pub offering Japanese food. It is in riverside near Raja Indian Cuisine. Kids are not welcome.
name[The Vaults], eatType[pub], food[Japanese], priceRange[less than £20], customer rating[average], area[riverside], familyFriendly[yes], near[Raja Indian Cuisine]	The Vaults, which has an average customer rating, is a cheap pub that offers Japanese cuisine. It is in the riverside area by Raja Indian Cuisine. Kids are welcome.
name[The Vaults], eatType[pub], food[Japanese], priceRange[less than £20], customer rating[low], area[city centre], familyFriendly[no], near[Raja Indian Cuisine]	The Vaults, which has a low customer rating, is a low-priced pub that serves Japanese food. Non-family-friendly The Vaults is located in the city centre near Raja Indian Cuisine.
name[The Vaults], eatType[pub], food[Japanese], priceRange[less than £20], customer rating[low], area[city centre], familyFriendly[yes], near[Raja Indian Cuisine]	The Vaults, which has a low customer rating, is a cheap pub that serves Japanese cuisine. It is located in the city centre area and can be found near Raja Indian Cuisine. Families are welcome.
name[The Vaults], eatType[pub], food[Japanese], priceRange[less than £20], customer rating[low], area[riverside], familyFriendly[no], near[Raja Indian Cuisine]	The Vaults, which has a low customer rating, is a low-priced pub that offers Japanese food. It is in riverside near Raja Indian Cuisine. It is not child-friendly.
name[The Vaults], eatType[pub], food[Japanese], priceRange[less than £20], customer rating[low], area[riverside], familyFriendly[yes], near[Raja Indian Cuisine]	The Vaults, which has a low customer rating, is a cheap pub that offers Japanese cuisine. It is in the riverside area by Raja Indian Cuisine. It is family-friendly.
name[The Vaults], eatType[pub], food[Japanese], priceRange[moderate], customer rating[1 out of 5], area[city centre], familyFriendly[no], near[Raja Indian Cuisine]	The Vaults, which has a customer rating of 1 out of 5, is an average-priced pub that serves Japanese food. Non-kid-friendly The Vaults is located in the city centre near Raja Indian Cuisine.
name[The Vaults], eatType[pub], food[Japanese], priceRange[moderate], customer rating[1 out of 5], area[city centre], familyFriendly[yes], near[Raja Indian Cuisine]	Moderately priced The Vaults is a pub that serves Japanese cuisine. Customers rate child-friendly The Vaults 1 out of 5. It is located in the city centre area and can be found near Raja Indian Cuisine.
name[The Vaults], eatType[restaurant], food[French], priceRange[high], area[riverside], familyFriendly[yes], near[Raja Indian Cuisine]	The Vaults, which is in riverside near Raja Indian Cuisine, is an expensive restaurant that offers French food. It is kid-friendly.
name[The Vaults], eatType[restaurant], food[French], priceRange[less than £20], area[city centre], familyFriendly[no], near[Raja Indian Cuisine]	The Vaults, which is in the city centre area by Raja Indian Cuisine, is a low-priced restaurant offering French cuisine. Children are not welcome.
name[The Vaults], eatType[restaurant], food[French], priceRange[less than £20], area[city centre], familyFriendly[yes], near[Raja Indian Cuisine]	The Vaults, which is located in the city centre near Raja Indian Cuisine, is a cheap restaurant serving French food. Children are welcome.
name[The Vaults], eatType[restaurant], food[French], priceRange[less than £20], area[riverside], familyFriendly[no], near[Raja Indian Cuisine]	The Vaults, which does not welcome kids, is a low-priced restaurant that serves French cuisine. It is located in the riverside area and can be found near Raja Indian Cuisine.
name[The Vaults], eatType[restaurant], food[French], priceRange[less than £20], area[riverside], familyFriendly[yes], near[Raja Indian Cuisine]	The Vaults, which is in riverside near Raja Indian Cuisine, is a cheap restaurant offering French food. Kids are welcome.
name[The Vaults], eatType[restaurant], food[French], priceRange[moderate], area[city centre], familyFriendly[no], near[Raja Indian Cuisine]	The Vaults, which is in the city centre area by Raja Indian Cuisine, is a mid-priced restaurant that offers French cuisine. It is not family-friendly.
name[The Vaults], eatType[restaurant], food[French], priceRange[moderate], area[city centre], familyFriendly[yes], near[Raja Indian Cuisine]	The Vaults, which is located in the city centre near Raja Indian Cuisine, is an average-priced restaurant serving French food. Families are welcome.
name[The Vaults], eatType[restaurant], food[French], priceRange[moderate], area[riverside], familyFriendly[no], near[Raja Indian Cuisine]	Moderately priced The Vaults is a restaurant serving French cuisine. It is located in the riverside area and can be found near Raja Indian Cuisine. It is not child-friendly.
name[The Vaults], eatType[restaurant], food[French], priceRange[moderate], area[riverside], familyFriendly[yes], near[Raja Indian Cuisine]	The Vaults, which is in riverside near Raja Indian Cuisine, is a mid-priced restaurant that offers French food. It is family-friendly.
name[The Vaults], eatType[restaurant], food[French], priceRange[more than £30], area[city centre], familyFriendly[no], near[Raja Indian Cuisine]	The Vaults, which is in the city centre area by Raja Indian Cuisine, is a high-priced restaurant offering French cuisine. It is not kid-friendly.
name[The Vaults], eatType[restaurant], food[French], priceRange[more than £30], area[city centre], familyFriendly[yes], near[Raja Indian Cuisine]	The Vaults, which is located in the city centre near Raja Indian Cuisine, is an expensive restaurant serving French food. It is child-friendly.
name[The Vaults], eatType[restaurant], food[French], priceRange[more than £30], area[riverside], familyFriendly[no], near[Raja Indian Cuisine]	The Vaults, which does not welcome children, is a high-priced restaurant serving French cuisine. It is located in the riverside area and can be found near Raja Indian Cuisine.
name[The Vaults], eatType[restaurant], food[French], priceRange[more than £30], area[riverside], familyFriendly[yes], near[Raja Indian Cuisine]	The Vaults, which is in riverside near Raja Indian Cuisine, is an expensive restaurant that offers French food. It is kid-friendly.
name[The Vaults], eatType[restaurant], food[Indian], priceRange[£20-25], area[riverside], familyFriendly[yes], near[Raja Indian Cuisine]	The Vaults, which is in the riverside area by Raja Indian Cuisine, is an average-priced restaurant that offers Indian cuisine. Children are welcome.
name[The Vaults], eatType[restaurant], food[Indian], priceRange[cheap], area[riverside], familyFriendly[yes], near[Raja Indian Cuisine]	The Vaults, which is located in the riverside near Raja Indian Cuisine, is a low-priced restaurant that serves Indian food. Kids are welcome.
name[The Vaults], eatType[restaurant], food[Indian], priceRange[high], area[city centre], familyFriendly[no], near[Raja Indian Cuisine]	The Vaults, which does not welcome kids, is a high-priced restaurant that serves Indian cuisine. It is located in the city centre area and can be found near Raja Indian Cuisine.
name[The Vaults], eatType[restaurant], food[Indian], priceRange[high], area[city centre], familyFriendly[yes], near[Raja Indian Cuisine]	The Vaults, which is in city centre near Raja Indian Cuisine, is an expensive restaurant that offers Indian food. Families are welcome.
name[The Waterman], eatType[pub], food[Indian], priceRange[high], area[city centre], familyFriendly[yes], near[Raja Indian Cuisine]	The Waterman, which is in the city centre area by Raja Indian Cuisine, is a high-priced pub offering Indian cuisine. It is family-friendly.
name[The Waterman], eatType[pub], food[Indian], priceRange[high], area[riverside], familyFriendly[no], near[Raja Indian Cuisine]	The Waterman, which is located in the riverside near Raja Indian Cuisine, is an expensive pub that serves Indian food. It is not family-friendly.
name[The Waterman], eatType[pub], food[Indian], priceRange[high], area[riverside], familyFriendly[yes], near[Raja Indian Cuisine]	Child-friendly The Waterman is a high-priced pub serving Indian cuisine. It is located in the riverside area and can be found near Raja Indian Cuisine.
name[The Waterman], eatType[pub], food[Indian], priceRange[less than £20], area[city centre], familyFriendly[no], near[Raja Indian Cuisine]	The Waterman, which is in city centre near Raja Indian Cuisine, is a cheap pub offering Indian food. It is not child-friendly.
name[The Waterman], eatType[pub], food[Indian], priceRange[less than £20], area[city centre], familyFriendly[yes], near[Raja Indian Cuisine]	The Waterman, which is in the city centre area by Raja Indian Cuisine, is a low-priced pub that offers Indian cuisine. It is kid-friendly.
name[The Waterman], eatType[pub], food[Indian], priceRange[less than £20], area[riverside], familyFriendly[no], near[Raja Indian Cuisine]	The Waterman, which is located in the riverside near Raja Indian Cuisine, is a cheap pub that serves Indian food. It is not kid-friendly.
name[The Waterman], eatType[pub], food[Indian], priceRange[less than £20], area[riverside], familyFriendly[yes], near[Raja Indian Cuisine]	The Waterman, which welcomes children, is a low-priced pub that serves Indian cuisine. It is located in the riverside area and can be found near Raja Indian Cuisine.
name[The Waterman], eatType[pub], food[Indian], priceRange[moderate], area[city centre], familyFriendly[no], near[Raja Indian Cuisine]	Moderately priced The Waterman is a pub offering Indian food. It is in city centre near Raja Indian Cuisine. Children are not welcome.
name[The Waterman], eatType[pub], food[Indian], priceRange[moderate], area[city centre], familyFriendly[yes], near[Raja Indian Cuisine]	The Waterman, which is in the city centre area by Raja Indian Cuisine, is a mid-priced pub that offers Indian cuisine. Kids are welcome.
name[The Waterman], eatType[pub], food[Indian], priceRange[moderate], area[riverside], familyFriendly[no], near[Raja Indian Cuisine]	The Waterman, which is located in the riverside near Raja Indian Cuisine, is an average-priced pub serving Indian food. Kids are not welcome.
name[The Waterman], eatType[pub], food[Indian], priceRange[moderate], area[riverside], familyFriendly[yes], near[Raja Indian Cuisine]	Moderately priced The Waterman is a pub that serves Indian cuisine. It is located in the riverside area and can be found near Raja Indian Cuisine. Families are welcome.
name[The Waterman], eatType[pub], food[Indian], priceRange[more than £30], area[riverside], familyFriendly[yes], near[Raja Indian Cuisine]	The Waterman, which is in riverside near Raja Indian Cuisine, is an expensive pub that offers Indian food. It is family-friendly.
name[The Waterman], eatType[pub], food[Italian], priceRange[£20-25], area[riverside], familyFriendly[yes], near[Raja Indian Cuisine]	The Waterman, which is in the riverside area by Raja Indian Cuisine, is a mid-priced pub offering Italian cuisine. It is child-friendly.
name[The Waterman], eatType[pub], food[Italian], priceRange[cheap], area[riverside], familyFriendly[yes], near[Raja Indian Cuisine]	The Waterman, which is located in the riverside near Raja Indian Cuisine, is a cheap pub serving Italian food. It is kid-friendly.
name[The Waterman], eatType[pub], food[Italian], priceRange[high], area[city centre], familyFriendly[no], near[Raja Indian Cuisine]	Non-family-friendly The Waterman is a high-priced pub serving Italian cuisine. It is located in the city centre area and can be found near Raja Indian Cuisine.
name[The Waterman], eatType[pub], food[Italian], priceRange[high], area[city centre], familyFriendly[yes], near[Raja Indian Cuisine]	The Waterman, which is in city centre near Raja Indian Cuisine, is an expensive pub that offers Italian food. Children are welcome.
name[The Waterman], eatType[pub], food[Italian], priceRange[high], area[riverside], familyFriendly[no], near[Raja Indian Cuisine]	The Waterman, which is in the riverside area by Raja Indian Cuisine, is a high-priced pub offering Italian cuisine. It is not child-friendly.
name[The Waterman], eatType[pub], food[Italian], priceRange[high], area[riverside], familyFriendly[yes], near[Raja Indian Cuisine]	The Waterman, which is located in the riverside near Raja Indian Cuisine, is an expensive pub serving Italian food. Kids are welcome.
name[The Waterman], eatType[pub], food[Italian], priceRange[less than £20], area[city centre], familyFriendly[no], near[Raja Indian Cuisine]	Non-kid-friendly The Waterman is a low-priced pub serving Italian cuisine. It is located in the city centre area and can be found near Raja Indian Cuisine.
name[The Waterman], eatType[pub], food[Italian], priceRange[less than £20], area[city centre], familyFriendly[yes], near[Raja Indian Cuisine]	The Waterman, which is in city centre near Raja Indian Cuisine, is a cheap pub offering Italian food. Families are welcome.
name[The Waterman], eatType[pub], food[Italian], priceRange[less than £20], area[riverside], familyFriendly[no], near[Raja Indian Cuisine]	The Waterman, which is in the riverside area by Raja Indian Cuisine, is a low-priced pub that offers Italian cuisine. Children are not welcome.
name[The Waterman], eatType[restaurant], food[Indian], priceRange[high], area[city centre], familyFriendly[yes], near[Raja Indian Cuisine]	The Waterman, which is located in the city centre near Raja Indian Cuisine, is a high-priced restaurant serving Indian food. It is family-friendly.
name[The Waterman], eatType[restaurant], food[Indian], priceRange[high], area[riverside], familyFriendly[no], near[Raja Indian Cuisine]	The Waterman, which does not welcome kids, is an expensive restaurant serving Indian cuisine. It is located in the riverside area and can be found near Raja Indian Cuisine.
name[The Waterman], eatType[restaurant], food[Indian], priceRange[high], area[riverside], familyFriendly[yes], near[Raja Indian Cuisine]	The Waterman, which is in riverside near Raja Indian Cuisine, is a high-priced restaurant offering Indian food. It is child-friendly.
name[The Waterman], eatType[restaurant], food[Indian], priceRange[less than £20], area[city centre], familyFriendly[no], near[Raja Indian Cuisine]	The Waterman, which is in the city centre area by Raja Indian Cuisine, is a cheap restaurant that offers Indian cuisine. It is not family-friendly.
name[The Waterman], eatType[restaurant], food[Indian], priceRange[less than £20], area[city centre], familyFriendly[yes], near[Raja Indian Cuisine]	The Waterman, which is located in the city centre near Raja Indian Cuisine, is a low-priced restaurant serving Indian food. It is kid-friendly.
name[The Waterman], eatType[restaurant], food[Indian], priceRange[less than £20], area[riverside], familyFriendly[no], near[Raja Indian Cuisine]	Non-child-friendly The Waterman is a cheap restaurant that serves Indian cuisine. It is located in the riverside area and can be found near Raja Indian Cuisine.
name[The Waterman], eatType[restaurant], food[Indian], priceRange[less than £20], area[riverside], familyFriendly[yes], near[Raja Indian Cuisine]	The Waterman, which is in riverside near Raja Indian Cuisine, is a low-priced restaurant offering Indian food. Children are welcome.
name[The Waterman], eatType[restaurant], food[Indian], priceRange[moderate], area[city centre], familyFriendly[no], near[Raja Indian Cuisine]	The Waterman, which is in the city centre area by Raja Indian Cuisine, is an average-priced restaurant that offers Indian cuisine. It is not kid-friendly.
name[The Waterman], eatType[restaurant], food[Indian], priceRange[moderate], area[city centre], familyFriendly[yes], near[Raja Indian Cuisine]	Moderately priced The Waterman is a restaurant serving Indian food. The Waterman, which welcomes kids, is located in the city centre near Raja Indian Cuisine.
name[The Waterman], eatType[restaurant], food[Indian], priceRange[moderate], area[riverside], familyFriendly[no], near[Raja Indian Cuisine]	The Waterman, which does not welcome children, is a mid-priced restaurant that serves Indian cuisine. It is located in the riverside area and can be found near Raja Indian Cuisine.
name[The Waterman], eatType[restaurant], food[Indian], priceRange[moderate], area[riverside], familyFriendly[yes], near[Raja Indian Cuisine]	The Waterman, which is in riverside near Raja Indian Cuisine, is an average-priced restaurant that offers Indian food. Families are welcome.
name[The Waterman], eatType[restaurant], food[Indian], priceRange[more than £30], area[riverside], familyFriendly[yes], near[Raja Indian Cuisine]	The Waterman, which is in the riverside area by Raja Indian Cuisine, is an expensive restaurant that offers Indian cuisine. It is family-friendly.
name[The Waterman], eatType[restaurant], food[Italian], priceRange[£20-25], area[riverside], familyFriendly[yes], near[Raja Indian Cuisine]	Moderately priced The Waterman is a restaurant that serves Italian food. Child-friendly The Waterman is located in the riverside near Raja Indian Cuisine.
name[The Waterman], eatType[restaurant], food[Italian], priceRange[cheap], area[riverside], familyFriendly[yes], near[Raja Indian Cuisine]	Kid-friendly The Waterman is a cheap restaurant serving Italian cuisine. It is located in the riverside area and can be found near Raja Indian Cuisine.
name[The Waterman], eatType[restaurant], food[Italian], priceRange[high], area[city centre], familyFriendly[no], near[Raja Indian Cuisine]	The Waterman, which is in city centre near Raja Indian Cuisine, is a high-priced restaurant offering Italian food. Kids are not welcome.
name[The Waterman], eatType[restaurant], food[Italian], priceRange[high], area[city centre], familyFriendly[yes], near[Raja Indian Cuisine]	The Waterman, which is in the city centre area by Raja Indian Cuisine, is an expensive restaurant that offers Italian cuisine. Children are welcome.
name[The Waterman], eatType[restaurant], food[Italian], priceRange[high], area[riverside], familyFriendly[no], near[Raja Indian Cuisine]	The Waterman, which is located in the riverside near Raja Indian Cuisine, is a high-priced restaurant that serves Italian food. It is not family-friendly.
name[The Waterman], eatType[restaurant], food[Italian], priceRange[high], area[riverside], familyFriendly[yes], near[Raja Indian Cuisine]	The Waterman, which welcomes kids, is an expensive restaurant that serves Italian cuisine. It is located in the riverside area and can be found near Raja Indian Cuisine.
name[The Waterman], eatType[restaurant], food[Italian], priceRange[less than £20], area[city centre], familyFriendly[no], near[Raja Indian Cuisine]	The Waterman, which is in city centre near Raja Indian Cuisine, is a low-priced restaurant offering Italian food. It is not child-friendly.
name[The Waterman], eatType[restaurant], food[Italian], priceRange[less than £20], area[city centre], familyFriendly[yes], near[Raja Indian Cuisine]	The Waterman, which is in the city centre area by Raja Indian Cuisine, is a cheap restaurant that offers Italian cuisine. Families are welcome.
name[The Waterman], eatType[restaurant], food[Italian], priceRange[less than £20], area[riverside], familyFriendly[no], near[Raja Indian Cuisine]	The Waterman, which is located in the riverside near Raja Indian Cuisine, is a low-priced restaurant serving Italian food. It is not kid-friendly.
name[The Wrestlers], eatType[pub], food[Italian], priceRange[less than £20], area[riverside], familyFriendly[no], near[Raja Indian Cuisine]	The Wrestlers, which does not welcome children, is a cheap pub serving Italian cuisine. It is located in the riverside area and can be found near Raja Indian Cuisine.
name[The Wrestlers], eatType[pub], food[Italian], priceRange[less than £20], area[riverside], familyFriendly[yes], near[Raja Indian Cuisine]	The Wrestlers, which is in riverside near Raja Indian Cuisine, is a low-priced pub offering Italian food. It is family-friendly.
name[The Wrestlers], eatType[pub], food[Italian], priceRange[moderate], area[city centre], familyFriendly[no], near[Raja Indian Cuisine]	The Wrestlers, which is in the city centre area by Raja Indian Cuisine, is a mid-priced pub offering Italian cuisine. Kids are not welcome.
name[The Wrestlers], eatType[pub], food[Italian], priceRange[moderate], area[city centre], familyFriendly[yes], near[Raja Indian Cuisine]	The Wrestlers, which is located in the city centre near Raja Indian Cuisine, is an average-priced pub that serves Italian food. It is child-friendly.
name[The Wrestlers], eatType[pub], food[Italian], priceRange[moderate], area[riverside], familyFriendly[no], near[Raja Indian Cuisine]	Moderately priced The Wrestlers is a pub serving Italian cuisine. It is located in the riverside area and can be found near Raja Indian Cuisine. It is not family-friendly.
name[The Wrestlers], eatType[pub], food[Italian], priceRange[moderate], area[riverside], familyFriendly[yes], near[Raja Indian Cuisine]	The Wrestlers, which is in riverside near Raja Indian Cuisine, is a mid-priced pub that offers Italian food. It is kid-friendly.
name[The Wrestlers], eatType[pub], food[Italian], priceRange[more than £30], area[riverside], familyFriendly[yes], near[Raja Indian Cuisine]	The Wrestlers, which is in the riverside area by Raja Indian Cuisine, is a high-priced pub offering Italian cuisine. Children are welcome.
name[The Wrestlers], eatType[pub], food[Japanese], priceRange[£20-25], area[riverside], familyFriendly[yes], near[Raja Indian Cuisine]	The Wrestlers, which is located in the riverside near Raja Indian Cuisine, is an average-priced pub serving Japanese food. Kids are welcome.
name[The Wrestlers], eatType[pub], food[Japanese], priceRange[cheap], area[riverside], familyFriendly[yes], near[Raja Indian Cuisine]	The Wrestlers, which welcomes families, is a cheap pub that serves Japanese cuisine. It is located in the riverside area and can be found near Raja Indian Cuisine.
name[The Wrestlers], eatType[pub], food[Japanese], priceRange[high], area[riverside], familyFriendly[yes], near[Raja Indian Cuisine]	The Wrestlers, which is in riverside near Raja Indian Cuisine, is an expensive pub that offers Japanese food. It is family-friendly.
name[The Wrestlers], eatType[pub], food[Japanese], priceRange[less than £20], area[city centre], familyFriendly[no], near[Raja Indian Cuisine]	The Wrestlers, which is in the city centre area by Raja Indian Cuisine, is a low-priced pub that offers Japanese cuisine. It is not child-friendly.
name[The Wrestlers], eatType[pub], food[Japanese], priceRange[less than £20], area[city centre], familyFriendly[yes], near[Raja Indian Cuisine]	The Wrestlers, which is located in the city centre near Raja Indian Cuisine, is a cheap pub serving Japanese food. It is child-friendly.
name[The Wrestlers], eatType[pub], food[Japanese], priceRange[less than £20], area[riverside], familyFriendly[no], near[Raja Indian Cuisine]	Non-kid-friendly The Wrestlers is a low-priced pub serving Japanese cuisine. It is located in the riverside area and can be found near Raja Indian Cuisine.
name[The Wrestlers], eatType[pub], food[Japanese], priceRange[less than £20], area[riverside], familyFriendly[yes], near[Raja Indian Cuisine]	The Wrestlers, which is in riverside near Raja Indian Cuisine, is a cheap pub offering Japanese food. It is kid-friendly.
name[The Wrestlers], eatType[pub], food[Japanese], priceRange[moderate], area[city centre], familyFriendly[no], near[Raja Indian Cuisine]	Moderately priced The Wrestlers is a pub that offers Japanese cuisine. It is in the city centre area by Raja Indian Cuisine. Children are not welcome.
name[The Wrestlers], eatType[pub], food[Japanese], priceRange[moderate], area[city centre], familyFriendly[yes], near[Raja Indian Cuisine]	The Wrestlers, which is located in the city centre near Raja Indian Cuisine, is a mid-priced pub that serves Japanese food. Children are welcome.
name[The Wrestlers], eatType[pub], food[Japanese], priceRange[moderate], area[riverside], familyFriendly[no], near[Raja Indian Cuisine]	The Wrestlers, which does not welcome kids, is an average-priced pub serving Japanese cuisine. It is located in the riverside area and can be found near Raja Indian Cuisine.
name[The Wrestlers], eatType[pub], food[Japanese], priceRange[moderate], area[riverside], familyFriendly[yes], near[Raja Indian Cuisine]	Moderately priced The Wrestlers is a pub that offers Japanese food. It is in riverside near Raja Indian Cuisine. Kids are welcome.
name[The Wrestlers], eatType[pub], food[Japanese], priceRange[moderate], customer rating[1 out of 5], area[city centre], familyFriendly[yes], near[Raja Indian Cuisine]	The Wrestlers, which has a customer rating of 1 out of 5, is a mid-priced pub that offers Japanese cuisine. It is in the city centre area by Raja Indian Cuisine. Families are welcome.
name[The Wrestlers], eatType[pub], food[Japanese], priceRange[moderate], customer rating[1 out of 5], area[riverside], familyFriendly[no], near[Raja Indian Cuisine]	The Wrestlers, which customers rate 1 out of 5, is an average-priced pub serving Japanese food. It is located in the riverside near Raja Indian Cuisine. It is not family-friendly.
name[The Wrestlers], eatType[pub], food[Japanese], priceRange[moderate], customer rating[1 out of 5], area[riverside], familyFriendly[yes], near[Raja Indian Cuisine]	Moderately priced The Wrestlers is a pub that serves Japanese cuisine. It has a customer rating of 1 out of 5. It is located in the riverside area and can be found near Raja Indian Cuisine. It is family-friendly.
name[The Wrestlers], eatType[pub], food[Japanese], priceRange[more than £30], area[city centre], familyFriendly[no], near[Raja Indian Cuisine]	The Wrestlers, which is in city centre near Raja Indian Cuisine, is a high-priced pub that offers Japanese food. It is not child-friendly.
name[The Wrestlers], eatType[pub], food[Japanese], priceRange[more than £30], area[city centre], familyFriendly[yes], near[Raja Indian Cuisine]	The Wrestlers, which is in the city centre area by Raja Indian Cuisine, is an expensive pub that offers Japanese cuisine. It is child-friendly.
name[The Wrestlers], eatType[pub], food[Japanese], priceRange[more than £30], area[riverside], familyFriendly[no], near[Raja Indian Cuisine]	The Wrestlers, which is located in the riverside near Raja Indian Cuisine, is a high-priced pub that serves Japanese food. It is not kid-friendly.
name[The Wrestlers], eatType[pub], food[Japanese], priceRange[more than £30], area[riverside], familyFriendly[yes], near[Raja Indian Cuisine]	Kid-friendly The Wrestlers is an expensive pub serving Japanese cuisine. It is located in the riverside area and can be found near Raja Indian Cuisine.
name[The Wrestlers], eatType[pub], food[Japanese], priceRange[more than £30], customer rating[5 out of 5], area[city centre], familyFriendly[no], near[Raja Indian Cuisine]	The Wrestlers, which customers rate 5 out of 5, is a high-priced pub offering Japanese food. It is in city centre near Raja Indian Cuisine. Children are not welcome.
name[The Wrestlers], eatType[pub], food[Japanese], priceRange[more than £30], customer rating[5 out of 5], area[city centre], familyFriendly[yes], near[Raja Indian Cuisine]	The Wrestlers, which has a customer rating of 5 out of 5, is an expensive pub offering Japanese cuisine. It is in the city centre area by Raja Indian Cuisine. Children are welcome.
name[The Wrestlers], eatType[pub], food[Japanese], priceRange[more than £30], customer rating[5 out of 5], area[riverside], familyFriendly[no], near[Raja Indian Cuisine]	The Wrestlers, which customers rate 5 out of 5, is a high-priced pub that serves Japanese food. It is located in the riverside near Raja Indian Cuisine. Kids are not welcome.
name[The Wrestlers], eatType[pub], food[Japanese], priceRange[more than £30], customer rating[5 out of 5], area[riverside], familyFriendly[yes], near[Raja Indian Cuisine]	The Wrestlers, which has a customer rating of 5 out of 5, is an expensive pub serving Japanese cuisine. It is located in the riverside area and can be found near Raja Indian Cuisine. Kids are welcome.
name[The Wrestlers], eatType[pub], food[Japanese], priceRange[more than £30], customer rating[low], area[city centre], familyFriendly[no], near[Raja Indian Cuisine]	The Wrestlers, which has a low customer rating, is a high-priced pub offering Japanese food. It is in city centre near Raja Indian Cuisine. It is not family-friendly.
name[The Wrestlers], eatType[pub], food[Japanese], priceRange[more than £30], customer rating[low], area[city centre], familyFriendly[yes], near[Raja Indian Cuisine]	The Wrestlers, which has a low customer rating, is an expensive pub that offers Japanese cuisine. It is in the city centre area by Raja Indian Cuisine. Families are welcome.
name[The Wrestlers], eatType[pub], food[Japanese], priceRange[more than £30], customer rating[low], area[riverside], familyFriendly[no], near[Raja Indian Cuisine]	The Wrestlers, which has a low customer rating, is a high-priced pub serving Japanese food. Non-child-friendly The Wrestlers is located in the riverside near Raja Indian Cuisine.
name[The Wrestlers], eatType[pub], food[Japanese], priceRange[more than £30], customer rating[low], area[riverside], familyFriendly[yes], near[Raja Indian Cuisine]	The Wrestlers, which has a low customer rating, is an expensive pub serving Japanese cuisine. It is located in the riverside area and can be found near Raja Indian Cuisine. It is family-friendly.
name[The Wrestlers], eatType[restaurant], food[Italian], priceRange[less than £20], area[riverside], familyFriendly[no], near[Raja Indian Cuisine]	The Wrestlers, which is in riverside near Raja Indian Cuisine, is a low-priced restaurant offering Italian food. It is not kid-friendly.
name[The Wrestlers], eatType[restaurant], food[Italian], priceRange[less than £20], area[riverside], familyFriendly[yes], near[Raja Indian Cuisine]	The Wrestlers, which is in the riverside area by Raja Indian Cuisine, is a cheap restaurant that offers Italian cuisine. It is child-friendly.
name[The Wrestlers], eatType[restaurant], food[Italian], priceRange[moderate], area[city centre], familyFriendly[no], near[Raja Indian Cuisine]	The Wrestlers, which is located in the city centre near Raja Indian Cuisine, is a mid-priced restaurant serving Italian food. Children are not welcome.
name[The Wrestlers], eatType[restaurant], food[Italian], priceRange[moderate], area[city centre], familyFriendly[yes], near[Raja Indian Cuisine]	Kid-friendly The Wrestlers is an average-priced restaurant serving Italian cuisine. It is located in the city centre area and can be found near Raja Indian Cuisine.
name[The Wrestlers], eatType[restaurant], food[Italian], priceRange[moderate], area[riverside], familyFriendly[no], near[Raja Indian Cuisine]	Moderately priced The Wrestlers is a restaurant offering Italian food. It is in riverside near Raja Indian Cuisine. Kids are not welcome.
name[The Wrestlers], eatType[restaurant], food[Italian], priceRange[moderate], area[riverside], familyFriendly[yes], near[Raja Indian Cuisine]	The Wrestlers, which is in the riverside area by Raja Indian Cuisine, is a mid-priced restaurant that offers Italian cuisine. Children are welcome.
name[The Wrestlers], eatType[restaurant], food[Italian], priceRange[more than £30], area[riverside], familyFriendly[yes], near[Raja Indian Cuisine]	The Wrestlers, which is located in the riverside near Raja Indian Cuisine, is a high-priced restaurant that serves Italian food. Kids are welcome.
name[The Wrestlers], eatType[restaurant], food[Japanese], priceRange[£20-25], area[riverside], familyFriendly[yes], near[Raja Indian Cuisine]	The Wrestlers, which welcomes families, is an average-priced restaurant that serves Japanese cuisine. It is located in the riverside area and can be found near Raja Indian Cuisine.
name[The Wrestlers], eatType[restaurant], food[Japanese], priceRange[cheap], area[riverside], familyFriendly[yes], near[Raja Indian Cuisine]	The Wrestlers, which is in riverside near Raja Indian Cuisine, is a low-priced restaurant that offers Japanese food. It is family-friendly.
name[The Wrestlers], eatType[restaurant], food[Japanese], priceRange[high], area[riverside], familyFriendly[yes], near[Raja Indian Cuisine]	The Wrestlers, which is in the riverside area by Raja Indian Cuisine, is an expensive restaurant offering Japanese cuisine. It is child-friendly.
name[The Wrestlers], eatType[restaurant], food[Japanese], priceRange[less than £20], area[city centre], familyFriendly[no], near[Raja Indian Cuisine]	The Wrestlers, which is located in the city centre near Raja Indian Cuisine, is a cheap restaurant that serves Japanese food. It is not family-friendly.
name[The Wrestlers], eatType[restaurant], food[Japanese], priceRange[less than £20], area[city centre], familyFriendly[yes], near[Raja Indian Cuisine]	Kid-friendly The Wrestlers is a low-priced restaurant serving Japanese cuisine. It is located in the city centre area and can be found near Raja Indian Cuisine.
name[The Wrestlers], eatType[restaurant], food[Japanese], priceRange[less than £20], area[riverside], familyFriendly[no], near[Raja Indian Cuisine]	The Wrestlers, which is in riverside near Raja Indian Cuisine, is a cheap restaurant offering Japanese food. It is not child-friendly.
name[The Wrestlers], eatType[restaurant], food[Japanese], priceRange[less than £20], area[riverside], familyFriendly[yes], near[Raja Indian Cuisine]	The Wrestlers, which is in the riverside area by Raja Indian Cuisine, is a low-priced restaurant offering Japanese cuisine. Children are welcome.
name[The Wrestlers], eatType[restaurant], food[Japanese], priceRange[moderate], area[city centre], familyFriendly[no], near[Raja Indian Cuisine]	Moderately priced The Wrestlers is a restaurant serving Japanese food. Non-kid-friendly The Wrestlers is located in the city centre near Raja Indian Cuisine.
name[The Wrestlers], eatType[restaurant], food[Japanese], priceRange[moderate], area[city centre], familyFriendly[yes], near[Raja Indian Cuisine]	The Wrestlers, which welcomes kids, is a mid-priced restaurant that serves Japanese cuisine. It is located in the city centre area and can be found near Raja Indian Cuisine.
name[The Wrestlers], eatType[restaurant], food[Japanese], priceRange[moderate], area[riverside], familyFriendly[no], near[Raja Indian Cuisine]	The Wrestlers, which is in riverside near Raja Indian Cuisine, is an average-priced restaurant offering Japanese food. Children are not welcome.
name[The Wrestlers], eatType[restaurant], food[Japanese], priceRange[moderate], area[riverside], familyFriendly[yes], near[Raja Indian Cuisine]	Moderately priced The Wrestlers is a restaurant offering Japanese cuisine. It is in the riverside area by Raja Indian Cuisine. Families are welcome.
name[The Wrestlers], eatType[restaurant], food[Japanese], priceRange[more than £30], area[city centre], familyFriendly[no], near[Raja Indian Cuisine]	The Wrestlers, which is located in the city centre near Raja Indian Cuisine, is a high-priced restaurant that serves Japanese food. Kids are not welcome.
name[The Wrestlers], eatType[restaurant], food[Japanese], priceRange[more than £30], area[city centre], familyFriendly[yes], near[Raja Indian Cuisine]	Family-friendly The Wrestlers is an expensive restaurant that serves Japanese cuisine. It is located in the city centre area and can be found near Raja Indian Cuisine.
name[The Wrestlers], eatType[restaurant], food[Japanese], priceRange[more than £30], area[riverside], familyFriendly[no], near[Raja Indian Cuisine]	The Wrestlers, which is in riverside near Raja Indian Cuisine, is a high-priced restaurant that offers Japanese food. It is not family-friendly.
name[The Wrestlers], eatType[restaurant], food[Japanese], priceRange[more than £30], area[riverside], familyFriendly[yes], near[Raja Indian Cuisine]	The Wrestlers, which is in the riverside area by Raja Indian Cuisine, is an expensive restaurant offering Japanese cuisine. It is child-friendly.
name[Wildwood], eatType[coffee shop], area[riverside]	The coffee shop Wildwood is located in the riverside.
name[Wildwood], eatType[pub], area[riverside]	The pub Wildwood is located in the riverside area.
name[Wildwood], eatType[pub], food[French], area[riverside], familyFriendly[yes], near[Raja Indian Cuisine]	Wildwood is a kid-friendly pub serving French food. It is in riverside and is located near Raja Indian Cuisine.
name[Wildwood], eatType[pub], food[Indian], area[city centre], familyFriendly[no], near[Raja Indian Cuisine]	Wildwood is a non-child-friendly pub serving Indian cuisine. It is in the city centre area and can be found near Raja Indian Cuisine.
name[Wildwood], eatType[pub], food[Indian], area[city centre], familyFriendly[yes], near[Raja Indian Cuisine]	The pub Wildwood is located in the city centre. It offers Indian food. Wildwood, which is near Raja Indian Cuisine, welcomes children.
name[Wildwood], eatType[pub], food[Indian], area[riverside], familyFriendly[no], near[Raja Indian Cuisine]	Wildwood, which is located in the riverside area by Raja Indian Cuisine, is a non-kid-friendly pub that offers Indian cuisine.
name[Wildwood], eatType[pub], food[Indian], area[riverside], familyFriendly[yes], near[Raja Indian Cuisine]	The pub Wildwood is in riverside. It serves Indian food. Wildwood, which is located near Raja Indian Cuisine, welcomes kids.
name[Wildwood], eatType[pub], food[Italian], area[city centre], familyFriendly[no], near[Raja Indian Cuisine]	The pub Wildwood is in the city centre area. It serves Italian cuisine. Wildwood which can be found near Raja Indian Cuisine does not welcome children.
name[Wildwood], eatType[pub], food[Italian], area[city centre], familyFriendly[yes], near[Raja Indian Cuisine]	The pub Wildwood is located in the city centre. It offers Italian food. Wildwood, which is near Raja Indian Cuisine, welcomes families.
name[Wildwood], eatType[pub], food[Italian], area[riverside], familyFriendly[no], near[Raja Indian Cuisine]	The pub Wildwood is located in the riverside area. It offers Italian cuisine. Wildwood, which is by Raja Indian Cuisine, does not welcome kids.
name[Wildwood], eatType[pub], food[Italian], area[riverside], familyFriendly[yes], near[Raja Indian Cuisine]	Wildwood is a family-friendly pub that serves Italian food. It is in riverside and is located near Raja Indian Cuisine.
name[Wildwood], eatType[restaurant], food[French], area[riverside], familyFriendly[yes], near[Raja Indian Cuisine]	Wildwood is a child-friendly restaurant that serves French cuisine. It is in the riverside area and can be found near Raja Indian Cuisine.
name[Wildwood], eatType[restaurant], food[Indian], area[city centre], familyFriendly[no], near[Raja Indian Cuisine]	Wildwood, which is located in the city centre near Raja Indian Cuisine, is a non-family-friendly restaurant offering Indian food.
name[Wildwood], eatType[restaurant], food[Indian], area[city centre], familyFriendly[yes], near[Raja Indian Cuisine]	Wildwood, which is located in the city centre area by Raja Indian Cuisine, is a kid-friendly restaurant offering Indian cuisine.
name[Wildwood], eatType[restaurant], food[Indian], area[riverside], familyFriendly[no], near[Raja Indian Cuisine]	Wildwood is a non-child-friendly restaurant serving Indian food. It is in riverside and is located near Raja Indian Cuisine.
name[Wildwood], eatType[restaurant], food[Indian], area[riverside], familyFriendly[yes], near[Raja Indian Cuisine]	The restaurant Wildwood is in the riverside area. It serves Indian cuisine. Wildwood which can be found near Raja Indian Cuisine welcomes children.
name[Wildwood], eatType[restaurant], food[Italian], area[city centre], familyFriendly[no], near[Raja Indian Cuisine]	Wildwood, which is located in the city centre near Raja Indian Cuisine, is a non-kid-friendly restaurant offering Italian food.
name[Wildwood], eatType[restaurant], food[Italian], area[city centre], familyFriendly[yes], near[Raja Indian Cuisine]	The restaurant Wildwood is located in the city centre area. It offers Italian cuisine. Wildwood, which is by Raja Indian Cuisine, welcomes kids.
name[Wildwood], eatType[restaurant], food[Italian], area[riverside], familyFriendly[no], near[Raja Indian Cuisine]	The restaurant Wildwood is in riverside. It serves Italian food. Wildwood, which is located near Raja Indian Cuisine, does not welcome children.
name[Wildwood], eatType[restaurant], food[Italian], area[riverside], familyFriendly[yes], near[Raja Indian Cuisine]	The restaurant Wildwood is in the riverside area. It serves Italian cuisine. Wildwood which can be found near Raja Indian Cuisine welcomes families.
name[Zizzi], eatType[coffee shop], area[riverside]	The coffee shop Zizzi is located in the riverside.
name[Zizzi], eatType[coffee shop], customer rating[average], near[Burger King]	The coffee shop Zizzi is near Burger King. It has an average customer rating.
name[Zizzi], eatType[coffee shop], customer rating[high], near[Burger King]	The coffee shop Zizzi is by Burger King. It has a high customer rating.
name[Zizzi], eatType[coffee shop], near[The Sorrento]	The coffee shop Zizzi is located near The Sorrento.
name[Zizzi], eatType[pub], area[riverside]	The pub Zizzi is located in the riverside area.
name[Zizzi], eatType[pub], customer rating[average], near[Burger King]	The pub Zizzi can be found near Burger King. It has an average customer rating.
name[Zizzi], eatType[pub], customer rating[high], near[Burger King]	The pub Zizzi is near Burger King. It has a high customer rating.
name[Zizzi], eatType[pub], near[The Sorrento]	The pub Zizzi is by The Sorrento.
