MR	output
"name[Blue Spice], eatType[coffee shop], area[city centre]"	"Blue Spice is a coffee shop in the city centre."
"name[Blue Spice], eatType[coffee shop], area[riverside]"	"Blue Spice is a coffee shop in the riverside area."
"name[Blue Spice], eatType[coffee shop], customer rating[5 out of 5], near[Crowne Plaza Hotel]"	"Blue Spice is a coffee shop near Crowne Plaza Hotel with a customer rating of 5 out of 5."
"name[Blue Spice], eatType[coffee shop], customer rating[average], near[Burger King]"	"Blue Spice is a coffee shop near Burger King with an average customer rating and a cheap price range."
"name[Blue Spice], eatType[coffee shop], customer rating[average], near[Crowne Plaza Hotel]"	"Blue Spice is a coffee shop near Crowne Plaza Hotel with an average customer rating and a cheap price range."
"name[Blue Spice], eatType[pub], area[city centre]"	"Blue Spice is a pub in the city centre."
"name[Blue Spice], eatType[pub], area[riverside]"	"Blue Spice is a pub in the riverside area."
"name[Blue Spice], eatType[pub], customer rating[5 out of 5], near[Crowne Plaza Hotel]"	"Blue Spice is a pub near Crowne Plaza Hotel with a customer rating of 5 out of 5."
"name[Blue Spice], eatType[pub], customer rating[average], near[Burger King]"	"Blue Spice is a pub near Burger King with an average customer rating."
"name[Blue Spice], eatType[pub], customer rating[average], near[Crowne Plaza Hotel]"	"Blue Spice is a pub near Crowne Plaza Hotel with an average customer rating."
"name[Blue Spice], eatType[pub], food[Chinese], area[city centre], familyFriendly[no], near[Rainbow Vegetarian Café]"	"Blue Spice is a chinese pub in the city centre near Rainbow Vegetarian Café. It is not family friendly."
"name[Blue Spice], eatType[pub], food[Chinese], area[city centre], familyFriendly[yes], near[Rainbow Vegetarian Café]"	"Blue Spice is a chinese pub in the city centre near Rainbow Vegetarian Café. It is family friendly."
"name[Blue Spice], eatType[pub], food[Chinese], area[riverside], familyFriendly[no], near[Rainbow Vegetarian Café]"	"Blue Spice is a chinese pub in the riverside area near Rainbow Vegetarian Café. It is not family friendly."
"name[Blue Spice], eatType[pub], food[Chinese], area[riverside], familyFriendly[yes], near[Rainbow Vegetarian Café]"	"Blue Spice is a chinese pub in the riverside area near Rainbow Vegetarian Café. It is family friendly."
"name[Blue Spice], eatType[pub], food[English], area[city centre], familyFriendly[no], near[Rainbow Vegetarian Café]"	"Blue Spice is a english pub in the city centre near Rainbow Vegetarian Café. It is not family friendly."
"name[Blue Spice], eatType[pub], food[English], area[city centre], familyFriendly[yes], near[Rainbow Vegetarian Café]"	"Blue Spice is a english pub in the city centre near Rainbow Vegetarian Café. It is family friendly."
"name[Blue Spice], eatType[pub], food[English], area[riverside], familyFriendly[no], near[Rainbow Vegetarian Café]"	"Blue Spice is a english pub in the riverside area near Rainbow Vegetarian Café. It is not family friendly."
"name[Blue Spice], eatType[pub], food[English], area[riverside], familyFriendly[yes], near[Rainbow Vegetarian Café]"	"Blue Spice is a english pub in the riverside area near Rainbow Vegetarian Café. It is family friendly."
"name[Blue Spice], eatType[restaurant], food[Chinese], area[city centre], familyFriendly[no], near[Rainbow Vegetarian Café]"	"Blue Spice is a chinese restaurant in the city centre near Rainbow Vegetarian Café. It is not family friendly."
"name[Blue Spice], eatType[restaurant], food[Chinese], area[city centre], familyFriendly[yes], near[Rainbow Vegetarian Café]"	"Blue Spice is a chinese restaurant in the city centre near Rainbow Vegetarian Café. It is family friendly."
"name[Blue Spice], eatType[restaurant], food[Chinese], area[riverside], familyFriendly[no], near[Rainbow Vegetarian Café]"	"Blue Spice is a chinese restaurant in the riverside area near Rainbow Vegetarian Café. It is not family friendly."
"name[Blue Spice], eatType[restaurant], food[Chinese], area[riverside], familyFriendly[yes], near[Rainbow Vegetarian Café]"	"Blue Spice is a chinese restaurant in the riverside area near Rainbow Vegetarian Café. It is family friendly."
"name[Blue Spice], eatType[restaurant], food[English], area[city centre], familyFriendly[no], near[Rainbow Vegetarian Café]"	"Blue Spice is a english restaurant in the city centre near Rainbow Vegetarian Café. It is not family friendly."
"name[Blue Spice], eatType[restaurant], food[English], area[city centre], familyFriendly[yes], near[Rainbow Vegetarian Café]"	"Blue Spice is a english restaurant in the city centre near Rainbow Vegetarian Café. It is family friendly."
"name[Blue Spice], eatType[restaurant], food[English], area[riverside], familyFriendly[no], near[Rainbow Vegetarian Café]"	"Blue Spice is a english restaurant in the riverside area near Rainbow Vegetarian Café. It is not family friendly."
"name[Blue Spice], eatType[restaurant], food[English], area[riverside], familyFriendly[yes], near[Rainbow Vegetarian Café]"	"Blue Spice is a english restaurant in the riverside area near Rainbow Vegetarian Café. It is family friendly."
"name[Clowns], eatType[coffee shop], customer rating[3 out of 5], near[All Bar One]"	"Clowns is a place near All Bar One with a customer rating of 3 out of 5."
"name[Clowns], eatType[coffee shop], customer rating[5 out of 5], near[Crowne Plaza Hotel]"	"Clowns is a coffee shop near Crowne Plaza Hotel with a customer rating of 5 out of 5."
"name[Clowns], eatType[coffee shop], near[The Sorrento]"	"Clowns is a place near The Sorrento."
"name[Clowns], eatType[pub], customer rating[3 out of 5], near[All Bar One]"	"Clowns is a pub near All Bar One with a customer rating of 3 out of 5."
"name[Clowns], eatType[pub], customer rating[5 out of 5], near[Crowne Plaza Hotel]"	"Clowns is a pub near Crowne Plaza Hotel with a customer rating of 5 out of 5."
"name[Clowns], eatType[pub], near[The Sorrento]"	"Clowns is a pub near The Sorrento."
"name[Cocum], eatType[coffee shop], customer rating[high], near[Burger King]"	"Cocum is a place near Burger King with a high customer rating."
"name[Cocum], eatType[coffee shop], customer rating[high], near[Café Sicilia]"	"Cocum is a place near Café Sicilia with a high customer rating."
"name[Cocum], eatType[coffee shop], customer rating[low], near[Café Sicilia]"	"Cocum is a coffee shop near Café Sicilia with a low customer rating."
"name[Cocum], eatType[coffee shop], customer rating[low], near[Express by Holiday Inn]"	"Cocum is a coffee shop near Express by Holiday Inn with a low customer rating."
"name[Cocum], eatType[coffee shop], near[The Rice Boat]"	"Cocum is a place near The Rice Boat."
"name[Cocum], eatType[coffee shop], near[The Sorrento]"	"Cocum is a place near The Sorrento."
"name[Cocum], eatType[pub], customer rating[high], near[Burger King]"	"Cocum is a pub near Burger King with a high customer rating."
"name[Cocum], eatType[pub], customer rating[high], near[Café Sicilia]"	"Cocum is a pub near Café Sicilia with a high customer rating."
"name[Cocum], eatType[pub], customer rating[low], near[Café Sicilia]"	"Cocum is a pub near Café Sicilia with a low customer rating."
"name[Cocum], eatType[pub], customer rating[low], near[Express by Holiday Inn]"	"Cocum is a pub near Express by Holiday Inn with a low customer rating."
"name[Cocum], eatType[pub], near[The Rice Boat]"	"Cocum is a pub near The Rice Boat."
"name[Cocum], eatType[pub], near[The Sorrento]"	"Cocum is a pub near The Sorrento."
"name[Cotto], eatType[coffee shop], near[The Bakers]"	"Cotto is a place near The Bakers."
"name[Cotto], eatType[pub], near[The Bakers]"	"Cotto is a pub near The Bakers."
"name[Giraffe], eatType[coffee shop], near[The Bakers]"	"Giraffe is a place near The Bakers."
"name[Giraffe], eatType[coffee shop], near[The Rice Boat]"	"Giraffe is a place near The Rice Boat."
"name[Giraffe], eatType[pub], food[English], area[riverside], familyFriendly[yes], near[Rainbow Vegetarian Café]"	"Giraffe is a english pub in the riverside area near Rainbow Vegetarian Café. It is family friendly."
"name[Giraffe], eatType[pub], food[Fast food], area[city centre], familyFriendly[no], near[Rainbow Vegetarian Café]"	"Giraffe is a fast food pub in the city centre near Rainbow Vegetarian Café. It is not family friendly."
"name[Giraffe], eatType[pub], food[Fast food], area[city centre], familyFriendly[yes], near[Rainbow Vegetarian Café]"	"Giraffe is a fast food pub in the city centre near Rainbow Vegetarian Café. It is family friendly."
"name[Giraffe], eatType[pub], food[Fast food], area[riverside], familyFriendly[no], near[Rainbow Vegetarian Café]"	"Giraffe is a fast food pub in the riverside area near Rainbow Vegetarian Café. It is not family friendly."
"name[Giraffe], eatType[pub], food[Fast food], area[riverside], familyFriendly[yes], near[Rainbow Vegetarian Café]"	"Giraffe is a fast food pub in the riverside area near Rainbow Vegetarian Café. It is family friendly."
"name[Giraffe], eatType[pub], food[Fast food], area[riverside], familyFriendly[yes], near[Raja Indian Cuisine]"	"Giraffe is a fast food pub in the riverside area near Raja Indian Cuisine. It is family friendly."
"name[Giraffe], eatType[pub], food[French], area[city centre], familyFriendly[no], near[Raja Indian Cuisine]"	"Giraffe is a french pub in the city centre near Raja Indian Cuisine. It is not family friendly."
"name[Giraffe], eatType[pub], food[French], area[city centre], familyFriendly[yes], near[Raja Indian Cuisine]"	"Giraffe is a french pub in the city centre near Raja Indian Cuisine. It is family friendly."
"name[Giraffe], eatType[pub], food[French], area[riverside], familyFriendly[no], near[Raja Indian Cuisine]"	"Giraffe is a french pub in the riverside area near Raja Indian Cuisine. It is not family friendly."
"name[Giraffe], eatType[pub], food[French], area[riverside], familyFriendly[yes], near[Raja Indian Cuisine]"	"Giraffe is a french pub in the riverside area near Raja Indian Cuisine. It is family friendly."
"name[Giraffe], eatType[pub], near[The Bakers]"	"Giraffe is a pub near The Bakers."
"name[Giraffe], eatType[pub], near[The Rice Boat]"	"Giraffe is a pub near The Rice Boat."
"name[Giraffe], eatType[restaurant], food[English], area[riverside], familyFriendly[yes], near[Rainbow Vegetarian Café]"	"Giraffe is a english restaurant in the riverside area near Rainbow Vegetarian Café. It is family friendly."
"name[Giraffe], eatType[restaurant], food[Fast food], area[city centre], familyFriendly[no], near[Rainbow Vegetarian Café]"	"Giraffe is a fast food restaurant in the city centre near Rainbow Vegetarian Café. It is not family friendly."
"name[Giraffe], eatType[restaurant], food[Fast food], area[city centre], familyFriendly[yes], near[Rainbow Vegetarian Café]"	"Giraffe is a fast food restaurant in the city centre near Rainbow Vegetarian Café. It is family friendly."
"name[Giraffe], eatType[restaurant], food[Fast food], area[riverside], familyFriendly[no], near[Rainbow Vegetarian Café]"	"Giraffe is a fast food restaurant in the riverside area near Rainbow Vegetarian Café. It is not family friendly."
"name[Giraffe], eatType[restaurant], food[Fast food], area[riverside], familyFriendly[yes], near[Rainbow Vegetarian Café]"	"Giraffe is a fast food restaurant in the riverside area near Rainbow Vegetarian Café. It is family friendly."
"name[Giraffe], eatType[restaurant], food[Fast food], area[riverside], familyFriendly[yes], near[Raja Indian Cuisine]"	"Giraffe is a fast food restaurant in the riverside area near Raja Indian Cuisine. It is family friendly."
"name[Giraffe], eatType[restaurant], food[French], area[city centre], familyFriendly[no], near[Raja Indian Cuisine]"	"Giraffe is a french restaurant in the city centre near Raja Indian Cuisine. It is not family friendly."
"name[Giraffe], eatType[restaurant], food[French], area[city centre], familyFriendly[yes], near[Raja Indian Cuisine]"	"Giraffe is a french restaurant in the city centre near Raja Indian Cuisine. It is family friendly."
"name[Giraffe], eatType[restaurant], food[French], area[riverside], familyFriendly[no], near[Raja Indian Cuisine]"	"Giraffe is a french restaurant in the riverside area near Raja Indian Cuisine. It is not family friendly."
"name[Giraffe], eatType[restaurant], food[French], area[riverside], familyFriendly[yes], near[Raja Indian Cuisine]"	"Giraffe is a french restaurant in the riverside area near Raja Indian Cuisine. It is family friendly."
"name[Green Man], eatType[coffee shop], customer rating[1 out of 5], near[All Bar One]"	"Green Man is a coffee shop near All Bar One with a customer rating of 1 out of 5."
"name[Green Man], eatType[coffee shop], customer rating[3 out of 5], near[All Bar One]"	"Green Man is a place near All Bar One with a customer rating of 3 out of 5."
"name[Green Man], eatType[pub], customer rating[1 out of 5], near[All Bar One]"	"Green Man is a pub near All Bar One with a customer rating of 1 out of 5."
"name[Green Man], eatType[pub], customer rating[3 out of 5], near[All Bar One]"	"Green Man is a pub near All Bar One with a customer rating of 3 out of 5."
"name[Green Man], eatType[pub], food[Italian], area[riverside], familyFriendly[yes], near[Express by Holiday Inn]"	"Green Man is a italian pub in the riverside area near Express by Holiday Inn. It is family friendly."
"name[Green Man], eatType[pub], food[Italian], area[riverside], familyFriendly[yes], near[Raja Indian Cuisine]"	"Green Man is a italian pub in the riverside area near Raja Indian Cuisine. It is family friendly."
"name[Green Man], eatType[pub], food[Japanese], area[city centre], familyFriendly[no], near[Express by Holiday Inn]"	"Green Man is a japanese pub in the city centre near Express by Holiday Inn. It is not family friendly."
"name[Green Man], eatType[pub], food[Japanese], area[city centre], familyFriendly[yes], near[Express by Holiday Inn]"	"Green Man is a japanese pub in the city centre near Express by Holiday Inn. It is family friendly."
"name[Green Man], eatType[pub], food[Japanese], area[riverside], familyFriendly[no], near[Express by Holiday Inn]"	"Green Man is a japanese pub in the riverside area near Express by Holiday Inn. It is not family friendly."
"name[Green Man], eatType[pub], food[Japanese], area[riverside], familyFriendly[yes], near[Express by Holiday Inn]"	"Green Man is a japanese pub in the riverside area near Express by Holiday Inn. It is family friendly."
"name[Green Man], eatType[restaurant], food[Italian], area[riverside], familyFriendly[yes], near[Express by Holiday Inn]"	"Green Man is a italian restaurant in the riverside area near Express by Holiday Inn. It is family friendly."
"name[Green Man], eatType[restaurant], food[Italian], area[riverside], familyFriendly[yes], near[Raja Indian Cuisine]"	"Green Man is a italian restaurant in the riverside area near Raja Indian Cuisine. It is family friendly."
"name[Green Man], eatType[restaurant], food[Japanese], area[city centre], familyFriendly[no], near[Express by Holiday Inn]"	"Green Man is a japanese restaurant in the city centre near Express by Holiday Inn. It is not family friendly."
"name[Green Man], eatType[restaurant], food[Japanese], area[city centre], familyFriendly[yes], near[Express by Holiday Inn]"	"Green Man is a japanese restaurant in the city centre near Express by Holiday Inn. It is family friendly."
"name[Green Man], eatType[restaurant], food[Japanese], area[riverside], familyFriendly[no], near[Express by Holiday Inn]"	"Green Man is a japanese restaurant in the riverside area near Express by Holiday Inn. It is not family friendly."
"name[Green Man], eatType[restaurant], food[Japanese], area[riverside], familyFriendly[yes], near[Express by Holiday Inn]"	"Green Man is a japanese restaurant in the riverside area near Express by Holiday Inn. It is family friendly."
"name[Loch Fyne], eatType[coffee shop], area[riverside]"	"Loch Fyne is a coffee shop in the riverside area."
"name[Loch Fyne], eatType[pub], area[riverside]"	"Loch Fyne is a pub in the riverside area."
"name[Strada], eatType[coffee shop], area[city centre]"	"Strada is a coffee shop in the city centre."
"name[Strada], eatType[coffee shop], customer rating[1 out of 5], near[All Bar One]"	"Strada is a coffee shop near All Bar One with a customer rating of 1 out of 5."
"name[Strada], eatType[coffee shop], customer rating[1 out of 5], near[Rainbow Vegetarian Café]"	"Strada is a coffee shop near Rainbow Vegetarian Café with a customer rating of 1 out of 5."
"name[Strada], eatType[coffee shop], customer rating[low], near[Express by Holiday Inn]"	"Strada is a coffee shop near Express by Holiday Inn with a low customer rating."
"name[Strada], eatType[pub], area[city centre]"	"Strada is a pub in the city centre."
"name[Strada], eatType[pub], customer rating[1 out of 5], near[All Bar One]"	"Strada is a pub near All Bar One with a customer rating of 1 out of 5."
"name[Strada], eatType[pub], customer rating[1 out of 5], near[Rainbow Vegetarian Café]"	"Strada is a pub near Rainbow Vegetarian Café with a customer rating of 1 out of 5."
"name[Strada], eatType[pub], customer rating[low], near[Express by Holiday Inn]"	"Strada is a pub near Express by Holiday Inn with a low customer rating."
"name[The Cricketers], eatType[coffee shop], customer rating[1 out of 5], familyFriendly[yes], near[Avalon]"	"The Cricketers is a kids friendly coffee shop near Avalon with a customer rating of 1 out of 5."
"name[The Cricketers], eatType[coffee shop], customer rating[3 out of 5], familyFriendly[yes], near[Avalon]"	"The Cricketers is a children friendly coffee shop near Avalon with a customer rating of 3 out of 5."
"name[The Cricketers], eatType[coffee shop], customer rating[3 out of 5], familyFriendly[yes], near[Crowne Plaza Hotel]"	"The Cricketers is a children friendly coffee shop near Crowne Plaza Hotel with a customer rating of 3 out of 5."
"name[The Cricketers], eatType[coffee shop], customer rating[5 out of 5], familyFriendly[no], near[Crowne Plaza Hotel]"	"The Cricketers is a non family friendly coffee shop near Crowne Plaza Hotel with an average customer rating of 5 out of 5."
"name[The Cricketers], eatType[coffee shop], customer rating[5 out of 5], familyFriendly[yes], near[Crowne Plaza Hotel]"	"The Cricketers is a family friendly coffee shop near Crowne Plaza Hotel with an average customer rating of 5 out of 5."
"name[The Cricketers], eatType[coffee shop], customer rating[average], familyFriendly[no], near[Café Sicilia]"	"The Cricketers is a non family friendly coffee shop near Café Sicilia with an average customer rating."
"name[The Cricketers], eatType[coffee shop], customer rating[average], familyFriendly[no], near[Crowne Plaza Hotel]"	"The Cricketers is a non family friendly coffee shop near Crowne Plaza Hotel with an average customer rating."
"name[The Cricketers], eatType[coffee shop], customer rating[average], familyFriendly[yes], near[Café Sicilia]"	"The Cricketers is a family friendly coffee shop near Café Sicilia with a customer rating of average."
"name[The Cricketers], eatType[coffee shop], customer rating[high], familyFriendly[yes], near[Café Sicilia]"	"The Cricketers is a children friendly coffee shop near Café Sicilia with a high customer rating."
"name[The Cricketers], eatType[coffee shop], customer rating[high], familyFriendly[yes], near[Express by Holiday Inn]"	"The Cricketers is a children friendly coffee shop near Express by Holiday Inn with a high customer rating."
"name[The Cricketers], eatType[coffee shop], customer rating[low], familyFriendly[no], near[Express by Holiday Inn]"	"The Cricketers is a non family friendly coffee shop near Express by Holiday Inn with a low customer rating."
"name[The Cricketers], eatType[coffee shop], customer rating[low], familyFriendly[no], near[Ranch]"	"The Cricketers is a non family friendly coffee shop near Ranch with a low customer rating."
"name[The Cricketers], eatType[coffee shop], customer rating[low], familyFriendly[yes], near[Ranch]"	"The Cricketers is a family friendly coffee shop near Ranch with a low customer rating."
"name[The Cricketers], eatType[restaurant], customer rating[1 out of 5], familyFriendly[yes], near[Avalon]"	"The Cricketers is a kids friendly restaurant near Avalon with a customer rating of 1 out of 5."
"name[The Cricketers], eatType[restaurant], customer rating[3 out of 5], familyFriendly[yes], near[Avalon]"	"The Cricketers is a kids friendly restaurant with a customer rating of 3 out of 5 near Avalon."
"name[The Cricketers], eatType[restaurant], customer rating[3 out of 5], familyFriendly[yes], near[Crowne Plaza Hotel]"	"The Cricketers is a kids friendly restaurant with a customer rating of 3 out of 5 near Crowne Plaza Hotel."
"name[The Cricketers], eatType[restaurant], customer rating[5 out of 5], familyFriendly[no], near[Crowne Plaza Hotel]"	"The Cricketers is a restaurant near Crowne Plaza Hotel in the non family friendly restaurant with a customer rating of 5 out of 5."
"name[The Cricketers], eatType[restaurant], customer rating[5 out of 5], familyFriendly[yes], near[Crowne Plaza Hotel]"	"The Cricketers is a children friendly restaurant near Crowne Plaza Hotel with a customer rating of 5 out of 5."
"name[The Cricketers], eatType[restaurant], customer rating[average], familyFriendly[no], near[Café Sicilia]"	"The Cricketers is a restaurant near Café Sicilia in the non family friendly restaurant with an average customer rating."
"name[The Cricketers], eatType[restaurant], customer rating[average], familyFriendly[no], near[Crowne Plaza Hotel]"	"The Cricketers is a restaurant near Crowne Plaza Hotel in the non family friendly restaurant with an average customer rating."
"name[The Cricketers], eatType[restaurant], customer rating[average], familyFriendly[yes], near[Café Sicilia]"	"The Cricketers is a family friendly restaurant near Café Sicilia with an average customer rating."
"name[The Cricketers], eatType[restaurant], customer rating[high], familyFriendly[yes], near[Café Sicilia]"	"The Cricketers is a children friendly restaurant near Café Sicilia with a high customer rating."
"name[The Cricketers], eatType[restaurant], customer rating[high], familyFriendly[yes], near[Express by Holiday Inn]"	"The Cricketers is a children friendly restaurant near Express by Holiday Inn with a high customer rating."
"name[The Cricketers], eatType[restaurant], customer rating[low], familyFriendly[no], near[Express by Holiday Inn]"	"The Cricketers is a non family friendly restaurant near Express by Holiday Inn with a low customer rating."
"name[The Cricketers], eatType[restaurant], customer rating[low], familyFriendly[no], near[Ranch]"	"The Cricketers is a non family friendly restaurant near Ranch with a low customer rating."
"name[The Cricketers], eatType[restaurant], customer rating[low], familyFriendly[yes], near[Ranch]"	"The Cricketers is a family friendly restaurant near Ranch with a low customer rating."
"name[The Cricketers], eatType[restaurant], food[Chinese], priceRange[£20-25], customer rating[high], area[city centre], familyFriendly[no], near[All Bar One]"	"The Cricketers is a chinese restaurant in the city centre near All Bar One. It is not kids friendly and has a high customer rating and a price range of £20-25."
"name[The Cricketers], eatType[restaurant], food[Chinese], priceRange[£20-25], customer rating[high], area[city centre], familyFriendly[yes], near[All Bar One]"	"The Cricketers is a chinese restaurant in the city centre near All Bar One. It is kids friendly and has a high customer rating and a price range of £20-25."
"name[The Cricketers], eatType[restaurant], food[Chinese], priceRange[£20-25], customer rating[high], area[riverside], familyFriendly[no], near[All Bar One]"	"The Cricketers is a chinese restaurant in the riverside area near All Bar One. It is not kids friendly and has a high customer rating and a price range of £20-25."
"name[The Cricketers], eatType[restaurant], food[Chinese], priceRange[£20-25], customer rating[high], area[riverside], familyFriendly[yes], near[All Bar One]"	"The Cricketers is a chinese restaurant in the riverside area near All Bar One. It is kids friendly and has a high customer rating and a price range of £20-25."
"name[The Cricketers], eatType[restaurant], food[Chinese], priceRange[cheap], customer rating[5 out of 5], area[city centre], familyFriendly[no], near[All Bar One]"	"The Cricketers is a cheap chinese restaurant in the city centre near All Bar One. It is not family friendly and has a customer rating of 5 out of 5."
"name[The Cricketers], eatType[restaurant], food[Chinese], priceRange[cheap], customer rating[5 out of 5], area[city centre], familyFriendly[yes], near[All Bar One]"	"The Cricketers is a cheap chinese restaurant in the city centre near All Bar One. It is family friendly and has a customer rating of 5 out of 5."
"name[The Cricketers], eatType[restaurant], food[Chinese], priceRange[cheap], customer rating[5 out of 5], area[riverside], familyFriendly[no], near[All Bar One]"	"The Cricketers is a cheap chinese restaurant in the riverside area near All Bar One. It is not family friendly and has a customer rating of 5 out of 5."
"name[The Cricketers], eatType[restaurant], food[Chinese], priceRange[cheap], customer rating[5 out of 5], area[riverside], familyFriendly[yes], near[All Bar One]"	"The Cricketers is a cheap chinese restaurant in the riverside area near All Bar One. It is family friendly and has a customer rating of 5 out of 5."
"name[The Cricketers], eatType[restaurant], food[Chinese], priceRange[cheap], customer rating[average], area[city centre], familyFriendly[no], near[All Bar One]"	"The Cricketers is a cheap chinese restaurant in the city centre near All Bar One. It is not family friendly and has an average customer rating."
"name[The Cricketers], eatType[restaurant], food[Chinese], priceRange[cheap], customer rating[average], area[city centre], familyFriendly[yes], near[All Bar One]"	"The Cricketers is a cheap chinese restaurant in the city centre near All Bar One. It is family friendly and has an average customer rating."
"name[The Cricketers], eatType[restaurant], food[Chinese], priceRange[cheap], customer rating[average], area[riverside], familyFriendly[no], near[All Bar One]"	"The Cricketers is a cheap chinese restaurant in the riverside area near All Bar One. It is not family friendly and has an average customer rating."
"name[The Cricketers], eatType[restaurant], food[Chinese], priceRange[cheap], customer rating[average], area[riverside], familyFriendly[yes], near[All Bar One]"	"The Cricketers is a cheap chinese restaurant in the riverside area near All Bar One. It is family friendly and has an average customer rating."
"name[The Cricketers], eatType[restaurant], food[Chinese], priceRange[high], customer rating[1 out of 5], area[city centre], familyFriendly[no], near[All Bar One]"	"The Cricketers is a chinese restaurant in the city centre near All Bar One. It is not children friendly and has a high price range and a customer rating of 1 out of 5."
"name[The Cricketers], eatType[restaurant], food[Chinese], priceRange[high], customer rating[1 out of 5], area[city centre], familyFriendly[yes], near[All Bar One]"	"The Cricketers is a chinese restaurant in the city centre near All Bar One. It is children friendly and has a high price range and a customer rating of 1 out of 5."
"name[The Cricketers], eatType[restaurant], food[Chinese], priceRange[high], customer rating[1 out of 5], area[riverside], familyFriendly[no], near[All Bar One]"	"The Cricketers is a chinese restaurant in the riverside area near All Bar One. It is not children friendly and has a high price range and a customer rating of 1 out of 5."
"name[The Cricketers], eatType[restaurant], food[Chinese], priceRange[high], customer rating[1 out of 5], area[riverside], familyFriendly[yes], near[All Bar One]"	"The Cricketers is a chinese restaurant in the riverside area near All Bar One. It is children friendly and has a high price range and a customer rating of 1 out of 5."
"name[The Cricketers], eatType[restaurant], food[Chinese], priceRange[high], customer rating[average], area[city centre], familyFriendly[no], near[All Bar One]"	"The Cricketers is a chinese restaurant in the city centre near All Bar One. It is not children friendly and has an average customer rating and a high price range."
"name[The Cricketers], eatType[restaurant], food[Chinese], priceRange[high], customer rating[average], area[city centre], familyFriendly[yes], near[All Bar One]"	"The Cricketers is a chinese restaurant in the city centre near All Bar One. It is children friendly and has an average customer rating and a high price range."
"name[The Cricketers], eatType[restaurant], food[Chinese], priceRange[high], customer rating[average], area[riverside], familyFriendly[no], near[All Bar One]"	"The Cricketers is a chinese restaurant in the riverside area near All Bar One. It is not children friendly and has an average customer rating and a high price range."
"name[The Cricketers], eatType[restaurant], food[Chinese], priceRange[high], customer rating[average], area[riverside], familyFriendly[yes], near[All Bar One]"	"The Cricketers is a chinese restaurant in the riverside area near All Bar One. It is children friendly and has an average customer rating and a high price range."
"name[The Cricketers], eatType[restaurant], food[Chinese], priceRange[less than £20], customer rating[low], area[city centre], familyFriendly[no], near[All Bar One]"	"The Cricketers is a chinese restaurant in the city centre near All Bar One. It is not family friendly and has a low customer rating and a price range of less than £20."
"name[The Cricketers], eatType[restaurant], food[Chinese], priceRange[less than £20], customer rating[low], area[city centre], familyFriendly[yes], near[All Bar One]"	"The Cricketers is a chinese restaurant in the city centre near All Bar One. It is family friendly and has a low customer rating and a price range of less than £20."
"name[The Cricketers], eatType[restaurant], food[Chinese], priceRange[less than £20], customer rating[low], area[riverside], familyFriendly[no], near[All Bar One]"	"The Cricketers is a chinese restaurant in the riverside area near All Bar One. It is not family friendly and has a low customer rating and a price range of less than £20."
"name[The Cricketers], eatType[restaurant], food[Chinese], priceRange[less than £20], customer rating[low], area[riverside], familyFriendly[yes], near[All Bar One]"	"The Cricketers is a chinese restaurant in the riverside area near All Bar One. It is family friendly and has a low customer rating and a price range of less than £20."
"name[The Cricketers], eatType[restaurant], food[Chinese], priceRange[moderate], customer rating[1 out of 5], area[city centre], familyFriendly[no], near[All Bar One]"	"The Cricketers is a chinese restaurant in the city centre near All Bar One. It is not kids friendly and has a moderate price range and a customer rating of 1 out of 5."
"name[The Cricketers], eatType[restaurant], food[Chinese], priceRange[moderate], customer rating[1 out of 5], area[city centre], familyFriendly[yes], near[All Bar One]"	"The Cricketers is a chinese restaurant in the city centre near All Bar One. It is kids friendly and has a moderate price range and a customer rating of 1 out of 5."
"name[The Cricketers], eatType[restaurant], food[Chinese], priceRange[moderate], customer rating[1 out of 5], area[riverside], familyFriendly[no], near[All Bar One]"	"The Cricketers is a chinese restaurant in the riverside area near All Bar One. It is not kids friendly and has a moderate price range and a customer rating of 1 out of 5."
"name[The Cricketers], eatType[restaurant], food[Chinese], priceRange[moderate], customer rating[1 out of 5], area[riverside], familyFriendly[yes], near[All Bar One]"	"The Cricketers is a chinese restaurant in the riverside area near All Bar One. It is kids friendly and has a moderate price range and a customer rating of 1 out of 5."
"name[The Cricketers], eatType[restaurant], food[Chinese], priceRange[moderate], customer rating[3 out of 5], area[city centre], familyFriendly[no], near[All Bar One]"	"The Cricketers is a chinese restaurant in the city centre near All Bar One. It is not kids friendly and has a moderate price range and a customer rating of 3 out of 5."
"name[The Cricketers], eatType[restaurant], food[Chinese], priceRange[moderate], customer rating[3 out of 5], area[city centre], familyFriendly[yes], near[All Bar One]"	"The Cricketers is a chinese restaurant in the city centre near All Bar One. It is kids friendly and has a moderate price range and a customer rating of 3 out of 5."
"name[The Cricketers], eatType[restaurant], food[Chinese], priceRange[moderate], customer rating[3 out of 5], area[riverside], familyFriendly[no], near[All Bar One]"	"The Cricketers is a chinese restaurant in the riverside area near All Bar One. It is not kids friendly and has a moderate price range and a customer rating of 3 out of 5."
"name[The Cricketers], eatType[restaurant], food[Chinese], priceRange[moderate], customer rating[3 out of 5], area[riverside], familyFriendly[yes], near[All Bar One]"	"The Cricketers is a chinese restaurant in the riverside area near All Bar One. It is kids friendly and has a moderate price range and a customer rating of 3 out of 5."
"name[The Cricketers], eatType[restaurant], food[Chinese], priceRange[more than £30], customer rating[high], area[city centre], familyFriendly[no], near[All Bar One]"	"The Cricketers is a chinese restaurant in the city centre near All Bar One. It is not children friendly and has a high customer rating and a price range of more than £30."
"name[The Cricketers], eatType[restaurant], food[Chinese], priceRange[more than £30], customer rating[high], area[city centre], familyFriendly[yes], near[All Bar One]"	"The Cricketers is a chinese restaurant in the city centre near All Bar One. It is children friendly and has a high customer rating and a price range of more than £30."
"name[The Cricketers], eatType[restaurant], food[Chinese], priceRange[more than £30], customer rating[high], area[riverside], familyFriendly[no], near[All Bar One]"	"The Cricketers is a chinese restaurant in the riverside area near All Bar One. It is not children friendly and has a high customer rating and a price range of more than £30."
"name[The Cricketers], eatType[restaurant], food[Chinese], priceRange[more than £30], customer rating[high], area[riverside], familyFriendly[yes], near[All Bar One]"	"The Cricketers is a chinese restaurant in the riverside area near All Bar One. It is children friendly and has a high customer rating and a price range of more than £30."
"name[The Cricketers], eatType[restaurant], food[English], priceRange[£20-25], customer rating[high], area[city centre], familyFriendly[no], near[All Bar One]"	"The Cricketers is a english restaurant in the city centre near All Bar One. It is not kids friendly and has a high customer rating and a price range of £20-25."
"name[The Cricketers], eatType[restaurant], food[English], priceRange[£20-25], customer rating[high], area[city centre], familyFriendly[yes], near[All Bar One]"	"The Cricketers is a english restaurant in the city centre near All Bar One. It is kids friendly and has a high customer rating and a price range of £20-25."
"name[The Cricketers], eatType[restaurant], food[English], priceRange[£20-25], customer rating[high], area[riverside], familyFriendly[no], near[All Bar One]"	"The Cricketers is a english restaurant in the riverside area near All Bar One. It is not kids friendly and has a high customer rating and a price range of £20-25."
"name[The Cricketers], eatType[restaurant], food[English], priceRange[£20-25], customer rating[high], area[riverside], familyFriendly[yes], near[All Bar One]"	"The Cricketers is a english restaurant in the riverside area near All Bar One. It is kids friendly and has a high customer rating and a price range of £20-25."
"name[The Cricketers], eatType[restaurant], food[English], priceRange[cheap], customer rating[5 out of 5], area[city centre], familyFriendly[no], near[Café Rouge]"	"The Cricketers is a cheap english restaurant in the city centre near Café Rouge. It is not family friendly and has a customer rating of 5 out of 5."
"name[The Cricketers], eatType[restaurant], food[English], priceRange[cheap], customer rating[5 out of 5], area[city centre], familyFriendly[yes], near[Café Rouge]"	"The Cricketers is a cheap english restaurant in the city centre near Café Rouge. It is family friendly and has a customer rating of 5 out of 5."
"name[The Cricketers], eatType[restaurant], food[English], priceRange[cheap], customer rating[5 out of 5], area[riverside], familyFriendly[no], near[Café Rouge]"	"The Cricketers is a cheap english restaurant in the riverside area near Café Rouge. It is not family friendly and has a customer rating of 5 out of 5."
"name[The Cricketers], eatType[restaurant], food[English], priceRange[cheap], customer rating[5 out of 5], area[riverside], familyFriendly[yes], near[Café Rouge]"	"The Cricketers is a cheap english restaurant in the riverside area near Café Rouge. It is family friendly and has a customer rating of 5 out of 5."
"name[The Cricketers], eatType[restaurant], food[English], priceRange[cheap], customer rating[average], area[city centre], familyFriendly[no], near[Café Rouge]"	"The Cricketers is a cheap english restaurant in the city centre near Café Rouge. It is not family friendly and has an average customer rating."
"name[The Cricketers], eatType[restaurant], food[English], priceRange[cheap], customer rating[average], area[city centre], familyFriendly[yes], near[Café Rouge]"	"The Cricketers is a cheap english restaurant in the city centre near Café Rouge. It is family friendly and has an average customer rating."
"name[The Cricketers], eatType[restaurant], food[English], priceRange[cheap], customer rating[average], area[riverside], familyFriendly[no], near[Café Rouge]"	"The Cricketers is a cheap english restaurant in the riverside area near Café Rouge. It is not family friendly and has an average customer rating."
"name[The Cricketers], eatType[restaurant], food[English], priceRange[cheap], customer rating[average], area[riverside], familyFriendly[yes], near[Café Rouge]"	"The Cricketers is a cheap english restaurant in the riverside area near Café Rouge. It is family friendly and has an average customer rating."
"name[The Cricketers], eatType[restaurant], food[English], priceRange[high], customer rating[1 out of 5], area[city centre], familyFriendly[no], near[Café Rouge]"	"The Cricketers is a english restaurant in the city centre near Café Rouge. It is not children friendly and has a high price range and a customer rating of 1 out of 5."
"name[The Cricketers], eatType[restaurant], food[English], priceRange[high], customer rating[1 out of 5], area[city centre], familyFriendly[yes], near[Café Rouge]"	"The Cricketers is a english restaurant in the city centre near Café Rouge. It is children friendly and has a high price range and a customer rating of 1 out of 5."
"name[The Cricketers], eatType[restaurant], food[English], priceRange[high], customer rating[1 out of 5], area[riverside], familyFriendly[no], near[Café Rouge]"	"The Cricketers is a english restaurant in the riverside area near Café Rouge. It is not children friendly and has a high price range and a customer rating of 1 out of 5."
"name[The Cricketers], eatType[restaurant], food[English], priceRange[high], customer rating[1 out of 5], area[riverside], familyFriendly[yes], near[Café Rouge]"	"The Cricketers is a english restaurant in the riverside area near Café Rouge. It is children friendly and has a high price range and a customer rating of 1 out of 5."
"name[The Cricketers], eatType[restaurant], food[English], priceRange[high], customer rating[average], area[city centre], familyFriendly[no], near[Café Rouge]"	"The Cricketers is a english restaurant in the city centre near Café Rouge. It is not children friendly and has an average customer rating and a high price range."
"name[The Cricketers], eatType[restaurant], food[English], priceRange[high], customer rating[average], area[city centre], familyFriendly[yes], near[Café Rouge]"	"The Cricketers is a english restaurant in the city centre near Café Rouge. It is children friendly and has an average customer rating and a high price range."
"name[The Cricketers], eatType[restaurant], food[English], priceRange[high], customer rating[average], area[riverside], familyFriendly[no], near[Café Rouge]"	"The Cricketers is a english restaurant in the riverside area near Café Rouge. It is not children friendly and has an average customer rating and a high price range."
"name[The Mill], eatType[pub], food[English], priceRange[high], area[riverside], familyFriendly[yes], near[Raja Indian Cuisine]"	"The Mill is a english pub in the riverside area near Raja Indian Cuisine. It is children friendly and has a high price range."
"name[The Mill], eatType[pub], food[English], priceRange[less than £20], area[city centre], familyFriendly[no], near[Raja Indian Cuisine]"	"The Mill is a non family friendly english pub in the city centre near Raja Indian Cuisine with a price range of less than £20."
"name[The Mill], eatType[pub], food[English], priceRange[less than £20], area[city centre], familyFriendly[yes], near[Raja Indian Cuisine]"	"The Mill is a english pub in the city centre near Raja Indian Cuisine. It is family friendly and has a price range of less than £20."
"name[The Mill], eatType[pub], food[English], priceRange[less than £20], area[riverside], familyFriendly[no], near[Raja Indian Cuisine]"	"The Mill is a english pub in the riverside area near Raja Indian Cuisine. It is not family friendly and has a price range of less than £20."
"name[The Mill], eatType[pub], food[English], priceRange[less than £20], area[riverside], familyFriendly[yes], near[Raja Indian Cuisine]"	"The Mill is a english pub in the riverside area near Raja Indian Cuisine. It is family friendly and has a price range of less than £20."
"name[The Mill], eatType[pub], food[English], priceRange[moderate], area[city centre], familyFriendly[no], near[Raja Indian Cuisine]"	"The Mill is a english pub in the city centre near Raja Indian Cuisine. It is not kids friendly and has a moderate price range."
"name[The Mill], eatType[pub], food[English], priceRange[moderate], area[city centre], familyFriendly[yes], near[Raja Indian Cuisine]"	"The Mill is a english pub in the city centre near Raja Indian Cuisine. It is kids friendly and has a moderate price range."
"name[The Mill], eatType[pub], food[English], priceRange[moderate], area[riverside], familyFriendly[no], near[Raja Indian Cuisine]"	"The Mill is a english pub in the riverside area near Raja Indian Cuisine. It is not kids friendly and has a moderate price range."
"name[The Mill], eatType[pub], food[English], priceRange[moderate], area[riverside], familyFriendly[yes], near[Raja Indian Cuisine]"	"The Mill is a english pub in the riverside area near Raja Indian Cuisine. It is kids friendly and has a moderate price range."
"name[The Mill], eatType[pub], food[English], priceRange[more than £30], area[riverside], familyFriendly[yes], near[Raja Indian Cuisine]"	"The Mill is a english pub in the riverside area near Raja Indian Cuisine. It is children friendly and has a price range of more than £30."
"name[The Mill], eatType[pub], food[Fast food], priceRange[£20-25], area[riverside], familyFriendly[yes], near[Raja Indian Cuisine]"	"The Mill is a fast food pub in the riverside area near Raja Indian Cuisine. It is kids friendly and has a price range of £20-25."
"name[The Mill], eatType[pub], food[Fast food], priceRange[£20-25], customer rating[high], area[city centre], familyFriendly[no], near[Café Rouge]"	"The Mill is a fast food pub in the city centre near Café Rouge. It is not kids friendly and has a high customer rating and a price range of £20-25."
"name[The Mill], eatType[pub], food[Fast food], priceRange[£20-25], customer rating[high], area[city centre], familyFriendly[yes], near[Café Rouge]"	"The Mill is a fast food pub in the city centre near Café Rouge. It is kids friendly and has a high customer rating and a price range of £20-25."
"name[The Mill], eatType[pub], food[Fast food], priceRange[£20-25], customer rating[high], area[riverside], familyFriendly[no], near[Café Rouge]"	"The Mill is a fast food pub in the riverside area near Café Rouge. It is not kids friendly and has a high customer rating and a price range of £20-25."
"name[The Mill], eatType[pub], food[Fast food], priceRange[£20-25], customer rating[high], area[riverside], familyFriendly[yes], near[Café Rouge]"	"The Mill is a fast food pub in the riverside area near Café Rouge. It is kids friendly and has a high customer rating and a price range of £20-25."
"name[The Mill], eatType[pub], food[Fast food], priceRange[£20-25], customer rating[high], area[riverside], familyFriendly[yes], near[Café Sicilia]"	"The Mill is a fast food pub in the riverside area near Café Sicilia. It is kids friendly and has a high customer rating and a price range of £20-25."
"name[The Mill], eatType[pub], food[Fast food], priceRange[cheap], area[riverside], familyFriendly[yes], near[Raja Indian Cuisine]"	"The Mill is a cheap fast food pub in the riverside area near Raja Indian Cuisine. It is family friendly."
"name[The Mill], eatType[pub], food[Fast food], priceRange[cheap], customer rating[5 out of 5], area[city centre], familyFriendly[no], near[Café Sicilia]"	"The Mill is a cheap fast food pub in the city centre near Café Sicilia. It is not family friendly and has a customer rating of 5 out of 5."
"name[The Mill], eatType[pub], food[Fast food], priceRange[cheap], customer rating[5 out of 5], area[city centre], familyFriendly[yes], near[Café Sicilia]"	"The Mill is a cheap fast food restaurant in the city centre near Café Sicilia. It is family friendly and has a customer rating of 5 out of 5."
"name[The Mill], eatType[pub], food[Fast food], priceRange[cheap], customer rating[5 out of 5], area[riverside], familyFriendly[no], near[Café Sicilia]"	"The Mill is a cheap fast food pub in the riverside area near Café Sicilia. It is not family friendly and has a customer rating of 5 out of 5."
"name[The Mill], eatType[pub], food[Fast food], priceRange[cheap], customer rating[5 out of 5], area[riverside], familyFriendly[yes], near[Café Sicilia]"	"The Mill is a cheap fast food restaurant in the riverside area near Café Sicilia. It is family friendly and has a customer rating of 5 out of 5."
"name[The Mill], eatType[pub], food[Fast food], priceRange[cheap], customer rating[average], area[city centre], familyFriendly[no], near[Café Sicilia]"	"The Mill is a cheap fast food pub in the city centre near Café Sicilia. It is not family friendly and has an average customer rating."
"name[The Mill], eatType[pub], food[Fast food], priceRange[cheap], customer rating[average], area[city centre], familyFriendly[yes], near[Café Sicilia]"	"The Mill is a fast food pub in the city centre near Café Sicilia. It is family friendly and has an average customer rating and a cheap price range."
"name[The Mill], eatType[pub], food[Fast food], priceRange[cheap], customer rating[average], area[riverside], familyFriendly[no], near[Café Sicilia]"	"The Mill is a cheap fast food pub in the riverside area near Café Sicilia. It is not family friendly and has an average customer rating."
"name[The Mill], eatType[pub], food[Fast food], priceRange[cheap], customer rating[average], area[riverside], familyFriendly[yes], near[Café Sicilia]"	"The Mill is a fast food pub in the riverside area near Café Sicilia. It is family friendly and has an average customer rating and a cheap price range."
"name[The Mill], eatType[pub], food[Fast food], priceRange[high], customer rating[1 out of 5], area[city centre], familyFriendly[no], near[Café Sicilia]"	"The Mill is a fast food pub in the city centre near Café Sicilia. It has a high price range and a customer rating of 1 out of 5. It is not children friendly."
"name[The Mill], eatType[pub], food[Fast food], priceRange[high], customer rating[1 out of 5], area[city centre], familyFriendly[yes], near[Café Sicilia]"	"The Mill is a fast food pub in the city centre near Café Sicilia. It is children friendly and has a high price range and a customer rating of 1 out of 5."
"name[The Mill], eatType[pub], food[Fast food], priceRange[high], customer rating[1 out of 5], area[riverside], familyFriendly[no], near[Café Sicilia]"	"The Mill is a fast food pub in the riverside area near Café Sicilia. It has a high price range and a customer rating of 1 out of 5. It is not children friendly."
"name[The Mill], eatType[pub], food[Fast food], priceRange[high], customer rating[1 out of 5], area[riverside], familyFriendly[yes], near[Café Sicilia]"	"The Mill is a fast food pub in the riverside area near Café Sicilia. It is children friendly and has a high price range and a customer rating of 1 out of 5."
"name[The Mill], eatType[pub], food[Fast food], priceRange[high], customer rating[average], area[city centre], familyFriendly[no], near[Café Sicilia]"	"The Mill is a fast food pub in the city centre near Café Sicilia. It is not children friendly and has a high price range and an average customer rating."
"name[The Mill], eatType[pub], food[Fast food], priceRange[high], customer rating[average], area[city centre], familyFriendly[yes], near[Café Sicilia]"	"The Mill is a fast food pub in the city centre near Café Sicilia. It is children friendly and has a high price range and an average customer rating."
"name[The Mill], eatType[pub], food[Fast food], priceRange[high], customer rating[average], area[riverside], familyFriendly[no], near[Café Sicilia]"	"The Mill is a fast food pub in the riverside area near Café Sicilia. It is not children friendly and has an average customer rating and a high price range."
"name[The Mill], eatType[pub], food[Fast food], priceRange[high], customer rating[average], area[riverside], familyFriendly[yes], near[Café Sicilia]"	"The Mill is a fast food pub in the riverside area near Café Sicilia. It is children friendly and has a high price range and an average customer rating."
"name[The Mill], eatType[pub], food[Fast food], priceRange[less than £20], customer rating[low], area[city centre], familyFriendly[no], near[Café Sicilia]"	"The Mill is a fast food pub in the city centre near Café Sicilia. It is not family friendly and has a low customer rating and a price range of less than £20."
"name[The Mill], eatType[pub], food[Fast food], priceRange[less than £20], customer rating[low], area[city centre], familyFriendly[yes], near[Café Sicilia]"	"The Mill is a fast food pub in the city centre near Café Sicilia. It is family friendly and has a low customer rating and a price range of less than £20."
"name[The Mill], eatType[pub], food[Fast food], priceRange[less than £20], customer rating[low], area[riverside], familyFriendly[no], near[Café Sicilia]"	"The Mill is a fast food pub in the riverside area near Café Sicilia. It is not family friendly and has a low customer rating and a price range of less than £20."
"name[The Mill], eatType[pub], food[Fast food], priceRange[less than £20], customer rating[low], area[riverside], familyFriendly[yes], near[Café Sicilia]"	"The Mill is a fast food pub in the riverside area near Café Sicilia. It is family friendly and has a low customer rating and a price range of less than £20."
"name[The Mill], eatType[pub], food[Fast food], priceRange[moderate], customer rating[1 out of 5], area[city centre], familyFriendly[no], near[Café Sicilia]"	"The Mill is a fast food pub in the city centre near Café Sicilia. It has a moderate price range and a customer rating of 1 out of 5. It is not kids friendly."
"name[The Mill], eatType[pub], food[Fast food], priceRange[moderate], customer rating[1 out of 5], area[city centre], familyFriendly[yes], near[Café Sicilia]"	"The Mill is a fast food pub in the city centre near Café Sicilia. It is kids friendly and has a moderate price range and a customer rating of 1 out of 5."
"name[The Mill], eatType[pub], food[Fast food], priceRange[moderate], customer rating[1 out of 5], area[riverside], familyFriendly[no], near[Café Sicilia]"	"The Mill is a fast food restaurant in the riverside area near Café Sicilia. It is not kids friendly and has a moderate price range and a customer rating of 1 out of 5."
"name[The Mill], eatType[pub], food[Fast food], priceRange[moderate], customer rating[1 out of 5], area[riverside], familyFriendly[yes], near[Café Sicilia]"	"The Mill is a fast food pub in the riverside area near Café Sicilia. It is kids friendly and has a moderate price range and a customer rating of 1 out of 5."
"name[The Mill], eatType[pub], food[Fast food], priceRange[moderate], customer rating[3 out of 5], area[city centre], familyFriendly[no], near[Café Sicilia]"	"The Mill is a fast food pub in the city centre near Café Sicilia. It is not kids friendly and has a moderate price range and a customer rating of 3 out of 5."
"name[The Mill], eatType[pub], food[Fast food], priceRange[moderate], customer rating[3 out of 5], area[city centre], familyFriendly[yes], near[Café Sicilia]"	"The Mill is a fast food pub in the city centre near Café Sicilia. It is kids friendly and has a moderate price range and a customer rating of 3 out of 5."
"name[The Mill], eatType[pub], food[Fast food], priceRange[moderate], customer rating[3 out of 5], area[riverside], familyFriendly[no], near[Café Sicilia]"	"The Mill is a fast food restaurant in the riverside area near Café Sicilia. It is not kids friendly and has a moderate price range and a customer rating of 3 out of 5."
"name[The Mill], eatType[pub], food[Fast food], priceRange[moderate], customer rating[3 out of 5], area[riverside], familyFriendly[yes], near[Café Sicilia]"	"The Mill is a fast food pub in the kids friendly pub in the riverside area near Café Sicilia. It has a moderate price range and a customer rating of 3 out of 5."
"name[The Mill], eatType[restaurant], food[English], priceRange[high], area[riverside], familyFriendly[yes], near[Raja Indian Cuisine]"	"The Mill is a english restaurant in the riverside area near Raja Indian Cuisine. It is children friendly and has a high price range."
"name[The Mill], eatType[restaurant], food[English], priceRange[high], customer rating[average], area[riverside], familyFriendly[yes], near[Café Rouge]"	"The Mill is a english restaurant in the riverside area near Café Rouge. It is children friendly and has an average customer rating and a high price range."
"name[The Mill], eatType[restaurant], food[English], priceRange[less than £20], area[city centre], familyFriendly[no], near[Raja Indian Cuisine]"	"The Mill is a english restaurant in the city centre near Raja Indian Cuisine. It is not family friendly and has a price range of less than £20."
"name[The Mill], eatType[restaurant], food[English], priceRange[less than £20], area[city centre], familyFriendly[yes], near[Raja Indian Cuisine]"	"The Mill is a english restaurant in the city centre near Raja Indian Cuisine. It is family friendly and has a price range of less than £20."
"name[The Mill], eatType[restaurant], food[English], priceRange[less than £20], area[riverside], familyFriendly[no], near[Raja Indian Cuisine]"	"The Mill is a english restaurant in the riverside area near Raja Indian Cuisine. It is not family friendly and has a price range of less than £20."
"name[The Mill], eatType[restaurant], food[English], priceRange[less than £20], area[riverside], familyFriendly[yes], near[Raja Indian Cuisine]"	"The Mill is a english restaurant in the riverside area near Raja Indian Cuisine. It is family friendly and has a price range of less than £20."
"name[The Mill], eatType[restaurant], food[English], priceRange[less than £20], customer rating[low], area[city centre], familyFriendly[no], near[Café Rouge]"	"The Mill is a english restaurant in the city centre near Café Rouge. It is not family friendly and has a low customer rating and a price range of less than £20."
"name[The Mill], eatType[restaurant], food[English], priceRange[less than £20], customer rating[low], area[city centre], familyFriendly[yes], near[Café Rouge]"	"The Mill is a english restaurant in the city centre near Café Rouge. It is family friendly and has a low customer rating and a price range of less than £20."
"name[The Mill], eatType[restaurant], food[English], priceRange[less than £20], customer rating[low], area[riverside], familyFriendly[no], near[Café Rouge]"	"The Mill is a english restaurant in the riverside area near Café Rouge. It is not family friendly and has a low customer rating and a price range of less than £20."
"name[The Mill], eatType[restaurant], food[English], priceRange[less than £20], customer rating[low], area[riverside], familyFriendly[yes], near[Café Rouge]"	"The Mill is a english restaurant in the riverside area near Café Rouge. It is family friendly and has a low customer rating and a price range of less than £20."
"name[The Mill], eatType[restaurant], food[English], priceRange[moderate], area[city centre], familyFriendly[no], near[Raja Indian Cuisine]"	"The Mill is a english restaurant in the city centre near Raja Indian Cuisine. It is not kids friendly and has a moderate price range."
"name[The Mill], eatType[restaurant], food[English], priceRange[moderate], area[city centre], familyFriendly[yes], near[Raja Indian Cuisine]"	"The Mill is a english restaurant in the city centre near Raja Indian Cuisine. It is kids friendly and has a moderate price range."
"name[The Mill], eatType[restaurant], food[English], priceRange[moderate], area[riverside], familyFriendly[no], near[Raja Indian Cuisine]"	"The Mill is a english restaurant in the riverside area near Raja Indian Cuisine. It is not kids friendly and has a moderate price range."
"name[The Mill], eatType[restaurant], food[English], priceRange[moderate], area[riverside], familyFriendly[yes], near[Raja Indian Cuisine]"	"The Mill is a english restaurant in the riverside area near Raja Indian Cuisine. It is kids friendly and has a moderate price range."
"name[The Mill], eatType[restaurant], food[English], priceRange[moderate], customer rating[1 out of 5], area[city centre], familyFriendly[no], near[Café Rouge]"	"The Mill is a english restaurant in the city centre near Café Rouge. It is not kids friendly and has a moderate price range and a customer rating of 1 out of 5."
"name[The Mill], eatType[restaurant], food[English], priceRange[moderate], customer rating[1 out of 5], area[city centre], familyFriendly[yes], near[Café Rouge]"	"The Mill is a english restaurant in the city centre near Café Rouge. It is kids friendly and has a moderate price range and a customer rating of 1 out of 5."
"name[The Mill], eatType[restaurant], food[English], priceRange[moderate], customer rating[1 out of 5], area[riverside], familyFriendly[no], near[Café Rouge]"	"The Mill is a english restaurant in the riverside area near Café Rouge. It is not kids friendly and has a moderate price range and a customer rating of 1 out of 5."
"name[The Mill], eatType[restaurant], food[English], priceRange[moderate], customer rating[1 out of 5], area[riverside], familyFriendly[yes], near[Café Rouge]"	"The Mill is a english restaurant in the riverside area near Café Rouge. It is kids friendly and has a moderate price range and a customer rating of 1 out of 5."
"name[The Mill], eatType[restaurant], food[English], priceRange[moderate], customer rating[3 out of 5], area[city centre], familyFriendly[no], near[Café Rouge]"	"The Mill is a english restaurant in the city centre near Café Rouge. It is not kids friendly and has a moderate price range and a customer rating of 3 out of 5."
"name[The Mill], eatType[restaurant], food[English], priceRange[moderate], customer rating[3 out of 5], area[city centre], familyFriendly[yes], near[Café Rouge]"	"The Mill is a english restaurant in the city centre near Café Rouge. It is kids friendly and has a moderate price range and a customer rating of 3 out of 5."
"name[The Mill], eatType[restaurant], food[English], priceRange[moderate], customer rating[3 out of 5], area[riverside], familyFriendly[no], near[Café Rouge]"	"The Mill is a english restaurant in the riverside area near Café Rouge. It is not kids friendly and has a moderate price range and a customer rating of 3 out of 5."
"name[The Mill], eatType[restaurant], food[English], priceRange[moderate], customer rating[3 out of 5], area[riverside], familyFriendly[yes], near[Café Rouge]"	"The Mill is a english restaurant in the riverside area near Café Rouge. It is kids friendly and has a moderate price range and a customer rating of 3 out of 5."
"name[The Mill], eatType[restaurant], food[English], priceRange[more than £30], area[riverside], familyFriendly[yes], near[Raja Indian Cuisine]"	"The Mill is a english restaurant in the riverside area near Raja Indian Cuisine. It is children friendly and has a price range of more than £30."
"name[The Mill], eatType[restaurant], food[English], priceRange[more than £30], customer rating[high], area[city centre], familyFriendly[no], near[Café Rouge]"	"The Mill is a english restaurant in the city centre near Café Rouge. It is not children friendly and has a high customer rating and a price range of more than £30."
"name[The Mill], eatType[restaurant], food[English], priceRange[more than £30], customer rating[high], area[city centre], familyFriendly[yes], near[Café Rouge]"	"The Mill is a english restaurant in the city centre near Café Rouge. It is children friendly and has a high customer rating and a price range of more than £30."
"name[The Mill], eatType[restaurant], food[English], priceRange[more than £30], customer rating[high], area[riverside], familyFriendly[no], near[Café Rouge]"	"The Mill is a english restaurant in the riverside area near Café Rouge. It is not children friendly and has a high customer rating and a price range of more than £30."
"name[The Mill], eatType[restaurant], food[English], priceRange[more than £30], customer rating[high], area[riverside], familyFriendly[yes], near[Café Rouge]"	"The Mill is a english restaurant in the riverside area near Café Rouge. It is children friendly and has a high customer rating and a price range of more than £30."
"name[The Mill], eatType[restaurant], food[Fast food], priceRange[£20-25], area[riverside], familyFriendly[yes], near[Raja Indian Cuisine]"	"The Mill is a fast food restaurant in the riverside area near Raja Indian Cuisine. It is kids friendly and has a price range of £20-25."
"name[The Mill], eatType[restaurant], food[Fast food], priceRange[cheap], area[riverside], familyFriendly[yes], near[Raja Indian Cuisine]"	"The Mill is a cheap fast food restaurant in the riverside area near Raja Indian Cuisine. It is family friendly."
"name[The Phoenix], eatType[pub], food[Fast food], priceRange[cheap], area[riverside], familyFriendly[yes], near[Raja Indian Cuisine]"	"The Phoenix is a cheap fast food pub in the riverside area near Raja Indian Cuisine. It is family friendly."
"name[The Phoenix], eatType[pub], food[Fast food], priceRange[high], area[city centre], familyFriendly[no], near[Raja Indian Cuisine]"	"The Phoenix is a fast food pub in the city centre near Raja Indian Cuisine. It is not children friendly and has a high price range."
"name[The Phoenix], eatType[pub], food[Fast food], priceRange[high], area[city centre], familyFriendly[yes], near[Raja Indian Cuisine]"	"The Phoenix is a fast food pub in the city centre near Raja Indian Cuisine. It is children friendly and has a high price range."
"name[The Phoenix], eatType[pub], food[Fast food], priceRange[high], area[riverside], familyFriendly[no], near[Raja Indian Cuisine]"	"The Phoenix is a fast food pub in the riverside area near Raja Indian Cuisine. It is not children friendly and has a high price range."
"name[The Phoenix], eatType[pub], food[Fast food], priceRange[high], area[riverside], familyFriendly[yes], near[Raja Indian Cuisine]"	"The Phoenix is a fast food pub in the riverside area near Raja Indian Cuisine. It is children friendly and has a high price range."
"name[The Phoenix], eatType[pub], food[Fast food], priceRange[less than £20], area[city centre], familyFriendly[no], near[Raja Indian Cuisine]"	"The Phoenix is a fast food pub in the city centre near Raja Indian Cuisine. It is not family friendly and has a price range of less than £20."
"name[The Phoenix], eatType[pub], food[Fast food], priceRange[less than £20], area[city centre], familyFriendly[yes], near[Raja Indian Cuisine]"	"The Phoenix is a fast food pub in the city centre near Raja Indian Cuisine. It is family friendly and has a price range of less than £20."
"name[The Phoenix], eatType[pub], food[Fast food], priceRange[less than £20], area[riverside], familyFriendly[no], near[Raja Indian Cuisine]"	"The Phoenix is a fast food pub in the riverside area near Raja Indian Cuisine. It is not family friendly and has a price range of less than £20."
"name[The Phoenix], eatType[pub], food[Fast food], priceRange[less than £20], area[riverside], familyFriendly[yes], near[Raja Indian Cuisine]"	"The Phoenix is a fast food pub in the riverside area near Raja Indian Cuisine. It is family friendly and has a price range of less than £20."
"name[The Phoenix], eatType[pub], food[Fast food], priceRange[moderate], area[city centre], familyFriendly[no], near[Raja Indian Cuisine]"	"The Phoenix is a fast food pub in the city centre near Raja Indian Cuisine. It is not kids friendly and has a moderate price range."
"name[The Phoenix], eatType[pub], food[Fast food], priceRange[moderate], area[city centre], familyFriendly[yes], near[Raja Indian Cuisine]"	"The Phoenix is a fast food pub in the city centre near Raja Indian Cuisine. It is kids friendly and has a moderate price range."
"name[The Phoenix], eatType[pub], food[Fast food], priceRange[moderate], area[riverside], familyFriendly[no], near[Raja Indian Cuisine]"	"The Phoenix is a fast food pub in the riverside area near Raja Indian Cuisine. It is not kids friendly and has a moderate price range."
"name[The Phoenix], eatType[pub], food[Fast food], priceRange[moderate], area[riverside], familyFriendly[yes], near[Raja Indian Cuisine]"	"The Phoenix is a fast food pub in the riverside area near Raja Indian Cuisine. It is kids friendly and has a moderate price range."
"name[The Phoenix], eatType[pub], food[Fast food], priceRange[moderate], customer rating[3 out of 5], area[riverside], familyFriendly[yes], near[Café Sicilia]"	"The Phoenix is a fast food pub in the kids friendly pub in the riverside area near Café Sicilia. It has a moderate price range and a customer rating of 3 out of 5."
"name[The Phoenix], eatType[pub], food[Fast food], priceRange[more than £30], area[riverside], familyFriendly[yes], near[Raja Indian Cuisine]"	"The Phoenix is a fast food pub in the riverside area near Raja Indian Cuisine. It is children friendly and has a price range of more than £30."
"name[The Phoenix], eatType[pub], food[Fast food], priceRange[more than £30], customer rating[high], area[city centre], familyFriendly[no], near[Café Sicilia]"	"The Phoenix is a fast food pub in the city centre near Café Sicilia. It is not children friendly and has a high customer rating and a price range of more than £30."
"name[The Phoenix], eatType[pub], food[Fast food], priceRange[more than £30], customer rating[high], area[city centre], familyFriendly[yes], near[Café Sicilia]"	"The Phoenix is a fast food restaurant in the city centre near Café Sicilia. It is children friendly and has a high customer rating and a price range of more than £30."
"name[The Phoenix], eatType[pub], food[Fast food], priceRange[more than £30], customer rating[high], area[riverside], familyFriendly[no], near[Café Sicilia]"	"The Phoenix is a fast food pub in the riverside area near Café Sicilia. It is not children friendly and has a high customer rating and a price range of more than £30."
"name[The Phoenix], eatType[pub], food[Fast food], priceRange[more than £30], customer rating[high], area[riverside], familyFriendly[yes], near[Café Sicilia]"	"The Phoenix is a fast food pub in the riverside area near Café Sicilia. It is children friendly and has a high customer rating and a price range of more than £30."
"name[The Phoenix], eatType[pub], food[French], priceRange[£20-25], area[riverside], familyFriendly[yes], near[Raja Indian Cuisine]"	"The Phoenix is a french pub in the riverside area near Raja Indian Cuisine. It is kids friendly and has a price range of £20-25."
"name[The Phoenix], eatType[pub], food[French], priceRange[£20-25], customer rating[3 out of 5], area[city centre], familyFriendly[no], near[Café Sicilia]"	"The Phoenix is a french restaurant in the city centre near Café Sicilia. It is not kids friendly and has a customer rating of 3 out of 5 and a price range of £20-25."
"name[The Phoenix], eatType[pub], food[French], priceRange[£20-25], customer rating[3 out of 5], area[city centre], familyFriendly[yes], near[Café Sicilia]"	"The Phoenix is a french pub in the city centre near Café Sicilia. It is kids friendly and has a customer rating of 3 out of 5 and a price range of £20-25."
"name[The Phoenix], eatType[pub], food[French], priceRange[£20-25], customer rating[3 out of 5], area[riverside], familyFriendly[no], near[Café Sicilia]"	"The Phoenix is a french pub in the riverside area near Café Sicilia. It has a customer rating of 3 out of 5 and a price range of £20-25. It is not kids friendly."
"name[The Phoenix], eatType[pub], food[French], priceRange[£20-25], customer rating[3 out of 5], area[riverside], familyFriendly[yes], near[Café Sicilia]"	"The Phoenix is a french pub in the riverside area near Café Sicilia. It is kids friendly and has a customer rating of 3 out of 5 and a price range of £20-25."
"name[The Phoenix], eatType[pub], food[French], priceRange[£20-25], customer rating[3 out of 5], area[riverside], familyFriendly[yes], near[Crowne Plaza Hotel]"	"The Phoenix is a french pub in the riverside area near Crowne Plaza Hotel. It is kids friendly and has a customer rating of 3 out of 5 and a price range of £20-25."
"name[The Phoenix], eatType[pub], food[French], priceRange[£20-25], customer rating[high], area[city centre], familyFriendly[no], near[Crowne Plaza Hotel]"	"The Phoenix is a french pub in the city centre near Crowne Plaza Hotel. It is not kids friendly and has a high customer rating and a price range of £20-25."
"name[The Phoenix], eatType[pub], food[French], priceRange[£20-25], customer rating[high], area[city centre], familyFriendly[yes], near[Crowne Plaza Hotel]"	"The Phoenix is a french pub in the city centre near Crowne Plaza Hotel. It is kids friendly and has a high customer rating and a price range of £20-25."
"name[The Phoenix], eatType[pub], food[French], priceRange[£20-25], customer rating[high], area[riverside], familyFriendly[no], near[Crowne Plaza Hotel]"	"The Phoenix is a french pub in the riverside area near Crowne Plaza Hotel. It is not kids friendly and has a high customer rating and a price range of £20-25."
"name[The Phoenix], eatType[pub], food[French], priceRange[£20-25], customer rating[high], area[riverside], familyFriendly[yes], near[Crowne Plaza Hotel]"	"The Phoenix is a french pub in the riverside area near Crowne Plaza Hotel. It has a high customer rating and a price range of £20-25. It is kids friendly."
"name[The Phoenix], eatType[pub], food[French], priceRange[cheap], area[riverside], familyFriendly[yes], near[Raja Indian Cuisine]"	"The Phoenix is a cheap french pub in the riverside area near Raja Indian Cuisine. It is family friendly."
"name[The Phoenix], eatType[pub], food[French], priceRange[cheap], customer rating[5 out of 5], area[city centre], familyFriendly[no], near[Crowne Plaza Hotel]"	"The Phoenix is a cheap french pub in the riverside area near Crowne Plaza Hotel. It is not family friendly and has a customer rating of 5 out of 5."
"name[The Phoenix], eatType[pub], food[French], priceRange[cheap], customer rating[5 out of 5], area[city centre], familyFriendly[yes], near[Crowne Plaza Hotel]"	"The Phoenix is a french pub in the city centre near Crowne Plaza Hotel. It is family friendly and has a cheap price range and a customer rating of 5 out of 5."
"name[The Phoenix], eatType[pub], food[French], priceRange[cheap], customer rating[5 out of 5], area[riverside], familyFriendly[no], near[Crowne Plaza Hotel]"	"The Phoenix is a cheap french pub in the riverside area near Crowne Plaza Hotel. It is not family friendly and has a customer rating of 5 out of 5."
"name[The Phoenix], eatType[pub], food[French], priceRange[cheap], customer rating[5 out of 5], area[riverside], familyFriendly[yes], near[Crowne Plaza Hotel]"	"The Phoenix is a cheap french pub in the riverside area near Crowne Plaza Hotel. It is family friendly and has a customer rating of 5 out of 5."
"name[The Phoenix], eatType[pub], food[French], priceRange[high], area[riverside], familyFriendly[yes], near[Raja Indian Cuisine]"	"The Phoenix is a french pub in the riverside area near Raja Indian Cuisine. It is children friendly and has a high price range."
"name[The Phoenix], eatType[pub], food[French], priceRange[high], customer rating[3 out of 5], area[city centre], familyFriendly[no], near[Crowne Plaza Hotel]"	"The Phoenix is a french pub in the city centre near Crowne Plaza Hotel. It has a high price range and a customer rating of 3 out of 5. It is not children friendly."
"name[The Phoenix], eatType[pub], food[French], priceRange[high], customer rating[3 out of 5], area[city centre], familyFriendly[yes], near[Crowne Plaza Hotel]"	"The Phoenix is a french pub in the city centre near Crowne Plaza Hotel. It is children friendly and has a high price range and a customer rating of 3 out of 5."
"name[The Phoenix], eatType[pub], food[French], priceRange[high], customer rating[3 out of 5], area[riverside], familyFriendly[no], near[Crowne Plaza Hotel]"	"The Phoenix is a french pub in the riverside area near Crowne Plaza Hotel. It has a high price range and a customer rating of 3 out of 5. It is not children friendly."
"name[The Phoenix], eatType[pub], food[French], priceRange[high], customer rating[3 out of 5], area[riverside], familyFriendly[yes], near[Crowne Plaza Hotel]"	"The Phoenix is a french pub in the riverside area near Crowne Plaza Hotel. It has a high price range and a customer rating of 3 out of 5. It is children friendly."
"name[The Phoenix], eatType[pub], food[French], priceRange[less than £20], customer rating[average], area[city centre], familyFriendly[no], near[Crowne Plaza Hotel]"	"The Phoenix is a french pub in the city centre near Crowne Plaza Hotel. It has an average customer rating and a price range of less than £20. It is not family friendly."
"name[The Phoenix], eatType[pub], food[French], priceRange[less than £20], customer rating[average], area[city centre], familyFriendly[yes], near[Crowne Plaza Hotel]"	"The Phoenix is a french pub in the city centre near Crowne Plaza Hotel. It is family friendly and has an average customer rating and a price range of less than £20."
"name[The Phoenix], eatType[pub], food[French], priceRange[less than £20], customer rating[average], area[riverside], familyFriendly[no], near[Crowne Plaza Hotel]"	"The Phoenix is a french pub in the riverside area near Crowne Plaza Hotel. It has an average customer rating and a price range of less than £20. It is not family friendly."
"name[The Phoenix], eatType[pub], food[French], priceRange[less than £20], customer rating[average], area[riverside], familyFriendly[yes], near[Crowne Plaza Hotel]"	"The Phoenix is a french pub in the riverside area near Crowne Plaza Hotel. It is family friendly and has an average customer rating and a price range of less than £20."
"name[The Phoenix], eatType[pub], food[French], priceRange[less than £20], customer rating[low], area[city centre], familyFriendly[no], near[Crowne Plaza Hotel]"	"The Phoenix is a italian pub in the city centre near Crowne Plaza Hotel. It is not family friendly and has a low customer rating and a price range of less than £20."
"name[The Phoenix], eatType[pub], food[French], priceRange[less than £20], customer rating[low], area[city centre], familyFriendly[yes], near[Crowne Plaza Hotel]"	"The Phoenix is a french pub in the city centre near Crowne Plaza Hotel. It is family friendly and has a low customer rating and a price range of less than £20."
"name[The Phoenix], eatType[pub], food[French], priceRange[less than £20], customer rating[low], area[riverside], familyFriendly[no], near[Crowne Plaza Hotel]"	"The Phoenix is a french pub in the riverside area near Crowne Plaza Hotel. It is not family friendly and has a low customer rating and a price range of less than £20."
"name[The Phoenix], eatType[pub], food[French], priceRange[less than £20], customer rating[low], area[riverside], familyFriendly[yes], near[Crowne Plaza Hotel]"	"The Phoenix is a french pub in the riverside area near Crowne Plaza Hotel. It is family friendly and has a low customer rating and a price range of less than £20."
"name[The Phoenix], eatType[pub], food[French], priceRange[moderate], customer rating[1 out of 5], area[city centre], familyFriendly[no], near[Crowne Plaza Hotel]"	"The Phoenix is a french pub in the city centre near Crowne Plaza Hotel. It is not kids friendly and has a moderate price range and a customer rating of 1 out of 5."
"name[The Phoenix], eatType[pub], food[French], priceRange[moderate], customer rating[1 out of 5], area[city centre], familyFriendly[yes], near[Crowne Plaza Hotel]"	"The Phoenix is a french pub in the moderate price range. It is a kids friendly pub in the city centre near Crowne Plaza Hotel. It has a customer rating of 1 out of 5."
"name[The Phoenix], eatType[pub], food[French], priceRange[moderate], customer rating[1 out of 5], area[riverside], familyFriendly[no], near[Crowne Plaza Hotel]"	"The Phoenix is a french pub in the riverside area near Crowne Plaza Hotel. It has a moderate price range and a customer rating of 1 out of 5. It is not kids friendly."
"name[The Phoenix], eatType[pub], food[French], priceRange[moderate], customer rating[1 out of 5], area[riverside], familyFriendly[yes], near[Crowne Plaza Hotel]"	"The Phoenix is a french pub in the riverside area near Crowne Plaza Hotel. It has a moderate price range and a customer rating of 1 out of 5. It is kids friendly."
"name[The Phoenix], eatType[pub], food[French], priceRange[more than £30], customer rating[5 out of 5], area[city centre], familyFriendly[no], near[Crowne Plaza Hotel]"	"The Phoenix is a french pub in the city centre near Crowne Plaza Hotel. It is not children friendly and has a customer rating of 5 out of 5 and a price range of more than £30."
"name[The Phoenix], eatType[pub], food[French], priceRange[more than £30], customer rating[5 out of 5], area[city centre], familyFriendly[yes], near[Crowne Plaza Hotel]"	"The Phoenix is a french pub in the city centre near Crowne Plaza Hotel. It is a children friendly pub with a customer rating of 5 out of 5 and a price range of more than £30."
"name[The Phoenix], eatType[pub], food[French], priceRange[more than £30], customer rating[5 out of 5], area[riverside], familyFriendly[no], near[Crowne Plaza Hotel]"	"The Phoenix is a french pub in the riverside area near Crowne Plaza Hotel. It has a customer rating of 5 out of 5 and a price range of more than £30. It is not children friendly."
"name[The Phoenix], eatType[pub], food[French], priceRange[more than £30], customer rating[5 out of 5], area[riverside], familyFriendly[yes], near[Crowne Plaza Hotel]"	"The Phoenix is a french pub in the riverside area near Crowne Plaza Hotel. It has a customer rating of 5 out of 5 and a price range of more than £30. It is children friendly."
"name[The Phoenix], eatType[pub], food[French], priceRange[more than £30], customer rating[low], area[city centre], familyFriendly[no], near[Crowne Plaza Hotel]"	"The Phoenix is a french pub in the city centre near Crowne Plaza Hotel. It is not children friendly and has a low customer rating and a price range of more than £30."
"name[The Phoenix], eatType[pub], food[French], priceRange[more than £30], customer rating[low], area[city centre], familyFriendly[yes], near[Crowne Plaza Hotel]"	"The Phoenix is a french pub in the city centre near Crowne Plaza Hotel. It is children friendly and has a low customer rating and a price range of more than £30."
"name[The Phoenix], eatType[pub], food[French], priceRange[more than £30], customer rating[low], area[riverside], familyFriendly[no], near[Crowne Plaza Hotel]"	"The Phoenix is a french pub in the riverside area near Crowne Plaza Hotel. It is not children friendly and has a low customer rating and a price range of more than £30."
"name[The Phoenix], eatType[pub], food[French], priceRange[more than £30], customer rating[low], area[riverside], familyFriendly[yes], near[Crowne Plaza Hotel]"	"The Phoenix is a french pub in the riverside area near Crowne Plaza Hotel. It is children friendly and has a low customer rating and a price range of more than £30."
"name[The Phoenix], eatType[restaurant], food[Fast food], priceRange[cheap], area[riverside], familyFriendly[yes], near[Raja Indian Cuisine]"	"The Phoenix is a cheap fast food restaurant in the riverside area near Raja Indian Cuisine. It is family friendly."
"name[The Phoenix], eatType[restaurant], food[Fast food], priceRange[high], area[city centre], familyFriendly[no], near[Raja Indian Cuisine]"	"The Phoenix is a fast food restaurant in the city centre near Raja Indian Cuisine. It is not children friendly and has a high price range."
"name[The Phoenix], eatType[restaurant], food[Fast food], priceRange[high], area[city centre], familyFriendly[yes], near[Raja Indian Cuisine]"	"The Phoenix is a fast food restaurant in the city centre near Raja Indian Cuisine. It is children friendly and has a high price range."
"name[The Phoenix], eatType[restaurant], food[Fast food], priceRange[high], area[riverside], familyFriendly[no], near[Raja Indian Cuisine]"	"The Phoenix is a fast food restaurant in the riverside area near Raja Indian Cuisine. It is not children friendly and has a high price range."
"name[The Phoenix], eatType[restaurant], food[Fast food], priceRange[high], area[riverside], familyFriendly[yes], near[Raja Indian Cuisine]"	"The Phoenix is a fast food restaurant in the riverside area near Raja Indian Cuisine. It is children friendly and has a high price range."
"name[The Phoenix], eatType[restaurant], food[Fast food], priceRange[less than £20], area[city centre], familyFriendly[no], near[Raja Indian Cuisine]"	"The Phoenix is a fast food restaurant in the city centre near Raja Indian Cuisine. It is not family friendly and has a price range of less than £20."
"name[The Phoenix], eatType[restaurant], food[Fast food], priceRange[less than £20], area[city centre], familyFriendly[yes], near[Raja Indian Cuisine]"	"The Phoenix is a fast food restaurant in the city centre near Raja Indian Cuisine. It is family friendly and has a price range of less than £20."
"name[The Phoenix], eatType[restaurant], food[Fast food], priceRange[less than £20], area[riverside], familyFriendly[no], near[Raja Indian Cuisine]"	"The Phoenix is a fast food restaurant in the riverside area near Raja Indian Cuisine. It is not family friendly and has a price range of less than £20."
"name[The Phoenix], eatType[restaurant], food[Fast food], priceRange[less than £20], area[riverside], familyFriendly[yes], near[Raja Indian Cuisine]"	"The Phoenix is a fast food restaurant in the riverside area near Raja Indian Cuisine. It is family friendly and has a price range of less than £20."
"name[The Phoenix], eatType[restaurant], food[Fast food], priceRange[moderate], area[city centre], familyFriendly[no], near[Raja Indian Cuisine]"	"The Phoenix is a fast food restaurant in the city centre near Raja Indian Cuisine. It is not kids friendly and has a moderate price range."
"name[The Phoenix], eatType[restaurant], food[Fast food], priceRange[moderate], area[city centre], familyFriendly[yes], near[Raja Indian Cuisine]"	"The Phoenix is a fast food restaurant in the city centre near Raja Indian Cuisine. It is kids friendly and has a moderate price range."
"name[The Phoenix], eatType[restaurant], food[Fast food], priceRange[moderate], area[riverside], familyFriendly[no], near[Raja Indian Cuisine]"	"The Phoenix is a fast food restaurant in the riverside area near Raja Indian Cuisine. It is not kids friendly and has a moderate price range."
"name[The Phoenix], eatType[restaurant], food[Fast food], priceRange[moderate], area[riverside], familyFriendly[yes], near[Raja Indian Cuisine]"	"The Phoenix is a fast food restaurant in the riverside area near Raja Indian Cuisine. It is kids friendly and has a moderate price range."
"name[The Phoenix], eatType[restaurant], food[Fast food], priceRange[more than £30], area[riverside], familyFriendly[yes], near[Raja Indian Cuisine]"	"The Phoenix is a fast food restaurant in the riverside area near Raja Indian Cuisine. It is children friendly and has a price range of more than £30."
"name[The Phoenix], eatType[restaurant], food[French], priceRange[£20-25], area[riverside], familyFriendly[yes], near[Raja Indian Cuisine]"	"The Phoenix is a french restaurant in the riverside area near Raja Indian Cuisine. It is kids friendly and has a price range of £20-25."
"name[The Phoenix], eatType[restaurant], food[French], priceRange[cheap], area[riverside], familyFriendly[yes], near[Raja Indian Cuisine]"	"The Phoenix is a cheap french restaurant in the riverside area near Raja Indian Cuisine. It is family friendly."
"name[The Phoenix], eatType[restaurant], food[French], priceRange[high], area[riverside], familyFriendly[yes], near[Raja Indian Cuisine]"	"The Phoenix is a french restaurant in the riverside area near Raja Indian Cuisine. It is children friendly and has a high price range."
"name[The Phoenix], eatType[restaurant], food[Indian], priceRange[£20-25], customer rating[high], area[city centre], familyFriendly[no], near[Crowne Plaza Hotel]"	"The Phoenix is a indian restaurant in the city centre near Crowne Plaza Hotel. It is not kids friendly and has a high customer rating and a price range of £20-25."
"name[The Phoenix], eatType[restaurant], food[Indian], priceRange[£20-25], customer rating[high], area[city centre], familyFriendly[yes], near[Crowne Plaza Hotel]"	"The Phoenix is a indian restaurant in the city centre near Crowne Plaza Hotel. It is kids friendly and has a high customer rating and a price range of £20-25."
"name[The Phoenix], eatType[restaurant], food[Indian], priceRange[£20-25], customer rating[high], area[riverside], familyFriendly[no], near[Crowne Plaza Hotel]"	"The Phoenix is a indian restaurant in the riverside area near Crowne Plaza Hotel. It is not kids friendly and has a high customer rating and a price range of £20-25."
"name[The Phoenix], eatType[restaurant], food[Indian], priceRange[£20-25], customer rating[high], area[riverside], familyFriendly[yes], near[Crowne Plaza Hotel]"	"The Phoenix is a indian restaurant in the riverside area near Crowne Plaza Hotel. It is kids friendly and has a high customer rating and a price range of £20-25."
"name[The Phoenix], eatType[restaurant], food[Indian], priceRange[cheap], customer rating[5 out of 5], area[city centre], familyFriendly[no], near[Crowne Plaza Hotel]"	"The Phoenix is a cheap indian restaurant in the city centre near Crowne Plaza Hotel. It is not family friendly and has a customer rating of 5 out of 5."
"name[The Phoenix], eatType[restaurant], food[Indian], priceRange[cheap], customer rating[5 out of 5], area[city centre], familyFriendly[yes], near[Crowne Plaza Hotel]"	"The Phoenix is a cheap indian restaurant in the city centre near Crowne Plaza Hotel. It is family friendly and has a customer rating of 5 out of 5."
"name[The Phoenix], eatType[restaurant], food[Indian], priceRange[cheap], customer rating[5 out of 5], area[riverside], familyFriendly[no], near[Crowne Plaza Hotel]"	"The Phoenix is a cheap indian restaurant in the riverside area near Crowne Plaza Hotel. It is not family friendly and has a customer rating of 5 out of 5."
"name[The Phoenix], eatType[restaurant], food[Indian], priceRange[cheap], customer rating[5 out of 5], area[riverside], familyFriendly[no], near[Express by Holiday Inn]"	"The Phoenix is a cheap indian restaurant in the riverside area near Express by Holiday Inn. It is not family friendly and has a customer rating of 5 out of 5."
"name[The Phoenix], eatType[restaurant], food[Indian], priceRange[cheap], customer rating[5 out of 5], area[riverside], familyFriendly[yes], near[Express by Holiday Inn]"	"The Phoenix is a cheap indian restaurant in the riverside area near Express by Holiday Inn. It is family friendly and has a customer rating of 5 out of 5."
"name[The Phoenix], eatType[restaurant], food[Indian], priceRange[cheap], customer rating[average], area[city centre], familyFriendly[no], near[Express by Holiday Inn]"	"The Phoenix is a cheap indian restaurant in the city centre near Express by Holiday Inn. It is not family friendly and has an average customer rating."
"name[The Plough], eatType[pub], food[Chinese], priceRange[£20-25], area[riverside], familyFriendly[yes], near[Raja Indian Cuisine]"	"The Plough is a chinese pub in the riverside area near Raja Indian Cuisine. It is kids friendly and has a price range of £20-25."
"name[The Plough], eatType[pub], food[Chinese], priceRange[cheap], area[riverside], familyFriendly[yes], near[Raja Indian Cuisine]"	"The Plough is a cheap chinese pub in the riverside area near Raja Indian Cuisine. It is family friendly."
"name[The Plough], eatType[pub], food[Chinese], priceRange[high], area[city centre], familyFriendly[no], near[Raja Indian Cuisine]"	"The Plough is a chinese pub in the city centre near Raja Indian Cuisine. It is not children friendly and has a high price range."
"name[The Plough], eatType[pub], food[Chinese], priceRange[high], area[city centre], familyFriendly[yes], near[Raja Indian Cuisine]"	"The Plough is a chinese pub in the city centre near Raja Indian Cuisine. It is children friendly and has a high price range."
"name[The Plough], eatType[pub], food[Chinese], priceRange[high], area[riverside], familyFriendly[no], near[Raja Indian Cuisine]"	"The Plough is a chinese pub in the riverside area near Raja Indian Cuisine. It is not children friendly and has a high price range."
"name[The Plough], eatType[pub], food[Chinese], priceRange[high], area[riverside], familyFriendly[yes], near[Raja Indian Cuisine]"	"The Plough is a chinese pub in the riverside area near Raja Indian Cuisine. It is children friendly and has a high price range."
"name[The Plough], eatType[pub], food[Chinese], priceRange[less than £20], area[city centre], familyFriendly[no], near[Raja Indian Cuisine]"	"The Plough is a chinese pub in the city centre near Raja Indian Cuisine. It is not family friendly and has a price range of less than £20."
"name[The Plough], eatType[restaurant], food[Chinese], priceRange[£20-25], area[riverside], familyFriendly[yes], near[Raja Indian Cuisine]"	"The Plough is a chinese restaurant in the riverside area near Raja Indian Cuisine. It is kids friendly and has a price range of £20-25."
"name[The Plough], eatType[restaurant], food[Chinese], priceRange[cheap], area[riverside], familyFriendly[yes], near[Raja Indian Cuisine]"	"The Plough is a cheap chinese restaurant in the riverside area near Raja Indian Cuisine. It is family friendly."
"name[The Plough], eatType[restaurant], food[Chinese], priceRange[high], area[city centre], familyFriendly[no], near[Raja Indian Cuisine]"	"The Plough is a chinese restaurant in the city centre near Raja Indian Cuisine. It is not children friendly and has a high price range."
"name[The Plough], eatType[restaurant], food[Chinese], priceRange[high], area[city centre], familyFriendly[yes], near[Raja Indian Cuisine]"	"The Plough is a chinese restaurant in the city centre near Raja Indian Cuisine. It is children friendly and has a high price range."
"name[The Plough], eatType[restaurant], food[Chinese], priceRange[high], area[riverside], familyFriendly[no], near[Raja Indian Cuisine]"	"The Plough is a chinese restaurant in the riverside area near Raja Indian Cuisine. It is not children friendly and has a high price range."
"name[The Plough], eatType[restaurant], food[Chinese], priceRange[high], area[riverside], familyFriendly[yes], near[Raja Indian Cuisine]"	"The Plough is a chinese restaurant in the riverside area near Raja Indian Cuisine. It is children friendly and has a high price range."
"name[The Plough], eatType[restaurant], food[Chinese], priceRange[less than £20], area[city centre], familyFriendly[no], near[Raja Indian Cuisine]"	"The Plough is a chinese restaurant in the city centre near Raja Indian Cuisine. It is not family friendly and has a price range of less than £20."
"name[The Punter], eatType[pub], food[Chinese], priceRange[less than £20], area[city centre], familyFriendly[yes], near[Raja Indian Cuisine]"	"The Punter is a chinese pub in the city centre near Raja Indian Cuisine. It is family friendly and has a price range of less than £20."
"name[The Punter], eatType[pub], food[Chinese], priceRange[less than £20], area[riverside], familyFriendly[no], near[Raja Indian Cuisine]"	"The Punter is a chinese pub in the riverside area near Raja Indian Cuisine. It is not family friendly and has a price range of less than £20."
"name[The Punter], eatType[pub], food[Chinese], priceRange[less than £20], area[riverside], familyFriendly[yes], near[Raja Indian Cuisine]"	"The Punter is a chinese pub in the riverside area near Raja Indian Cuisine. It is family friendly and has a price range of less than £20."
"name[The Punter], eatType[pub], food[Chinese], priceRange[moderate], area[city centre], familyFriendly[no], near[Raja Indian Cuisine]"	"The Punter is a chinese pub in the city centre near Raja Indian Cuisine. It is not kids friendly and has a moderate price range."
"name[The Punter], eatType[pub], food[Chinese], priceRange[moderate], area[city centre], familyFriendly[yes], near[Raja Indian Cuisine]"	"The Punter is a chinese pub in the city centre near Raja Indian Cuisine. It is kids friendly and has a moderate price range."
"name[The Punter], eatType[pub], food[Chinese], priceRange[moderate], area[riverside], familyFriendly[no], near[Raja Indian Cuisine]"	"The Punter is a chinese pub in the riverside area near Raja Indian Cuisine. It is not kids friendly and has a moderate price range."
"name[The Punter], eatType[pub], food[Chinese], priceRange[moderate], area[riverside], familyFriendly[yes], near[Raja Indian Cuisine]"	"The Punter is a chinese pub in the riverside area near Raja Indian Cuisine. It is kids friendly and has a moderate price range."
"name[The Punter], eatType[pub], food[Chinese], priceRange[more than £30], area[riverside], familyFriendly[yes], near[Raja Indian Cuisine]"	"The Punter is a chinese pub in the riverside area near Raja Indian Cuisine. It is children friendly and has a price range of more than £30."
"name[The Punter], eatType[pub], food[English], priceRange[£20-25], area[riverside], familyFriendly[yes], near[Raja Indian Cuisine]"	"The Punter is a english pub in the riverside area near Raja Indian Cuisine. It is kids friendly and has a price range of £20-25."
"name[The Punter], eatType[pub], food[English], priceRange[cheap], area[riverside], familyFriendly[yes], near[Raja Indian Cuisine]"	"The Punter is a cheap english pub in the riverside area near Raja Indian Cuisine. It is family friendly."
"name[The Punter], eatType[pub], food[English], priceRange[high], area[city centre], familyFriendly[no], near[Raja Indian Cuisine]"	"The Punter is a english pub in the city centre near Raja Indian Cuisine. It is not children friendly and has a high price range."
"name[The Punter], eatType[pub], food[English], priceRange[high], area[city centre], familyFriendly[yes], near[Raja Indian Cuisine]"	"The Punter is a english pub in the city centre near Raja Indian Cuisine. It is children friendly and has a high price range."
"name[The Punter], eatType[pub], food[English], priceRange[high], area[riverside], familyFriendly[no], near[Raja Indian Cuisine]"	"The Punter is a english pub in the riverside area near Raja Indian Cuisine. It is not children friendly and has a high price range."
"name[The Punter], eatType[pub], food[English], priceRange[high], area[riverside], familyFriendly[yes], near[Raja Indian Cuisine]"	"The Punter is a english pub in the riverside area near Raja Indian Cuisine. It is children friendly and has a high price range."
"name[The Punter], eatType[pub], food[Italian], priceRange[high], customer rating[average], area[city centre], familyFriendly[no], near[Rainbow Vegetarian Café]"	"The Punter is a italian pub in the city centre near Rainbow Vegetarian Café. It has an average customer rating and a high price range. It is not children friendly."
"name[The Punter], eatType[restaurant], food[Chinese], priceRange[less than £20], area[city centre], familyFriendly[yes], near[Raja Indian Cuisine]"	"The Punter is a chinese restaurant in the city centre near Raja Indian Cuisine. It is family friendly and has a price range of less than £20."
"name[The Punter], eatType[restaurant], food[Chinese], priceRange[less than £20], area[riverside], familyFriendly[no], near[Raja Indian Cuisine]"	"The Punter is a chinese restaurant in the riverside area near Raja Indian Cuisine. It is not family friendly and has a price range of less than £20."
"name[The Punter], eatType[restaurant], food[Chinese], priceRange[less than £20], area[riverside], familyFriendly[yes], near[Raja Indian Cuisine]"	"The Punter is a chinese restaurant in the riverside area near Raja Indian Cuisine. It is family friendly and has a price range of less than £20."
"name[The Punter], eatType[restaurant], food[Chinese], priceRange[moderate], area[city centre], familyFriendly[no], near[Raja Indian Cuisine]"	"The Punter is a chinese restaurant in the city centre near Raja Indian Cuisine. It is not kids friendly and has a moderate price range."
"name[The Punter], eatType[restaurant], food[Chinese], priceRange[moderate], area[city centre], familyFriendly[yes], near[Raja Indian Cuisine]"	"The Punter is a chinese restaurant in the city centre near Raja Indian Cuisine. It is kids friendly and has a moderate price range."
"name[The Punter], eatType[restaurant], food[Chinese], priceRange[moderate], area[riverside], familyFriendly[no], near[Raja Indian Cuisine]"	"The Punter is a chinese restaurant in the riverside area near Raja Indian Cuisine. It is not kids friendly and has a moderate price range."
"name[The Punter], eatType[restaurant], food[Chinese], priceRange[moderate], area[riverside], familyFriendly[yes], near[Raja Indian Cuisine]"	"The Punter is a chinese restaurant in the riverside area near Raja Indian Cuisine. It is kids friendly and has a moderate price range."
"name[The Punter], eatType[restaurant], food[Chinese], priceRange[more than £30], area[riverside], familyFriendly[yes], near[Raja Indian Cuisine]"	"The Punter is a chinese restaurant in the riverside area near Raja Indian Cuisine. It is children friendly and has a price range of more than £30."
"name[The Punter], eatType[restaurant], food[English], priceRange[£20-25], area[riverside], familyFriendly[yes], near[Raja Indian Cuisine]"	"The Punter is a english restaurant in the riverside area near Raja Indian Cuisine. It is kids friendly and has a price range of £20-25."
"name[The Punter], eatType[restaurant], food[English], priceRange[cheap], area[riverside], familyFriendly[yes], near[Raja Indian Cuisine]"	"The Punter is a cheap english restaurant in the riverside area near Raja Indian Cuisine. It is family friendly."
"name[The Punter], eatType[restaurant], food[English], priceRange[high], area[city centre], familyFriendly[no], near[Raja Indian Cuisine]"	"The Punter is a english restaurant in the city centre near Raja Indian Cuisine. It is not children friendly and has a high price range."
"name[The Punter], eatType[restaurant], food[English], priceRange[high], area[city centre], familyFriendly[yes], near[Raja Indian Cuisine]"	"The Punter is a english restaurant in the city centre near Raja Indian Cuisine. It is children friendly and has a high price range."
"name[The Punter], eatType[restaurant], food[English], priceRange[high], area[riverside], familyFriendly[no], near[Raja Indian Cuisine]"	"The Punter is a english restaurant in the riverside area near Raja Indian Cuisine. It is not children friendly and has a high price range."
"name[The Punter], eatType[restaurant], food[English], priceRange[high], area[riverside], familyFriendly[yes], near[Raja Indian Cuisine]"	"The Punter is a english restaurant in the riverside area near Raja Indian Cuisine. It is children friendly and has a high price range."
"name[The Punter], eatType[restaurant], food[Indian], priceRange[cheap], customer rating[average], area[city centre], familyFriendly[yes], near[Express by Holiday Inn]"	"The Punter is a cheap indian restaurant in the city centre near Express by Holiday Inn. It is family friendly and has an average customer rating."
"name[The Punter], eatType[restaurant], food[Indian], priceRange[cheap], customer rating[average], area[riverside], familyFriendly[no], near[Express by Holiday Inn]"	"The Punter is a cheap indian restaurant in the riverside area near Express by Holiday Inn. It is not family friendly and has an average customer rating."
"name[The Punter], eatType[restaurant], food[Indian], priceRange[cheap], customer rating[average], area[riverside], familyFriendly[yes], near[Express by Holiday Inn]"	"The Punter is a cheap indian restaurant in the riverside area near Express by Holiday Inn. It is family friendly and has an average customer rating."
"name[The Punter], eatType[restaurant], food[Indian], priceRange[high], customer rating[1 out of 5], area[city centre], familyFriendly[no], near[Express by Holiday Inn]"	"The Punter is a indian restaurant in the city centre near Express by Holiday Inn. It is not children friendly and has a high price range and a customer rating of 1 out of 5."
"name[The Punter], eatType[restaurant], food[Indian], priceRange[high], customer rating[1 out of 5], area[city centre], familyFriendly[yes], near[Express by Holiday Inn]"	"The Punter is a indian restaurant in the city centre near Express by Holiday Inn. It is children friendly and has a high price range and a customer rating of 1 out of 5."
"name[The Punter], eatType[restaurant], food[Indian], priceRange[high], customer rating[1 out of 5], area[riverside], familyFriendly[no], near[Express by Holiday Inn]"	"The Punter is a indian restaurant in the riverside area near Express by Holiday Inn. It is not children friendly and has a high price range and a customer rating of 1 out of 5."
"name[The Punter], eatType[restaurant], food[Indian], priceRange[high], customer rating[1 out of 5], area[riverside], familyFriendly[yes], near[Express by Holiday Inn]"	"The Punter is a indian restaurant in the riverside area near Express by Holiday Inn. It is children friendly and has a high price range and a customer rating of 1 out of 5."
"name[The Punter], eatType[restaurant], food[Indian], priceRange[high], customer rating[average], area[city centre], familyFriendly[no], near[Express by Holiday Inn]"	"The Punter is a indian restaurant in the city centre near Express by Holiday Inn. It is not children friendly and has an average customer rating and a high price range."
"name[The Punter], eatType[restaurant], food[Indian], priceRange[high], customer rating[average], area[city centre], familyFriendly[yes], near[Express by Holiday Inn]"	"The Punter is a indian restaurant in the city centre near Express by Holiday Inn. It is children friendly and has an average customer rating and a high price range."
"name[The Punter], eatType[restaurant], food[Indian], priceRange[high], customer rating[average], area[riverside], familyFriendly[no], near[Express by Holiday Inn]"	"The Punter is a indian restaurant in the riverside area near Express by Holiday Inn. It is not children friendly and has an average customer rating and a high price range."
"name[The Punter], eatType[restaurant], food[Indian], priceRange[high], customer rating[average], area[riverside], familyFriendly[yes], near[Express by Holiday Inn]"	"The Punter is a indian restaurant in the riverside area near Express by Holiday Inn. It is children friendly and has an average customer rating and a high price range."
"name[The Punter], eatType[restaurant], food[Indian], priceRange[less than £20], customer rating[low], area[city centre], familyFriendly[no], near[Express by Holiday Inn]"	"The Punter is a indian restaurant in the city centre near Express by Holiday Inn. It is not family friendly and has a low customer rating and a price range of less than £20."
"name[The Punter], eatType[restaurant], food[Indian], priceRange[less than £20], customer rating[low], area[city centre], familyFriendly[yes], near[Express by Holiday Inn]"	"The Punter is a indian restaurant in the city centre near Express by Holiday Inn. It is family friendly and has a low customer rating and a price range of less than £20."
"name[The Punter], eatType[restaurant], food[Indian], priceRange[less than £20], customer rating[low], area[riverside], familyFriendly[no], near[Express by Holiday Inn]"	"The Punter is a indian restaurant in the riverside area near Express by Holiday Inn. It is not family friendly and has a low customer rating and a price range of less than £20."
"name[The Punter], eatType[restaurant], food[Indian], priceRange[less than £20], customer rating[low], area[riverside], familyFriendly[yes], near[Express by Holiday Inn]"	"The Punter is a indian restaurant in the riverside area near Express by Holiday Inn. It is family friendly and has a low customer rating and a price range of less than £20."
"name[The Punter], eatType[restaurant], food[Indian], priceRange[moderate], customer rating[1 out of 5], area[city centre], familyFriendly[no], near[Express by Holiday Inn]"	"The Punter is a indian restaurant in the city centre near Express by Holiday Inn. It is not kids friendly and has a moderate price range and a customer rating of 1 out of 5."
"name[The Punter], eatType[restaurant], food[Indian], priceRange[moderate], customer rating[1 out of 5], area[city centre], familyFriendly[yes], near[Express by Holiday Inn]"	"The Punter is a indian restaurant in the city centre near Express by Holiday Inn. It is kids friendly and has a moderate price range and a customer rating of 1 out of 5."
"name[The Punter], eatType[restaurant], food[Indian], priceRange[moderate], customer rating[1 out of 5], area[riverside], familyFriendly[no], near[Express by Holiday Inn]"	"The Punter is a indian restaurant in the riverside area near Express by Holiday Inn. It is not kids friendly and has a moderate price range and a customer rating of 1 out of 5."
"name[The Punter], eatType[restaurant], food[Indian], priceRange[moderate], customer rating[1 out of 5], area[riverside], familyFriendly[yes], near[Express by Holiday Inn]"	"The Punter is a indian restaurant in the riverside area near Express by Holiday Inn. It is kids friendly and has a moderate price range and a customer rating of 1 out of 5."
"name[The Punter], eatType[restaurant], food[Indian], priceRange[moderate], customer rating[3 out of 5], area[city centre], familyFriendly[no], near[Express by Holiday Inn]"	"The Punter is a indian restaurant in the city centre near Express by Holiday Inn. It is not kids friendly and has a moderate price range and a customer rating of 3 out of 5."
"name[The Punter], eatType[restaurant], food[Indian], priceRange[moderate], customer rating[3 out of 5], area[city centre], familyFriendly[yes], near[Express by Holiday Inn]"	"The Punter is a indian restaurant in the city centre near Express by Holiday Inn. It is kids friendly and has a moderate price range and a customer rating of 3 out of 5."
"name[The Punter], eatType[restaurant], food[Indian], priceRange[moderate], customer rating[3 out of 5], area[riverside], familyFriendly[no], near[Express by Holiday Inn]"	"The Punter is a indian restaurant in the riverside area near Express by Holiday Inn. It is not kids friendly and has a moderate price range and a customer rating of 3 out of 5."
"name[The Punter], eatType[restaurant], food[Indian], priceRange[moderate], customer rating[3 out of 5], area[riverside], familyFriendly[yes], near[Express by Holiday Inn]"	"The Punter is a indian restaurant in the riverside area near Express by Holiday Inn. It is kids friendly and has a moderate price range and a customer rating of 3 out of 5."
"name[The Punter], eatType[restaurant], food[Indian], priceRange[more than £30], customer rating[high], area[city centre], familyFriendly[no], near[Express by Holiday Inn]"	"The Punter is a indian restaurant in the city centre near Express by Holiday Inn. It is not children friendly and has a high customer rating and a price range of more than £30."
"name[The Punter], eatType[restaurant], food[Indian], priceRange[more than £30], customer rating[high], area[city centre], familyFriendly[yes], near[Express by Holiday Inn]"	"The Punter is a indian restaurant in the city centre near Express by Holiday Inn. It is children friendly and has a high customer rating and a price range of more than £30."
"name[The Punter], eatType[restaurant], food[Indian], priceRange[more than £30], customer rating[high], area[riverside], familyFriendly[no], near[Express by Holiday Inn]"	"The Punter is a indian restaurant in the riverside area near Express by Holiday Inn. It is not children friendly and has a high customer rating and a price range of more than £30."
"name[The Punter], eatType[restaurant], food[Indian], priceRange[more than £30], customer rating[high], area[riverside], familyFriendly[yes], near[Express by Holiday Inn]"	"The Punter is a indian restaurant in the riverside area near Express by Holiday Inn. It is children friendly and has a high customer rating and a price range of more than £30."
"name[The Punter], eatType[restaurant], food[Italian], priceRange[£20-25], customer rating[high], area[city centre], familyFriendly[no], near[Express by Holiday Inn]"	"The Punter is a italian restaurant in the city centre near Express by Holiday Inn. It is not kids friendly and has a high customer rating and a price range of £20-25."
"name[The Punter], eatType[restaurant], food[Italian], priceRange[£20-25], customer rating[high], area[city centre], familyFriendly[yes], near[Express by Holiday Inn]"	"The Punter is a italian restaurant in the city centre near Express by Holiday Inn. It is kids friendly and has a high customer rating and a price range of £20-25."
"name[The Punter], eatType[restaurant], food[Italian], priceRange[£20-25], customer rating[high], area[riverside], familyFriendly[no], near[Express by Holiday Inn]"	"The Punter is a italian restaurant in the riverside area near Express by Holiday Inn. It is not kids friendly and has a high customer rating and a price range of £20-25."
"name[The Punter], eatType[restaurant], food[Italian], priceRange[£20-25], customer rating[high], area[riverside], familyFriendly[yes], near[Express by Holiday Inn]"	"The Punter is a italian restaurant in the riverside area near Express by Holiday Inn. It is kids friendly and has a high customer rating and a price range of £20-25."
"name[The Punter], eatType[restaurant], food[Italian], priceRange[cheap], customer rating[5 out of 5], area[city centre], familyFriendly[no], near[Express by Holiday Inn]"	"The Punter is a cheap italian restaurant in the city centre near Express by Holiday Inn. It is not family friendly and has a customer rating of 5 out of 5."
"name[The Punter], eatType[restaurant], food[Italian], priceRange[cheap], customer rating[5 out of 5], area[city centre], familyFriendly[no], near[Rainbow Vegetarian Café]"	"The Punter is a cheap italian restaurant in the city centre near Rainbow Vegetarian Café. It is not family friendly and has a customer rating of 5 out of 5."
"name[The Punter], eatType[restaurant], food[Italian], priceRange[cheap], customer rating[5 out of 5], area[city centre], familyFriendly[yes], near[Rainbow Vegetarian Café]"	"The Punter is a cheap italian restaurant in the city centre near Rainbow Vegetarian Café. It is family friendly and has a customer rating of 5 out of 5."
"name[The Punter], eatType[restaurant], food[Italian], priceRange[cheap], customer rating[5 out of 5], area[riverside], familyFriendly[no], near[Rainbow Vegetarian Café]"	"The Punter is a cheap italian restaurant in the riverside area near Rainbow Vegetarian Café. It is not family friendly and has a customer rating of 5 out of 5."
"name[The Punter], eatType[restaurant], food[Italian], priceRange[cheap], customer rating[5 out of 5], area[riverside], familyFriendly[yes], near[Rainbow Vegetarian Café]"	"The Punter is a cheap italian restaurant in the riverside area near Rainbow Vegetarian Café. It is family friendly and has a customer rating of 5 out of 5."
"name[The Punter], eatType[restaurant], food[Italian], priceRange[cheap], customer rating[average], area[city centre], familyFriendly[no], near[Rainbow Vegetarian Café]"	"The Punter is a cheap italian restaurant in the city centre near Rainbow Vegetarian Café. It is not family friendly and has an average customer rating."
"name[The Punter], eatType[restaurant], food[Italian], priceRange[cheap], customer rating[average], area[city centre], familyFriendly[yes], near[Rainbow Vegetarian Café]"	"The Punter is a cheap italian restaurant in the city centre near Rainbow Vegetarian Café. It is family friendly and has an average customer rating."
"name[The Punter], eatType[restaurant], food[Italian], priceRange[cheap], customer rating[average], area[riverside], familyFriendly[no], near[Rainbow Vegetarian Café]"	"The Punter is a cheap italian restaurant in the riverside area near Rainbow Vegetarian Café. It is not family friendly and has an average customer rating."
"name[The Punter], eatType[restaurant], food[Italian], priceRange[cheap], customer rating[average], area[riverside], familyFriendly[yes], near[Rainbow Vegetarian Café]"	"The Punter is a cheap italian restaurant in the riverside area near Rainbow Vegetarian Café. It is family friendly and has an average customer rating."
"name[The Punter], eatType[restaurant], food[Italian], priceRange[high], customer rating[1 out of 5], area[city centre], familyFriendly[no], near[Rainbow Vegetarian Café]"	"The Punter is a italian restaurant in the city centre near Rainbow Vegetarian Café. It is not children friendly and has a high price range and a customer rating of 1 out of 5."
"name[The Punter], eatType[restaurant], food[Italian], priceRange[high], customer rating[1 out of 5], area[city centre], familyFriendly[yes], near[Rainbow Vegetarian Café]"	"The Punter is a italian restaurant in the city centre near Rainbow Vegetarian Café. It is children friendly and has a high price range and a customer rating of 1 out of 5."
"name[The Punter], eatType[restaurant], food[Italian], priceRange[high], customer rating[1 out of 5], area[riverside], familyFriendly[no], near[Rainbow Vegetarian Café]"	"The Punter is a italian restaurant in the riverside area near Rainbow Vegetarian Café. It is not children friendly and has a high price range and a customer rating of 1 out of 5."
"name[The Punter], eatType[restaurant], food[Italian], priceRange[high], customer rating[1 out of 5], area[riverside], familyFriendly[yes], near[Rainbow Vegetarian Café]"	"The Punter is a italian restaurant in the riverside area near Rainbow Vegetarian Café. It is children friendly and has a high price range and a customer rating of 1 out of 5."
"name[The Vaults], eatType[pub], food[French], priceRange[high], area[riverside], familyFriendly[yes], near[Raja Indian Cuisine]"	"The Vaults is a french pub in the riverside area near Raja Indian Cuisine. It is children friendly and has a high price range."
"name[The Vaults], eatType[pub], food[French], priceRange[less than £20], area[city centre], familyFriendly[no], near[Raja Indian Cuisine]"	"The Vaults is a non family friendly french pub in the city centre near Raja Indian Cuisine with a price range of less than £20."
"name[The Vaults], eatType[pub], food[French], priceRange[less than £20], area[city centre], familyFriendly[yes], near[Raja Indian Cuisine]"	"The Vaults is a french pub in the city centre near Raja Indian Cuisine. It is family friendly and has a price range of less than £20."
"name[The Vaults], eatType[pub], food[French], priceRange[less than £20], area[riverside], familyFriendly[no], near[Raja Indian Cuisine]"	"The Vaults is a french pub in the riverside area near Raja Indian Cuisine. It is not family friendly and has a price range of less than £20."
"name[The Vaults], eatType[pub], food[French], priceRange[less than £20], area[riverside], familyFriendly[yes], near[Raja Indian Cuisine]"	"The Vaults is a french pub in the riverside area near Raja Indian Cuisine. It is family friendly and has a price range of less than £20."
"name[The Vaults], eatType[pub], food[French], priceRange[moderate], area[city centre], familyFriendly[no], near[Raja Indian Cuisine]"	"The Vaults is a french pub in the city centre near Raja Indian Cuisine. It is not kids friendly and has a moderate price range."
"name[The Vaults], eatType[pub], food[French], priceRange[moderate], area[city centre], familyFriendly[yes], near[Raja Indian Cuisine]"	"The Vaults is a french pub in the city centre near Raja Indian Cuisine. It is kids friendly and has a moderate price range."
"name[The Vaults], eatType[pub], food[French], priceRange[moderate], area[riverside], familyFriendly[no], near[Raja Indian Cuisine]"	"The Vaults is a french pub in the riverside area near Raja Indian Cuisine. It is not kids friendly and has a moderate price range."
"name[The Vaults], eatType[pub], food[French], priceRange[moderate], area[riverside], familyFriendly[yes], near[Raja Indian Cuisine]"	"The Vaults is a french pub in the riverside area near Raja Indian Cuisine. It is kids friendly and has a moderate price range."
"name[The Vaults], eatType[pub], food[French], priceRange[more than £30], area[city centre], familyFriendly[no], near[Raja Indian Cuisine]"	"The Vaults is a french pub in the city centre near Raja Indian Cuisine. It is not kids friendly and has a price range of more than £30."
"name[The Vaults], eatType[pub], food[French], priceRange[more than £30], area[city centre], familyFriendly[yes], near[Raja Indian Cuisine]"	"The Vaults is a french pub in the city centre near Raja Indian Cuisine. It is children friendly and has a price range of more than £30."
"name[The Vaults], eatType[pub], food[French], priceRange[more than £30], area[riverside], familyFriendly[no], near[Raja Indian Cuisine]"	"The Vaults is a french pub in the riverside area near Raja Indian Cuisine. It is not children friendly and has a price range of more than £30."
"name[The Vaults], eatType[pub], food[French], priceRange[more than £30], area[riverside], familyFriendly[yes], near[Raja Indian Cuisine]"	"The Vaults is a french pub in the riverside area near Raja Indian Cuisine. It is children friendly and has a price range of more than £30."
"name[The Vaults], eatType[pub], food[Indian], priceRange[£20-25], area[riverside], familyFriendly[yes], near[Raja Indian Cuisine]"	"The Vaults is a indian pub in the riverside area near Raja Indian Cuisine. It is kids friendly and has a price range of £20-25."
"name[The Vaults], eatType[pub], food[Indian], priceRange[cheap], area[riverside], familyFriendly[yes], near[Raja Indian Cuisine]"	"The Vaults is a cheap indian pub in the riverside area near Raja Indian Cuisine. It is family friendly."
"name[The Vaults], eatType[pub], food[Indian], priceRange[high], area[city centre], familyFriendly[no], near[Raja Indian Cuisine]"	"The Vaults is a indian pub in the city centre near Raja Indian Cuisine. It is not children friendly and has a high price range."
"name[The Vaults], eatType[pub], food[Indian], priceRange[high], area[city centre], familyFriendly[yes], near[Raja Indian Cuisine]"	"The Vaults is a indian pub in the city centre near Raja Indian Cuisine. It is children friendly and has a high price range."
"name[The Vaults], eatType[pub], food[Italian], priceRange[high], customer rating[average], area[city centre], familyFriendly[no], near[Rainbow Vegetarian Café]"	"The Vaults is a italian pub in the city centre near Rainbow Vegetarian Café. It has an average customer rating and a high price range. It is not children friendly."
"name[The Vaults], eatType[pub], food[Italian], priceRange[high], customer rating[average], area[city centre], familyFriendly[yes], near[Rainbow Vegetarian Café]"	"The Vaults is a italian pub in the city centre near Rainbow Vegetarian Café. It is children friendly and has a high price range and an average customer rating."
"name[The Vaults], eatType[pub], food[Italian], priceRange[high], customer rating[average], area[riverside], familyFriendly[no], near[Rainbow Vegetarian Café]"	"The Vaults is a italian pub in the riverside area near Rainbow Vegetarian Café. It is not children friendly and has an average customer rating and a high price range."
"name[The Vaults], eatType[pub], food[Italian], priceRange[high], customer rating[average], area[riverside], familyFriendly[yes], near[Rainbow Vegetarian Café]"	"The Vaults is a italian pub in the riverside area near Rainbow Vegetarian Café. It is children friendly and has a high price range and an average customer rating."
"name[The Vaults], eatType[pub], food[Italian], priceRange[less than £20], customer rating[low], area[city centre], familyFriendly[no], near[Rainbow Vegetarian Café]"	"The Vaults is a italian pub in the city centre near Rainbow Vegetarian Café. It is not family friendly and has a low customer rating and a price range of less than £20."
"name[The Vaults], eatType[pub], food[Italian], priceRange[less than £20], customer rating[low], area[city centre], familyFriendly[yes], near[Rainbow Vegetarian Café]"	"The Vaults is a italian pub in the city centre near Rainbow Vegetarian Café. It is family friendly and has a low customer rating and a price range of less than £20."
"name[The Vaults], eatType[pub], food[Italian], priceRange[less than £20], customer rating[low], area[riverside], familyFriendly[no], near[Rainbow Vegetarian Café]"	"The Vaults is a italian pub in the riverside area near Rainbow Vegetarian Café. It is not family friendly and has a low customer rating and a price range of less than £20."
"name[The Vaults], eatType[pub], food[Italian], priceRange[less than £20], customer rating[low], area[riverside], familyFriendly[yes], near[Rainbow Vegetarian Café]"	"The Vaults is a italian pub in the riverside area near Rainbow Vegetarian Café. It is family friendly and has a low customer rating and a price range of less than £20."
"name[The Vaults], eatType[pub], food[Italian], priceRange[moderate], customer rating[1 out of 5], area[city centre], familyFriendly[no], near[Rainbow Vegetarian Café]"	"The Vaults is a italian pub in the city centre near Rainbow Vegetarian Café. It has a moderate price range and a customer rating of 1 out of 5. It is not kids friendly."
"name[The Vaults], eatType[pub], food[Italian], priceRange[moderate], customer rating[1 out of 5], area[city centre], familyFriendly[yes], near[Rainbow Vegetarian Café]"	"The Vaults is a italian pub in the city centre near Rainbow Vegetarian Café. It is kids friendly and has a customer rating of 1 out of 5 and a moderate price range."
"name[The Vaults], eatType[pub], food[Italian], priceRange[moderate], customer rating[1 out of 5], area[riverside], familyFriendly[no], near[Rainbow Vegetarian Café]"	"The Vaults is a italian pub in the riverside area near Rainbow Vegetarian Café. It has a moderate price range and a customer rating of 1 out of 5. It is not kids friendly."
"name[The Vaults], eatType[pub], food[Italian], priceRange[moderate], customer rating[1 out of 5], area[riverside], familyFriendly[yes], near[Rainbow Vegetarian Café]"	"The Vaults is a italian pub in the riverside area near Rainbow Vegetarian Café. It is kids friendly and has a moderate price range and a customer rating of 1 out of 5."
"name[The Vaults], eatType[pub], food[Italian], priceRange[moderate], customer rating[3 out of 5], area[city centre], familyFriendly[no], near[Rainbow Vegetarian Café]"	"The Vaults is a italian pub in the city centre near Rainbow Vegetarian Café. It has a moderate price range and a customer rating of 3 out of 5. It is not kids friendly."
"name[The Vaults], eatType[pub], food[Italian], priceRange[moderate], customer rating[3 out of 5], area[city centre], familyFriendly[yes], near[Rainbow Vegetarian Café]"	"The Vaults is a italian pub in the moderate price range. It is a kids friendly pub in the city centre near Rainbow Vegetarian Café. It has a customer rating of 3 out of 5."
"name[The Vaults], eatType[pub], food[Italian], priceRange[moderate], customer rating[3 out of 5], area[riverside], familyFriendly[no], near[Rainbow Vegetarian Café]"	"The Vaults is a italian pub in the riverside area near Rainbow Vegetarian Café. It has a moderate price range and a customer rating of 3 out of 5. It is not kids friendly."
"name[The Vaults], eatType[pub], food[Italian], priceRange[moderate], customer rating[3 out of 5], area[riverside], familyFriendly[yes], near[Rainbow Vegetarian Café]"	"The Vaults is a italian pub in the riverside area near Rainbow Vegetarian Café. It is kids friendly and has a moderate price range and a customer rating of 3 out of 5."
"name[The Vaults], eatType[pub], food[Italian], priceRange[more than £30], customer rating[high], area[city centre], familyFriendly[no], near[Rainbow Vegetarian Café]"	"The Vaults is a italian pub in the city centre near Rainbow Vegetarian Café. It is not children friendly and has a high customer rating and a price range of more than £30."
"name[The Vaults], eatType[pub], food[Italian], priceRange[more than £30], customer rating[high], area[city centre], familyFriendly[yes], near[Rainbow Vegetarian Café]"	"The Vaults is a italian pub in the city centre near Rainbow Vegetarian Café. It is children friendly and has a high customer rating and a price range of more than £30."
"name[The Vaults], eatType[pub], food[Italian], priceRange[more than £30], customer rating[high], area[riverside], familyFriendly[no], near[Rainbow Vegetarian Café]"	"The Vaults is a italian pub in the riverside area near Rainbow Vegetarian Café. It is not children friendly and has a high customer rating and a price range of more than £30."
"name[The Vaults], eatType[pub], food[Italian], priceRange[more than £30], customer rating[high], area[riverside], familyFriendly[yes], near[Rainbow Vegetarian Café]"	"The Vaults is a italian pub in the riverside area near Rainbow Vegetarian Café. It is children friendly and has a high customer rating and a price range of more than £30."
"name[The Vaults], eatType[pub], food[Japanese], priceRange[£20-25], customer rating[3 out of 5], area[city centre], familyFriendly[no], near[Rainbow Vegetarian Café]"	"The Vaults is a japanese restaurant in the city centre near Rainbow Vegetarian Café. It is not kids friendly and has a customer rating of 3 out of 5 and a price range of £20-25."
"name[The Vaults], eatType[pub], food[Japanese], priceRange[£20-25], customer rating[3 out of 5], area[city centre], familyFriendly[yes], near[Rainbow Vegetarian Café]"	"The Vaults is a japanese pub in the city centre near Rainbow Vegetarian Café. It is kids friendly and has a customer rating of 3 out of 5 and a price range of £20-25."
"name[The Vaults], eatType[pub], food[Japanese], priceRange[£20-25], customer rating[3 out of 5], area[riverside], familyFriendly[no], near[Rainbow Vegetarian Café]"	"The Vaults is a japanese restaurant in the riverside area near Rainbow Vegetarian Café. It is not kids friendly and has a customer rating of 3 out of 5 and a price range of £20-25."
"name[The Vaults], eatType[pub], food[Japanese], priceRange[£20-25], customer rating[3 out of 5], area[riverside], familyFriendly[yes], near[Rainbow Vegetarian Café]"	"The Vaults is a japanese pub in the riverside area near Rainbow Vegetarian Café. It is kids friendly and has a customer rating of 3 out of 5 and a price range of £20-25."
"name[The Vaults], eatType[pub], food[Japanese], priceRange[£20-25], customer rating[high], area[city centre], familyFriendly[no], near[Rainbow Vegetarian Café]"	"The Vaults is a japanese pub in the city centre near Rainbow Vegetarian Café. It is not kids friendly and has a high customer rating and a price range of £20-25."
"name[The Vaults], eatType[pub], food[Japanese], priceRange[£20-25], customer rating[high], area[city centre], familyFriendly[yes], near[Rainbow Vegetarian Café]"	"The Vaults is a japanese pub in the city centre near Rainbow Vegetarian Café. It is kids friendly and has a high customer rating and a price range of £20-25."
"name[The Vaults], eatType[pub], food[Japanese], priceRange[£20-25], customer rating[high], area[riverside], familyFriendly[no], near[Rainbow Vegetarian Café]"	"The Vaults is a japanese pub in the riverside area near Rainbow Vegetarian Café. It is not kids friendly and has a high customer rating and a price range of £20-25."
"name[The Vaults], eatType[pub], food[Japanese], priceRange[£20-25], customer rating[high], area[riverside], familyFriendly[no], near[Raja Indian Cuisine]"	"The Vaults is a japanese pub in the riverside area near Raja Indian Cuisine. It is not kids friendly and has a high customer rating and a price range of £20-25."
"name[The Vaults], eatType[pub], food[Japanese], priceRange[£20-25], customer rating[high], area[riverside], familyFriendly[yes], near[Raja Indian Cuisine]"	"The Vaults is a japanese pub in the riverside area near Raja Indian Cuisine. It has a high customer rating and a price range of £20-25. It is kids friendly."
"name[The Vaults], eatType[pub], food[Japanese], priceRange[cheap], customer rating[5 out of 5], area[city centre], familyFriendly[no], near[Raja Indian Cuisine]"	"The Vaults is a cheap japanese pub in the city centre near Raja Indian Cuisine. It is not family friendly and has a customer rating of 5 out of 5."
"name[The Vaults], eatType[pub], food[Japanese], priceRange[cheap], customer rating[5 out of 5], area[city centre], familyFriendly[yes], near[Raja Indian Cuisine]"	"The Vaults is a japanese pub in the city centre near Raja Indian Cuisine. It is family friendly and has a cheap price range and a customer rating of 5 out of 5."
"name[The Vaults], eatType[pub], food[Japanese], priceRange[cheap], customer rating[5 out of 5], area[riverside], familyFriendly[no], near[Raja Indian Cuisine]"	"The Vaults is a cheap japanese pub in the riverside area near Raja Indian Cuisine. It is not family friendly and has a customer rating of 5 out of 5."
"name[The Vaults], eatType[pub], food[Japanese], priceRange[cheap], customer rating[5 out of 5], area[riverside], familyFriendly[yes], near[Raja Indian Cuisine]"	"The Vaults is a cheap japanese pub in the riverside area near Raja Indian Cuisine. It has a customer rating of 5 out of 5. It is family friendly."
"name[The Vaults], eatType[pub], food[Japanese], priceRange[high], customer rating[3 out of 5], area[city centre], familyFriendly[no], near[Raja Indian Cuisine]"	"The Vaults is a japanese pub in the city centre near Raja Indian Cuisine. It has a high price range and a customer rating of 3 out of 5. It is not children friendly."
"name[The Vaults], eatType[pub], food[Japanese], priceRange[high], customer rating[3 out of 5], area[city centre], familyFriendly[yes], near[Raja Indian Cuisine]"	"The Vaults is a japanese pub in the city centre near Raja Indian Cuisine. It is children friendly and has a high price range and a customer rating of 3 out of 5."
"name[The Vaults], eatType[pub], food[Japanese], priceRange[high], customer rating[3 out of 5], area[riverside], familyFriendly[no], near[Raja Indian Cuisine]"	"The Vaults is a japanese pub in the riverside area near Raja Indian Cuisine. It has a high price range and a customer rating of 3 out of 5. It is not children friendly."
"name[The Vaults], eatType[pub], food[Japanese], priceRange[high], customer rating[3 out of 5], area[riverside], familyFriendly[yes], near[Raja Indian Cuisine]"	"The Vaults is a japanese pub in the riverside area near Raja Indian Cuisine. It has a high price range and a customer rating of 3 out of 5. It is children friendly."
"name[The Vaults], eatType[pub], food[Japanese], priceRange[less than £20], customer rating[average], area[city centre], familyFriendly[no], near[Raja Indian Cuisine]"	"The Vaults is a japanese pub in the city centre near Raja Indian Cuisine. It has an average customer rating and a price range of less than £20. It is not family friendly."
"name[The Vaults], eatType[pub], food[Japanese], priceRange[less than £20], customer rating[average], area[city centre], familyFriendly[yes], near[Raja Indian Cuisine]"	"The Vaults is a japanese pub in the city centre near Raja Indian Cuisine. It is family friendly and has an average customer rating and a price range of less than £20."
"name[The Vaults], eatType[pub], food[Japanese], priceRange[less than £20], customer rating[average], area[riverside], familyFriendly[no], near[Raja Indian Cuisine]"	"The Vaults is a japanese pub in the riverside area near Raja Indian Cuisine. It has an average customer rating and a price range of less than £20. It is not family friendly."
"name[The Vaults], eatType[pub], food[Japanese], priceRange[less than £20], customer rating[average], area[riverside], familyFriendly[yes], near[Raja Indian Cuisine]"	"The Vaults is a japanese pub in the riverside area near Raja Indian Cuisine. It is family friendly and has an average customer rating and a price range of less than £20."
"name[The Vaults], eatType[pub], food[Japanese], priceRange[less than £20], customer rating[low], area[city centre], familyFriendly[no], near[Raja Indian Cuisine]"	"The Vaults is a japanese pub in the city centre near Raja Indian Cuisine. It has a low customer rating and a price range of less than £20. It is not family friendly."
"name[The Vaults], eatType[pub], food[Japanese], priceRange[less than £20], customer rating[low], area[city centre], familyFriendly[yes], near[Raja Indian Cuisine]"	"The Vaults is a japanese pub in the city centre near Raja Indian Cuisine. It is family friendly and has a low customer rating and a price range of less than £20."
"name[The Vaults], eatType[pub], food[Japanese], priceRange[less than £20], customer rating[low], area[riverside], familyFriendly[no], near[Raja Indian Cuisine]"	"The Vaults is a japanese pub in the riverside area near Raja Indian Cuisine. It is not family friendly and has a low customer rating and a price range of less than £20."
"name[The Vaults], eatType[pub], food[Japanese], priceRange[less than £20], customer rating[low], area[riverside], familyFriendly[yes], near[Raja Indian Cuisine]"	"The Vaults is a japanese pub in the riverside area near Raja Indian Cuisine. It is family friendly and has a low customer rating and a price range of less than £20."
"name[The Vaults], eatType[pub], food[Japanese], priceRange[moderate], customer rating[1 out of 5], area[city centre], familyFriendly[no], near[Raja Indian Cuisine]"	"The Vaults is a japanese pub in the city centre near Raja Indian Cuisine. It has a moderate price range and a customer rating of 1 out of 5. It is not kids friendly."
"name[The Vaults], eatType[pub], food[Japanese], priceRange[moderate], customer rating[1 out of 5], area[city centre], familyFriendly[yes], near[Raja Indian Cuisine]"	"The Vaults is a japanese pub in the city centre near Raja Indian Cuisine. It is kids friendly and has a moderate price range and a customer rating of 1 out of 5."
"name[The Vaults], eatType[restaurant], food[French], priceRange[high], area[riverside], familyFriendly[yes], near[Raja Indian Cuisine]"	"The Vaults is a french restaurant in the riverside area near Raja Indian Cuisine. It is children friendly and has a high price range."
"name[The Vaults], eatType[restaurant], food[French], priceRange[less than £20], area[city centre], familyFriendly[no], near[Raja Indian Cuisine]"	"The Vaults is a french restaurant in the city centre near Raja Indian Cuisine. It is not family friendly and has a price range of less than £20."
"name[The Vaults], eatType[restaurant], food[French], priceRange[less than £20], area[city centre], familyFriendly[yes], near[Raja Indian Cuisine]"	"The Vaults is a french restaurant in the city centre near Raja Indian Cuisine. It is family friendly and has a price range of less than £20."
"name[The Vaults], eatType[restaurant], food[French], priceRange[less than £20], area[riverside], familyFriendly[no], near[Raja Indian Cuisine]"	"The Vaults is a french restaurant in the riverside area near Raja Indian Cuisine. It is not family friendly and has a price range of less than £20."
"name[The Vaults], eatType[restaurant], food[French], priceRange[less than £20], area[riverside], familyFriendly[yes], near[Raja Indian Cuisine]"	"The Vaults is a french restaurant in the riverside area near Raja Indian Cuisine. It is family friendly and has a price range of less than £20."
"name[The Vaults], eatType[restaurant], food[French], priceRange[moderate], area[city centre], familyFriendly[no], near[Raja Indian Cuisine]"	"The Vaults is a french restaurant in the city centre near Raja Indian Cuisine. It is not kids friendly and has a moderate price range."
"name[The Vaults], eatType[restaurant], food[French], priceRange[moderate], area[city centre], familyFriendly[yes], near[Raja Indian Cuisine]"	"The Vaults is a french restaurant in the city centre near Raja Indian Cuisine. It is kids friendly and has a moderate price range."
"name[The Vaults], eatType[restaurant], food[French], priceRange[moderate], area[riverside], familyFriendly[no], near[Raja Indian Cuisine]"	"The Vaults is a french restaurant in the riverside area near Raja Indian Cuisine. It is not kids friendly and has a moderate price range."
"name[The Vaults], eatType[restaurant], food[French], priceRange[moderate], area[riverside], familyFriendly[yes], near[Raja Indian Cuisine]"	"The Vaults is a french restaurant in the riverside area near Raja Indian Cuisine. It is kids friendly and has a moderate price range."
"name[The Vaults], eatType[restaurant], food[French], priceRange[more than £30], area[city centre], familyFriendly[no], near[Raja Indian Cuisine]"	"The Vaults is a french restaurant in the city centre near Raja Indian Cuisine. It is not children friendly and has a price range of more than £30."
"name[The Vaults], eatType[restaurant], food[French], priceRange[more than £30], area[city centre], familyFriendly[yes], near[Raja Indian Cuisine]"	"The Vaults is a french restaurant in the city centre near Raja Indian Cuisine. It is children friendly and has a price range of more than £30."
"name[The Vaults], eatType[restaurant], food[French], priceRange[more than £30], area[riverside], familyFriendly[no], near[Raja Indian Cuisine]"	"The Vaults is a french restaurant in the riverside area near Raja Indian Cuisine. It is not children friendly and has a price range of more than £30."
"name[The Vaults], eatType[restaurant], food[French], priceRange[more than £30], area[riverside], familyFriendly[yes], near[Raja Indian Cuisine]"	"The Vaults is a french restaurant in the riverside area near Raja Indian Cuisine. It is children friendly and has a price range of more than £30."
"name[The Vaults], eatType[restaurant], food[Indian], priceRange[£20-25], area[riverside], familyFriendly[yes], near[Raja Indian Cuisine]"	"The Vaults is a indian restaurant in the riverside area near Raja Indian Cuisine. It is kids friendly and has a price range of £20-25."
"name[The Vaults], eatType[restaurant], food[Indian], priceRange[cheap], area[riverside], familyFriendly[yes], near[Raja Indian Cuisine]"	"The Vaults is a cheap indian restaurant in the riverside area near Raja Indian Cuisine. It is family friendly."
"name[The Vaults], eatType[restaurant], food[Indian], priceRange[high], area[city centre], familyFriendly[no], near[Raja Indian Cuisine]"	"The Vaults is a indian restaurant in the city centre near Raja Indian Cuisine. It is not children friendly and has a high price range."
"name[The Vaults], eatType[restaurant], food[Indian], priceRange[high], area[city centre], familyFriendly[yes], near[Raja Indian Cuisine]"	"The Vaults is a indian restaurant in the city centre near Raja Indian Cuisine. It is children friendly and has a high price range."
"name[The Waterman], eatType[pub], food[Indian], priceRange[high], area[city centre], familyFriendly[yes], near[Raja Indian Cuisine]"	"The Waterman is a indian pub in the city centre near Raja Indian Cuisine. It is children friendly and has a high price range."
"name[The Waterman], eatType[pub], food[Indian], priceRange[high], area[riverside], familyFriendly[no], near[Raja Indian Cuisine]"	"The Waterman is a indian pub in the riverside area near Raja Indian Cuisine. It is not children friendly and has a high price range."
"name[The Waterman], eatType[pub], food[Indian], priceRange[high], area[riverside], familyFriendly[yes], near[Raja Indian Cuisine]"	"The Waterman is a indian pub in the riverside area near Raja Indian Cuisine. It is children friendly and has a high price range."
"name[The Waterman], eatType[pub], food[Indian], priceRange[less than £20], area[city centre], familyFriendly[no], near[Raja Indian Cuisine]"	"The Waterman is a indian pub in the city centre near Raja Indian Cuisine. It is not family friendly and has a price range of less than £20."
"name[The Waterman], eatType[pub], food[Indian], priceRange[less than £20], area[city centre], familyFriendly[yes], near[Raja Indian Cuisine]"	"The Waterman is a indian pub in the city centre near Raja Indian Cuisine. It is family friendly and has a price range of less than £20."
"name[The Waterman], eatType[pub], food[Indian], priceRange[less than £20], area[riverside], familyFriendly[no], near[Raja Indian Cuisine]"	"The Waterman is a indian pub in the riverside area near Raja Indian Cuisine. It is not family friendly and has a price range of less than £20."
"name[The Waterman], eatType[pub], food[Indian], priceRange[less than £20], area[riverside], familyFriendly[yes], near[Raja Indian Cuisine]"	"The Waterman is a indian pub in the riverside area near Raja Indian Cuisine. It is family friendly and has a price range of less than £20."
"name[The Waterman], eatType[pub], food[Indian], priceRange[moderate], area[city centre], familyFriendly[no], near[Raja Indian Cuisine]"	"The Waterman is a indian pub in the city centre near Raja Indian Cuisine. It is not kids friendly and has a moderate price range."
"name[The Waterman], eatType[pub], food[Indian], priceRange[moderate], area[city centre], familyFriendly[yes], near[Raja Indian Cuisine]"	"The Waterman is a indian pub in the city centre near Raja Indian Cuisine. It is kids friendly and has a moderate price range."
"name[The Waterman], eatType[pub], food[Indian], priceRange[moderate], area[riverside], familyFriendly[no], near[Raja Indian Cuisine]"	"The Waterman is a indian pub in the riverside area near Raja Indian Cuisine. It is not kids friendly and has a moderate price range."
"name[The Waterman], eatType[pub], food[Indian], priceRange[moderate], area[riverside], familyFriendly[yes], near[Raja Indian Cuisine]"	"The Waterman is a indian pub in the riverside area near Raja Indian Cuisine. It is kids friendly and has a moderate price range."
"name[The Waterman], eatType[pub], food[Indian], priceRange[more than £30], area[riverside], familyFriendly[yes], near[Raja Indian Cuisine]"	"The Waterman is a indian pub in the riverside area near Raja Indian Cuisine. It is children friendly and has a price range of more than £30."
"name[The Waterman], eatType[pub], food[Italian], priceRange[£20-25], area[riverside], familyFriendly[yes], near[Raja Indian Cuisine]"	"The Waterman is a italian pub in the riverside area near Raja Indian Cuisine. It is kids friendly and has a price range of £20-25."
"name[The Waterman], eatType[pub], food[Italian], priceRange[cheap], area[riverside], familyFriendly[yes], near[Raja Indian Cuisine]"	"The Waterman is a cheap italian pub in the riverside area near Raja Indian Cuisine. It is family friendly."
"name[The Waterman], eatType[pub], food[Italian], priceRange[high], area[city centre], familyFriendly[no], near[Raja Indian Cuisine]"	"The Waterman is a italian pub in the city centre near Raja Indian Cuisine. It is not children friendly and has a high price range."
"name[The Waterman], eatType[pub], food[Italian], priceRange[high], area[city centre], familyFriendly[yes], near[Raja Indian Cuisine]"	"The Waterman is a italian pub in the city centre near Raja Indian Cuisine. It is children friendly and has a high price range."
"name[The Waterman], eatType[pub], food[Italian], priceRange[high], area[riverside], familyFriendly[no], near[Raja Indian Cuisine]"	"The Waterman is a italian pub in the riverside area near Raja Indian Cuisine. It is not children friendly and has a high price range."
"name[The Waterman], eatType[pub], food[Italian], priceRange[high], area[riverside], familyFriendly[yes], near[Raja Indian Cuisine]"	"The Waterman is a italian pub in the riverside area near Raja Indian Cuisine. It is children friendly and has a high price range."
"name[The Waterman], eatType[pub], food[Italian], priceRange[less than £20], area[city centre], familyFriendly[no], near[Raja Indian Cuisine]"	"The Waterman is a italian pub in the city centre near Raja Indian Cuisine. It is not family friendly and has a price range of less than £20."
"name[The Waterman], eatType[pub], food[Italian], priceRange[less than £20], area[city centre], familyFriendly[yes], near[Raja Indian Cuisine]"	"The Waterman is a italian pub in the city centre near Raja Indian Cuisine. It is family friendly and has a price range of less than £20."
"name[The Waterman], eatType[pub], food[Italian], priceRange[less than £20], area[riverside], familyFriendly[no], near[Raja Indian Cuisine]"	"The Waterman is a italian pub in the riverside area near Raja Indian Cuisine. It is not family friendly and has a price range of less than £20."
"name[The Waterman], eatType[restaurant], food[Indian], priceRange[high], area[city centre], familyFriendly[yes], near[Raja Indian Cuisine]"	"The Waterman is a indian restaurant in the city centre near Raja Indian Cuisine. It is children friendly and has a high price range."
"name[The Waterman], eatType[restaurant], food[Indian], priceRange[high], area[riverside], familyFriendly[no], near[Raja Indian Cuisine]"	"The Waterman is a indian restaurant in the riverside area near Raja Indian Cuisine. It is not children friendly and has a high price range."
"name[The Waterman], eatType[restaurant], food[Indian], priceRange[high], area[riverside], familyFriendly[yes], near[Raja Indian Cuisine]"	"The Waterman is a indian restaurant in the riverside area near Raja Indian Cuisine. It is children friendly and has a high price range."
"name[The Waterman], eatType[restaurant], food[Indian], priceRange[less than £20], area[city centre], familyFriendly[no], near[Raja Indian Cuisine]"	"The Waterman is a indian restaurant in the city centre near Raja Indian Cuisine. It is not family friendly and has a price range of less than £20."
"name[The Waterman], eatType[restaurant], food[Indian], priceRange[less than £20], area[city centre], familyFriendly[yes], near[Raja Indian Cuisine]"	"The Waterman is a indian restaurant in the city centre near Raja Indian Cuisine. It is family friendly and has a price range of less than £20."
"name[The Waterman], eatType[restaurant], food[Indian], priceRange[less than £20], area[riverside], familyFriendly[no], near[Raja Indian Cuisine]"	"The Waterman is a indian restaurant in the riverside area near Raja Indian Cuisine. It is not family friendly and has a price range of less than £20."
"name[The Waterman], eatType[restaurant], food[Indian], priceRange[less than £20], area[riverside], familyFriendly[yes], near[Raja Indian Cuisine]"	"The Waterman is a indian restaurant in the riverside area near Raja Indian Cuisine. It is family friendly and has a price range of less than £20."
"name[The Waterman], eatType[restaurant], food[Indian], priceRange[moderate], area[city centre], familyFriendly[no], near[Raja Indian Cuisine]"	"The Waterman is a indian restaurant in the city centre near Raja Indian Cuisine. It is not kids friendly and has a moderate price range."
"name[The Waterman], eatType[restaurant], food[Indian], priceRange[moderate], area[city centre], familyFriendly[yes], near[Raja Indian Cuisine]"	"The Waterman is a indian restaurant in the city centre near Raja Indian Cuisine. It is kids friendly and has a moderate price range."
"name[The Waterman], eatType[restaurant], food[Indian], priceRange[moderate], area[riverside], familyFriendly[no], near[Raja Indian Cuisine]"	"The Waterman is a indian restaurant in the riverside area near Raja Indian Cuisine. It is not kids friendly and has a moderate price range."
"name[The Waterman], eatType[restaurant], food[Indian], priceRange[moderate], area[riverside], familyFriendly[yes], near[Raja Indian Cuisine]"	"The Waterman is a indian restaurant in the riverside area near Raja Indian Cuisine. It is kids friendly and has a moderate price range."
"name[The Waterman], eatType[restaurant], food[Indian], priceRange[more than £30], area[riverside], familyFriendly[yes], near[Raja Indian Cuisine]"	"The Waterman is a indian restaurant in the riverside area near Raja Indian Cuisine. It is children friendly and has a price range of more than £30."
"name[The Waterman], eatType[restaurant], food[Italian], priceRange[£20-25], area[riverside], familyFriendly[yes], near[Raja Indian Cuisine]"	"The Waterman is a italian restaurant in the riverside area near Raja Indian Cuisine. It is kids friendly and has a price range of £20-25."
"name[The Waterman], eatType[restaurant], food[Italian], priceRange[cheap], area[riverside], familyFriendly[yes], near[Raja Indian Cuisine]"	"The Waterman is a cheap italian restaurant in the riverside area near Raja Indian Cuisine. It is family friendly."
"name[The Waterman], eatType[restaurant], food[Italian], priceRange[high], area[city centre], familyFriendly[no], near[Raja Indian Cuisine]"	"The Waterman is a italian restaurant in the city centre near Raja Indian Cuisine. It is not children friendly and has a high price range."
"name[The Waterman], eatType[restaurant], food[Italian], priceRange[high], area[city centre], familyFriendly[yes], near[Raja Indian Cuisine]"	"The Waterman is a italian restaurant in the city centre near Raja Indian Cuisine. It is children friendly and has a high price range."
"name[The Waterman], eatType[restaurant], food[Italian], priceRange[high], area[riverside], familyFriendly[no], near[Raja Indian Cuisine]"	"The Waterman is a italian restaurant in the riverside area near Raja Indian Cuisine. It is not children friendly and has a high price range."
"name[The Waterman], eatType[restaurant], food[Italian], priceRange[high], area[riverside], familyFriendly[yes], near[Raja Indian Cuisine]"	"The Waterman is a italian restaurant in the riverside area near Raja Indian Cuisine. It is children friendly and has a high price range."
"name[The Waterman], eatType[restaurant], food[Italian], priceRange[less than £20], area[city centre], familyFriendly[no], near[Raja Indian Cuisine]"	"The Waterman is a italian restaurant in the city centre near Raja Indian Cuisine. It is not family friendly and has a price range of less than £20."
"name[The Waterman], eatType[restaurant], food[Italian], priceRange[less than £20], area[city centre], familyFriendly[yes], near[Raja Indian Cuisine]"	"The Waterman is a italian restaurant in the city centre near Raja Indian Cuisine. It is family friendly and has a price range of less than £20."
"name[The Waterman], eatType[restaurant], food[Italian], priceRange[less than £20], area[riverside], familyFriendly[no], near[Raja Indian Cuisine]"	"The Waterman is a italian restaurant in the riverside area near Raja Indian Cuisine. It is not family friendly and has a price range of less than £20."
"name[The Wrestlers], eatType[pub], food[Italian], priceRange[less than £20], area[riverside], familyFriendly[no], near[Raja Indian Cuisine]"	"The Wrestlers is a italian pub in the riverside area near Raja Indian Cuisine. It is not family friendly and has a price range of less than £20."
"name[The Wrestlers], eatType[pub], food[Italian], priceRange[less than £20], area[riverside], familyFriendly[yes], near[Raja Indian Cuisine]"	"The Wrestlers is a italian pub in the riverside area near Raja Indian Cuisine. It is family friendly and has a price range of less than £20."
"name[The Wrestlers], eatType[pub], food[Italian], priceRange[moderate], area[city centre], familyFriendly[no], near[Raja Indian Cuisine]"	"The Wrestlers is a italian pub in the city centre near Raja Indian Cuisine. It is not kids friendly and has a moderate price range."
"name[The Wrestlers], eatType[pub], food[Italian], priceRange[moderate], area[city centre], familyFriendly[yes], near[Raja Indian Cuisine]"	"The Wrestlers is a italian pub in the city centre near Raja Indian Cuisine. It is kids friendly and has a moderate price range."
"name[The Wrestlers], eatType[pub], food[Italian], priceRange[moderate], area[riverside], familyFriendly[no], near[Raja Indian Cuisine]"	"The Wrestlers is a italian pub in the riverside area near Raja Indian Cuisine. It is not kids friendly and has a moderate price range."
"name[The Wrestlers], eatType[pub], food[Italian], priceRange[moderate], area[riverside], familyFriendly[yes], near[Raja Indian Cuisine]"	"The Wrestlers is a italian pub in the riverside area near Raja Indian Cuisine. It is kids friendly and has a moderate price range."
"name[The Wrestlers], eatType[pub], food[Italian], priceRange[more than £30], area[riverside], familyFriendly[yes], near[Raja Indian Cuisine]"	"The Wrestlers is a italian pub in the riverside area near Raja Indian Cuisine. It is children friendly and has a price range of more than £30."
"name[The Wrestlers], eatType[pub], food[Japanese], priceRange[£20-25], area[riverside], familyFriendly[yes], near[Raja Indian Cuisine]"	"The Wrestlers is a japanese pub in the riverside area near Raja Indian Cuisine. It is kids friendly and has a price range of £20-25."
"name[The Wrestlers], eatType[pub], food[Japanese], priceRange[cheap], area[riverside], familyFriendly[yes], near[Raja Indian Cuisine]"	"The Wrestlers is a cheap japanese pub in the riverside area near Raja Indian Cuisine. It is family friendly."
"name[The Wrestlers], eatType[pub], food[Japanese], priceRange[high], area[riverside], familyFriendly[yes], near[Raja Indian Cuisine]"	"The Wrestlers is a japanese pub in the riverside area near Raja Indian Cuisine. It is children friendly and has a high price range."
"name[The Wrestlers], eatType[pub], food[Japanese], priceRange[less than £20], area[city centre], familyFriendly[no], near[Raja Indian Cuisine]"	"The Wrestlers is a japanese pub in the city centre near Raja Indian Cuisine. It is not family friendly and has a price range of less than £20."
"name[The Wrestlers], eatType[pub], food[Japanese], priceRange[less than £20], area[city centre], familyFriendly[yes], near[Raja Indian Cuisine]"	"The Wrestlers is a japanese pub in the city centre near Raja Indian Cuisine. It is family friendly and has a price range of less than £20."
"name[The Wrestlers], eatType[pub], food[Japanese], priceRange[less than £20], area[riverside], familyFriendly[no], near[Raja Indian Cuisine]"	"The Wrestlers is a japanese pub in the riverside area near Raja Indian Cuisine. It is not family friendly and has a price range of less than £20."
"name[The Wrestlers], eatType[pub], food[Japanese], priceRange[less than £20], area[riverside], familyFriendly[yes], near[Raja Indian Cuisine]"	"The Wrestlers is a japanese pub in the riverside area near Raja Indian Cuisine. It is family friendly and has a price range of less than £20."
"name[The Wrestlers], eatType[pub], food[Japanese], priceRange[moderate], area[city centre], familyFriendly[no], near[Raja Indian Cuisine]"	"The Wrestlers is a japanese pub in the city centre near Raja Indian Cuisine. It is not kids friendly and has a moderate price range."
"name[The Wrestlers], eatType[pub], food[Japanese], priceRange[moderate], area[city centre], familyFriendly[yes], near[Raja Indian Cuisine]"	"The Wrestlers is a japanese pub in the city centre near Raja Indian Cuisine. It is kids friendly and has a moderate price range."
"name[The Wrestlers], eatType[pub], food[Japanese], priceRange[moderate], area[riverside], familyFriendly[no], near[Raja Indian Cuisine]"	"The Wrestlers is a japanese pub in the riverside area near Raja Indian Cuisine. It is not kids friendly and has a moderate price range."
"name[The Wrestlers], eatType[pub], food[Japanese], priceRange[moderate], area[riverside], familyFriendly[yes], near[Raja Indian Cuisine]"	"The Wrestlers is a japanese pub in the riverside area near Raja Indian Cuisine. It is kids friendly and has a moderate price range."
"name[The Wrestlers], eatType[pub], food[Japanese], priceRange[moderate], customer rating[1 out of 5], area[city centre], familyFriendly[yes], near[Raja Indian Cuisine]"	"The Wrestlers is a japanese pub in the city centre near Raja Indian Cuisine. It is kids friendly and has a moderate price range and a customer rating of 1 out of 5."
"name[The Wrestlers], eatType[pub], food[Japanese], priceRange[moderate], customer rating[1 out of 5], area[riverside], familyFriendly[no], near[Raja Indian Cuisine]"	"The Wrestlers is a japanese pub in the riverside area near Raja Indian Cuisine. It has a moderate price range and a customer rating of 1 out of 5. It is not kids friendly."
"name[The Wrestlers], eatType[pub], food[Japanese], priceRange[moderate], customer rating[1 out of 5], area[riverside], familyFriendly[yes], near[Raja Indian Cuisine]"	"The Wrestlers is a chinese pub in the riverside area near Raja Indian Cuisine. It is kids friendly and has a moderate price range and a customer rating of 1 out of 5."
"name[The Wrestlers], eatType[pub], food[Japanese], priceRange[more than £30], area[city centre], familyFriendly[no], near[Raja Indian Cuisine]"	"The Wrestlers is a japanese pub in the city centre near Raja Indian Cuisine. It is not children friendly and has a price range of more than £30."
"name[The Wrestlers], eatType[pub], food[Japanese], priceRange[more than £30], area[city centre], familyFriendly[yes], near[Raja Indian Cuisine]"	"The Wrestlers is a japanese pub in the city centre near Raja Indian Cuisine. It is children friendly and has a price range of more than £30."
"name[The Wrestlers], eatType[pub], food[Japanese], priceRange[more than £30], area[riverside], familyFriendly[no], near[Raja Indian Cuisine]"	"The Wrestlers is a japanese pub in the riverside area near Raja Indian Cuisine. It is not children friendly and has a price range of more than £30."
"name[The Wrestlers], eatType[pub], food[Japanese], priceRange[more than £30], area[riverside], familyFriendly[yes], near[Raja Indian Cuisine]"	"The Wrestlers is a japanese pub in the riverside area near Raja Indian Cuisine. It is children friendly and has a price range of more than £30."
"name[The Wrestlers], eatType[pub], food[Japanese], priceRange[more than £30], customer rating[5 out of 5], area[city centre], familyFriendly[no], near[Raja Indian Cuisine]"	"The Wrestlers is a japanese pub in the city centre near Raja Indian Cuisine. It is not children friendly and has a customer rating of 5 out of 5 and a price range of more than £30."
"name[The Wrestlers], eatType[pub], food[Japanese], priceRange[more than £30], customer rating[5 out of 5], area[city centre], familyFriendly[yes], near[Raja Indian Cuisine]"	"The Wrestlers is a japanese pub in the city centre near Raja Indian Cuisine. It is children friendly and has a customer rating of 5 out of 5 and a price range of more than £30."
"name[The Wrestlers], eatType[pub], food[Japanese], priceRange[more than £30], customer rating[5 out of 5], area[riverside], familyFriendly[no], near[Raja Indian Cuisine]"	"The Wrestlers is a japanese pub in the riverside area near Raja Indian Cuisine. It has a customer rating of 5 out of 5 and a price range of more than £30. It is not children friendly."
"name[The Wrestlers], eatType[pub], food[Japanese], priceRange[more than £30], customer rating[5 out of 5], area[riverside], familyFriendly[yes], near[Raja Indian Cuisine]"	"The Wrestlers is a japanese pub in the riverside area near Raja Indian Cuisine. It is children friendly and has a customer rating of 5 out of 5 and a price range of more than £30."
"name[The Wrestlers], eatType[pub], food[Japanese], priceRange[more than £30], customer rating[low], area[city centre], familyFriendly[no], near[Raja Indian Cuisine]"	"The Wrestlers is a japanese pub in the city centre near Raja Indian Cuisine. It is not children friendly and has a low customer rating and a price range of more than £30."
"name[The Wrestlers], eatType[pub], food[Japanese], priceRange[more than £30], customer rating[low], area[city centre], familyFriendly[yes], near[Raja Indian Cuisine]"	"The Wrestlers is a japanese pub in the city centre near Raja Indian Cuisine. It is children friendly and has a low customer rating and a price range of more than £30."
"name[The Wrestlers], eatType[pub], food[Japanese], priceRange[more than £30], customer rating[low], area[riverside], familyFriendly[no], near[Raja Indian Cuisine]"	"The Wrestlers is a japanese pub in the riverside area near Raja Indian Cuisine. It is not children friendly and has a low customer rating and a price range of more than £30."
"name[The Wrestlers], eatType[pub], food[Japanese], priceRange[more than £30], customer rating[low], area[riverside], familyFriendly[yes], near[Raja Indian Cuisine]"	"The Wrestlers is a japanese pub in the riverside area near Raja Indian Cuisine. It is children friendly and has a low customer rating and a price range of more than £30."
"name[The Wrestlers], eatType[restaurant], food[Italian], priceRange[less than £20], area[riverside], familyFriendly[no], near[Raja Indian Cuisine]"	"The Wrestlers is a italian restaurant in the riverside area near Raja Indian Cuisine. It is not family friendly and has a price range of less than £20."
"name[The Wrestlers], eatType[restaurant], food[Italian], priceRange[less than £20], area[riverside], familyFriendly[yes], near[Raja Indian Cuisine]"	"The Wrestlers is a italian restaurant in the riverside area near Raja Indian Cuisine. It is family friendly and has a price range of less than £20."
"name[The Wrestlers], eatType[restaurant], food[Italian], priceRange[moderate], area[city centre], familyFriendly[no], near[Raja Indian Cuisine]"	"The Wrestlers is a italian restaurant in the city centre near Raja Indian Cuisine. It is not kids friendly and has a moderate price range."
"name[The Wrestlers], eatType[restaurant], food[Italian], priceRange[moderate], area[city centre], familyFriendly[yes], near[Raja Indian Cuisine]"	"The Wrestlers is a italian restaurant in the city centre near Raja Indian Cuisine. It is kids friendly and has a moderate price range."
"name[The Wrestlers], eatType[restaurant], food[Italian], priceRange[moderate], area[riverside], familyFriendly[no], near[Raja Indian Cuisine]"	"The Wrestlers is a italian restaurant in the riverside area near Raja Indian Cuisine. It is not kids friendly and has a moderate price range."
"name[The Wrestlers], eatType[restaurant], food[Italian], priceRange[moderate], area[riverside], familyFriendly[yes], near[Raja Indian Cuisine]"	"The Wrestlers is a italian restaurant in the riverside area near Raja Indian Cuisine. It is kids friendly and has a moderate price range."
"name[The Wrestlers], eatType[restaurant], food[Italian], priceRange[more than £30], area[riverside], familyFriendly[yes], near[Raja Indian Cuisine]"	"The Wrestlers is a italian restaurant in the riverside area near Raja Indian Cuisine. It is children friendly and has a price range of more than £30."
"name[The Wrestlers], eatType[restaurant], food[Japanese], priceRange[£20-25], area[riverside], familyFriendly[yes], near[Raja Indian Cuisine]"	"The Wrestlers is a japanese restaurant in the riverside area near Raja Indian Cuisine. It is kids friendly and has a price range of £20-25."
"name[The Wrestlers], eatType[restaurant], food[Japanese], priceRange[cheap], area[riverside], familyFriendly[yes], near[Raja Indian Cuisine]"	"The Wrestlers is a cheap japanese restaurant in the riverside area near Raja Indian Cuisine. It is family friendly."
"name[The Wrestlers], eatType[restaurant], food[Japanese], priceRange[high], area[riverside], familyFriendly[yes], near[Raja Indian Cuisine]"	"The Wrestlers is a japanese restaurant in the riverside area near Raja Indian Cuisine. It is children friendly and has a high price range."
"name[The Wrestlers], eatType[restaurant], food[Japanese], priceRange[less than £20], area[city centre], familyFriendly[no], near[Raja Indian Cuisine]"	"The Wrestlers is a japanese restaurant in the city centre near Raja Indian Cuisine. It is not family friendly and has a price range of less than £20."
"name[The Wrestlers], eatType[restaurant], food[Japanese], priceRange[less than £20], area[city centre], familyFriendly[yes], near[Raja Indian Cuisine]"	"The Wrestlers is a japanese restaurant in the city centre near Raja Indian Cuisine. It is family friendly and has a price range of less than £20."
"name[The Wrestlers], eatType[restaurant], food[Japanese], priceRange[less than £20], area[riverside], familyFriendly[no], near[Raja Indian Cuisine]"	"The Wrestlers is a japanese restaurant in the riverside area near Raja Indian Cuisine. It is not family friendly and has a price range of less than £20."
"name[The Wrestlers], eatType[restaurant], food[Japanese], priceRange[less than £20], area[riverside], familyFriendly[yes], near[Raja Indian Cuisine]"	"The Wrestlers is a japanese restaurant in the riverside area near Raja Indian Cuisine. It is family friendly and has a price range of less than £20."
"name[The Wrestlers], eatType[restaurant], food[Japanese], priceRange[moderate], area[city centre], familyFriendly[no], near[Raja Indian Cuisine]"	"The Wrestlers is a japanese restaurant in the city centre near Raja Indian Cuisine. It is not kids friendly and has a moderate price range."
"name[The Wrestlers], eatType[restaurant], food[Japanese], priceRange[moderate], area[city centre], familyFriendly[yes], near[Raja Indian Cuisine]"	"The Wrestlers is a japanese restaurant in the city centre near Raja Indian Cuisine. It is kids friendly and has a moderate price range."
"name[The Wrestlers], eatType[restaurant], food[Japanese], priceRange[moderate], area[riverside], familyFriendly[no], near[Raja Indian Cuisine]"	"The Wrestlers is a japanese restaurant in the riverside area near Raja Indian Cuisine. It is not kids friendly and has a moderate price range."
"name[The Wrestlers], eatType[restaurant], food[Japanese], priceRange[moderate], area[riverside], familyFriendly[yes], near[Raja Indian Cuisine]"	"The Wrestlers is a japanese restaurant in the riverside area near Raja Indian Cuisine. It is kids friendly and has a moderate price range."
"name[The Wrestlers], eatType[restaurant], food[Japanese], priceRange[more than £30], area[city centre], familyFriendly[no], near[Raja Indian Cuisine]"	"The Wrestlers is a japanese restaurant in the city centre near Raja Indian Cuisine. It is not children friendly and has a price range of more than £30."
"name[The Wrestlers], eatType[restaurant], food[Japanese], priceRange[more than £30], area[city centre], familyFriendly[yes], near[Raja Indian Cuisine]"	"The Wrestlers is a japanese restaurant in the city centre near Raja Indian Cuisine. It is children friendly and has a price range of more than £30."
"name[The Wrestlers], eatType[restaurant], food[Japanese], priceRange[more than £30], area[riverside], familyFriendly[no], near[Raja Indian Cuisine]"	"The Wrestlers is a japanese restaurant in the riverside area near Raja Indian Cuisine. It is not children friendly and has a price range of more than £30."
"name[The Wrestlers], eatType[restaurant], food[Japanese], priceRange[more than £30], area[riverside], familyFriendly[yes], near[Raja Indian Cuisine]"	"The Wrestlers is a japanese restaurant in the riverside area near Raja Indian Cuisine. It is children friendly and has a price range of more than £30."
"name[Wildwood], eatType[coffee shop], area[riverside]"	"Wildwood is a coffee shop in the riverside area."
"name[Wildwood], eatType[pub], area[riverside]"	"Wildwood is a pub in the riverside area."
"name[Wildwood], eatType[pub], food[French], area[riverside], familyFriendly[yes], near[Raja Indian Cuisine]"	"Wildwood is a french pub in the riverside area near Raja Indian Cuisine. It is family friendly."
"name[Wildwood], eatType[pub], food[Indian], area[city centre], familyFriendly[no], near[Raja Indian Cuisine]"	"Wildwood is a indian pub in the city centre near Raja Indian Cuisine. It is not family friendly."
"name[Wildwood], eatType[pub], food[Indian], area[city centre], familyFriendly[yes], near[Raja Indian Cuisine]"	"Wildwood is a indian pub in the city centre near Raja Indian Cuisine. It is family friendly."
"name[Wildwood], eatType[pub], food[Indian], area[riverside], familyFriendly[no], near[Raja Indian Cuisine]"	"Wildwood is a indian pub in the riverside area near Raja Indian Cuisine. It is not family friendly."
"name[Wildwood], eatType[pub], food[Indian], area[riverside], familyFriendly[yes], near[Raja Indian Cuisine]"	"Wildwood is a indian pub in the riverside area near Raja Indian Cuisine. It is family friendly."
"name[Wildwood], eatType[pub], food[Italian], area[city centre], familyFriendly[no], near[Raja Indian Cuisine]"	"Wildwood is a italian pub in the city centre near Raja Indian Cuisine. It is not family friendly."
"name[Wildwood], eatType[pub], food[Italian], area[city centre], familyFriendly[yes], near[Raja Indian Cuisine]"	"Wildwood is a italian pub in the city centre near Raja Indian Cuisine. It is family friendly."
"name[Wildwood], eatType[pub], food[Italian], area[riverside], familyFriendly[no], near[Raja Indian Cuisine]"	"Wildwood is a italian pub in the riverside area near Raja Indian Cuisine. It is not family friendly."
"name[Wildwood], eatType[pub], food[Italian], area[riverside], familyFriendly[yes], near[Raja Indian Cuisine]"	"Wildwood is a italian pub in the riverside area near Raja Indian Cuisine. It is family friendly."
"name[Wildwood], eatType[restaurant], food[French], area[riverside], familyFriendly[yes], near[Raja Indian Cuisine]"	"Wildwood is a french restaurant in the riverside area near Raja Indian Cuisine. It is family friendly."
"name[Wildwood], eatType[restaurant], food[Indian], area[city centre], familyFriendly[no], near[Raja Indian Cuisine]"	"Wildwood is a indian restaurant in the city centre near Raja Indian Cuisine. It is not family friendly."
"name[Wildwood], eatType[restaurant], food[Indian], area[city centre], familyFriendly[yes], near[Raja Indian Cuisine]"	"Wildwood is a indian restaurant in the city centre near Raja Indian Cuisine. It is family friendly."
"name[Wildwood], eatType[restaurant], food[Indian], area[riverside], familyFriendly[no], near[Raja Indian Cuisine]"	"Wildwood is a indian restaurant in the riverside area near Raja Indian Cuisine. It is not family friendly."
"name[Wildwood], eatType[restaurant], food[Indian], area[riverside], familyFriendly[yes], near[Raja Indian Cuisine]"	"Wildwood is a indian restaurant in the riverside area near Raja Indian Cuisine. It is family friendly."
"name[Wildwood], eatType[restaurant], food[Italian], area[city centre], familyFriendly[no], near[Raja Indian Cuisine]"	"Wildwood is a italian restaurant in the city centre near Raja Indian Cuisine. It is not family friendly."
"name[Wildwood], eatType[restaurant], food[Italian], area[city centre], familyFriendly[yes], near[Raja Indian Cuisine]"	"Wildwood is a italian restaurant in the city centre near Raja Indian Cuisine. It is family friendly."
"name[Wildwood], eatType[restaurant], food[Italian], area[riverside], familyFriendly[no], near[Raja Indian Cuisine]"	"Wildwood is a italian restaurant in the riverside area near Raja Indian Cuisine. It is not family friendly."
"name[Wildwood], eatType[restaurant], food[Italian], area[riverside], familyFriendly[yes], near[Raja Indian Cuisine]"	"Wildwood is a italian restaurant in the riverside area near Raja Indian Cuisine. It is family friendly."
"name[Zizzi], eatType[coffee shop], area[riverside]"	"Zizzi is a coffee shop in the riverside area."
"name[Zizzi], eatType[coffee shop], customer rating[average], near[Burger King]"	"Zizzi is a coffee shop near Burger King with an average customer rating and a cheap price range."
"name[Zizzi], eatType[coffee shop], customer rating[high], near[Burger King]"	"Zizzi is a place near Burger King with a high customer rating."
"name[Zizzi], eatType[coffee shop], near[The Sorrento]"	"Zizzi is a place near The Sorrento."
"name[Zizzi], eatType[pub], area[riverside]"	"Zizzi is a pub in the riverside area."
"name[Zizzi], eatType[pub], customer rating[average], near[Burger King]"	"Zizzi is a pub near Burger King with an average customer rating."
"name[Zizzi], eatType[pub], customer rating[high], near[Burger King]"	"Zizzi is a pub near Burger King with a high customer rating."
"name[Zizzi], eatType[pub], near[The Sorrento]"	"Zizzi is a pub near The Sorrento."
