MR	output
name[Blue Spice], eatType[coffee shop], area[city centre]	Blue Spice is a coffee shop located in the city centre.
name[Blue Spice], eatType[coffee shop], area[riverside]	Blue Spice is a coffee shop in the riverside area.
name[Blue Spice], eatType[coffee shop], customer rating[5 out of 5], near[Crowne Plaza Hotel]	Blue Spice is a coffee shop near Crowne Plaza Hotel with a customer rating of 5 out of 5.
name[Blue Spice], eatType[coffee shop], customer rating[average], near[Burger King]	Blue Spice is a coffee shop near Burger King with an average customer rating.
name[Blue Spice], eatType[coffee shop], customer rating[average], near[Crowne Plaza Hotel]	Blue Spice is a coffee shop near Crowne Plaza Hotel with an average customer rating.
name[Blue Spice], eatType[pub], area[city centre]	Blue Spice pub located in the city centre.
name[Blue Spice], eatType[pub], area[riverside]	Blue Spice pub located in the riverside area.
name[Blue Spice], eatType[pub], customer rating[5 out of 5], near[Crowne Plaza Hotel]	Blue Spice pub near Crowne Plaza Hotel with a customer rating of 5 out of 5.
name[Blue Spice], eatType[pub], customer rating[average], near[Burger King]	Blue Spice pub near Burger King with an average customer rating.
name[Blue Spice], eatType[pub], customer rating[average], near[Crowne Plaza Hotel]	Blue Spice pub near Crowne Plaza Hotel with an average customer rating.
name[Blue Spice], eatType[pub], food[Chinese], area[city centre], familyFriendly[no], near[Rainbow Vegetarian Café]	Blue Spice is a Chinese pub located in the city centre near Rainbow Vegetarian Café it is not family-friendly.
name[Blue Spice], eatType[pub], food[Chinese], area[city centre], familyFriendly[yes], near[Rainbow Vegetarian Café]	Blue Spice is a family friendly pub serving Chinese food in the city centre near Rainbow Vegetarian Café.
name[Blue Spice], eatType[pub], food[Chinese], area[riverside], familyFriendly[no], near[Rainbow Vegetarian Café]	Blue Spice is a Chinese pub located in riverside near Rainbow Vegetarian Café it is not family friendly.
name[Blue Spice], eatType[pub], food[Chinese], area[riverside], familyFriendly[yes], near[Rainbow Vegetarian Café]	Blue Spice is a family friendly pub serving Chinese food in riverside near Rainbow Vegetarian Café.
name[Blue Spice], eatType[pub], food[English], area[city centre], familyFriendly[no], near[Rainbow Vegetarian Café]	Blue Spice is an English pub located in the city centre near Rainbow Vegetarian Café it is not family-friendly.
name[Blue Spice], eatType[pub], food[English], area[city centre], familyFriendly[yes], near[Rainbow Vegetarian Café]	Blue Spice is a family-friendly pub serving English food near Rainbow Vegetarian Café in the city centre.
name[Blue Spice], eatType[pub], food[English], area[riverside], familyFriendly[no], near[Rainbow Vegetarian Café]	Blue Spice is an English pub located in riverside near Rainbow Vegetarian Café it is not family-friendly.
name[Blue Spice], eatType[pub], food[English], area[riverside], familyFriendly[yes], near[Rainbow Vegetarian Café]	Blue Spice is a family friendly pub serving English food it is located near Rainbow Vegetarian Café in riverside.
name[Blue Spice], eatType[restaurant], food[Chinese], area[city centre], familyFriendly[no], near[Rainbow Vegetarian Café]	Blue Spice is a Chinese restaurant in the city centre near Rainbow Vegetarian Café it is not family friendly.
name[Blue Spice], eatType[restaurant], food[Chinese], area[city centre], familyFriendly[yes], near[Rainbow Vegetarian Café]	Blue Spice is a family friendly restaurant Chinese food near Rainbow Vegetarian Café in the city centre.
name[Blue Spice], eatType[restaurant], food[Chinese], area[riverside], familyFriendly[no], near[Rainbow Vegetarian Café]	Blue Spice is a Chinese restaurant in riverside near Rainbow Vegetarian Café it is not family friendly.
name[Blue Spice], eatType[restaurant], food[Chinese], area[riverside], familyFriendly[yes], near[Rainbow Vegetarian Café]	Blue Spice is a family friendly restaurant Chinese located near Rainbow Vegetarian Café in riverside.
name[Blue Spice], eatType[restaurant], food[English], area[city centre], familyFriendly[no], near[Rainbow Vegetarian Café]	Blue Spice is an English restaurant in the city centre near Rainbow Vegetarian Café it is not family-friendly.
name[Blue Spice], eatType[restaurant], food[English], area[city centre], familyFriendly[yes], near[Rainbow Vegetarian Café]	Blue Spice is a family friendly restaurant English food near Rainbow Vegetarian Café in the city centre.
name[Blue Spice], eatType[restaurant], food[English], area[riverside], familyFriendly[no], near[Rainbow Vegetarian Café]	Blue Spice is an English restaurant in riverside near Rainbow Vegetarian Café it is not family-friendly.
name[Blue Spice], eatType[restaurant], food[English], area[riverside], familyFriendly[yes], near[Rainbow Vegetarian Café]	Blue Spice is a family friendly restaurant English food near Rainbow Vegetarian Café in riverside.
name[Clowns], eatType[coffee shop], customer rating[3 out of 5], near[All Bar One]	Clowns is a coffee shop near All Bar One with a customer rating of 3 out of 5.
name[Clowns], eatType[coffee shop], customer rating[5 out of 5], near[Crowne Plaza Hotel]	Clowns is a coffee shop near Crowne Plaza Hotel with a customer rating of 5 out of 5.
name[Clowns], eatType[coffee shop], near[The Sorrento]	Clowns is a coffee shop near The Sorrento.
name[Clowns], eatType[pub], customer rating[3 out of 5], near[All Bar One]	Clowns pub near All Bar One with a customer rating of 3 out of 5.
name[Clowns], eatType[pub], customer rating[5 out of 5], near[Crowne Plaza Hotel]	Clowns pub near Crowne Plaza Hotel with a customer rating of 5 out of 5.
name[Clowns], eatType[pub], near[The Sorrento]	Clowns pub near The Sorrento.
name[Cocum], eatType[coffee shop], customer rating[high], near[Burger King]	Cocum is a coffee shop near Burger King with a high customer rating.
name[Cocum], eatType[coffee shop], customer rating[high], near[Café Sicilia]	Cocum is a coffee shop near Café Sicilia with a high customer rating.
name[Cocum], eatType[coffee shop], customer rating[low], near[Café Sicilia]	Cocum is a coffee shop near Café Sicilia with a low customer rating.
name[Cocum], eatType[coffee shop], customer rating[low], near[Express by Holiday Inn]	Cocum is a coffee shop near Express by Holiday Inn with a low customer rating.
name[Cocum], eatType[coffee shop], near[The Rice Boat]	Cocum is a coffee shop near The Rice Boat.
name[Cocum], eatType[coffee shop], near[The Sorrento]	Cocum is a coffee shop near The Sorrento.
name[Cocum], eatType[pub], customer rating[high], near[Burger King]	Cocum pub with a high customer rating near Burger King.
name[Cocum], eatType[pub], customer rating[high], near[Café Sicilia]	Cocum pub with a high customer rating near Café Sicilia.
name[Cocum], eatType[pub], customer rating[low], near[Café Sicilia]	Cocum pub near Café Sicilia with a low customer rating.
name[Cocum], eatType[pub], customer rating[low], near[Express by Holiday Inn]	Cocum pub near Express by Holiday Inn with a low customer rating.
name[Cocum], eatType[pub], near[The Rice Boat]	Cocum pub near The Rice Boat.
name[Cocum], eatType[pub], near[The Sorrento]	Cocum pub near The Sorrento.
name[Cotto], eatType[coffee shop], near[The Bakers]	Cotto is a coffee shop near The Bakers.
name[Cotto], eatType[pub], near[The Bakers]	Cotto pub near The Bakers.
name[Giraffe], eatType[coffee shop], near[The Bakers]	Giraffe is a coffee shop near The Bakers.
name[Giraffe], eatType[coffee shop], near[The Rice Boat]	Giraffe is a coffee shop near The Rice Boat.
name[Giraffe], eatType[pub], food[English], area[riverside], familyFriendly[yes], near[Rainbow Vegetarian Café]	Giraffe is a family friendly pub serving English food it is located near Rainbow Vegetarian Café in riverside.
name[Giraffe], eatType[pub], food[Fast food], area[city centre], familyFriendly[no], near[Rainbow Vegetarian Café]	Giraffe is a Fast food pub located in the city centre near Rainbow Vegetarian Café it is not family-friendly.
name[Giraffe], eatType[pub], food[Fast food], area[city centre], familyFriendly[yes], near[Rainbow Vegetarian Café]	Giraffe is a family friendly pub serving Fast food in the city centre near Rainbow Vegetarian Café.
name[Giraffe], eatType[pub], food[Fast food], area[riverside], familyFriendly[no], near[Rainbow Vegetarian Café]	Giraffe is a Fast food pub located in riverside near Rainbow Vegetarian Café it is not family-friendly.
name[Giraffe], eatType[pub], food[Fast food], area[riverside], familyFriendly[yes], near[Rainbow Vegetarian Café]	Giraffe is a family friendly pub serving Fast food in riverside near Rainbow Vegetarian Café.
name[Giraffe], eatType[pub], food[Fast food], area[riverside], familyFriendly[yes], near[Raja Indian Cuisine]	Giraffe is a family friendly pub serving Fast food in riverside near Raja Indian Cuisine.
name[Giraffe], eatType[pub], food[French], area[city centre], familyFriendly[no], near[Raja Indian Cuisine]	Giraffe is a French pub located in the city centre near Raja Indian Cuisine it is not family-friendly.
name[Giraffe], eatType[pub], food[French], area[city centre], familyFriendly[yes], near[Raja Indian Cuisine]	Giraffe is a family-friendly pub serving French food located in the city centre near Raja Indian Cuisine.
name[Giraffe], eatType[pub], food[French], area[riverside], familyFriendly[no], near[Raja Indian Cuisine]	Giraffe is a French pub located in the riverside near Raja Indian Cuisine it is not family-friendly.
name[Giraffe], eatType[pub], food[French], area[riverside], familyFriendly[yes], near[Raja Indian Cuisine]	Giraffe is a family friendly pub serving French food in the riverside near Raja Indian Cuisine.
name[Giraffe], eatType[pub], near[The Bakers]	Giraffe pub near The Bakers.
name[Giraffe], eatType[pub], near[The Rice Boat]	Giraffe pub near The Rice Boat.
name[Giraffe], eatType[restaurant], food[English], area[riverside], familyFriendly[yes], near[Rainbow Vegetarian Café]	Giraffe is a family friendly restaurant English food near Rainbow Vegetarian Café in riverside.
name[Giraffe], eatType[restaurant], food[Fast food], area[city centre], familyFriendly[no], near[Rainbow Vegetarian Café]	Giraffe is a Fast food restaurant located in the city centre near Rainbow Vegetarian Café it is not family-friendly.
name[Giraffe], eatType[restaurant], food[Fast food], area[city centre], familyFriendly[yes], near[Rainbow Vegetarian Café]	Giraffe is a family friendly restaurant Fast food in the city centre near Rainbow Vegetarian Café.
name[Giraffe], eatType[restaurant], food[Fast food], area[riverside], familyFriendly[no], near[Rainbow Vegetarian Café]	Giraffe is a Fast food restaurant located in riverside near Rainbow Vegetarian Café it is not family-friendly.
name[Giraffe], eatType[restaurant], food[Fast food], area[riverside], familyFriendly[yes], near[Rainbow Vegetarian Café]	Giraffe is a family friendly restaurant Fast food in riverside near Rainbow Vegetarian Café.
name[Giraffe], eatType[restaurant], food[Fast food], area[riverside], familyFriendly[yes], near[Raja Indian Cuisine]	Giraffe is a family friendly restaurant Fast food in riverside near Raja Indian Cuisine.
name[Giraffe], eatType[restaurant], food[French], area[city centre], familyFriendly[no], near[Raja Indian Cuisine]	Giraffe is a French restaurant in the city centre near Raja Indian Cuisine it is not family-friendly.
name[Giraffe], eatType[restaurant], food[French], area[city centre], familyFriendly[yes], near[Raja Indian Cuisine]	Giraffe is a family-friendly restaurant serving French food near Raja Indian Cuisine in the city centre.
name[Giraffe], eatType[restaurant], food[French], area[riverside], familyFriendly[no], near[Raja Indian Cuisine]	Giraffe is a French restaurant located in riverside near Raja Indian Cuisine it is not family-friendly.
name[Giraffe], eatType[restaurant], food[French], area[riverside], familyFriendly[yes], near[Raja Indian Cuisine]	Giraffe is a family friendly restaurant serving French food near Raja Indian Cuisine in riverside.
name[Green Man], eatType[coffee shop], customer rating[1 out of 5], near[All Bar One]	Green Man is a coffee shop near All Bar One with a customer rating of 1 out of 5.
name[Green Man], eatType[coffee shop], customer rating[3 out of 5], near[All Bar One]	Green Man is a coffee shop near All Bar One with a customer rating of 3 out of 5.
name[Green Man], eatType[pub], customer rating[1 out of 5], near[All Bar One]	Green Man pub near All Bar One with a customer rating of 1 out of 5.
name[Green Man], eatType[pub], customer rating[3 out of 5], near[All Bar One]	Green Man pub near All Bar One with a customer rating of 3 out of 5.
name[Green Man], eatType[pub], food[Italian], area[riverside], familyFriendly[yes], near[Express by Holiday Inn]	Green Man is a family friendly pub serving Italian food it is located in the riverside near Express by Holiday Inn.
name[Green Man], eatType[pub], food[Italian], area[riverside], familyFriendly[yes], near[Raja Indian Cuisine]	Green Man is a family friendly pub serving Italian food it is located in the riverside near Raja Indian Cuisine.
name[Green Man], eatType[pub], food[Japanese], area[city centre], familyFriendly[no], near[Express by Holiday Inn]	Green Man is a Japanese pub located in the city centre near Express by Holiday Inn it is not family-friendly.
name[Green Man], eatType[pub], food[Japanese], area[city centre], familyFriendly[yes], near[Express by Holiday Inn]	Green Man is a family friendly pub serving Japanese food located in the city centre near Express by Holiday Inn.
name[Green Man], eatType[pub], food[Japanese], area[riverside], familyFriendly[no], near[Express by Holiday Inn]	Green Man is a Japanese pub located in riverside near Express by Holiday Inn it is not family-friendly.
name[Green Man], eatType[pub], food[Japanese], area[riverside], familyFriendly[yes], near[Express by Holiday Inn]	Green Man is a family friendly pub serving Japanese food it is located in the riverside near Express by Holiday Inn.
name[Green Man], eatType[restaurant], food[Italian], area[riverside], familyFriendly[yes], near[Express by Holiday Inn]	Green Man is a family friendly restaurant Italian restaurant near Express by Holiday Inn in riverside.
name[Green Man], eatType[restaurant], food[Italian], area[riverside], familyFriendly[yes], near[Raja Indian Cuisine]	Green Man is a family friendly restaurant Italian restaurant near Raja Indian Cuisine in riverside.
name[Green Man], eatType[restaurant], food[Japanese], area[city centre], familyFriendly[no], near[Express by Holiday Inn]	Green Man is a Japanese restaurant located in the city centre near Express by Holiday Inn it is not family-friendly.
name[Green Man], eatType[restaurant], food[Japanese], area[city centre], familyFriendly[yes], near[Express by Holiday Inn]	Green Man is a family friendly restaurant Japanese food near Express by Holiday Inn in the city centre.
name[Green Man], eatType[restaurant], food[Japanese], area[riverside], familyFriendly[no], near[Express by Holiday Inn]	Green Man is a Japanese restaurant located in riverside near Express by Holiday Inn it is not family-friendly.
name[Green Man], eatType[restaurant], food[Japanese], area[riverside], familyFriendly[yes], near[Express by Holiday Inn]	Green Man is a family friendly restaurant Japanese near Express by Holiday Inn in riverside.
name[Loch Fyne], eatType[coffee shop], area[riverside]	Loch Fyne is a coffee shop in the riverside area.
name[Loch Fyne], eatType[pub], area[riverside]	Loch Fyne pub located in the riverside area.
name[Strada], eatType[coffee shop], area[city centre]	Strada is a coffee shop located in the city centre.
name[Strada], eatType[coffee shop], customer rating[1 out of 5], near[All Bar One]	Strada is a coffee shop near All Bar One with a customer rating of 1 out of 5.
name[Strada], eatType[coffee shop], customer rating[1 out of 5], near[Rainbow Vegetarian Café]	Strada is a coffee shop near Rainbow Vegetarian Café with a customer rating of 1 out of 5.
name[Strada], eatType[coffee shop], customer rating[low], near[Express by Holiday Inn]	Strada is a coffee shop near Express by Holiday Inn with a low customer rating.
name[Strada], eatType[pub], area[city centre]	Strada pub located in the city centre.
name[Strada], eatType[pub], customer rating[1 out of 5], near[All Bar One]	Strada pub near All Bar One with a customer rating of 1 out of 5.
name[Strada], eatType[pub], customer rating[1 out of 5], near[Rainbow Vegetarian Café]	Strada pub near Rainbow Vegetarian Café with a customer rating of 1 out of 5.
name[Strada], eatType[pub], customer rating[low], near[Express by Holiday Inn]	Strada pub near Express by Holiday Inn with a low customer rating.
name[The Cricketers], eatType[coffee shop], customer rating[1 out of 5], familyFriendly[yes], near[Avalon]	The Cricketers is a children friendly coffee shop near Avalon with a customer rating of 1 out of 5.
name[The Cricketers], eatType[coffee shop], customer rating[3 out of 5], familyFriendly[yes], near[Avalon]	The Cricketers is a children friendly coffee shop near Avalon with a customer rating of 3 out of 5.
name[The Cricketers], eatType[coffee shop], customer rating[3 out of 5], familyFriendly[yes], near[Crowne Plaza Hotel]	The Cricketers is a children friendly coffee shop near Crowne Plaza Hotel with a customer rating of 3 out of 5.
name[The Cricketers], eatType[coffee shop], customer rating[5 out of 5], familyFriendly[no], near[Crowne Plaza Hotel]	The Cricketers near Crowne Plaza Hotel is a non - family-friendly coffee shop with a customer rating of 5 out of 5.
name[The Cricketers], eatType[coffee shop], customer rating[5 out of 5], familyFriendly[yes], near[Crowne Plaza Hotel]	The Cricketers is a family friendly coffee shop near Crowne Plaza Hotel with a customer rating of 5 out of 5.
name[The Cricketers], eatType[coffee shop], customer rating[average], familyFriendly[no], near[Café Sicilia]	The Cricketers near Café Sicilia is not a family-friendly coffee shop with an average customer rating.
name[The Cricketers], eatType[coffee shop], customer rating[average], familyFriendly[no], near[Crowne Plaza Hotel]	The Cricketers near Crowne Plaza Hotel is not a family-friendly coffee shop with an average customer rating.
name[The Cricketers], eatType[coffee shop], customer rating[average], familyFriendly[yes], near[Café Sicilia]	The Cricketers is a family friendly coffee shop near Café Sicilia with an average customer rating.
name[The Cricketers], eatType[coffee shop], customer rating[high], familyFriendly[yes], near[Café Sicilia]	The Cricketers is a children friendly coffee shop near Café Sicilia with a high customer rating.
name[The Cricketers], eatType[coffee shop], customer rating[high], familyFriendly[yes], near[Express by Holiday Inn]	The Cricketers is a children friendly coffee shop near Express by Holiday Inn with a high customer rating.
name[The Cricketers], eatType[coffee shop], customer rating[low], familyFriendly[no], near[Express by Holiday Inn]	The Cricketers is a coffee shop near Express by Holiday Inn with a low customer rating and is not family-friendly.
name[The Cricketers], eatType[coffee shop], customer rating[low], familyFriendly[no], near[Ranch]	The Cricketers is a coffee shop near Ranch with a low customer rating and is not family-friendly.
name[The Cricketers], eatType[coffee shop], customer rating[low], familyFriendly[yes], near[Ranch]	The Cricketers is a family friendly coffee shop near Ranch with a low customer rating.
name[The Cricketers], eatType[restaurant], customer rating[1 out of 5], familyFriendly[yes], near[Avalon]	The Cricketers is a children friendly restaurant near Avalon with a customer rating of 1 out of 5.
name[The Cricketers], eatType[restaurant], customer rating[3 out of 5], familyFriendly[yes], near[Avalon]	The Cricketers is a children friendly restaurant near Avalon with a customer rating of 3 out of 5.
name[The Cricketers], eatType[restaurant], customer rating[3 out of 5], familyFriendly[yes], near[Crowne Plaza Hotel]	The Cricketers is a children friendly restaurant near Crowne Plaza Hotel with a customer rating of 3 out of 5.
name[The Cricketers], eatType[restaurant], customer rating[5 out of 5], familyFriendly[no], near[Crowne Plaza Hotel]	The Cricketers near Crowne Plaza Hotel is not family-friendly restaurant with a customer rating of 5 out of 5.
name[The Cricketers], eatType[restaurant], customer rating[5 out of 5], familyFriendly[yes], near[Crowne Plaza Hotel]	The Cricketers is a family friendly restaurant near Crowne Plaza Hotel with a customer rating of 5 out of 5.
name[The Cricketers], eatType[restaurant], customer rating[average], familyFriendly[no], near[Café Sicilia]	The Cricketers near Café Sicilia is not family-friendly restaurant with an average customer rating.
name[The Cricketers], eatType[restaurant], customer rating[average], familyFriendly[no], near[Crowne Plaza Hotel]	The Cricketers near Crowne Plaza Hotel is not family-friendly restaurant with an average customer rating.
name[The Cricketers], eatType[restaurant], customer rating[average], familyFriendly[yes], near[Café Sicilia]	The Cricketers is a family friendly restaurant near Café Sicilia with an average customer rating.
name[The Cricketers], eatType[restaurant], customer rating[high], familyFriendly[yes], near[Café Sicilia]	The Cricketers is a children friendly restaurant near Café Sicilia with a high customer rating.
name[The Cricketers], eatType[restaurant], customer rating[high], familyFriendly[yes], near[Express by Holiday Inn]	The Cricketers is a children friendly restaurant near Express by Holiday Inn with a high customer rating.
name[The Cricketers], eatType[restaurant], customer rating[low], familyFriendly[no], near[Express by Holiday Inn]	The Cricketers is a restaurant near Express by Holiday Inn has a low customer rating and is not family-friendly.
name[The Cricketers], eatType[restaurant], customer rating[low], familyFriendly[no], near[Ranch]	The Cricketers is a restaurant near Ranch has a low customer rating and is not family-friendly.
name[The Cricketers], eatType[restaurant], customer rating[low], familyFriendly[yes], near[Ranch]	The Cricketers is a family friendly restaurant near Ranch with a low customer rating.
name[The Cricketers], eatType[restaurant], food[Chinese], priceRange[£20-25], customer rating[high], area[city centre], familyFriendly[no], near[All Bar One]	The Cricketers is a Chinese restaurant in the city centre near All Bar One it has a price range of £20-25 and has a high customer rating is not kid friendly.
name[The Cricketers], eatType[restaurant], food[Chinese], priceRange[£20-25], customer rating[high], area[city centre], familyFriendly[yes], near[All Bar One]	The Cricketers is a Chinese restaurant in the city centre near All Bar One with a price range of more than £30 and has a high customer rating is kid friendly.
name[The Cricketers], eatType[restaurant], food[Chinese], priceRange[£20-25], customer rating[high], area[riverside], familyFriendly[no], near[All Bar One]	The Cricketers is a Chinese restaurant in riverside near All Bar One it has a high customer rating price range is £20-25 and is not kids friendly.
name[The Cricketers], eatType[restaurant], food[Chinese], priceRange[£20-25], customer rating[high], area[riverside], familyFriendly[yes], near[All Bar One]	The Cricketers is a Chinese restaurant in riverside near All Bar One it has a high customer rating is kid friendly the price range is £20-25.
name[The Cricketers], eatType[restaurant], food[Chinese], priceRange[cheap], customer rating[5 out of 5], area[city centre], familyFriendly[no], near[All Bar One]	The Cricketers is a cheap Chinese restaurant in the city centre near All Bar One and has a customer rating of 5 out of 5 is not family friendly.
name[The Cricketers], eatType[restaurant], food[Chinese], priceRange[cheap], customer rating[5 out of 5], area[city centre], familyFriendly[yes], near[All Bar One]	The Cricketers is a cheap Chinese restaurant in the city centre near All Bar One it is family friendly and has a customer rating of 5 out of 5.
name[The Cricketers], eatType[restaurant], food[Chinese], priceRange[cheap], customer rating[5 out of 5], area[riverside], familyFriendly[no], near[All Bar One]	The Cricketers is a cheap Chinese restaurant in riverside near All Bar One and has a customer rating of 5 out of 5 is not family friendly.
name[The Cricketers], eatType[restaurant], food[Chinese], priceRange[cheap], customer rating[5 out of 5], area[riverside], familyFriendly[yes], near[All Bar One]	The Cricketers is a cheap Chinese restaurant in riverside near All Bar One has a customer rating of 5 out of 5 and is family friendly.
name[The Cricketers], eatType[restaurant], food[Chinese], priceRange[cheap], customer rating[average], area[city centre], familyFriendly[no], near[All Bar One]	The Cricketers is a cheap Chinese restaurant in the city centre near All Bar One it has an average customer rating and is not family friendly.
name[The Cricketers], eatType[restaurant], food[Chinese], priceRange[cheap], customer rating[average], area[city centre], familyFriendly[yes], near[All Bar One]	The Cricketers is a cheap Chinese restaurant in the city centre near All Bar One with an average customer rating and is family friendly.
name[The Cricketers], eatType[restaurant], food[Chinese], priceRange[cheap], customer rating[average], area[riverside], familyFriendly[no], near[All Bar One]	The Cricketers is a cheap Chinese restaurant in riverside near All Bar One it has an average customer rating and is not family friendly.
name[The Cricketers], eatType[restaurant], food[Chinese], priceRange[cheap], customer rating[average], area[riverside], familyFriendly[yes], near[All Bar One]	The Cricketers is a cheap Chinese restaurant in riverside near All Bar One has an average customer rating and is family friendly.
name[The Cricketers], eatType[restaurant], food[Chinese], priceRange[high], customer rating[1 out of 5], area[city centre], familyFriendly[no], near[All Bar One]	The Cricketers is a Chinese restaurant in the city centre near All Bar One it has a high price range, a 1 out of 5 and is not child friendly.
name[The Cricketers], eatType[restaurant], food[Chinese], priceRange[high], customer rating[1 out of 5], area[city centre], familyFriendly[yes], near[All Bar One]	The Cricketers is a Chinese restaurant in the city centre near All Bar One it has a high price range, a 1 out of 5 and is child friendly.
name[The Cricketers], eatType[restaurant], food[Chinese], priceRange[high], customer rating[1 out of 5], area[riverside], familyFriendly[no], near[All Bar One]	The Cricketers is a Chinese restaurant in the riverside near All Bar One has a high price range, a 1 out of 5 and is not child friendly.
name[The Cricketers], eatType[restaurant], food[Chinese], priceRange[high], customer rating[1 out of 5], area[riverside], familyFriendly[yes], near[All Bar One]	The Cricketers is a Chinese restaurant in the riverside near All Bar One with a high price range, a 1 out of 5 and is child friendly.
name[The Cricketers], eatType[restaurant], food[Chinese], priceRange[high], customer rating[average], area[city centre], familyFriendly[no], near[All Bar One]	The Cricketers is a Chinese restaurant in the city centre near All Bar One it has a high price range, a average customer rating and is not child friendly.
name[The Cricketers], eatType[restaurant], food[Chinese], priceRange[high], customer rating[average], area[city centre], familyFriendly[yes], near[All Bar One]	The Cricketers is a Chinese restaurant in the city centre near All Bar One it has a high price range, has an average customer rating and is child friendly.
name[The Cricketers], eatType[restaurant], food[Chinese], priceRange[high], customer rating[average], area[riverside], familyFriendly[no], near[All Bar One]	The Cricketers is a Chinese restaurant in the riverside near All Bar One it has a high price range, a average customer rating and is not child friendly.
name[The Cricketers], eatType[restaurant], food[Chinese], priceRange[high], customer rating[average], area[riverside], familyFriendly[yes], near[All Bar One]	The Cricketers is a Chinese restaurant in the riverside near All Bar One it has a high price range, has an average customer rating and is child friendly.
name[The Cricketers], eatType[restaurant], food[Chinese], priceRange[less than £20], customer rating[low], area[city centre], familyFriendly[no], near[All Bar One]	The Cricketers is a Chinese restaurant in the city centre near All Bar One it has a price range less than £20 it has a low customer rating and is not family friendly.
name[The Cricketers], eatType[restaurant], food[Chinese], priceRange[less than £20], customer rating[low], area[city centre], familyFriendly[yes], near[All Bar One]	The Cricketers is a Chinese restaurant in the city centre near All Bar One it has a price range less than £20 it has a low customer rating and is family friendly.
name[The Cricketers], eatType[restaurant], food[Chinese], priceRange[less than £20], customer rating[low], area[riverside], familyFriendly[no], near[All Bar One]	The Cricketers is a Chinese restaurant in the riverside area near All Bar One it has a price range of less than £20 it has a low customer rating and is not family friendly.
name[The Cricketers], eatType[restaurant], food[Chinese], priceRange[less than £20], customer rating[low], area[riverside], familyFriendly[yes], near[All Bar One]	The Cricketers is a Chinese restaurant in the riverside area near All Bar One it has a price range of less than £20 it has a low customer rating and is family friendly.
name[The Cricketers], eatType[restaurant], food[Chinese], priceRange[moderate], customer rating[1 out of 5], area[city centre], familyFriendly[no], near[All Bar One]	The Cricketers is a Chinese restaurant in the city centre near All Bar One it has a moderate price range, a customer rating of 1 out of 5 and is not kid friendly.
name[The Cricketers], eatType[restaurant], food[Chinese], priceRange[moderate], customer rating[1 out of 5], area[city centre], familyFriendly[yes], near[All Bar One]	The Cricketers is a Chinese restaurant in the city centre near All Bar One it has a moderate price range it is kid friendly and has a customer rating of 1 out of 5.
name[The Cricketers], eatType[restaurant], food[Chinese], priceRange[moderate], customer rating[1 out of 5], area[riverside], familyFriendly[no], near[All Bar One]	The Cricketers is a Chinese restaurant in the riverside area near All Bar One has a moderate price range it has a customer rating of 1 out of 5 and is not kid friendly.
name[The Cricketers], eatType[restaurant], food[Chinese], priceRange[moderate], customer rating[1 out of 5], area[riverside], familyFriendly[yes], near[All Bar One]	The Cricketers is a Chinese restaurant in the riverside area near All Bar One it has a moderate price range it is kid friendly and has a customer rating of 1 out of 5.
name[The Cricketers], eatType[restaurant], food[Chinese], priceRange[moderate], customer rating[3 out of 5], area[city centre], familyFriendly[no], near[All Bar One]	The Cricketers is a moderately priced Chinese restaurant in the city centre near All Bar One it has a customer rating of 3 out of 5 and is not kid friendly.
name[The Cricketers], eatType[restaurant], food[Chinese], priceRange[moderate], customer rating[3 out of 5], area[city centre], familyFriendly[yes], near[All Bar One]	The Cricketers is a moderately priced Chinese restaurant in the city centre near All Bar One it is kid friendly and has a customer rating of 3 out of 5.
name[The Cricketers], eatType[restaurant], food[Chinese], priceRange[moderate], customer rating[3 out of 5], area[riverside], familyFriendly[no], near[All Bar One]	The Cricketers is a Chinese restaurant in the riverside area near All Bar One it has a moderate price range, a customer rating of 3 out of 5 and is not kid friendly.
name[The Cricketers], eatType[restaurant], food[Chinese], priceRange[moderate], customer rating[3 out of 5], area[riverside], familyFriendly[yes], near[All Bar One]	The Cricketers is a moderately priced Chinese restaurant in riverside near All Bar One it is kid friendly and has a customer rating of 3 out of 5.
name[The Cricketers], eatType[restaurant], food[Chinese], priceRange[more than £30], customer rating[high], area[city centre], familyFriendly[no], near[All Bar One]	The Cricketers is a Chinese restaurant in the city centre near All Bar One it has a price range of more than £30 and a high customer rating it is not child friendly.
name[The Cricketers], eatType[restaurant], food[Chinese], priceRange[more than £30], customer rating[high], area[city centre], familyFriendly[yes], near[All Bar One]	The Cricketers is a Chinese restaurant in the city centre near All Bar One it has a price range of more than £30 and has a high customer rating is child friendly.
name[The Cricketers], eatType[restaurant], food[Chinese], priceRange[more than £30], customer rating[high], area[riverside], familyFriendly[no], near[All Bar One]	The Cricketers is a Chinese restaurant in riverside near All Bar One has a high customer rating the price range is more than £30 it is not children friendly.
name[The Cricketers], eatType[restaurant], food[Chinese], priceRange[more than £30], customer rating[high], area[riverside], familyFriendly[yes], near[All Bar One]	The Cricketers is a Chinese restaurant in riverside near All Bar One has a high customer rating it is child friendly the price range is more than £30.
name[The Cricketers], eatType[restaurant], food[English], priceRange[£20-25], customer rating[high], area[city centre], familyFriendly[no], near[All Bar One]	The Cricketers is an English restaurant in the city centre near All Bar One it has a price range of £20-25 and has a high customer rating is not kid friendly.
name[The Cricketers], eatType[restaurant], food[English], priceRange[£20-25], customer rating[high], area[city centre], familyFriendly[yes], near[All Bar One]	The Cricketers is an English restaurant in the city centre near All Bar One with a price range of £20-25 and has a high customer rating is kid friendly.
name[The Cricketers], eatType[restaurant], food[English], priceRange[£20-25], customer rating[high], area[riverside], familyFriendly[no], near[All Bar One]	The Cricketers is an English restaurant in the riverside near All Bar One with a price range of £20-25 and has a high customer rating is not kid friendly.
name[The Cricketers], eatType[restaurant], food[English], priceRange[£20-25], customer rating[high], area[riverside], familyFriendly[yes], near[All Bar One]	The Cricketers is an English restaurant in the riverside near All Bar One with a price range of £20-25 and has a high customer rating is kid friendly.
name[The Cricketers], eatType[restaurant], food[English], priceRange[cheap], customer rating[5 out of 5], area[city centre], familyFriendly[no], near[Café Rouge]	The Cricketers is a cheap English restaurant in the city centre near Café Rouge it is not family-friendly and has a customer rating of 5 out of 5.
name[The Cricketers], eatType[restaurant], food[English], priceRange[cheap], customer rating[5 out of 5], area[city centre], familyFriendly[yes], near[Café Rouge]	The Cricketers is a cheap family friendly restaurant English food in the city centre near Café Rouge and has a customer rating of 5 out of 5.
name[The Cricketers], eatType[restaurant], food[English], priceRange[cheap], customer rating[5 out of 5], area[riverside], familyFriendly[no], near[Café Rouge]	The Cricketers is a cheap English restaurant in riverside near Café Rouge, has a customer rating of 5 out of 5 and is not family friendly.
name[The Cricketers], eatType[restaurant], food[English], priceRange[cheap], customer rating[5 out of 5], area[riverside], familyFriendly[yes], near[Café Rouge]	The Cricketers is a cheap English restaurant in riverside near Café Rouge it is family friendly and has a customer rating of 5 out of 5.
name[The Cricketers], eatType[restaurant], food[English], priceRange[cheap], customer rating[average], area[city centre], familyFriendly[no], near[Café Rouge]	The Cricketers is a cheap English restaurant in the city centre near Café Rouge it has a average customer rating and is not family-friendly.
name[The Cricketers], eatType[restaurant], food[English], priceRange[cheap], customer rating[average], area[city centre], familyFriendly[yes], near[Café Rouge]	The Cricketers is a cheap English restaurant in the city centre near Café Rouge it is family friendly and has a customer rating of average.
name[The Cricketers], eatType[restaurant], food[English], priceRange[cheap], customer rating[average], area[riverside], familyFriendly[no], near[Café Rouge]	The Cricketers is a cheap English restaurant in riverside near Café Rouge it has an average customer rating and is not family-friendly.
name[The Cricketers], eatType[restaurant], food[English], priceRange[cheap], customer rating[average], area[riverside], familyFriendly[yes], near[Café Rouge]	The Cricketers is a cheap English restaurant in riverside near Café Rouge has an average customer rating and is family friendly.
name[The Cricketers], eatType[restaurant], food[English], priceRange[high], customer rating[1 out of 5], area[city centre], familyFriendly[no], near[Café Rouge]	The Cricketers is an English restaurant in the city centre near Café Rouge it has a high price range, a 1 out of 5 and is not child friendly.
name[The Cricketers], eatType[restaurant], food[English], priceRange[high], customer rating[1 out of 5], area[city centre], familyFriendly[yes], near[Café Rouge]	The Cricketers is an English restaurant in the city centre near Café Rouge it has a high price range it is child friendly and has a customer rating of 1 out of 5.
name[The Cricketers], eatType[restaurant], food[English], priceRange[high], customer rating[1 out of 5], area[riverside], familyFriendly[no], near[Café Rouge]	The Cricketers is an English restaurant in the riverside near Café Rouge with a high price range, a 1 out of 5 and is not children friendly.
name[The Cricketers], eatType[restaurant], food[English], priceRange[high], customer rating[1 out of 5], area[riverside], familyFriendly[yes], near[Café Rouge]	The Cricketers is an English restaurant in the riverside near Café Rouge it has a high price range it is children friendly and has a customer rating of 1 out of 5.
name[The Cricketers], eatType[restaurant], food[English], priceRange[high], customer rating[average], area[city centre], familyFriendly[no], near[Café Rouge]	The Cricketers is an English restaurant in the city centre near Café Rouge it has a high price range, a average customer rating and is not child friendly.
name[The Cricketers], eatType[restaurant], food[English], priceRange[high], customer rating[average], area[city centre], familyFriendly[yes], near[Café Rouge]	The Cricketers is an English restaurant in the city centre near Café Rouge it has a high price range, has an average customer rating and is child friendly.
name[The Cricketers], eatType[restaurant], food[English], priceRange[high], customer rating[average], area[riverside], familyFriendly[no], near[Café Rouge]	The Cricketers is an English restaurant in the riverside near Café Rouge it has a high price range, a average customer rating and is not child friendly.
name[The Mill], eatType[pub], food[English], priceRange[high], area[riverside], familyFriendly[yes], near[Raja Indian Cuisine]	The Mill is a high priced English pub located in riverside near Raja Indian Cuisine it is children friendly.
name[The Mill], eatType[pub], food[English], priceRange[less than £20], area[city centre], familyFriendly[no], near[Raja Indian Cuisine]	The Mill is an English pub located in the city centre near Raja Indian Cuisine with a price range less than £20 it is not family-friendly.
name[The Mill], eatType[pub], food[English], priceRange[less than £20], area[city centre], familyFriendly[yes], near[Raja Indian Cuisine]	The Mill is a family-friendly pub serving English food with a price range of less than £20 it is located in the city centre near Raja Indian Cuisine.
name[The Mill], eatType[pub], food[English], priceRange[less than £20], area[riverside], familyFriendly[no], near[Raja Indian Cuisine]	The Mill is a pub serving English food in the low price range it is located in the riverside near Raja Indian Cuisine it is not family-friendly.
name[The Mill], eatType[pub], food[English], priceRange[less than £20], area[riverside], familyFriendly[yes], near[Raja Indian Cuisine]	The Mill is a family friendly pub serving English food for less than £20 it is located in the riverside near Raja Indian Cuisine.
name[The Mill], eatType[pub], food[English], priceRange[moderate], area[city centre], familyFriendly[no], near[Raja Indian Cuisine]	The Mill is a moderately priced English pub located in the city centre near Raja Indian Cuisine it is not kid friendly.
name[The Mill], eatType[pub], food[English], priceRange[moderate], area[city centre], familyFriendly[yes], near[Raja Indian Cuisine]	The Mill is a moderately priced English pub located in the city centre near Raja Indian Cuisine it is kid friendly.
name[The Mill], eatType[pub], food[English], priceRange[moderate], area[riverside], familyFriendly[no], near[Raja Indian Cuisine]	The Mill is a moderately priced English pub located in riverside near Raja Indian Cuisine it is not kid friendly and.
name[The Mill], eatType[pub], food[English], priceRange[moderate], area[riverside], familyFriendly[yes], near[Raja Indian Cuisine]	The Mill is a moderately priced English pub located in the riverside near Raja Indian Cuisine it is kid friendly.
name[The Mill], eatType[pub], food[English], priceRange[more than £30], area[riverside], familyFriendly[yes], near[Raja Indian Cuisine]	The Mill is a high price range it is a children friendly pub located in riverside near Raja Indian Cuisine serves English food.
name[The Mill], eatType[pub], food[Fast food], priceRange[£20-25], area[riverside], familyFriendly[yes], near[Raja Indian Cuisine]	The Mill is a Fast food pub in the riverside near Raja Indian Cuisine with a price range of £20-25 and is family friendly.
name[The Mill], eatType[pub], food[Fast food], priceRange[£20-25], customer rating[high], area[city centre], familyFriendly[no], near[Café Rouge]	The Mill is a Fast food pub in the city centre near Café Rouge it has a price range of £20-25 and has a high customer rating is not kid friendly.
name[The Mill], eatType[pub], food[Fast food], priceRange[£20-25], customer rating[high], area[city centre], familyFriendly[yes], near[Café Rouge]	The Mill is a Fast food pub in the city centre near Café Rouge with a price range of £20-25 and has a high customer rating is kid friendly.
name[The Mill], eatType[pub], food[Fast food], priceRange[£20-25], customer rating[high], area[riverside], familyFriendly[no], near[Café Rouge]	The Mill is a Fast food pub located in the riverside near Café Rouge it has a high customer rating price range is £20-25 and is not kids friendly.
name[The Mill], eatType[pub], food[Fast food], priceRange[£20-25], customer rating[high], area[riverside], familyFriendly[yes], near[Café Rouge]	The Mill is a Fast food pub located in the riverside near Café Rouge with a high customer rating is kid friendly and has a price range of £20-25.
name[The Mill], eatType[pub], food[Fast food], priceRange[£20-25], customer rating[high], area[riverside], familyFriendly[yes], near[Café Sicilia]	The Mill is a Fast food pub located in the riverside near Café Sicilia with a high customer rating is kid friendly and has a price range of £20-25.
name[The Mill], eatType[pub], food[Fast food], priceRange[cheap], area[riverside], familyFriendly[yes], near[Raja Indian Cuisine]	The Mill is a cheap family friendly pub serving Fast food in riverside near Raja Indian Cuisine.
name[The Mill], eatType[pub], food[Fast food], priceRange[cheap], customer rating[5 out of 5], area[city centre], familyFriendly[no], near[Café Sicilia]	The Mill is a cheap Fast food pub located in the city centre near Café Sicilia, has a customer rating of 5 out of 5 and is not family-friendly.
name[The Mill], eatType[pub], food[Fast food], priceRange[cheap], customer rating[5 out of 5], area[city centre], familyFriendly[yes], near[Café Sicilia]	The Mill is a cheap family friendly pub serving Fast food in the city centre near Café Sicilia with a customer rating of 5 out of 5.
name[The Mill], eatType[pub], food[Fast food], priceRange[cheap], customer rating[5 out of 5], area[riverside], familyFriendly[no], near[Café Sicilia]	The Mill is a cheap Fast food pub located in riverside near Café Sicilia, has a customer rating of 5 out of 5 and is not family-friendly.
name[The Mill], eatType[pub], food[Fast food], priceRange[cheap], customer rating[5 out of 5], area[riverside], familyFriendly[yes], near[Café Sicilia]	The Mill is a cheap family friendly pub serving Fast food in riverside near Café Sicilia with a customer rating of 5 out of 5.
name[The Mill], eatType[pub], food[Fast food], priceRange[cheap], customer rating[average], area[city centre], familyFriendly[no], near[Café Sicilia]	The Mill is a cheap Fast food pub located in the city centre near Café Sicilia it has an average customer rating and is not family-friendly.
name[The Mill], eatType[pub], food[Fast food], priceRange[cheap], customer rating[average], area[city centre], familyFriendly[yes], near[Café Sicilia]	The Mill is a cheap Fast food pub located in the city centre near Café Sicilia with an average customer rating and is family friendly.
name[The Mill], eatType[pub], food[Fast food], priceRange[cheap], customer rating[average], area[riverside], familyFriendly[no], near[Café Sicilia]	The Mill is a cheap Fast food pub located in riverside near Café Sicilia it has an average customer rating and is not family-friendly.
name[The Mill], eatType[pub], food[Fast food], priceRange[cheap], customer rating[average], area[riverside], familyFriendly[yes], near[Café Sicilia]	The Mill is a cheap Fast food pub located in riverside near Café Sicilia has an average customer rating and is family friendly.
name[The Mill], eatType[pub], food[Fast food], priceRange[high], customer rating[1 out of 5], area[city centre], familyFriendly[no], near[Café Sicilia]	The Mill is a Fast food pub in the city centre near Café Sicilia it has a customer rating of 5, a 1 out of 5 and is not child friendly.
name[The Mill], eatType[pub], food[Fast food], priceRange[high], customer rating[1 out of 5], area[city centre], familyFriendly[yes], near[Café Sicilia]	The Mill is a Fast food pub in the city centre near Café Sicilia it has a customer rating of 5, has a 1 out of 5 and is child friendly.
name[The Mill], eatType[pub], food[Fast food], priceRange[high], customer rating[1 out of 5], area[riverside], familyFriendly[no], near[Café Sicilia]	The Mill is a Fast food pub in the riverside near Café Sicilia with a high price range, a 1 out of 5 and is not child friendly.
name[The Mill], eatType[pub], food[Fast food], priceRange[high], customer rating[1 out of 5], area[riverside], familyFriendly[yes], near[Café Sicilia]	The Mill is a Fast food pub in the riverside near Café Sicilia with a high price range, a 1 out of 5 and is child friendly.
name[The Mill], eatType[pub], food[Fast food], priceRange[high], customer rating[average], area[city centre], familyFriendly[no], near[Café Sicilia]	The Mill is a Fast food pub in the city centre near Café Sicilia it has a high price range, average customer rating and is not child friendly.
name[The Mill], eatType[pub], food[Fast food], priceRange[high], customer rating[average], area[city centre], familyFriendly[yes], near[Café Sicilia]	The Mill is a Fast food pub in the city centre near Café Sicilia it has a high price range, has an average customer rating and is child friendly.
name[The Mill], eatType[pub], food[Fast food], priceRange[high], customer rating[average], area[riverside], familyFriendly[no], near[Café Sicilia]	The Mill is a Fast food pub located in riverside near Café Sicilia it has an average customer rating the price range is high and is not child friendly.
name[The Mill], eatType[pub], food[Fast food], priceRange[high], customer rating[average], area[riverside], familyFriendly[yes], near[Café Sicilia]	The Mill is a Fast food pub located in riverside near Café Sicilia it has an average customer rating the price range is high and is child friendly.
name[The Mill], eatType[pub], food[Fast food], priceRange[less than £20], customer rating[low], area[city centre], familyFriendly[no], near[Café Sicilia]	The Mill is a Fast food pub in the city centre near Café Sicilia it has a price range less than £20 it has a low customer rating and is not family-friendly.
name[The Mill], eatType[pub], food[Fast food], priceRange[less than £20], customer rating[low], area[city centre], familyFriendly[yes], near[Café Sicilia]	The Mill is a family friendly pub serving Fast food with a price range of less than £20 it is located in the city centre near Café Sicilia with a low customer rating.
name[The Mill], eatType[pub], food[Fast food], priceRange[less than £20], customer rating[low], area[riverside], familyFriendly[no], near[Café Sicilia]	The Mill is a pub that serves Fast food it is located in the riverside area near Café Sicilia has a low customer rating the price range is less than £20 it is not family-friendly.
name[The Mill], eatType[pub], food[Fast food], priceRange[less than £20], customer rating[low], area[riverside], familyFriendly[yes], near[Café Sicilia]	The Mill is a family friendly pub serving Fast food with a price range of less than £20 it is located in the riverside near Café Sicilia has a low customer rating.
name[The Mill], eatType[pub], food[Fast food], priceRange[moderate], customer rating[1 out of 5], area[city centre], familyFriendly[no], near[Café Sicilia]	The Mill is a Fast food pub in the city centre near Café Sicilia it has a moderate price range, a customer rating of 1 out of 5 and is not kid friendly.
name[The Mill], eatType[pub], food[Fast food], priceRange[moderate], customer rating[1 out of 5], area[city centre], familyFriendly[yes], near[Café Sicilia]	The Mill is a Fast food pub in the city centre near Café Sicilia it has a moderate price range with a customer rating of 1 out of 5 and is kid friendly.
name[The Mill], eatType[pub], food[Fast food], priceRange[moderate], customer rating[1 out of 5], area[riverside], familyFriendly[no], near[Café Sicilia]	The Mill is a Fast food pub in the riverside area near Café Sicilia it has a moderate price range, a customer rating of 1 out of 5 and is not kid friendly.
name[The Mill], eatType[pub], food[Fast food], priceRange[moderate], customer rating[1 out of 5], area[riverside], familyFriendly[yes], near[Café Sicilia]	The Mill is a Fast food pub in the riverside area near Café Sicilia it has a moderate price range with a customer rating of 1 out of 5 and is kid friendly.
name[The Mill], eatType[pub], food[Fast food], priceRange[moderate], customer rating[3 out of 5], area[city centre], familyFriendly[no], near[Café Sicilia]	The Mill is a moderately priced Fast food pub located in the city centre near Café Sicilia it has a customer rating of 3 out of 5 and is not kid friendly.
name[The Mill], eatType[pub], food[Fast food], priceRange[moderate], customer rating[3 out of 5], area[city centre], familyFriendly[yes], near[Café Sicilia]	The Mill is a moderately priced Fast food pub located in the city centre near Café Sicilia it is kid friendly with a customer rating of 3 out of 5.
name[The Mill], eatType[pub], food[Fast food], priceRange[moderate], customer rating[3 out of 5], area[riverside], familyFriendly[no], near[Café Sicilia]	The Mill is a moderately priced Fast food pub located in the riverside near Café Sicilia it has a customer rating of 3 out of 5 and is not kid friendly.
name[The Mill], eatType[pub], food[Fast food], priceRange[moderate], customer rating[3 out of 5], area[riverside], familyFriendly[yes], near[Café Sicilia]	The Mill is a moderately priced Fast food pub located in riverside near Café Sicilia has a customer rating of 3 out of 5 and is kid friendly.
name[The Mill], eatType[restaurant], food[English], priceRange[high], area[riverside], familyFriendly[yes], near[Raja Indian Cuisine]	The Mill is an English restaurant in the riverside near Raja Indian Cuisine with a high price range and is child friendly.
name[The Mill], eatType[restaurant], food[English], priceRange[high], customer rating[average], area[riverside], familyFriendly[yes], near[Café Rouge]	The Mill is an English restaurant in the riverside near Café Rouge it has a high price range, has an average customer rating and is child friendly.
name[The Mill], eatType[restaurant], food[English], priceRange[less than £20], area[city centre], familyFriendly[no], near[Raja Indian Cuisine]	The Mill is an English restaurant in the city centre near Raja Indian Cuisine with a price range less than £20 it is not family-friendly.
name[The Mill], eatType[restaurant], food[English], priceRange[less than £20], area[city centre], familyFriendly[yes], near[Raja Indian Cuisine]	The Mill is a family-friendly restaurant serving English food it has a price range of less than £20 it is located in the city centre near Raja Indian Cuisine.
name[The Mill], eatType[restaurant], food[English], priceRange[less than £20], area[riverside], familyFriendly[no], near[Raja Indian Cuisine]	The Mill is an English restaurant in the riverside near Raja Indian Cuisine with a price range of less than £20 it is not family-friendly.
name[The Mill], eatType[restaurant], food[English], priceRange[less than £20], area[riverside], familyFriendly[yes], near[Raja Indian Cuisine]	The Mill is a family friendly restaurant serving English food for less than £20 it is located in the riverside near Raja Indian Cuisine.
name[The Mill], eatType[restaurant], food[English], priceRange[less than £20], customer rating[low], area[city centre], familyFriendly[no], near[Café Rouge]	The Mill is an English restaurant in the city centre near Café Rouge it has a price range less than £20 it has a low customer rating and is not family-friendly.
name[The Mill], eatType[restaurant], food[English], priceRange[less than £20], customer rating[low], area[city centre], familyFriendly[yes], near[Café Rouge]	The Mill is a family friendly restaurant serving English food it has a price range of less than £20 it is located in the city centre near Café Rouge with a low customer rating.
name[The Mill], eatType[restaurant], food[English], priceRange[less than £20], customer rating[low], area[riverside], familyFriendly[no], near[Café Rouge]	The Mill is an English restaurant in the riverside area near Café Rouge it has a price range of less than £20 it has a low customer rating and is not family-friendly.
name[The Mill], eatType[restaurant], food[English], priceRange[less than £20], customer rating[low], area[riverside], familyFriendly[yes], near[Café Rouge]	The Mill is a family friendly restaurant serving English food it has a price range of less than £20 it is located in the riverside near Café Rouge and has a low customer rating.
name[The Mill], eatType[restaurant], food[English], priceRange[moderate], area[city centre], familyFriendly[no], near[Raja Indian Cuisine]	The Mill is a moderately priced English restaurant near Raja Indian Cuisine in the city centre it is not kid friendly.
name[The Mill], eatType[restaurant], food[English], priceRange[moderate], area[city centre], familyFriendly[yes], near[Raja Indian Cuisine]	The Mill is a moderately priced English restaurant near Raja Indian Cuisine in the city centre is.
name[The Mill], eatType[restaurant], food[English], priceRange[moderate], area[riverside], familyFriendly[no], near[Raja Indian Cuisine]	The Mill is an English restaurant in the riverside near Raja Indian Cuisine it has a moderate price range it is not kid friendly and.
name[The Mill], eatType[restaurant], food[English], priceRange[moderate], area[riverside], familyFriendly[yes], near[Raja Indian Cuisine]	The Mill is a moderately priced English restaurant near Raja Indian Cuisine in riverside is kid friendly.
name[The Mill], eatType[restaurant], food[English], priceRange[moderate], customer rating[1 out of 5], area[city centre], familyFriendly[no], near[Café Rouge]	The Mill is an English restaurant in the city centre near Café Rouge it has a moderate price range it is not kid friendly and has a customer rating of 1 out of 5.
name[The Mill], eatType[restaurant], food[English], priceRange[moderate], customer rating[1 out of 5], area[city centre], familyFriendly[yes], near[Café Rouge]	The Mill is an English restaurant in the city centre near Café Rouge it has a moderate price range it is kid friendly and has a customer rating of 1 out of 5.
name[The Mill], eatType[restaurant], food[English], priceRange[moderate], customer rating[1 out of 5], area[riverside], familyFriendly[no], near[Café Rouge]	The Mill is an English restaurant in the riverside near Café Rouge it has a moderate price range it is not kid friendly and has a customer rating of 1 out of 5.
name[The Mill], eatType[restaurant], food[English], priceRange[moderate], customer rating[1 out of 5], area[riverside], familyFriendly[yes], near[Café Rouge]	The Mill is an English restaurant in the riverside area near Café Rouge it has a moderate price range it is kid friendly and has a customer rating of 1 out of 5.
name[The Mill], eatType[restaurant], food[English], priceRange[moderate], customer rating[3 out of 5], area[city centre], familyFriendly[no], near[Café Rouge]	The Mill is a moderately priced English restaurant in the city centre near Café Rouge it is not kid friendly and has a customer rating of 3 out of 5.
name[The Mill], eatType[restaurant], food[English], priceRange[moderate], customer rating[3 out of 5], area[city centre], familyFriendly[yes], near[Café Rouge]	The Mill is a moderately priced English restaurant in the city centre near Café Rouge it is kid friendly and has a customer rating of 3 out of 5.
name[The Mill], eatType[restaurant], food[English], priceRange[moderate], customer rating[3 out of 5], area[riverside], familyFriendly[no], near[Café Rouge]	The Mill is an English restaurant in the riverside near Café Rouge it has a moderate price range it is not kids friendly and has a customer rating of 3 out of 5.
name[The Mill], eatType[restaurant], food[English], priceRange[moderate], customer rating[3 out of 5], area[riverside], familyFriendly[yes], near[Café Rouge]	The Mill is a moderately priced English restaurant in the riverside near Café Rouge it is kid friendly and has a customer rating of 3 out of 5.
name[The Mill], eatType[restaurant], food[English], priceRange[more than £30], area[riverside], familyFriendly[yes], near[Raja Indian Cuisine]	The Mill is an English restaurant in the riverside near Raja Indian Cuisine it has a price range and is child friendly.
name[The Mill], eatType[restaurant], food[English], priceRange[more than £30], customer rating[high], area[city centre], familyFriendly[no], near[Café Rouge]	The Mill is an English restaurant in the city centre near Café Rouge it has a price range of more than £30 and a high customer rating it is not child friendly.
name[The Mill], eatType[restaurant], food[English], priceRange[more than £30], customer rating[high], area[city centre], familyFriendly[yes], near[Café Rouge]	The Mill is an English restaurant in the city centre near Café Rouge it has a price range of more than £30 and has a high customer rating is child friendly.
name[The Mill], eatType[restaurant], food[English], priceRange[more than £30], customer rating[high], area[riverside], familyFriendly[no], near[Café Rouge]	The Mill is an English restaurant in the riverside area near Café Rouge it has a price range of more than £30 and a high customer rating it is not children friendly.
name[The Mill], eatType[restaurant], food[English], priceRange[more than £30], customer rating[high], area[riverside], familyFriendly[yes], near[Café Rouge]	The Mill is an English restaurant in the riverside area near Café Rouge it has a price range of more than £30 and a high customer rating is child friendly.
name[The Mill], eatType[restaurant], food[Fast food], priceRange[£20-25], area[riverside], familyFriendly[yes], near[Raja Indian Cuisine]	The Mill is a Fast food restaurant in the riverside near Raja Indian Cuisine with a price range of £20-25 and is family friendly.
name[The Mill], eatType[restaurant], food[Fast food], priceRange[cheap], area[riverside], familyFriendly[yes], near[Raja Indian Cuisine]	The Mill is a cheap family friendly restaurant Fast food in riverside near Raja Indian Cuisine.
name[The Phoenix], eatType[pub], food[Fast food], priceRange[cheap], area[riverside], familyFriendly[yes], near[Raja Indian Cuisine]	The Phoenix is a cheap family friendly pub serving Fast food in riverside near Raja Indian Cuisine.
name[The Phoenix], eatType[pub], food[Fast food], priceRange[high], area[city centre], familyFriendly[no], near[Raja Indian Cuisine]	The Phoenix is a Fast food pub in the city centre near Raja Indian Cuisine it has a high price range and is not child friendly.
name[The Phoenix], eatType[pub], food[Fast food], priceRange[high], area[city centre], familyFriendly[yes], near[Raja Indian Cuisine]	The Phoenix is a high priced Fast food pub located in the city centre near Raja Indian Cuisine it is family friendly.
name[The Phoenix], eatType[pub], food[Fast food], priceRange[high], area[riverside], familyFriendly[no], near[Raja Indian Cuisine]	The Phoenix is a Fast food pub in the riverside near Raja Indian Cuisine with a high price range it is not children friendly and.
name[The Phoenix], eatType[pub], food[Fast food], priceRange[high], area[riverside], familyFriendly[yes], near[Raja Indian Cuisine]	The Phoenix is a Fast food pub in the riverside near Raja Indian Cuisine with a high price range and is child friendly.
name[The Phoenix], eatType[pub], food[Fast food], priceRange[less than £20], area[city centre], familyFriendly[no], near[Raja Indian Cuisine]	The Phoenix is a Fast food pub in the city centre near Raja Indian Cuisine with a price range less than £20 it is not family-friendly.
name[The Phoenix], eatType[pub], food[Fast food], priceRange[less than £20], area[city centre], familyFriendly[yes], near[Raja Indian Cuisine]	The Phoenix is a family friendly pub serving Fast food with a price range of less than £20 it is located in the city centre near Raja Indian Cuisine.
name[The Phoenix], eatType[pub], food[Fast food], priceRange[less than £20], area[riverside], familyFriendly[no], near[Raja Indian Cuisine]	The Phoenix is a Fast food pub in the riverside near Raja Indian Cuisine with a price range less than £20 it is not family-friendly.
name[The Phoenix], eatType[pub], food[Fast food], priceRange[less than £20], area[riverside], familyFriendly[yes], near[Raja Indian Cuisine]	The Phoenix is a family friendly pub serving Fast food for less than £20 it is located in the riverside near Raja Indian Cuisine.
name[The Phoenix], eatType[pub], food[Fast food], priceRange[moderate], area[city centre], familyFriendly[no], near[Raja Indian Cuisine]	The Phoenix is a moderately priced Fast food pub located in the city centre near Raja Indian Cuisine it is not kid friendly.
name[The Phoenix], eatType[pub], food[Fast food], priceRange[moderate], area[city centre], familyFriendly[yes], near[Raja Indian Cuisine]	The Phoenix is a moderately priced Fast food pub located in the city centre near Raja Indian Cuisine it is kid friendly.
name[The Phoenix], eatType[pub], food[Fast food], priceRange[moderate], area[riverside], familyFriendly[no], near[Raja Indian Cuisine]	The Phoenix is a moderately priced Fast food pub located in riverside near Raja Indian Cuisine it is not kid friendly.
name[The Phoenix], eatType[pub], food[Fast food], priceRange[moderate], area[riverside], familyFriendly[yes], near[Raja Indian Cuisine]	The Phoenix is a moderately priced Fast food pub located in riverside near Raja Indian Cuisine it is kid friendly.
name[The Phoenix], eatType[pub], food[Fast food], priceRange[moderate], customer rating[3 out of 5], area[riverside], familyFriendly[yes], near[Café Sicilia]	The Phoenix is a moderately priced Fast food pub located in riverside near Café Sicilia has a customer rating of 3 out of 5 and is kid friendly.
name[The Phoenix], eatType[pub], food[Fast food], priceRange[more than £30], area[riverside], familyFriendly[yes], near[Raja Indian Cuisine]	The Phoenix is a family friendly pub serving Fast food in riverside near Raja Indian Cuisine with a price range of more than £30.
name[The Phoenix], eatType[pub], food[Fast food], priceRange[more than £30], customer rating[high], area[city centre], familyFriendly[no], near[Café Sicilia]	The Phoenix is a Fast food pub in the city centre near Café Sicilia it has a price range of more than £30 and a high customer rating it is not child friendly.
name[The Phoenix], eatType[pub], food[Fast food], priceRange[more than £30], customer rating[high], area[city centre], familyFriendly[yes], near[Café Sicilia]	The Phoenix is a Fast food pub in the city centre near Café Sicilia it has a price range of more than £30 and has a high customer rating it is child friendly.
name[The Phoenix], eatType[pub], food[Fast food], priceRange[more than £30], customer rating[high], area[riverside], familyFriendly[no], near[Café Sicilia]	The Phoenix is a Fast food pub located in the riverside near Café Sicilia has a high customer rating price range it is not children friendly.
name[The Phoenix], eatType[pub], food[Fast food], priceRange[more than £30], customer rating[high], area[riverside], familyFriendly[yes], near[Café Sicilia]	The Phoenix is a Fast food pub located in the riverside near Café Sicilia with a high customer rating it is child friendly the price range is more than £30.
name[The Phoenix], eatType[pub], food[French], priceRange[£20-25], area[riverside], familyFriendly[yes], near[Raja Indian Cuisine]	The Phoenix is a moderately priced French pub located in the riverside near Raja Indian Cuisine it is family friendly.
name[The Phoenix], eatType[pub], food[French], priceRange[£20-25], customer rating[3 out of 5], area[city centre], familyFriendly[no], near[Café Sicilia]	The Phoenix is a French pub located in the city centre near Café Sicilia with a price range of £20-25, has a customer rating of 3 out of 5 and is not kid friendly.
name[The Phoenix], eatType[pub], food[French], priceRange[£20-25], customer rating[3 out of 5], area[city centre], familyFriendly[yes], near[Café Sicilia]	The Phoenix is a moderately priced French pub located in the city centre near Café Sicilia it is kid friendly and has a customer rating of 3 out of 5.
name[The Phoenix], eatType[pub], food[French], priceRange[£20-25], customer rating[3 out of 5], area[riverside], familyFriendly[no], near[Café Sicilia]	The Phoenix is a French pub in the riverside near Café Sicilia with a price range of £20-25, has a customer rating of 3 out of 5 and is not kid friendly.
name[The Phoenix], eatType[pub], food[French], priceRange[£20-25], customer rating[3 out of 5], area[riverside], familyFriendly[yes], near[Café Sicilia]	The Phoenix is a moderately priced French pub located in the riverside near Café Sicilia has a customer rating of 3 out of 5 and is kid friendly.
name[The Phoenix], eatType[pub], food[French], priceRange[£20-25], customer rating[3 out of 5], area[riverside], familyFriendly[yes], near[Crowne Plaza Hotel]	The Phoenix is a moderately priced French pub located in the riverside near Crowne Plaza Hotel has a customer rating of 3 out of 5 and is kid friendly.
name[The Phoenix], eatType[pub], food[French], priceRange[£20-25], customer rating[high], area[city centre], familyFriendly[no], near[Crowne Plaza Hotel]	The Phoenix is a French pub in the city centre near Crowne Plaza Hotel it has a price range of £20-25 and has a high customer rating is not kid friendly.
name[The Phoenix], eatType[pub], food[French], priceRange[£20-25], customer rating[high], area[city centre], familyFriendly[yes], near[Crowne Plaza Hotel]	The Phoenix is a French pub in the city centre near Crowne Plaza Hotel with a price range of 20-25 and has a high customer rating is kid friendly.
name[The Phoenix], eatType[pub], food[French], priceRange[£20-25], customer rating[high], area[riverside], familyFriendly[no], near[Crowne Plaza Hotel]	The Phoenix is a French pub located in the riverside near Crowne Plaza Hotel has a high customer rating price range is £20-25 and is not kids friendly.
name[The Phoenix], eatType[pub], food[French], priceRange[£20-25], customer rating[high], area[riverside], familyFriendly[yes], near[Crowne Plaza Hotel]	The Phoenix is a French pub in the riverside near Crowne Plaza Hotel with a price range of £20-25 and has a high customer rating is kid friendly.
name[The Phoenix], eatType[pub], food[French], priceRange[cheap], area[riverside], familyFriendly[yes], near[Raja Indian Cuisine]	The Phoenix is a cheap family friendly pub serving French food in riverside near Raja Indian Cuisine.
name[The Phoenix], eatType[pub], food[French], priceRange[cheap], customer rating[5 out of 5], area[city centre], familyFriendly[no], near[Crowne Plaza Hotel]	The Phoenix is a cheap French pub located in the city centre near Crowne Plaza Hotel has a customer rating of 5 out of 5 and is not family-friendly.
name[The Phoenix], eatType[pub], food[French], priceRange[cheap], customer rating[5 out of 5], area[city centre], familyFriendly[yes], near[Crowne Plaza Hotel]	The Phoenix is a cheap family friendly pub serving French food located in the city centre near Crowne Plaza Hotel with a customer rating of 5 out of 5.
name[The Phoenix], eatType[pub], food[French], priceRange[cheap], customer rating[5 out of 5], area[riverside], familyFriendly[no], near[Crowne Plaza Hotel]	The Phoenix is a cheap French pub located in riverside near Crowne Plaza Hotel has a customer rating of 5 out of 5 and is not family-friendly.
name[The Phoenix], eatType[pub], food[French], priceRange[cheap], customer rating[5 out of 5], area[riverside], familyFriendly[yes], near[Crowne Plaza Hotel]	The Phoenix is a cheap family friendly pub serving French food in the riverside near Crowne Plaza Hotel and has a customer rating of 5 out of 5.
name[The Phoenix], eatType[pub], food[French], priceRange[high], area[riverside], familyFriendly[yes], near[Raja Indian Cuisine]	The Phoenix is a high priced French pub located in riverside near Raja Indian Cuisine it is children friendly.
name[The Phoenix], eatType[pub], food[French], priceRange[high], customer rating[3 out of 5], area[city centre], familyFriendly[no], near[Crowne Plaza Hotel]	The Phoenix is a high priced French pub located in the city centre near Crowne Plaza Hotel it has a customer rating of 3 out of 5 and is not child friendly.
name[The Phoenix], eatType[pub], food[French], priceRange[high], customer rating[3 out of 5], area[city centre], familyFriendly[yes], near[Crowne Plaza Hotel]	The Phoenix is a high priced French pub located in the city centre near Crowne Plaza Hotel it is a child friendly and has a customer rating of 3 out of 5.
name[The Phoenix], eatType[pub], food[French], priceRange[high], customer rating[3 out of 5], area[riverside], familyFriendly[no], near[Crowne Plaza Hotel]	The Phoenix is a French pub in the riverside near Crowne Plaza Hotel with a high price range, a customer rating of 3 out of 5 and is not child friendly.
name[The Phoenix], eatType[pub], food[French], priceRange[high], customer rating[3 out of 5], area[riverside], familyFriendly[yes], near[Crowne Plaza Hotel]	The Phoenix is a high priced French pub located in the riverside near Crowne Plaza Hotel it is children friendly and has a customer rating of 3 out of 5.
name[The Phoenix], eatType[pub], food[French], priceRange[less than £20], customer rating[average], area[city centre], familyFriendly[no], near[Crowne Plaza Hotel]	The Phoenix is a French pub in the city centre near Crowne Plaza Hotel it has a price range less than £20, has an average customer rating and is not family-friendly.
name[The Phoenix], eatType[pub], food[French], priceRange[less than £20], customer rating[average], area[city centre], familyFriendly[yes], near[Crowne Plaza Hotel]	The Phoenix is a family-friendly pub serving French food with a price range less than £20 it is located in the city centre near Crowne Plaza Hotel has an average customer rating.
name[The Phoenix], eatType[pub], food[French], priceRange[less than £20], customer rating[average], area[riverside], familyFriendly[no], near[Crowne Plaza Hotel]	The Phoenix is a French pub in the riverside near Crowne Plaza Hotel with a price range less than £20 it has an average customer rating and is not family-friendly.
name[The Phoenix], eatType[pub], food[French], priceRange[less than £20], customer rating[average], area[riverside], familyFriendly[yes], near[Crowne Plaza Hotel]	The Phoenix is a family friendly pub serving French food in the riverside near Crowne Plaza Hotel has an average customer rating.
name[The Phoenix], eatType[pub], food[French], priceRange[less than £20], customer rating[low], area[city centre], familyFriendly[no], near[Crowne Plaza Hotel]	The Phoenix is a French pub in the city centre near Crowne Plaza Hotel it has a price range less than £20, has a low customer rating and is not family-friendly.
name[The Phoenix], eatType[pub], food[French], priceRange[less than £20], customer rating[low], area[city centre], familyFriendly[yes], near[Crowne Plaza Hotel]	The Phoenix is a family-friendly pub serving French food in the price range is less than £20 it is located in the city centre near Crowne Plaza Hotel with a low customer rating.
name[The Phoenix], eatType[pub], food[French], priceRange[less than £20], customer rating[low], area[riverside], familyFriendly[no], near[Crowne Plaza Hotel]	The Phoenix is a pub serving French food in the price range is less than £20 it is located in the riverside near Crowne Plaza Hotel has a low customer rating and is not family-friendly.
name[The Phoenix], eatType[pub], food[French], priceRange[less than £20], customer rating[low], area[riverside], familyFriendly[yes], near[Crowne Plaza Hotel]	The Phoenix is a family friendly pub serving French food in the price range is less than £20 it is located in the riverside near Crowne Plaza Hotel has a low customer rating.
name[The Phoenix], eatType[pub], food[French], priceRange[moderate], customer rating[1 out of 5], area[city centre], familyFriendly[no], near[Crowne Plaza Hotel]	The Phoenix is a French pub in the city centre near Crowne Plaza Hotel it has a moderate price range, a customer rating of 1 out of 5 and is not kid friendly.
name[The Phoenix], eatType[pub], food[French], priceRange[moderate], customer rating[1 out of 5], area[city centre], familyFriendly[yes], near[Crowne Plaza Hotel]	The Phoenix is a moderately priced French pub located in the city centre near Crowne Plaza Hotel it is kid friendly with a customer rating of 1 out of 5.
name[The Phoenix], eatType[pub], food[French], priceRange[moderate], customer rating[1 out of 5], area[riverside], familyFriendly[no], near[Crowne Plaza Hotel]	The Phoenix is a French pub in the riverside area near Crowne Plaza Hotel it has a moderate price range, a customer rating of 1 out of 5 and is not kid friendly.
name[The Phoenix], eatType[pub], food[French], priceRange[moderate], customer rating[1 out of 5], area[riverside], familyFriendly[yes], near[Crowne Plaza Hotel]	The Phoenix is a moderately priced French pub located in the riverside near Crowne Plaza Hotel it is kid friendly has a customer rating of 1 out of 5.
name[The Phoenix], eatType[pub], food[French], priceRange[more than £30], customer rating[5 out of 5], area[city centre], familyFriendly[no], near[Crowne Plaza Hotel]	The Phoenix is a French pub in the city centre near Crowne Plaza Hotel it has a price range of more than £30, has a customer rating 5 out of 5 and is not child friendly.
name[The Phoenix], eatType[pub], food[French], priceRange[more than £30], customer rating[5 out of 5], area[city centre], familyFriendly[yes], near[Crowne Plaza Hotel]	The Phoenix is a French pub in the city centre near Crowne Plaza Hotel it has a price range of more than £30, has a customer rating 5 out of 5 and is child friendly.
name[The Phoenix], eatType[pub], food[French], priceRange[more than £30], customer rating[5 out of 5], area[riverside], familyFriendly[no], near[Crowne Plaza Hotel]	The Phoenix is a French pub in the riverside near Crowne Plaza Hotel it has a price range of more than £30, has a customer rating 5 out of 5 and is not child friendly.
name[The Phoenix], eatType[pub], food[French], priceRange[more than £30], customer rating[5 out of 5], area[riverside], familyFriendly[yes], near[Crowne Plaza Hotel]	The Phoenix is a French pub in the riverside near Crowne Plaza Hotel it has a price range of 5 customer rating and is child friendly.
name[The Phoenix], eatType[pub], food[French], priceRange[more than £30], customer rating[low], area[city centre], familyFriendly[no], near[Crowne Plaza Hotel]	The Phoenix is a French pub in the city centre near Crowne Plaza Hotel it has a price range of more than £30, has a low customer rating and is not family-friendly.
name[The Phoenix], eatType[pub], food[French], priceRange[more than £30], customer rating[low], area[city centre], familyFriendly[yes], near[Crowne Plaza Hotel]	The Phoenix is a French pub in the city centre near Crowne Plaza Hotel it has a price range of more than £30, has a low customer rating and is child friendly.
name[The Phoenix], eatType[pub], food[French], priceRange[more than £30], customer rating[low], area[riverside], familyFriendly[no], near[Crowne Plaza Hotel]	The Phoenix is a French pub in the riverside near Crowne Plaza Hotel it has a price range of more than £30, has a low customer rating and is not family-friendly.
name[The Phoenix], eatType[pub], food[French], priceRange[more than £30], customer rating[low], area[riverside], familyFriendly[yes], near[Crowne Plaza Hotel]	The Phoenix is a French pub in the riverside near Crowne Plaza Hotel it has a price range of more than £30, has a low customer rating and is child friendly.
name[The Phoenix], eatType[restaurant], food[Fast food], priceRange[cheap], area[riverside], familyFriendly[yes], near[Raja Indian Cuisine]	The Phoenix is a cheap family friendly restaurant Fast food in riverside near Raja Indian Cuisine.
name[The Phoenix], eatType[restaurant], food[Fast food], priceRange[high], area[city centre], familyFriendly[no], near[Raja Indian Cuisine]	The Phoenix is a Fast food restaurant in the city centre near Raja Indian Cuisine it has a high price range and is not child friendly.
name[The Phoenix], eatType[restaurant], food[Fast food], priceRange[high], area[city centre], familyFriendly[yes], near[Raja Indian Cuisine]	The Phoenix is a Fast food restaurant in the city centre near Raja Indian Cuisine has a high price range and is child friendly.
name[The Phoenix], eatType[restaurant], food[Fast food], priceRange[high], area[riverside], familyFriendly[no], near[Raja Indian Cuisine]	The Phoenix is a Fast food restaurant in the riverside near Raja Indian Cuisine it has a high price range and is not child friendly.
name[The Phoenix], eatType[restaurant], food[Fast food], priceRange[high], area[riverside], familyFriendly[yes], near[Raja Indian Cuisine]	The Phoenix is a Fast food restaurant in the riverside near Raja Indian Cuisine has a high price range and is child friendly.
name[The Phoenix], eatType[restaurant], food[Fast food], priceRange[less than £20], area[city centre], familyFriendly[no], near[Raja Indian Cuisine]	The Phoenix is a Fast food restaurant in the city centre near Raja Indian Cuisine with a price range less than £20 it is not family-friendly.
name[The Phoenix], eatType[restaurant], food[Fast food], priceRange[less than £20], area[city centre], familyFriendly[yes], near[Raja Indian Cuisine]	The Phoenix is a family-friendly restaurant Fast food for less than £20 it is located in the city centre near Raja Indian Cuisine.
name[The Phoenix], eatType[restaurant], food[Fast food], priceRange[less than £20], area[riverside], familyFriendly[no], near[Raja Indian Cuisine]	The Phoenix is a Fast food coffee shop in the riverside near Raja Indian Cuisine with a price range of less than £20 it is not family-friendly.
name[The Phoenix], eatType[restaurant], food[Fast food], priceRange[less than £20], area[riverside], familyFriendly[yes], near[Raja Indian Cuisine]	The Phoenix is a family friendly restaurant Fast food for less than £20 it is located in the riverside near Raja Indian Cuisine.
name[The Phoenix], eatType[restaurant], food[Fast food], priceRange[moderate], area[city centre], familyFriendly[no], near[Raja Indian Cuisine]	The Phoenix is a Fast food restaurant in the city centre near Raja Indian Cuisine it has a moderate price range it is not kids friendly.
name[The Phoenix], eatType[restaurant], food[Fast food], priceRange[moderate], area[city centre], familyFriendly[yes], near[Raja Indian Cuisine]	The Phoenix is a moderately priced Fast food restaurant in the city centre near Raja Indian Cuisine it is kid friendly.
name[The Phoenix], eatType[restaurant], food[Fast food], priceRange[moderate], area[riverside], familyFriendly[no], near[Raja Indian Cuisine]	The Phoenix is a Fast food coffee shop in the riverside near Raja Indian Cuisine with a moderate price range it is not kids friendly.
name[The Phoenix], eatType[restaurant], food[Fast food], priceRange[moderate], area[riverside], familyFriendly[yes], near[Raja Indian Cuisine]	The Phoenix is a moderately priced Fast food pub in riverside near Raja Indian Cuisine it is kid friendly.
name[The Phoenix], eatType[restaurant], food[Fast food], priceRange[more than £30], area[riverside], familyFriendly[yes], near[Raja Indian Cuisine]	The Phoenix is a Fast food restaurant in the riverside near Raja Indian Cuisine it has a price range and is child friendly.
name[The Phoenix], eatType[restaurant], food[French], priceRange[£20-25], area[riverside], familyFriendly[yes], near[Raja Indian Cuisine]	The Phoenix is a French restaurant in the riverside near Raja Indian Cuisine with a price range of £20-25 and is kid friendly.
name[The Phoenix], eatType[restaurant], food[French], priceRange[cheap], area[riverside], familyFriendly[yes], near[Raja Indian Cuisine]	The Phoenix is a cheap family friendly restaurant French food in riverside near Raja Indian Cuisine.
name[The Phoenix], eatType[restaurant], food[French], priceRange[high], area[riverside], familyFriendly[yes], near[Raja Indian Cuisine]	The Phoenix is a French restaurant in the riverside near Raja Indian Cuisine with a high price range and is child friendly.
name[The Phoenix], eatType[restaurant], food[Indian], priceRange[£20-25], customer rating[high], area[city centre], familyFriendly[no], near[Crowne Plaza Hotel]	The Phoenix is an Indian restaurant in the city centre near Crowne Plaza Hotel it has a price range of £20-25 and has a high customer rating is not kid friendly.
name[The Phoenix], eatType[restaurant], food[Indian], priceRange[£20-25], customer rating[high], area[city centre], familyFriendly[yes], near[Crowne Plaza Hotel]	The Phoenix is an Indian restaurant in the city centre near Crowne Plaza Hotel it has a price range of more than £30 and has a high customer rating is kid friendly.
name[The Phoenix], eatType[restaurant], food[Indian], priceRange[£20-25], customer rating[high], area[riverside], familyFriendly[no], near[Crowne Plaza Hotel]	The Phoenix is an Indian restaurant in the riverside near Crowne Plaza Hotel it has a high customer rating price range is £20-25 and is not kids friendly.
name[The Phoenix], eatType[restaurant], food[Indian], priceRange[£20-25], customer rating[high], area[riverside], familyFriendly[yes], near[Crowne Plaza Hotel]	The Phoenix is an Indian restaurant in the riverside near Crowne Plaza Hotel has a high customer rating is kid friendly the price range is £20-25.
name[The Phoenix], eatType[restaurant], food[Indian], priceRange[cheap], customer rating[5 out of 5], area[city centre], familyFriendly[no], near[Crowne Plaza Hotel]	The Phoenix is a cheap Indian restaurant located in the city centre near Crowne Plaza Hotel, has a customer rating of 5 out of 5 and is not family friendly.
name[The Phoenix], eatType[restaurant], food[Indian], priceRange[cheap], customer rating[5 out of 5], area[city centre], familyFriendly[yes], near[Crowne Plaza Hotel]	The Phoenix is a cheap Indian restaurant in the city centre near Crowne Plaza Hotel it is family friendly and has a customer rating of 5 out of 5.
name[The Phoenix], eatType[restaurant], food[Indian], priceRange[cheap], customer rating[5 out of 5], area[riverside], familyFriendly[no], near[Crowne Plaza Hotel]	The Phoenix is an Indian food in the cheap price range restaurant located in riverside near Crowne Plaza Hotel, has a customer rating of 5 out of 5 and is not family friendly.
name[The Phoenix], eatType[restaurant], food[Indian], priceRange[cheap], customer rating[5 out of 5], area[riverside], familyFriendly[no], near[Express by Holiday Inn]	The Phoenix is an Indian food in the cheap price range restaurant located in riverside near Express by Holiday Inn, has a customer rating of 5 out of 5 and is not family friendly.
name[The Phoenix], eatType[restaurant], food[Indian], priceRange[cheap], customer rating[5 out of 5], area[riverside], familyFriendly[yes], near[Express by Holiday Inn]	The Phoenix is a cheap Indian restaurant in riverside near Express by Holiday Inn has a customer rating of 5 out of 5 and is family friendly.
name[The Phoenix], eatType[restaurant], food[Indian], priceRange[cheap], customer rating[average], area[city centre], familyFriendly[no], near[Express by Holiday Inn]	The Phoenix is an Indian food in the cheap price range restaurant located in the city centre near Express by Holiday Inn it has a customer rating and is not family friendly.
name[The Plough], eatType[pub], food[Chinese], priceRange[£20-25], area[riverside], familyFriendly[yes], near[Raja Indian Cuisine]	The Plough is a Chinese pub in the riverside near Raja Indian Cuisine with a price range of £20-25 and is kid friendly.
name[The Plough], eatType[pub], food[Chinese], priceRange[cheap], area[riverside], familyFriendly[yes], near[Raja Indian Cuisine]	The Plough is a cheap family friendly pub serving Chinese food in riverside near Raja Indian Cuisine.
name[The Plough], eatType[pub], food[Chinese], priceRange[high], area[city centre], familyFriendly[no], near[Raja Indian Cuisine]	The Plough is a Chinese pub in the city centre near Raja Indian Cuisine it has a high price range and is not child friendly.
name[The Plough], eatType[pub], food[Chinese], priceRange[high], area[city centre], familyFriendly[yes], near[Raja Indian Cuisine]	The Plough is a high priced Chinese pub in the city centre near Raja Indian Cuisine it is family friendly.
name[The Plough], eatType[pub], food[Chinese], priceRange[high], area[riverside], familyFriendly[no], near[Raja Indian Cuisine]	The Plough is a Chinese pub in the riverside near Raja Indian Cuisine with a high price range it is not child friendly.
name[The Plough], eatType[pub], food[Chinese], priceRange[high], area[riverside], familyFriendly[yes], near[Raja Indian Cuisine]	The Plough is a high priced Chinese pub in riverside near Raja Indian Cuisine it is children friendly.
name[The Plough], eatType[pub], food[Chinese], priceRange[less than £20], area[city centre], familyFriendly[no], near[Raja Indian Cuisine]	The Plough is a Chinese pub with a price range of less than £20 it is located in the city centre near Raja Indian Cuisine it is not family friendly.
name[The Plough], eatType[restaurant], food[Chinese], priceRange[£20-25], area[riverside], familyFriendly[yes], near[Raja Indian Cuisine]	The Plough is a Chinese restaurant in the riverside near Raja Indian Cuisine with a price range of £20-25 and is family friendly.
name[The Plough], eatType[restaurant], food[Chinese], priceRange[cheap], area[riverside], familyFriendly[yes], near[Raja Indian Cuisine]	The Plough is a cheap Chinese restaurant in riverside near Raja Indian Cuisine it is family friendly.
name[The Plough], eatType[restaurant], food[Chinese], priceRange[high], area[city centre], familyFriendly[no], near[Raja Indian Cuisine]	The Plough is a Chinese restaurant in the city centre near Raja Indian Cuisine it has a high price range and is not child friendly.
name[The Plough], eatType[restaurant], food[Chinese], priceRange[high], area[city centre], familyFriendly[yes], near[Raja Indian Cuisine]	The Plough is a Chinese restaurant in the city centre near Raja Indian Cuisine has a high price range and is child friendly.
name[The Plough], eatType[restaurant], food[Chinese], priceRange[high], area[riverside], familyFriendly[no], near[Raja Indian Cuisine]	The Plough is a Chinese restaurant in riverside near Raja Indian Cuisine the price range is high and is not child friendly.
name[The Plough], eatType[restaurant], food[Chinese], priceRange[high], area[riverside], familyFriendly[yes], near[Raja Indian Cuisine]	The Plough is a Chinese restaurant in riverside near Raja Indian Cuisine the price range is high and is child friendly.
name[The Plough], eatType[restaurant], food[Chinese], priceRange[less than £20], area[city centre], familyFriendly[no], near[Raja Indian Cuisine]	The Plough is a Chinese restaurant with a price range of less than £20 it is located in the city centre near Raja Indian Cuisine it is not family friendly.
name[The Punter], eatType[pub], food[Chinese], priceRange[less than £20], area[city centre], familyFriendly[yes], near[Raja Indian Cuisine]	The Punter is a family friendly pub serving Chinese food for less than £20 it is located in the city centre near Raja Indian Cuisine.
name[The Punter], eatType[pub], food[Chinese], priceRange[less than £20], area[riverside], familyFriendly[no], near[Raja Indian Cuisine]	The Punter is a Chinese pub in the riverside near Raja Indian Cuisine with a price range less than £20 it is not family friendly.
name[The Punter], eatType[pub], food[Chinese], priceRange[less than £20], area[riverside], familyFriendly[yes], near[Raja Indian Cuisine]	The Punter is a family friendly pub serving Chinese food for less than £20 it is located in the riverside near Raja Indian Cuisine.
name[The Punter], eatType[pub], food[Chinese], priceRange[moderate], area[city centre], familyFriendly[no], near[Raja Indian Cuisine]	The Punter is a moderately priced Chinese pub located in the city centre near Raja Indian Cuisine it is not kid friendly.
name[The Punter], eatType[pub], food[Chinese], priceRange[moderate], area[city centre], familyFriendly[yes], near[Raja Indian Cuisine]	The Punter is a moderately priced Chinese pub in the city centre near Raja Indian Cuisine it is kid friendly.
name[The Punter], eatType[pub], food[Chinese], priceRange[moderate], area[riverside], familyFriendly[no], near[Raja Indian Cuisine]	The Punter is a moderately priced Chinese pub located in riverside near Raja Indian Cuisine it is not kid friendly.
name[The Punter], eatType[pub], food[Chinese], priceRange[moderate], area[riverside], familyFriendly[yes], near[Raja Indian Cuisine]	The Punter is a moderately priced Chinese pub in the riverside near Raja Indian Cuisine it is kid friendly.
name[The Punter], eatType[pub], food[Chinese], priceRange[more than £30], area[riverside], familyFriendly[yes], near[Raja Indian Cuisine]	The Punter is a high price range it is a child friendly pub located in the riverside near Raja Indian Cuisine serves Chinese food.
name[The Punter], eatType[pub], food[English], priceRange[£20-25], area[riverside], familyFriendly[yes], near[Raja Indian Cuisine]	The Punter is an English pub in the riverside near Raja Indian Cuisine with a price range of £20-25 and is kid friendly.
name[The Punter], eatType[pub], food[English], priceRange[cheap], area[riverside], familyFriendly[yes], near[Raja Indian Cuisine]	The Punter is a cheap family friendly pub located in the riverside near Raja Indian Cuisine serves English food.
name[The Punter], eatType[pub], food[English], priceRange[high], area[city centre], familyFriendly[no], near[Raja Indian Cuisine]	The Punter is an English pub in the city centre near Raja Indian Cuisine it has a high price range and is not child friendly.
name[The Punter], eatType[pub], food[English], priceRange[high], area[city centre], familyFriendly[yes], near[Raja Indian Cuisine]	The Punter is a high priced English pub located in the city centre near Raja Indian Cuisine it is family friendly.
name[The Punter], eatType[pub], food[English], priceRange[high], area[riverside], familyFriendly[no], near[Raja Indian Cuisine]	The Punter is an English pub in the riverside near Raja Indian Cuisine with a high price range and is not child friendly.
name[The Punter], eatType[pub], food[English], priceRange[high], area[riverside], familyFriendly[yes], near[Raja Indian Cuisine]	The Punter is a high priced English pub located in riverside near Raja Indian Cuisine it is children friendly.
name[The Punter], eatType[pub], food[Italian], priceRange[high], customer rating[average], area[city centre], familyFriendly[no], near[Rainbow Vegetarian Café]	The Punter is an Italian pub located in the city centre near Rainbow Vegetarian Café it has a high price range, has a average customer rating and is not child friendly.
name[The Punter], eatType[restaurant], food[Chinese], priceRange[less than £20], area[city centre], familyFriendly[yes], near[Raja Indian Cuisine]	The Punter is a family friendly restaurant serving Chinese food for less than £20 it is located in the city centre near Raja Indian Cuisine.
name[The Punter], eatType[restaurant], food[Chinese], priceRange[less than £20], area[riverside], familyFriendly[no], near[Raja Indian Cuisine]	The Punter is a Chinese restaurant in the riverside near Raja Indian Cuisine with a price range of less than £20 it is not family friendly.
name[The Punter], eatType[restaurant], food[Chinese], priceRange[less than £20], area[riverside], familyFriendly[yes], near[Raja Indian Cuisine]	The Punter is a family friendly restaurant serving Chinese food for less than £20 it is located in the riverside near Raja Indian Cuisine.
name[The Punter], eatType[restaurant], food[Chinese], priceRange[moderate], area[city centre], familyFriendly[no], near[Raja Indian Cuisine]	The Punter is a moderately priced Chinese restaurant near Raja Indian Cuisine in the city centre it is not kid friendly.
name[The Punter], eatType[restaurant], food[Chinese], priceRange[moderate], area[city centre], familyFriendly[yes], near[Raja Indian Cuisine]	The Punter is a moderately priced Chinese restaurant in the city centre near Raja Indian Cuisine it is kid friendly.
name[The Punter], eatType[restaurant], food[Chinese], priceRange[moderate], area[riverside], familyFriendly[no], near[Raja Indian Cuisine]	The Punter is a Chinese restaurant with a moderate price range it is located in the riverside near Raja Indian Cuisine it is not kid friendly.
name[The Punter], eatType[restaurant], food[Chinese], priceRange[moderate], area[riverside], familyFriendly[yes], near[Raja Indian Cuisine]	The Punter is a moderately priced Chinese restaurant in riverside near Raja Indian Cuisine it is kid friendly.
name[The Punter], eatType[restaurant], food[Chinese], priceRange[more than £30], area[riverside], familyFriendly[yes], near[Raja Indian Cuisine]	The Punter is a Chinese restaurant in riverside near Raja Indian Cuisine the price range is more than £30 it is child friendly.
name[The Punter], eatType[restaurant], food[English], priceRange[£20-25], area[riverside], familyFriendly[yes], near[Raja Indian Cuisine]	The Punter is an English restaurant in the riverside near Raja Indian Cuisine with a price range of £20-25 and is kid friendly.
name[The Punter], eatType[restaurant], food[English], priceRange[cheap], area[riverside], familyFriendly[yes], near[Raja Indian Cuisine]	The Punter is a cheap family friendly restaurant in riverside near Raja Indian Cuisine serves English food.
name[The Punter], eatType[restaurant], food[English], priceRange[high], area[city centre], familyFriendly[no], near[Raja Indian Cuisine]	The Punter is an English restaurant in the city centre near Raja Indian Cuisine it has a high price range and is not child friendly.
name[The Punter], eatType[restaurant], food[English], priceRange[high], area[city centre], familyFriendly[yes], near[Raja Indian Cuisine]	The Punter is an English restaurant in the city centre near Raja Indian Cuisine it has a high price range and is child friendly.
name[The Punter], eatType[restaurant], food[English], priceRange[high], area[riverside], familyFriendly[no], near[Raja Indian Cuisine]	The Punter is an English restaurant in the riverside near Raja Indian Cuisine with a high price range and is not child friendly.
name[The Punter], eatType[restaurant], food[English], priceRange[high], area[riverside], familyFriendly[yes], near[Raja Indian Cuisine]	The Punter is an English restaurant in the riverside near Raja Indian Cuisine with a high price range and is child friendly.
name[The Punter], eatType[restaurant], food[Indian], priceRange[cheap], customer rating[average], area[city centre], familyFriendly[yes], near[Express by Holiday Inn]	The Punter is a cheap Indian restaurant in the city centre near Express by Holiday Inn has an average customer rating and is family friendly.
name[The Punter], eatType[restaurant], food[Indian], priceRange[cheap], customer rating[average], area[riverside], familyFriendly[no], near[Express by Holiday Inn]	The Punter is an Indian food in the cheap price range restaurant located in riverside near Express by Holiday Inn it has a customer rating and is not family friendly.
name[The Punter], eatType[restaurant], food[Indian], priceRange[cheap], customer rating[average], area[riverside], familyFriendly[yes], near[Express by Holiday Inn]	The Punter is a cheap Indian restaurant in riverside near Express by Holiday Inn has an average customer rating and is family friendly.
name[The Punter], eatType[restaurant], food[Indian], priceRange[high], customer rating[1 out of 5], area[city centre], familyFriendly[no], near[Express by Holiday Inn]	The Punter is an Indian restaurant in the city centre near Express by Holiday Inn it has a customer rating of 5, has a customer rating of 1 out of 5 and is not child friendly.
name[The Punter], eatType[restaurant], food[Indian], priceRange[high], customer rating[1 out of 5], area[city centre], familyFriendly[yes], near[Express by Holiday Inn]	The Punter is an Indian restaurant in the city centre near Express by Holiday Inn it has a high price range it is child friendly and has a customer rating of 1 out of 5.
name[The Punter], eatType[restaurant], food[Indian], priceRange[high], customer rating[1 out of 5], area[riverside], familyFriendly[no], near[Express by Holiday Inn]	The Punter is an Indian restaurant in the riverside near Express by Holiday Inn has a customer rating of 5, a high price range and is not children friendly.
name[The Punter], eatType[restaurant], food[Indian], priceRange[high], customer rating[1 out of 5], area[riverside], familyFriendly[yes], near[Express by Holiday Inn]	The Punter is an Indian restaurant in the riverside near Express by Holiday Inn it has a high price range, a 1 out of 5 and is child friendly.
name[The Punter], eatType[restaurant], food[Indian], priceRange[high], customer rating[average], area[city centre], familyFriendly[no], near[Express by Holiday Inn]	The Punter is an Indian restaurant in the city centre near Express by Holiday Inn it has a high price range, has a average customer rating and is not family-friendly.
name[The Punter], eatType[restaurant], food[Indian], priceRange[high], customer rating[average], area[city centre], familyFriendly[yes], near[Express by Holiday Inn]	The Punter is an Indian food in the high price range restaurant located in the city centre near Express by Holiday Inn it has a average customer rating and is child friendly.
name[The Punter], eatType[restaurant], food[Indian], priceRange[high], customer rating[average], area[riverside], familyFriendly[no], near[Express by Holiday Inn]	The Punter is an Indian restaurant in the riverside near Express by Holiday Inn it has a high price range, has a average customer rating and is not children friendly.
name[The Punter], eatType[restaurant], food[Indian], priceRange[high], customer rating[average], area[riverside], familyFriendly[yes], near[Express by Holiday Inn]	The Punter is an Indian restaurant in the riverside near Express by Holiday Inn it has a high price range, has an average customer rating and is child friendly.
name[The Punter], eatType[restaurant], food[Indian], priceRange[less than £20], customer rating[low], area[city centre], familyFriendly[no], near[Express by Holiday Inn]	The Punter is an Indian restaurant in the city centre near Express by Holiday Inn it has a price range less than £20 it has a low customer rating and is not family friendly.
name[The Punter], eatType[restaurant], food[Indian], priceRange[less than £20], customer rating[low], area[city centre], familyFriendly[yes], near[Express by Holiday Inn]	The Punter is a restaurant in the city centre near Express by Holiday Inn it has a price range less than £20 it has a low customer rating and is family friendly.
name[The Punter], eatType[restaurant], food[Indian], priceRange[less than £20], customer rating[low], area[riverside], familyFriendly[no], near[Express by Holiday Inn]	The Punter is an Indian restaurant in the riverside near Express by Holiday Inn it has a price range of less than £20 it has a low customer rating and is not family friendly.
name[The Punter], eatType[restaurant], food[Indian], priceRange[less than £20], customer rating[low], area[riverside], familyFriendly[yes], near[Express by Holiday Inn]	The Punter is a restaurant in the riverside area near Express by Holiday Inn it has a price range of less than £20 it has a low customer rating and is family friendly.
name[The Punter], eatType[restaurant], food[Indian], priceRange[moderate], customer rating[1 out of 5], area[city centre], familyFriendly[no], near[Express by Holiday Inn]	The Punter is an Indian restaurant in the city centre near Express by Holiday Inn it has a moderate price range, a customer rating of 1 out of 5 and is not kid friendly.
name[The Punter], eatType[restaurant], food[Indian], priceRange[moderate], customer rating[1 out of 5], area[city centre], familyFriendly[yes], near[Express by Holiday Inn]	The Punter is a moderate restaurant in the city centre near Express by Holiday Inn it is kid friendly and has a customer rating of 1 out of 5.
name[The Punter], eatType[restaurant], food[Indian], priceRange[moderate], customer rating[1 out of 5], area[riverside], familyFriendly[no], near[Express by Holiday Inn]	The Punter is an Indian restaurant in the riverside near Express by Holiday Inn it has a moderate price range, a customer rating of 1 out of 5 and is not kid friendly.
name[The Punter], eatType[restaurant], food[Indian], priceRange[moderate], customer rating[1 out of 5], area[riverside], familyFriendly[yes], near[Express by Holiday Inn]	The Punter is an Indian restaurant in the riverside near Express by Holiday Inn it has a moderate price range it is kid friendly and has a customer rating of 1 out of 5.
name[The Punter], eatType[restaurant], food[Indian], priceRange[moderate], customer rating[3 out of 5], area[city centre], familyFriendly[no], near[Express by Holiday Inn]	The Punter is an Indian food in the moderate price range restaurant located in the city centre near Express by Holiday Inn it has a customer rating of 3 out of 5 and is not kid friendly.
name[The Punter], eatType[restaurant], food[Indian], priceRange[moderate], customer rating[3 out of 5], area[city centre], familyFriendly[yes], near[Express by Holiday Inn]	The Punter is a moderately priced Indian restaurant in the city centre near Express by Holiday Inn it is kid friendly and has a customer rating of 3 out of 5.
name[The Punter], eatType[restaurant], food[Indian], priceRange[moderate], customer rating[3 out of 5], area[riverside], familyFriendly[no], near[Express by Holiday Inn]	The Punter is an Indian food in the moderate price range restaurant located in riverside near Express by Holiday Inn it has a customer rating of 3 out of 5 and is not kid friendly.
name[The Punter], eatType[restaurant], food[Indian], priceRange[moderate], customer rating[3 out of 5], area[riverside], familyFriendly[yes], near[Express by Holiday Inn]	The Punter is a moderately priced Indian restaurant in the riverside near Express by Holiday Inn it is kid friendly and has a customer rating of 3 out of 5.
name[The Punter], eatType[restaurant], food[Indian], priceRange[more than £30], customer rating[high], area[city centre], familyFriendly[no], near[Express by Holiday Inn]	The Punter is an Indian restaurant in the city centre near Express by Holiday Inn it has a price range of more than £30 and has a high customer rating it is not children friendly.
name[The Punter], eatType[restaurant], food[Indian], priceRange[more than £30], customer rating[high], area[city centre], familyFriendly[yes], near[Express by Holiday Inn]	The Punter is a restaurant in the city centre near Express by Holiday Inn it has a price range of more than £30 and has a high customer rating is child friendly.
name[The Punter], eatType[restaurant], food[Indian], priceRange[more than £30], customer rating[high], area[riverside], familyFriendly[no], near[Express by Holiday Inn]	The Punter is an Indian restaurant in the riverside near Express by Holiday Inn it has a price range of more than £30 and a high customer rating it is not children friendly.
name[The Punter], eatType[restaurant], food[Indian], priceRange[more than £30], customer rating[high], area[riverside], familyFriendly[yes], near[Express by Holiday Inn]	The Punter is a restaurant in the riverside near Express by Holiday Inn it has a price range of more than £30 and has a high customer rating is child friendly.
name[The Punter], eatType[restaurant], food[Italian], priceRange[£20-25], customer rating[high], area[city centre], familyFriendly[no], near[Express by Holiday Inn]	The Punter is an Italian restaurant in the city centre near Express by Holiday Inn it has a price range of £20-25 and has a high customer rating is not child friendly.
name[The Punter], eatType[restaurant], food[Italian], priceRange[£20-25], customer rating[high], area[city centre], familyFriendly[yes], near[Express by Holiday Inn]	The Punter is an Italian restaurant in the city centre near Express by Holiday Inn it has a price range and a high customer rating is child friendly.
name[The Punter], eatType[restaurant], food[Italian], priceRange[£20-25], customer rating[high], area[riverside], familyFriendly[no], near[Express by Holiday Inn]	The Punter is an Italian restaurant in the riverside near Express by Holiday Inn it has a high customer rating price range and is not kids friendly.
name[The Punter], eatType[restaurant], food[Italian], priceRange[£20-25], customer rating[high], area[riverside], familyFriendly[yes], near[Express by Holiday Inn]	The Punter is an Italian restaurant in the riverside near Express by Holiday Inn has a high customer rating is child friendly the price range is £20-25.
name[The Punter], eatType[restaurant], food[Italian], priceRange[cheap], customer rating[5 out of 5], area[city centre], familyFriendly[no], near[Express by Holiday Inn]	The Punter is a cheap Italian restaurant in the city centre near Express by Holiday Inn, has a customer rating of 5 out of 5 and is not family-friendly.
name[The Punter], eatType[restaurant], food[Italian], priceRange[cheap], customer rating[5 out of 5], area[city centre], familyFriendly[no], near[Rainbow Vegetarian Café]	The Punter is a cheap Italian restaurant in the city centre near Rainbow Vegetarian Café, has a customer rating of 5 out of 5 and is not family-friendly.
name[The Punter], eatType[restaurant], food[Italian], priceRange[cheap], customer rating[5 out of 5], area[city centre], familyFriendly[yes], near[Rainbow Vegetarian Café]	The Punter is a cheap family friendly restaurant Italian restaurant located in the city centre near Rainbow Vegetarian Café and has a customer rating of 5 out of 5.
name[The Punter], eatType[restaurant], food[Italian], priceRange[cheap], customer rating[5 out of 5], area[riverside], familyFriendly[no], near[Rainbow Vegetarian Café]	The Punter is a cheap Italian restaurant shop in riverside near Rainbow Vegetarian Café, has a customer rating of 5 out of 5 and is not family friendly.
name[The Punter], eatType[restaurant], food[Italian], priceRange[cheap], customer rating[5 out of 5], area[riverside], familyFriendly[yes], near[Rainbow Vegetarian Café]	The Punter is a cheap family friendly restaurant with a high customer rating Italian restaurant located in the riverside near Rainbow Vegetarian Café.
name[The Punter], eatType[restaurant], food[Italian], priceRange[cheap], customer rating[average], area[city centre], familyFriendly[no], near[Rainbow Vegetarian Café]	The Punter is a cheap Italian restaurant in the city centre near Rainbow Vegetarian Café it has a customer rating and is not family-friendly.
name[The Punter], eatType[restaurant], food[Italian], priceRange[cheap], customer rating[average], area[city centre], familyFriendly[yes], near[Rainbow Vegetarian Café]	The Punter is a cheap family friendly restaurant with an average customer rating Italian restaurant located in the city centre near Rainbow Vegetarian Café.
name[The Punter], eatType[restaurant], food[Italian], priceRange[cheap], customer rating[average], area[riverside], familyFriendly[no], near[Rainbow Vegetarian Café]	The Punter is a cheap Italian restaurant in riverside near Rainbow Vegetarian Café it has an average customer rating and is not family-friendly.
name[The Punter], eatType[restaurant], food[Italian], priceRange[cheap], customer rating[average], area[riverside], familyFriendly[yes], near[Rainbow Vegetarian Café]	The Punter is a cheap family friendly restaurant with an average customer rating Italian restaurant located in the riverside near Rainbow Vegetarian Café.
name[The Punter], eatType[restaurant], food[Italian], priceRange[high], customer rating[1 out of 5], area[city centre], familyFriendly[no], near[Rainbow Vegetarian Café]	The Punter is an Italian restaurant in the city centre near Rainbow Vegetarian Café it has a customer rating of 5, a high price range and is not child friendly.
name[The Punter], eatType[restaurant], food[Italian], priceRange[high], customer rating[1 out of 5], area[city centre], familyFriendly[yes], near[Rainbow Vegetarian Café]	The Punter is an Italian restaurant in the city centre near Rainbow Vegetarian Café it has a high price range it is child - friendly and has a customer rating of 1 out of 5.
name[The Punter], eatType[restaurant], food[Italian], priceRange[high], customer rating[1 out of 5], area[riverside], familyFriendly[no], near[Rainbow Vegetarian Café]	The Punter is an Italian coffee restaurant in the riverside near Rainbow Vegetarian Café with a high price range, a 1 out of 5 and is not child friendly.
name[The Punter], eatType[restaurant], food[Italian], priceRange[high], customer rating[1 out of 5], area[riverside], familyFriendly[yes], near[Rainbow Vegetarian Café]	The Punter is an Italian restaurant in the riverside near Rainbow Vegetarian Café it has a high price range, a 1 out of 5 and is child friendly.
name[The Vaults], eatType[pub], food[French], priceRange[high], area[riverside], familyFriendly[yes], near[Raja Indian Cuisine]	The Vaults is a high priced French pub located in riverside near Raja Indian Cuisine it is children friendly.
name[The Vaults], eatType[pub], food[French], priceRange[less than £20], area[city centre], familyFriendly[no], near[Raja Indian Cuisine]	The Vaults is a low priced French pub located in the city centre near Raja Indian Cuisine it is not family-friendly.
name[The Vaults], eatType[pub], food[French], priceRange[less than £20], area[city centre], familyFriendly[yes], near[Raja Indian Cuisine]	The Vaults is a family-friendly pub serving French food with a price range less than £20 it is located in the city centre near Raja Indian Cuisine.
name[The Vaults], eatType[pub], food[French], priceRange[less than £20], area[riverside], familyFriendly[no], near[Raja Indian Cuisine]	The Vaults is a low priced French pub located in riverside near Raja Indian Cuisine it is not family-friendly.
name[The Vaults], eatType[pub], food[French], priceRange[less than £20], area[riverside], familyFriendly[yes], near[Raja Indian Cuisine]	The Vaults is a family friendly pub serving French food with a price range less than £20 it is located in the riverside near Raja Indian Cuisine.
name[The Vaults], eatType[pub], food[French], priceRange[moderate], area[city centre], familyFriendly[no], near[Raja Indian Cuisine]	The Vaults is a moderately priced French pub located in the city centre near Raja Indian Cuisine it is not kid friendly.
name[The Vaults], eatType[pub], food[French], priceRange[moderate], area[city centre], familyFriendly[yes], near[Raja Indian Cuisine]	The Vaults is a moderately priced French pub located in the city centre near Raja Indian Cuisine it is kid friendly.
name[The Vaults], eatType[pub], food[French], priceRange[moderate], area[riverside], familyFriendly[no], near[Raja Indian Cuisine]	The Vaults is a moderately priced French pub located in the riverside near Raja Indian Cuisine it is not kid friendly.
name[The Vaults], eatType[pub], food[French], priceRange[moderate], area[riverside], familyFriendly[yes], near[Raja Indian Cuisine]	The Vaults is a moderately priced French pub located in the riverside near Raja Indian Cuisine it is kid friendly.
name[The Vaults], eatType[pub], food[French], priceRange[more than £30], area[city centre], familyFriendly[no], near[Raja Indian Cuisine]	The Vaults is a French pub in the city centre near Raja Indian Cuisine it has a price range of more than £30 it is not child friendly.
name[The Vaults], eatType[pub], food[French], priceRange[more than £30], area[city centre], familyFriendly[yes], near[Raja Indian Cuisine]	The Vaults is a high price range it is a child friendly pub located in the city centre near Raja Indian Cuisine serves French food.
name[The Vaults], eatType[pub], food[French], priceRange[more than £30], area[riverside], familyFriendly[no], near[Raja Indian Cuisine]	The Vaults is a French pub in the riverside near Raja Indian Cuisine it has a price range of more than £30 it is not child friendly.
name[The Vaults], eatType[pub], food[French], priceRange[more than £30], area[riverside], familyFriendly[yes], near[Raja Indian Cuisine]	The Vaults is a low priced family friendly pub located in the riverside near Raja Indian Cuisine serves French food.
name[The Vaults], eatType[pub], food[Indian], priceRange[£20-25], area[riverside], familyFriendly[yes], near[Raja Indian Cuisine]	The Vaults is an Indian pub in the riverside near Raja Indian Cuisine with a price range of £20-25 and is kid friendly.
name[The Vaults], eatType[pub], food[Indian], priceRange[cheap], area[riverside], familyFriendly[yes], near[Raja Indian Cuisine]	The Vaults is a cheap Indian pub in the riverside near Raja Indian Cuisine it is family friendly.
name[The Vaults], eatType[pub], food[Indian], priceRange[high], area[city centre], familyFriendly[no], near[Raja Indian Cuisine]	The Vaults is an Indian food in the high price range pub located in the city centre near Raja Indian Cuisine it is not children friendly.
name[The Vaults], eatType[pub], food[Indian], priceRange[high], area[city centre], familyFriendly[yes], near[Raja Indian Cuisine]	The Vaults is an Indian food in the high price range pub located in the city centre near Raja Indian Cuisine it is family friendly.
name[The Vaults], eatType[pub], food[Italian], priceRange[high], customer rating[average], area[city centre], familyFriendly[no], near[Rainbow Vegetarian Café]	The Vaults is an Italian pub located in the city centre near Rainbow Vegetarian Café it has a high price range, has a average customer rating and is not child friendly.
name[The Vaults], eatType[pub], food[Italian], priceRange[high], customer rating[average], area[city centre], familyFriendly[yes], near[Rainbow Vegetarian Café]	The Vaults is an Italian pub in the city centre near Rainbow Vegetarian Café it has a high price range, has an average customer rating and is child friendly.
name[The Vaults], eatType[pub], food[Italian], priceRange[high], customer rating[average], area[riverside], familyFriendly[no], near[Rainbow Vegetarian Café]	The Vaults is an Italian pub in the riverside near Rainbow Vegetarian Café it has a high price range, has a average customer rating and is not child friendly.
name[The Vaults], eatType[pub], food[Italian], priceRange[high], customer rating[average], area[riverside], familyFriendly[yes], near[Rainbow Vegetarian Café]	The Vaults is an Italian pub in the riverside near Rainbow Vegetarian Café it has a high price range, has an average customer rating and is child friendly.
name[The Vaults], eatType[pub], food[Italian], priceRange[less than £20], customer rating[low], area[city centre], familyFriendly[no], near[Rainbow Vegetarian Café]	The Vaults is an Italian pub located in the city centre near Rainbow Vegetarian Café it has a price range less than £20 it has a low customer rating and is not family-friendly.
name[The Vaults], eatType[pub], food[Italian], priceRange[less than £20], customer rating[low], area[city centre], familyFriendly[yes], near[Rainbow Vegetarian Café]	The Vaults is a family friendly pub serving Italian food with a price range less than £20 it is located in the city centre near Rainbow Vegetarian Café with a low customer rating.
name[The Vaults], eatType[pub], food[Italian], priceRange[less than £20], customer rating[low], area[riverside], familyFriendly[no], near[Rainbow Vegetarian Café]	The Vaults is a pub Italian restaurant located in the riverside area near Rainbow Vegetarian Café has a low customer rating the price range is less than £20 it is not family-friendly.
name[The Vaults], eatType[pub], food[Italian], priceRange[less than £20], customer rating[low], area[riverside], familyFriendly[yes], near[Rainbow Vegetarian Café]	The Vaults is a family friendly pub serving Italian food for less than £20 it is located in the riverside near Rainbow Vegetarian Café has a low customer rating.
name[The Vaults], eatType[pub], food[Italian], priceRange[moderate], customer rating[1 out of 5], area[city centre], familyFriendly[no], near[Rainbow Vegetarian Café]	The Vaults is an Italian pub located in the city centre near Rainbow Vegetarian Café it has a moderate price range, a customer rating of 1 out of 5 and is not kid - friendly.
name[The Vaults], eatType[pub], food[Italian], priceRange[moderate], customer rating[1 out of 5], area[city centre], familyFriendly[yes], near[Rainbow Vegetarian Café]	The Vaults is a moderately priced Italian pub located in the city centre near Rainbow Vegetarian Café it is kid friendly with a customer rating of 1 out of 5.
name[The Vaults], eatType[pub], food[Italian], priceRange[moderate], customer rating[1 out of 5], area[riverside], familyFriendly[no], near[Rainbow Vegetarian Café]	The Vaults is an Italian pub in the riverside area near Rainbow Vegetarian Café it has a moderate price range, a customer rating of 1 out of 5 and is not kid friendly.
name[The Vaults], eatType[pub], food[Italian], priceRange[moderate], customer rating[1 out of 5], area[riverside], familyFriendly[yes], near[Rainbow Vegetarian Café]	The Vaults is a moderately priced Italian pub located in the riverside near Rainbow Vegetarian Café has a customer rating of 1 out of 5 and is kid friendly.
name[The Vaults], eatType[pub], food[Italian], priceRange[moderate], customer rating[3 out of 5], area[city centre], familyFriendly[no], near[Rainbow Vegetarian Café]	The Vaults is a moderately priced Italian pub located in the city centre near Rainbow Vegetarian Café it has a customer rating of 3 out of 5 and is not kid friendly.
name[The Vaults], eatType[pub], food[Italian], priceRange[moderate], customer rating[3 out of 5], area[city centre], familyFriendly[yes], near[Rainbow Vegetarian Café]	The Vaults is a moderately priced Italian pub located in the city centre near Rainbow Vegetarian Café it is kid friendly with a customer rating of 3 out of 5.
name[The Vaults], eatType[pub], food[Italian], priceRange[moderate], customer rating[3 out of 5], area[riverside], familyFriendly[no], near[Rainbow Vegetarian Café]	The Vaults is a moderately priced Italian pub located in the riverside near Rainbow Vegetarian Café has a customer rating of 3 out of 5 and is not kid friendly.
name[The Vaults], eatType[pub], food[Italian], priceRange[moderate], customer rating[3 out of 5], area[riverside], familyFriendly[yes], near[Rainbow Vegetarian Café]	The Vaults is a moderately priced Italian pub located in the riverside near Rainbow Vegetarian Café has a customer rating of 3 out of 5 and is kid friendly.
name[The Vaults], eatType[pub], food[Italian], priceRange[more than £30], customer rating[high], area[city centre], familyFriendly[no], near[Rainbow Vegetarian Café]	The Vaults is an Italian pub located in the city centre near Rainbow Vegetarian Café it has a price range of more than £30 and has a high customer rating it is not child friendly.
name[The Vaults], eatType[pub], food[Italian], priceRange[more than £30], customer rating[high], area[city centre], familyFriendly[yes], near[Rainbow Vegetarian Café]	The Vaults is an Italian pub located in the city centre near Rainbow Vegetarian Café it has a price range of more than £30 and has a high customer rating is child friendly.
name[The Vaults], eatType[pub], food[Italian], priceRange[more than £30], customer rating[high], area[riverside], familyFriendly[no], near[Rainbow Vegetarian Café]	The Vaults is an Italian pub located in the riverside near Rainbow Vegetarian Café has a high customer rating price range it is not child friendly.
name[The Vaults], eatType[pub], food[Italian], priceRange[more than £30], customer rating[high], area[riverside], familyFriendly[yes], near[Rainbow Vegetarian Café]	The Vaults is an Italian pub located in the riverside near Rainbow Vegetarian Café has a high customer rating food in the and is child friendly.
name[The Vaults], eatType[pub], food[Japanese], priceRange[£20-25], customer rating[3 out of 5], area[city centre], familyFriendly[no], near[Rainbow Vegetarian Café]	The Vaults is a Japanese pub located in the city centre near Rainbow Vegetarian Café with a price range of £20-25, has a customer rating of 3 out of 5 and is not family-friendly.
name[The Vaults], eatType[pub], food[Japanese], priceRange[£20-25], customer rating[3 out of 5], area[city centre], familyFriendly[yes], near[Rainbow Vegetarian Café]	The Vaults is a Japanese pub in the city centre near Rainbow Vegetarian Café with a price range of £20-25, has a customer rating of 3 out of 5 and is family friendly.
name[The Vaults], eatType[pub], food[Japanese], priceRange[£20-25], customer rating[3 out of 5], area[riverside], familyFriendly[no], near[Rainbow Vegetarian Café]	The Vaults is a Japanese pub in the riverside area near Rainbow Vegetarian Café with a price range of £20-25, has a customer rating of 3 out of 5 and is not kid friendly.
name[The Vaults], eatType[pub], food[Japanese], priceRange[£20-25], customer rating[3 out of 5], area[riverside], familyFriendly[yes], near[Rainbow Vegetarian Café]	The Vaults is a Japanese pub in the riverside area near Rainbow Vegetarian Café with a price range of £20-25, has a customer rating of 3 out of 5 and is kid friendly.
name[The Vaults], eatType[pub], food[Japanese], priceRange[£20-25], customer rating[high], area[city centre], familyFriendly[no], near[Rainbow Vegetarian Café]	The Vaults is a Japanese pub in the city centre near Rainbow Vegetarian Café with a price range of £20-25 and has a high customer rating it is not kid - friendly.
name[The Vaults], eatType[pub], food[Japanese], priceRange[£20-25], customer rating[high], area[city centre], familyFriendly[yes], near[Rainbow Vegetarian Café]	The Vaults is a Japanese pub in the city centre near Rainbow Vegetarian Café with a price range of £20-25 and has a high customer rating is kid friendly.
name[The Vaults], eatType[pub], food[Japanese], priceRange[£20-25], customer rating[high], area[riverside], familyFriendly[no], near[Rainbow Vegetarian Café]	The Vaults is a Japanese pub located in the riverside near Rainbow Vegetarian Café it has a high customer rating price range is £20-25 and is not kids friendly.
name[The Vaults], eatType[pub], food[Japanese], priceRange[£20-25], customer rating[high], area[riverside], familyFriendly[no], near[Raja Indian Cuisine]	The Vaults is a Japanese pub located in the riverside near Raja Indian Cuisine it has a high customer rating price range is £20-25 and is not kids friendly.
name[The Vaults], eatType[pub], food[Japanese], priceRange[£20-25], customer rating[high], area[riverside], familyFriendly[yes], near[Raja Indian Cuisine]	The Vaults is a Japanese pub in the riverside near Raja Indian Cuisine has a high customer rating is kid friendly and costs price range.
name[The Vaults], eatType[pub], food[Japanese], priceRange[cheap], customer rating[5 out of 5], area[city centre], familyFriendly[no], near[Raja Indian Cuisine]	The Vaults is a cheap Japanese pub located in the city centre near Raja Indian Cuisine, has a customer rating of 5 out of 5 and is not family-friendly.
name[The Vaults], eatType[pub], food[Japanese], priceRange[cheap], customer rating[5 out of 5], area[city centre], familyFriendly[yes], near[Raja Indian Cuisine]	The Vaults is a cheap family friendly pub serving Japanese food in the city centre near Raja Indian Cuisine with a customer rating of 5 out of 5.
name[The Vaults], eatType[pub], food[Japanese], priceRange[cheap], customer rating[5 out of 5], area[riverside], familyFriendly[no], near[Raja Indian Cuisine]	The Vaults is a cheap Japanese pub located in riverside near Raja Indian Cuisine, has a customer rating of 5 out of 5 and is not family-friendly.
name[The Vaults], eatType[pub], food[Japanese], priceRange[cheap], customer rating[5 out of 5], area[riverside], familyFriendly[yes], near[Raja Indian Cuisine]	The Vaults is a cheap family friendly pub serving Japanese food it is located in the riverside near Raja Indian Cuisine with a customer rating of 5 out of 5.
name[The Vaults], eatType[pub], food[Japanese], priceRange[high], customer rating[3 out of 5], area[city centre], familyFriendly[no], near[Raja Indian Cuisine]	The Vaults is a Japanese pub in the city centre near Raja Indian Cuisine it has a high price range, a customer rating of 3 out of 5 and is not child friendly.
name[The Vaults], eatType[pub], food[Japanese], priceRange[high], customer rating[3 out of 5], area[city centre], familyFriendly[yes], near[Raja Indian Cuisine]	The Vaults is a high priced Japanese pub in the city centre near Raja Indian Cuisine it is family friendly and has a customer rating of 3 out of 5.
name[The Vaults], eatType[pub], food[Japanese], priceRange[high], customer rating[3 out of 5], area[riverside], familyFriendly[no], near[Raja Indian Cuisine]	The Vaults is a Japanese pub in the riverside near Raja Indian Cuisine with a high price range, a customer rating of 3 out of 5 and is not child friendly.
name[The Vaults], eatType[pub], food[Japanese], priceRange[high], customer rating[3 out of 5], area[riverside], familyFriendly[yes], near[Raja Indian Cuisine]	The Vaults is a Japanese pub in the riverside near Raja Indian Cuisine with a high price range it is child - friendly and has a customer rating of 3 out of 5.
name[The Vaults], eatType[pub], food[Japanese], priceRange[less than £20], customer rating[average], area[city centre], familyFriendly[no], near[Raja Indian Cuisine]	The Vaults is a Japanese pub in the city centre near Raja Indian Cuisine with a price range less than £20 it has an average customer rating and is not family-friendly.
name[The Vaults], eatType[pub], food[Japanese], priceRange[less than £20], customer rating[average], area[city centre], familyFriendly[yes], near[Raja Indian Cuisine]	The Vaults is a family friendly pub serving Japanese food for less than £20 it is located in the city centre near Raja Indian Cuisine with an average customer rating.
name[The Vaults], eatType[pub], food[Japanese], priceRange[less than £20], customer rating[average], area[riverside], familyFriendly[no], near[Raja Indian Cuisine]	The Vaults is a Japanese pub in the riverside area near Raja Indian Cuisine with a price range of less than £20 it has an average customer rating and is not family-friendly.
name[The Vaults], eatType[pub], food[Japanese], priceRange[less than £20], customer rating[average], area[riverside], familyFriendly[yes], near[Raja Indian Cuisine]	The Vaults is a family friendly pub serving Japanese food for less than £20 it is located in the riverside near Raja Indian Cuisine with an average customer rating.
name[The Vaults], eatType[pub], food[Japanese], priceRange[less than £20], customer rating[low], area[city centre], familyFriendly[no], near[Raja Indian Cuisine]	The Vaults is a Japanese pub in the city centre near Raja Indian Cuisine it has a price range less than £20 it has a low customer rating and is not family-friendly.
name[The Vaults], eatType[pub], food[Japanese], priceRange[less than £20], customer rating[low], area[city centre], familyFriendly[yes], near[Raja Indian Cuisine]	The Vaults is a family friendly pub serving Japanese food in the price range is less than £20 it is located in the city centre near Raja Indian Cuisine with a low customer rating.
name[The Vaults], eatType[pub], food[Japanese], priceRange[less than £20], customer rating[low], area[riverside], familyFriendly[no], near[Raja Indian Cuisine]	The Vaults is a Japanese pub in the riverside area near Raja Indian Cuisine with a price range of less than £20 it has a low customer rating and is not family-friendly.
name[The Vaults], eatType[pub], food[Japanese], priceRange[less than £20], customer rating[low], area[riverside], familyFriendly[yes], near[Raja Indian Cuisine]	The Vaults is a family friendly pub serving Japanese food for less than £20 it is located in the riverside near Raja Indian Cuisine with a low customer rating.
name[The Vaults], eatType[pub], food[Japanese], priceRange[moderate], customer rating[1 out of 5], area[city centre], familyFriendly[no], near[Raja Indian Cuisine]	The Vaults is a Japanese pub in the city centre near Raja Indian Cuisine it has a moderate price range, a customer rating of 1 out of 5 and is not kid - friendly.
name[The Vaults], eatType[pub], food[Japanese], priceRange[moderate], customer rating[1 out of 5], area[city centre], familyFriendly[yes], near[Raja Indian Cuisine]	The Vaults is a Japanese pub in the city centre near Raja Indian Cuisine it has a moderate price range it is kid - friendly and has a customer rating of 1 out of 5.
name[The Vaults], eatType[restaurant], food[French], priceRange[high], area[riverside], familyFriendly[yes], near[Raja Indian Cuisine]	The Vaults is a French restaurant in the riverside near Raja Indian Cuisine with a high price range and is child friendly.
name[The Vaults], eatType[restaurant], food[French], priceRange[less than £20], area[city centre], familyFriendly[no], near[Raja Indian Cuisine]	The Vaults is a French restaurant in the city centre near Raja Indian Cuisine with a price range less than £20 it is not family-friendly.
name[The Vaults], eatType[restaurant], food[French], priceRange[less than £20], area[city centre], familyFriendly[yes], near[Raja Indian Cuisine]	The Vaults is a family-friendly restaurant serving French food with a price range of less than £20 it is located in the city centre near Raja Indian Cuisine.
name[The Vaults], eatType[restaurant], food[French], priceRange[less than £20], area[riverside], familyFriendly[no], near[Raja Indian Cuisine]	The Vaults is a French restaurant in the riverside near Raja Indian Cuisine with a price range less than £20 it is not family-friendly.
name[The Vaults], eatType[restaurant], food[French], priceRange[less than £20], area[riverside], familyFriendly[yes], near[Raja Indian Cuisine]	The Vaults is a family friendly restaurant serving French food with a price range of less than £20 it is located in the riverside near Raja Indian Cuisine.
name[The Vaults], eatType[restaurant], food[French], priceRange[moderate], area[city centre], familyFriendly[no], near[Raja Indian Cuisine]	The Vaults is a moderately priced French restaurant near Raja Indian Cuisine in the city centre is not family-friendly.
name[The Vaults], eatType[restaurant], food[French], priceRange[moderate], area[city centre], familyFriendly[yes], near[Raja Indian Cuisine]	The Vaults is a moderately priced French restaurant near Raja Indian Cuisine in the city centre is.
name[The Vaults], eatType[restaurant], food[French], priceRange[moderate], area[riverside], familyFriendly[no], near[Raja Indian Cuisine]	The Vaults is a moderately priced French restaurant near Raja Indian Cuisine in the riverside area and is not kid friendly.
name[The Vaults], eatType[restaurant], food[French], priceRange[moderate], area[riverside], familyFriendly[yes], near[Raja Indian Cuisine]	The Vaults is a moderately priced French restaurant near Raja Indian Cuisine in riverside is child friendly.
name[The Vaults], eatType[restaurant], food[French], priceRange[more than £30], area[city centre], familyFriendly[no], near[Raja Indian Cuisine]	The Vaults is a French restaurant in the city centre near Raja Indian Cuisine it has a price range and is not child friendly.
name[The Vaults], eatType[restaurant], food[French], priceRange[more than £30], area[city centre], familyFriendly[yes], near[Raja Indian Cuisine]	The Vaults is a children friendly restaurant serving French food in the price range is more than £30 it is located in the city centre near Raja Indian Cuisine.
name[The Vaults], eatType[restaurant], food[French], priceRange[more than £30], area[riverside], familyFriendly[no], near[Raja Indian Cuisine]	The Vaults is a French restaurant in the riverside near Raja Indian Cuisine it has a price range of more than £30 it is not child friendly.
name[The Vaults], eatType[restaurant], food[French], priceRange[more than £30], area[riverside], familyFriendly[yes], near[Raja Indian Cuisine]	The Vaults is a French restaurant in the riverside near Raja Indian Cuisine with a price range it is child friendly.
name[The Vaults], eatType[restaurant], food[Indian], priceRange[£20-25], area[riverside], familyFriendly[yes], near[Raja Indian Cuisine]	The Vaults is an Indian restaurant in the riverside near Raja Indian Cuisine with a price range of £20-25 and is family friendly.
name[The Vaults], eatType[restaurant], food[Indian], priceRange[cheap], area[riverside], familyFriendly[yes], near[Raja Indian Cuisine]	The Vaults is a cheap Indian restaurant in riverside near Raja Indian Cuisine it is family friendly.
name[The Vaults], eatType[restaurant], food[Indian], priceRange[high], area[city centre], familyFriendly[no], near[Raja Indian Cuisine]	The Vaults is an Indian food in the high price range restaurant located in the city centre near Raja Indian Cuisine it is not children friendly.
name[The Vaults], eatType[restaurant], food[Indian], priceRange[high], area[city centre], familyFriendly[yes], near[Raja Indian Cuisine]	The Vaults is an Indian food in the high price range restaurant in the city centre near Raja Indian Cuisine it is family friendly.
name[The Waterman], eatType[pub], food[Indian], priceRange[high], area[city centre], familyFriendly[yes], near[Raja Indian Cuisine]	The Waterman is an Indian food in the high price range pub located in the city centre near Raja Indian Cuisine it is family friendly.
name[The Waterman], eatType[pub], food[Indian], priceRange[high], area[riverside], familyFriendly[no], near[Raja Indian Cuisine]	The Waterman is an Indian pub in the riverside near Raja Indian Cuisine it has a high price range and is not kid friendly.
name[The Waterman], eatType[pub], food[Indian], priceRange[high], area[riverside], familyFriendly[yes], near[Raja Indian Cuisine]	The Waterman is an Indian food in the high price range pub located in riverside near Raja Indian Cuisine it is children friendly.
name[The Waterman], eatType[pub], food[Indian], priceRange[less than £20], area[city centre], familyFriendly[no], near[Raja Indian Cuisine]	The Waterman is an Indian pub in the city centre near Raja Indian Cuisine with a price range less than £20 it is not family-friendly.
name[The Waterman], eatType[pub], food[Indian], priceRange[less than £20], area[city centre], familyFriendly[yes], near[Raja Indian Cuisine]	The Waterman is a family friendly pub serving Indian food in the price range is less than £20 it is located in the city centre near Raja Indian Cuisine.
name[The Waterman], eatType[pub], food[Indian], priceRange[less than £20], area[riverside], familyFriendly[no], near[Raja Indian Cuisine]	The Waterman is a pub serving Indian food in the low price range it is located in the riverside near Raja Indian Cuisine it is not family friendly.
name[The Waterman], eatType[pub], food[Indian], priceRange[less than £20], area[riverside], familyFriendly[yes], near[Raja Indian Cuisine]	The Waterman is a family friendly pub serving Indian food in the price range is less than £20 it is located in the riverside near Raja Indian Cuisine.
name[The Waterman], eatType[pub], food[Indian], priceRange[moderate], area[city centre], familyFriendly[no], near[Raja Indian Cuisine]	The Waterman is a moderately priced Indian pub located in the city centre near Raja Indian Cuisine it is not kid friendly.
name[The Waterman], eatType[pub], food[Indian], priceRange[moderate], area[city centre], familyFriendly[yes], near[Raja Indian Cuisine]	The Waterman is a moderately priced Indian pub located in the city centre near Raja Indian Cuisine it is kid friendly.
name[The Waterman], eatType[pub], food[Indian], priceRange[moderate], area[riverside], familyFriendly[no], near[Raja Indian Cuisine]	The Waterman is a moderately priced Indian pub located in the riverside near Raja Indian Cuisine it is not kid friendly and.
name[The Waterman], eatType[pub], food[Indian], priceRange[moderate], area[riverside], familyFriendly[yes], near[Raja Indian Cuisine]	The Waterman is a moderately priced Indian pub located in the riverside near Raja Indian Cuisine it is kid friendly.
name[The Waterman], eatType[pub], food[Indian], priceRange[more than £30], area[riverside], familyFriendly[yes], near[Raja Indian Cuisine]	The Waterman is an Indian pub in the riverside near Raja Indian Cuisine it has a price range and is child friendly.
name[The Waterman], eatType[pub], food[Italian], priceRange[£20-25], area[riverside], familyFriendly[yes], near[Raja Indian Cuisine]	The Waterman is a family friendly pub serving Italian food for a price range it is located in the riverside near Raja Indian Cuisine.
name[The Waterman], eatType[pub], food[Italian], priceRange[cheap], area[riverside], familyFriendly[yes], near[Raja Indian Cuisine]	The Waterman is a cheap family friendly pub Italian riverside near Raja Indian Cuisine.
name[The Waterman], eatType[pub], food[Italian], priceRange[high], area[city centre], familyFriendly[no], near[Raja Indian Cuisine]	The Waterman is a high priced Italian pub located in the city centre near Raja Indian Cuisine it is not child friendly.
name[The Waterman], eatType[pub], food[Italian], priceRange[high], area[city centre], familyFriendly[yes], near[Raja Indian Cuisine]	The Waterman is a high priced Italian pub in the city centre near Raja Indian Cuisine it is family friendly.
name[The Waterman], eatType[pub], food[Italian], priceRange[high], area[riverside], familyFriendly[no], near[Raja Indian Cuisine]	The Waterman is a high priced Italian pub located in riverside near Raja Indian Cuisine it is not children friendly and.
name[The Waterman], eatType[pub], food[Italian], priceRange[high], area[riverside], familyFriendly[yes], near[Raja Indian Cuisine]	The Waterman is a high priced Italian pub located in riverside near Raja Indian Cuisine it is children friendly.
name[The Waterman], eatType[pub], food[Italian], priceRange[less than £20], area[city centre], familyFriendly[no], near[Raja Indian Cuisine]	The Waterman is a low priced Italian pub located in the city centre near Raja Indian Cuisine it is not family-friendly.
name[The Waterman], eatType[pub], food[Italian], priceRange[less than £20], area[city centre], familyFriendly[yes], near[Raja Indian Cuisine]	The Waterman is a family-friendly pub serving Italian food for less than £20 it is located in the city centre near Raja Indian Cuisine.
name[The Waterman], eatType[pub], food[Italian], priceRange[less than £20], area[riverside], familyFriendly[no], near[Raja Indian Cuisine]	The Waterman is a low priced Italian pub located in riverside near Raja Indian Cuisine it is not family-friendly.
name[The Waterman], eatType[restaurant], food[Indian], priceRange[high], area[city centre], familyFriendly[yes], near[Raja Indian Cuisine]	The Waterman is an Indian food in the high price range restaurant in the city centre near Raja Indian Cuisine it is family friendly.
name[The Waterman], eatType[restaurant], food[Indian], priceRange[high], area[riverside], familyFriendly[no], near[Raja Indian Cuisine]	The Waterman is an Indian restaurant in the riverside near Raja Indian Cuisine it has a high price range and is not children friendly.
name[The Waterman], eatType[restaurant], food[Indian], priceRange[high], area[riverside], familyFriendly[yes], near[Raja Indian Cuisine]	The Waterman is an Indian food in the high price range restaurant in riverside near Raja Indian Cuisine it is children friendly.
name[The Waterman], eatType[restaurant], food[Indian], priceRange[less than £20], area[city centre], familyFriendly[no], near[Raja Indian Cuisine]	The Waterman is an Indian restaurant in the city centre near Raja Indian Cuisine it has a price range less than £20 it is not family friendly.
name[The Waterman], eatType[restaurant], food[Indian], priceRange[less than £20], area[city centre], familyFriendly[yes], near[Raja Indian Cuisine]	The Waterman is a family friendly restaurant Indian food in the low price range it is located in the city centre near Raja Indian Cuisine.
name[The Waterman], eatType[restaurant], food[Indian], priceRange[less than £20], area[riverside], familyFriendly[no], near[Raja Indian Cuisine]	The Waterman is an Indian restaurant in the riverside near Raja Indian Cuisine with a price range of less than £20 it is not family friendly.
name[The Waterman], eatType[restaurant], food[Indian], priceRange[less than £20], area[riverside], familyFriendly[yes], near[Raja Indian Cuisine]	The Waterman is an Indian restaurant in the riverside near Raja Indian Cuisine with a price range of less than £20 it is family friendly.
name[The Waterman], eatType[restaurant], food[Indian], priceRange[moderate], area[city centre], familyFriendly[no], near[Raja Indian Cuisine]	The Waterman is an Indian food in the moderate price range restaurant located in the city centre near Raja Indian Cuisine it is not kid friendly.
name[The Waterman], eatType[restaurant], food[Indian], priceRange[moderate], area[city centre], familyFriendly[yes], near[Raja Indian Cuisine]	The Waterman is a moderately priced Indian restaurant in the city centre near Raja Indian Cuisine it is kid friendly.
name[The Waterman], eatType[restaurant], food[Indian], priceRange[moderate], area[riverside], familyFriendly[no], near[Raja Indian Cuisine]	The Waterman is an Indian food in the moderate price range restaurant located in riverside near Raja Indian Cuisine it is not kid friendly.
name[The Waterman], eatType[restaurant], food[Indian], priceRange[moderate], area[riverside], familyFriendly[yes], near[Raja Indian Cuisine]	The Waterman is a moderately priced Indian restaurant in riverside near Raja Indian Cuisine it is kid friendly.
name[The Waterman], eatType[restaurant], food[Indian], priceRange[more than £30], area[riverside], familyFriendly[yes], near[Raja Indian Cuisine]	The Waterman is a food in the more than £30 it is located in the riverside near Raja Indian Cuisine it is a children friendly restaurant.
name[The Waterman], eatType[restaurant], food[Italian], priceRange[£20-25], area[riverside], familyFriendly[yes], near[Raja Indian Cuisine]	The Waterman is a family friendly restaurant Italian food with a price range it is near Raja Indian Cuisine in riverside.
name[The Waterman], eatType[restaurant], food[Italian], priceRange[cheap], area[riverside], familyFriendly[yes], near[Raja Indian Cuisine]	The Waterman is a cheap family friendly restaurant Italian riverside near Raja Indian Cuisine.
name[The Waterman], eatType[restaurant], food[Italian], priceRange[high], area[city centre], familyFriendly[no], near[Raja Indian Cuisine]	The Waterman is an Italian restaurant in the city centre near Raja Indian Cuisine it has a high price range and is not child friendly.
name[The Waterman], eatType[restaurant], food[Italian], priceRange[high], area[city centre], familyFriendly[yes], near[Raja Indian Cuisine]	The Waterman is a children friendly restaurant Italian food in the high price range it is located in the city centre near Raja Indian Cuisine.
name[The Waterman], eatType[restaurant], food[Italian], priceRange[high], area[riverside], familyFriendly[no], near[Raja Indian Cuisine]	The Waterman is an Italian restaurant in the riverside near Raja Indian Cuisine it has a high price range and is not child friendly.
name[The Waterman], eatType[restaurant], food[Italian], priceRange[high], area[riverside], familyFriendly[yes], near[Raja Indian Cuisine]	The Waterman is a children friendly restaurant Italian food in the high price range it is located in the riverside near Raja Indian Cuisine.
name[The Waterman], eatType[restaurant], food[Italian], priceRange[less than £20], area[city centre], familyFriendly[no], near[Raja Indian Cuisine]	The Waterman is an Italian restaurant in the city centre near Raja Indian Cuisine it has a price range less than £20 it is not family-friendly.
name[The Waterman], eatType[restaurant], food[Italian], priceRange[less than £20], area[city centre], familyFriendly[yes], near[Raja Indian Cuisine]	The Waterman is a family-friendly restaurant in Italian food for less than £20 it is located in the city centre near Raja Indian Cuisine.
name[The Waterman], eatType[restaurant], food[Italian], priceRange[less than £20], area[riverside], familyFriendly[no], near[Raja Indian Cuisine]	The Waterman is an Italian restaurant in the riverside near Raja Indian Cuisine with a price range less than £20 it is not family-friendly.
name[The Wrestlers], eatType[pub], food[Italian], priceRange[less than £20], area[riverside], familyFriendly[no], near[Raja Indian Cuisine]	The Wrestlers is a low priced Italian pub located in riverside near Raja Indian Cuisine it is not family-friendly.
name[The Wrestlers], eatType[pub], food[Italian], priceRange[less than £20], area[riverside], familyFriendly[yes], near[Raja Indian Cuisine]	The Wrestlers is a family friendly pub serving Italian food for less than £20 it is located in the riverside near Raja Indian Cuisine.
name[The Wrestlers], eatType[pub], food[Italian], priceRange[moderate], area[city centre], familyFriendly[no], near[Raja Indian Cuisine]	The Wrestlers is a moderately priced Italian pub located in the city centre near Raja Indian Cuisine it is not kid friendly.
name[The Wrestlers], eatType[pub], food[Italian], priceRange[moderate], area[city centre], familyFriendly[yes], near[Raja Indian Cuisine]	The Wrestlers is a moderately priced Italian pub located in the city centre near Raja Indian Cuisine it is kid friendly.
name[The Wrestlers], eatType[pub], food[Italian], priceRange[moderate], area[riverside], familyFriendly[no], near[Raja Indian Cuisine]	The Wrestlers is a moderately priced Italian pub located in the riverside near Raja Indian Cuisine it is not kid friendly and.
name[The Wrestlers], eatType[pub], food[Italian], priceRange[moderate], area[riverside], familyFriendly[yes], near[Raja Indian Cuisine]	The Wrestlers is a moderately priced Italian pub located in the riverside near Raja Indian Cuisine it is kid friendly.
name[The Wrestlers], eatType[pub], food[Italian], priceRange[more than £30], area[riverside], familyFriendly[yes], near[Raja Indian Cuisine]	The Wrestlers is a family friendly pub serving Italian food for more than £30 it is located in the riverside near Raja Indian Cuisine.
name[The Wrestlers], eatType[pub], food[Japanese], priceRange[£20-25], area[riverside], familyFriendly[yes], near[Raja Indian Cuisine]	The Wrestlers is a Japanese pub in the riverside near Raja Indian Cuisine with a price range of £20-25 and is family friendly.
name[The Wrestlers], eatType[pub], food[Japanese], priceRange[cheap], area[riverside], familyFriendly[yes], near[Raja Indian Cuisine]	The Wrestlers is a cheap family friendly pub serving Japanese food it is located in the riverside near Raja Indian Cuisine.
name[The Wrestlers], eatType[pub], food[Japanese], priceRange[high], area[riverside], familyFriendly[yes], near[Raja Indian Cuisine]	The Wrestlers is a high priced Japanese pub in riverside near Raja Indian Cuisine it is family friendly.
name[The Wrestlers], eatType[pub], food[Japanese], priceRange[less than £20], area[city centre], familyFriendly[no], near[Raja Indian Cuisine]	The Wrestlers is a Japanese pub in the city centre near Raja Indian Cuisine with a price range less than £20 it is not family-friendly.
name[The Wrestlers], eatType[pub], food[Japanese], priceRange[less than £20], area[city centre], familyFriendly[yes], near[Raja Indian Cuisine]	The Wrestlers is a family friendly pub serving Japanese food with a price range of less than £20 it is located in the city centre near Raja Indian Cuisine.
name[The Wrestlers], eatType[pub], food[Japanese], priceRange[less than £20], area[riverside], familyFriendly[no], near[Raja Indian Cuisine]	The Wrestlers is a Japanese pub in the riverside near Raja Indian Cuisine with a price range less than £20 it is not family-friendly.
name[The Wrestlers], eatType[pub], food[Japanese], priceRange[less than £20], area[riverside], familyFriendly[yes], near[Raja Indian Cuisine]	The Wrestlers is a family friendly pub serving Japanese food with a price range of less than £20 it is located in the riverside near Raja Indian Cuisine.
name[The Wrestlers], eatType[pub], food[Japanese], priceRange[moderate], area[city centre], familyFriendly[no], near[Raja Indian Cuisine]	The Wrestlers is a moderately priced Japanese pub located in the city centre near Raja Indian Cuisine it is not kid friendly.
name[The Wrestlers], eatType[pub], food[Japanese], priceRange[moderate], area[city centre], familyFriendly[yes], near[Raja Indian Cuisine]	The Wrestlers is a moderately priced Japanese pub in the city centre near Raja Indian Cuisine it is kid friendly.
name[The Wrestlers], eatType[pub], food[Japanese], priceRange[moderate], area[riverside], familyFriendly[no], near[Raja Indian Cuisine]	The Wrestlers is a moderately priced Japanese pub located in riverside near Raja Indian Cuisine it is not kid friendly.
name[The Wrestlers], eatType[pub], food[Japanese], priceRange[moderate], area[riverside], familyFriendly[yes], near[Raja Indian Cuisine]	The Wrestlers is a moderately priced Japanese pub in the riverside near Raja Indian Cuisine it is kid friendly.
name[The Wrestlers], eatType[pub], food[Japanese], priceRange[moderate], customer rating[1 out of 5], area[city centre], familyFriendly[yes], near[Raja Indian Cuisine]	The Wrestlers is a Japanese pub in the city centre near Raja Indian Cuisine it has a moderate price range it is kid - friendly and has a customer rating of 1 out of 5.
name[The Wrestlers], eatType[pub], food[Japanese], priceRange[moderate], customer rating[1 out of 5], area[riverside], familyFriendly[no], near[Raja Indian Cuisine]	The Wrestlers is a Japanese pub in the riverside area near Raja Indian Cuisine it has a moderate price range, a customer rating of 1 out of 5 and is not kid friendly.
name[The Wrestlers], eatType[pub], food[Japanese], priceRange[moderate], customer rating[1 out of 5], area[riverside], familyFriendly[yes], near[Raja Indian Cuisine]	The Wrestlers is a Japanese pub in the riverside area near Raja Indian Cuisine it has a moderate price range it is kid friendly and has a customer rating of 1 out of 5.
name[The Wrestlers], eatType[pub], food[Japanese], priceRange[more than £30], area[city centre], familyFriendly[no], near[Raja Indian Cuisine]	The Wrestlers is a Japanese pub in the city centre near Raja Indian Cuisine it has a price range of more than £30 it is not child friendly.
name[The Wrestlers], eatType[pub], food[Japanese], priceRange[more than £30], area[city centre], familyFriendly[yes], near[Raja Indian Cuisine]	The Wrestlers is a children friendly pub serving Japanese food it has a price range located in the city centre near Raja Indian Cuisine.
name[The Wrestlers], eatType[pub], food[Japanese], priceRange[more than £30], area[riverside], familyFriendly[no], near[Raja Indian Cuisine]	The Wrestlers is a Japanese pub in the riverside near Raja Indian Cuisine it has a price range of more than £30 it is not children friendly.
name[The Wrestlers], eatType[pub], food[Japanese], priceRange[more than £30], area[riverside], familyFriendly[yes], near[Raja Indian Cuisine]	The Wrestlers is a family friendly pub serving Japanese food in the riverside near Raja Indian Cuisine with a price range of more than £30.
name[The Wrestlers], eatType[pub], food[Japanese], priceRange[more than £30], customer rating[5 out of 5], area[city centre], familyFriendly[no], near[Raja Indian Cuisine]	The Wrestlers is a Japanese pub in the city centre near Raja Indian Cuisine it has a price range of more than £30, has a customer rating of 5 out of 5 and is not family-friendly.
name[The Wrestlers], eatType[pub], food[Japanese], priceRange[more than £30], customer rating[5 out of 5], area[city centre], familyFriendly[yes], near[Raja Indian Cuisine]	The Wrestlers is a Japanese pub in the city centre near Raja Indian Cuisine it has a price range of more than £30, has a customer rating 5 out of 5 and is family friendly.
name[The Wrestlers], eatType[pub], food[Japanese], priceRange[more than £30], customer rating[5 out of 5], area[riverside], familyFriendly[no], near[Raja Indian Cuisine]	The Wrestlers is a Japanese pub in the riverside near Raja Indian Cuisine it has a price range of more than £30, has a customer rating of 5 out of 5 and is not family-friendly.
name[The Wrestlers], eatType[pub], food[Japanese], priceRange[more than £30], customer rating[5 out of 5], area[riverside], familyFriendly[yes], near[Raja Indian Cuisine]	The Wrestlers is a Japanese pub in the riverside near Raja Indian Cuisine it has a price range of more than £30, has a customer rating of 5 out of 5 and is family friendly.
name[The Wrestlers], eatType[pub], food[Japanese], priceRange[more than £30], customer rating[low], area[city centre], familyFriendly[no], near[Raja Indian Cuisine]	The Wrestlers is a Japanese pub in the city centre near Raja Indian Cuisine it has a price range of more than £30, has a low customer rating and is not family-friendly.
name[The Wrestlers], eatType[pub], food[Japanese], priceRange[more than £30], customer rating[low], area[city centre], familyFriendly[yes], near[Raja Indian Cuisine]	The Wrestlers is a Japanese pub in the city centre near Raja Indian Cuisine it has a price range of more than £30, has a low customer rating and is family friendly.
name[The Wrestlers], eatType[pub], food[Japanese], priceRange[more than £30], customer rating[low], area[riverside], familyFriendly[no], near[Raja Indian Cuisine]	The Wrestlers is a Japanese pub in the riverside near Raja Indian Cuisine it has a price range of more than £30, has a low customer rating and is not family-friendly.
name[The Wrestlers], eatType[pub], food[Japanese], priceRange[more than £30], customer rating[low], area[riverside], familyFriendly[yes], near[Raja Indian Cuisine]	The Wrestlers is a Japanese pub in the riverside near Raja Indian Cuisine it has a price range of more than £30 but has a low customer rating and is family friendly.
name[The Wrestlers], eatType[restaurant], food[Italian], priceRange[less than £20], area[riverside], familyFriendly[no], near[Raja Indian Cuisine]	The Wrestlers is an Italian restaurant in the riverside near Raja Indian Cuisine with a price range less than £20 it is not family-friendly.
name[The Wrestlers], eatType[restaurant], food[Italian], priceRange[less than £20], area[riverside], familyFriendly[yes], near[Raja Indian Cuisine]	The Wrestlers is a family friendly restaurant in Italian food for less than £20 it is located in the riverside near Raja Indian Cuisine.
name[The Wrestlers], eatType[restaurant], food[Italian], priceRange[moderate], area[city centre], familyFriendly[no], near[Raja Indian Cuisine]	The Wrestlers is a moderately priced Italian restaurant in the city centre near Raja Indian Cuisine it is not kid friendly.
name[The Wrestlers], eatType[restaurant], food[Italian], priceRange[moderate], area[city centre], familyFriendly[yes], near[Raja Indian Cuisine]	The Wrestlers is a moderately priced Italian restaurant in the city centre near Raja Indian Cuisine it is kid friendly.
name[The Wrestlers], eatType[restaurant], food[Italian], priceRange[moderate], area[riverside], familyFriendly[no], near[Raja Indian Cuisine]	The Wrestlers is a moderately priced Italian restaurant near Raja Indian Cuisine in the riverside area and is not kid friendly.
name[The Wrestlers], eatType[restaurant], food[Italian], priceRange[moderate], area[riverside], familyFriendly[yes], near[Raja Indian Cuisine]	The Wrestlers is a moderately priced Italian restaurant in the riverside near Raja Indian Cuisine it is kid friendly.
name[The Wrestlers], eatType[restaurant], food[Italian], priceRange[more than £30], area[riverside], familyFriendly[yes], near[Raja Indian Cuisine]	The Wrestlers is a family friendly restaurant Italian food for more than £30 it is located in the riverside near Raja Indian Cuisine.
name[The Wrestlers], eatType[restaurant], food[Japanese], priceRange[£20-25], area[riverside], familyFriendly[yes], near[Raja Indian Cuisine]	The Wrestlers is a Japanese restaurant in the riverside near Raja Indian Cuisine with a price range of £20-25 and is family friendly.
name[The Wrestlers], eatType[restaurant], food[Japanese], priceRange[cheap], area[riverside], familyFriendly[yes], near[Raja Indian Cuisine]	The Wrestlers is a cheap family friendly restaurant Japanese food in riverside near Raja Indian Cuisine.
name[The Wrestlers], eatType[restaurant], food[Japanese], priceRange[high], area[riverside], familyFriendly[yes], near[Raja Indian Cuisine]	The Wrestlers is a Japanese restaurant in the riverside near Raja Indian Cuisine with a high price range and is child friendly.
name[The Wrestlers], eatType[restaurant], food[Japanese], priceRange[less than £20], area[city centre], familyFriendly[no], near[Raja Indian Cuisine]	The Wrestlers is a Japanese restaurant in the city centre near Raja Indian Cuisine with a price range less than £20 it is not family-friendly.
name[The Wrestlers], eatType[restaurant], food[Japanese], priceRange[less than £20], area[city centre], familyFriendly[yes], near[Raja Indian Cuisine]	The Wrestlers is a family friendly restaurant Japanese food for less than £20 it is located in the city centre near Raja Indian Cuisine.
name[The Wrestlers], eatType[restaurant], food[Japanese], priceRange[less than £20], area[riverside], familyFriendly[no], near[Raja Indian Cuisine]	The Wrestlers is a Japanese coffee shop in the riverside near Raja Indian Cuisine with a price range of less than £20 it is not family-friendly.
name[The Wrestlers], eatType[restaurant], food[Japanese], priceRange[less than £20], area[riverside], familyFriendly[yes], near[Raja Indian Cuisine]	The Wrestlers is a family friendly restaurant Japanese food for less than £20 it is located in the riverside near Raja Indian Cuisine.
name[The Wrestlers], eatType[restaurant], food[Japanese], priceRange[moderate], area[city centre], familyFriendly[no], near[Raja Indian Cuisine]	The Wrestlers is a moderately priced Japanese restaurant near Raja Indian Cuisine in the city centre it is not kid friendly.
name[The Wrestlers], eatType[restaurant], food[Japanese], priceRange[moderate], area[city centre], familyFriendly[yes], near[Raja Indian Cuisine]	The Wrestlers is a moderately priced Japanese restaurant in the city centre near Raja Indian Cuisine it is kid friendly.
name[The Wrestlers], eatType[restaurant], food[Japanese], priceRange[moderate], area[riverside], familyFriendly[no], near[Raja Indian Cuisine]	The Wrestlers is a Japanese coffee shop in the riverside area near Raja Indian Cuisine it has a moderate price range it is not kid friendly and.
name[The Wrestlers], eatType[restaurant], food[Japanese], priceRange[moderate], area[riverside], familyFriendly[yes], near[Raja Indian Cuisine]	The Wrestlers is a moderately priced Japanese restaurant in riverside near Raja Indian Cuisine it is kid friendly.
name[The Wrestlers], eatType[restaurant], food[Japanese], priceRange[more than £30], area[city centre], familyFriendly[no], near[Raja Indian Cuisine]	The Wrestlers is a Japanese restaurant in the city centre near Raja Indian Cuisine it has a price range of more than £30 it is not child friendly.
name[The Wrestlers], eatType[restaurant], food[Japanese], priceRange[more than £30], area[city centre], familyFriendly[yes], near[Raja Indian Cuisine]	The Wrestlers is a Japanese restaurant in the city centre near Raja Indian Cuisine it has a price range and is child friendly.
name[The Wrestlers], eatType[restaurant], food[Japanese], priceRange[more than £30], area[riverside], familyFriendly[no], near[Raja Indian Cuisine]	The Wrestlers is a Japanese coffee shop in the riverside near Raja Indian Cuisine it has a price range of more than £30 it is not children friendly.
name[The Wrestlers], eatType[restaurant], food[Japanese], priceRange[more than £30], area[riverside], familyFriendly[yes], near[Raja Indian Cuisine]	The Wrestlers is a Japanese restaurant in the riverside near Raja Indian Cuisine with a price range and is child friendly.
name[Wildwood], eatType[coffee shop], area[riverside]	Wildwood is a coffee shop in the riverside area.
name[Wildwood], eatType[pub], area[riverside]	Wildwood pub located in the riverside area.
name[Wildwood], eatType[pub], food[French], area[riverside], familyFriendly[yes], near[Raja Indian Cuisine]	Wildwood is a family friendly pub serving French food in the riverside near Raja Indian Cuisine.
name[Wildwood], eatType[pub], food[Indian], area[city centre], familyFriendly[no], near[Raja Indian Cuisine]	Wildwood is an Indian pub located in the city centre near Raja Indian Cuisine it is not family-friendly.
name[Wildwood], eatType[pub], food[Indian], area[city centre], familyFriendly[yes], near[Raja Indian Cuisine]	Wildwood is a family friendly pub serving Indian food in the city centre near Raja Indian Cuisine.
name[Wildwood], eatType[pub], food[Indian], area[riverside], familyFriendly[no], near[Raja Indian Cuisine]	Wildwood is an Indian pub located in the riverside near Raja Indian Cuisine it is not family friendly.
name[Wildwood], eatType[pub], food[Indian], area[riverside], familyFriendly[yes], near[Raja Indian Cuisine]	Wildwood is an Indian pub in the riverside near Raja Indian Cuisine it is family friendly.
name[Wildwood], eatType[pub], food[Italian], area[city centre], familyFriendly[no], near[Raja Indian Cuisine]	Wildwood is an Italian pub located in the city centre near Raja Indian Cuisine it is not family-friendly.
name[Wildwood], eatType[pub], food[Italian], area[city centre], familyFriendly[yes], near[Raja Indian Cuisine]	Wildwood is a family friendly pub serving Italian located in the city centre near Raja Indian Cuisine.
name[Wildwood], eatType[pub], food[Italian], area[riverside], familyFriendly[no], near[Raja Indian Cuisine]	Wildwood is an Italian pub located in the riverside near Raja Indian Cuisine it is not family-friendly.
name[Wildwood], eatType[pub], food[Italian], area[riverside], familyFriendly[yes], near[Raja Indian Cuisine]	Wildwood is a family friendly pub serving Italian food it is located in the riverside near Raja Indian Cuisine.
name[Wildwood], eatType[restaurant], food[French], area[riverside], familyFriendly[yes], near[Raja Indian Cuisine]	Wildwood is a family friendly restaurant serving French food near Raja Indian Cuisine in riverside.
name[Wildwood], eatType[restaurant], food[Indian], area[city centre], familyFriendly[no], near[Raja Indian Cuisine]	Wildwood is an Indian restaurant in the city centre near Raja Indian Cuisine it is not family friendly.
name[Wildwood], eatType[restaurant], food[Indian], area[city centre], familyFriendly[yes], near[Raja Indian Cuisine]	Wildwood is an Indian restaurant in the city centre near Raja Indian Cuisine it is family friendly.
name[Wildwood], eatType[restaurant], food[Indian], area[riverside], familyFriendly[no], near[Raja Indian Cuisine]	Wildwood is an Indian restaurant located in riverside near Raja Indian Cuisine it is not family friendly.
name[Wildwood], eatType[restaurant], food[Indian], area[riverside], familyFriendly[yes], near[Raja Indian Cuisine]	Wildwood is an Indian restaurant in riverside near Raja Indian Cuisine it is family friendly.
name[Wildwood], eatType[restaurant], food[Italian], area[city centre], familyFriendly[no], near[Raja Indian Cuisine]	Wildwood is an Italian restaurant in the city centre near Raja Indian Cuisine it is not family-friendly.
name[Wildwood], eatType[restaurant], food[Italian], area[city centre], familyFriendly[yes], near[Raja Indian Cuisine]	Wildwood is a family friendly restaurant Italian food near Raja Indian Cuisine in the city centre.
name[Wildwood], eatType[restaurant], food[Italian], area[riverside], familyFriendly[no], near[Raja Indian Cuisine]	Wildwood is an Italian restaurant in the riverside near Raja Indian Cuisine it is not family-friendly.
name[Wildwood], eatType[restaurant], food[Italian], area[riverside], familyFriendly[yes], near[Raja Indian Cuisine]	Wildwood is a family friendly restaurant Italian restaurant near Raja Indian Cuisine in riverside.
name[Zizzi], eatType[coffee shop], area[riverside]	Zizzi is a coffee shop in the riverside area.
name[Zizzi], eatType[coffee shop], customer rating[average], near[Burger King]	Zizzi is a coffee shop near Burger King with an average customer rating.
name[Zizzi], eatType[coffee shop], customer rating[high], near[Burger King]	Zizzi is a coffee shop near Burger King with a high customer rating.
name[Zizzi], eatType[coffee shop], near[The Sorrento]	Zizzi is a coffee shop near The Sorrento.
name[Zizzi], eatType[pub], area[riverside]	Zizzi pub located in the riverside area.
name[Zizzi], eatType[pub], customer rating[average], near[Burger King]	Zizzi pub near Burger King with an average customer rating.
name[Zizzi], eatType[pub], customer rating[high], near[Burger King]	Zizzi pub with a high customer rating near Burger King.
name[Zizzi], eatType[pub], near[The Sorrento]	Zizzi pub near The Sorrento.
