MR	output
'name[Blue Spice], eatType[coffee shop], area[city centre]'	'The city centre is a coffee shop called Blue Spice.'
'name[Blue Spice], eatType[coffee shop], area[riverside]'	'In the riverside area, Blue Spice is a coffee shop.'
'name[Blue Spice], eatType[coffee shop], customer rating[5 out of 5], near[Crowne Plaza Hotel]'	'With a customer rating of 5 out of 5, Blue Spice is a coffee shop near Crowne Plaza Hotel.'
'name[Blue Spice], eatType[coffee shop], customer rating[average], near[Burger King]'	'With an average customer rating, Blue Spice is a coffee shop near Burger King.'
'name[Blue Spice], eatType[coffee shop], customer rating[average], near[Crowne Plaza Hotel]'	'With an average customer rating, Blue Spice is a coffee shop near Crowne Plaza Hotel.'
'name[Blue Spice], eatType[pub], area[city centre]'	'The pub in the city centre is Blue Spice.'
'name[Blue Spice], eatType[pub], area[riverside]'	'In the riverside area, Blue Spice is a pub.'
'name[Blue Spice], eatType[pub], customer rating[5 out of 5], near[Crowne Plaza Hotel]'	'Blue Spice is a pub near Crowne Plaza Hotel with a customer rating of 5 out of 5.'
'name[Blue Spice], eatType[pub], customer rating[average], near[Burger King]'	'Blue Spice is a pub near Burger King with an average customer rating.'
'name[Blue Spice], eatType[pub], customer rating[average], near[Crowne Plaza Hotel]'	'Blue Spice is a pub near Crowne Plaza Hotel with an average customer rating.'
'name[Blue Spice], eatType[pub], food[Chinese], area[city centre], familyFriendly[no], near[Rainbow Vegetarian Café]'	'Blue Spice is a chinese pub located in the city centre near Rainbow Vegetarian Café. It is not family friendly.'
'name[Blue Spice], eatType[pub], food[Chinese], area[city centre], familyFriendly[yes], near[Rainbow Vegetarian Café]'	'Blue Spice is a family friendly chinese pub in the city centre near Rainbow Vegetarian Café.'
'name[Blue Spice], eatType[pub], food[Chinese], area[riverside], familyFriendly[no], near[Rainbow Vegetarian Café]'	'Blue Spice is a chinese pub near Rainbow Vegetarian Café in the riverside area. It is not family friendly.'
'name[Blue Spice], eatType[pub], food[Chinese], area[riverside], familyFriendly[yes], near[Rainbow Vegetarian Café]'	'Blue Spice is a family friendly chinese pub near Rainbow Vegetarian Café in the riverside area.'
'name[Blue Spice], eatType[pub], food[English], area[city centre], familyFriendly[no], near[Rainbow Vegetarian Café]'	'Blue Spice is a non-family-friendly english pub near Rainbow Vegetarian Café in the city centre.'
'name[Blue Spice], eatType[pub], food[English], area[city centre], familyFriendly[yes], near[Rainbow Vegetarian Café]'	'Blue Spice is a family-friendly english pub in the city centre near Rainbow Vegetarian Café.'
'name[Blue Spice], eatType[pub], food[English], area[riverside], familyFriendly[no], near[Rainbow Vegetarian Café]'	'Blue Spice is an english pub near Rainbow Vegetarian Café in the riverside area. It is not family-friendly.'
'name[Blue Spice], eatType[pub], food[English], area[riverside], familyFriendly[yes], near[Rainbow Vegetarian Café]'	'Blue Spice is a family friendly english pub near Rainbow Vegetarian Café in the riverside area.'
'name[Blue Spice], eatType[restaurant], food[Chinese], area[city centre], familyFriendly[no], near[Rainbow Vegetarian Café]'	'Blue Spice is a non-family-friendly chinese restaurant in the city centre near Rainbow Vegetarian Café.'
'name[Blue Spice], eatType[restaurant], food[Chinese], area[city centre], familyFriendly[yes], near[Rainbow Vegetarian Café]'	'Blue Spice is a family friendly chinese restaurant in the city centre near Rainbow Vegetarian Café.'
'name[Blue Spice], eatType[restaurant], food[Chinese], area[riverside], familyFriendly[no], near[Rainbow Vegetarian Café]'	'Blue Spice is a non-family friendly chinese restaurant in the riverside area near Rainbow Vegetarian Café.'
'name[Blue Spice], eatType[restaurant], food[Chinese], area[riverside], familyFriendly[yes], near[Rainbow Vegetarian Café]'	'Blue Spice is a family friendly chinese restaurant in the riverside area near Rainbow Vegetarian Café.'
'name[Blue Spice], eatType[restaurant], food[English], area[city centre], familyFriendly[no], near[Rainbow Vegetarian Café]'	'Blue Spice is an english restaurant located in the city centre near Rainbow Vegetarian Café. It is not family-friendly.'
'name[Blue Spice], eatType[restaurant], food[English], area[city centre], familyFriendly[yes], near[Rainbow Vegetarian Café]'	'Blue Spice is a family-friendly english restaurant in the city centre near Rainbow Vegetarian Café.'
'name[Blue Spice], eatType[restaurant], food[English], area[riverside], familyFriendly[no], near[Rainbow Vegetarian Café]'	'Blue Spice is a non-family-friendly english restaurant in the riverside area near Rainbow Vegetarian Café.'
'name[Blue Spice], eatType[restaurant], food[English], area[riverside], familyFriendly[yes], near[Rainbow Vegetarian Café]'	'Blue Spice is a family friendly english restaurant in the riverside area near Rainbow Vegetarian Café.'
'name[Clowns], eatType[coffee shop], customer rating[3 out of 5], near[All Bar One]'	'With a customer rating of 3 out of 5, Clowns is a coffee shop near All Bar One.'
'name[Clowns], eatType[coffee shop], customer rating[5 out of 5], near[Crowne Plaza Hotel]'	'With a customer rating of 5 out of 5, Clowns is a coffee shop near Crowne Plaza Hotel.'
'name[Clowns], eatType[coffee shop], near[The Sorrento]'	'Near The Sorrento is Clowns. It is a coffee shop.'
'name[Clowns], eatType[pub], customer rating[3 out of 5], near[All Bar One]'	'Clowns is a pub near All Bar One. It has a customer rating of 3 out of 5.'
'name[Clowns], eatType[pub], customer rating[5 out of 5], near[Crowne Plaza Hotel]'	'Clowns is a pub near Crowne Plaza Hotel with a customer rating of 5 out of 5.'
'name[Clowns], eatType[pub], near[The Sorrento]'	'Clowns is a pub near The Sorrento.'
'name[Cocum], eatType[coffee shop], customer rating[high], near[Burger King]'	'Cocum is a high customer rating coffee shop near Burger King.'
'name[Cocum], eatType[coffee shop], customer rating[high], near[Café Sicilia]'	'Near Café Sicilia is a highly rated coffee shop named Cocum.'
'name[Cocum], eatType[coffee shop], customer rating[low], near[Café Sicilia]'	'With a low customer rating, Cocum is a coffee shop near Café Sicilia.'
'name[Cocum], eatType[coffee shop], customer rating[low], near[Express by Holiday Inn]'	'With a low customer rating, Cocum is a coffee shop near Express by Holiday Inn.'
'name[Cocum], eatType[coffee shop], near[The Rice Boat]'	'Near The Rice Boat is Cocum. It is a coffee shop.'
'name[Cocum], eatType[coffee shop], near[The Sorrento]'	'Near The Sorrento is Cocum. It is a coffee shop.'
'name[Cocum], eatType[pub], customer rating[high], near[Burger King]'	'Cocum is a pub near Burger King with a high customer rating.'
'name[Cocum], eatType[pub], customer rating[high], near[Café Sicilia]'	'Cocum is a pub near Café Sicilia with a high customer rating.'
'name[Cocum], eatType[pub], customer rating[low], near[Café Sicilia]'	'Cocum is a pub near Café Sicilia with a low customer rating.'
'name[Cocum], eatType[pub], customer rating[low], near[Express by Holiday Inn]'	'Cocum is a pub near Express by Holiday Inn with a low customer rating.'
'name[Cocum], eatType[pub], near[The Rice Boat]'	'Cocum is a pub near The Rice Boat.'
'name[Cocum], eatType[pub], near[The Sorrento]'	'Cocum is a pub near The Sorrento.'
'name[Cotto], eatType[coffee shop], near[The Bakers]'	'Near The Bakers is Cotto. It is a coffee shop.'
'name[Cotto], eatType[pub], near[The Bakers]'	'Cotto is a pub near The Bakers.'
'name[Giraffe], eatType[coffee shop], near[The Bakers]'	'Near The Bakers is Giraffe. It is a coffee shop.'
'name[Giraffe], eatType[coffee shop], near[The Rice Boat]'	'Near The Rice Boat is Giraffe. It is a coffee shop.'
'name[Giraffe], eatType[pub], food[English], area[riverside], familyFriendly[yes], near[Rainbow Vegetarian Café]'	'Giraffe is a family friendly english pub near Rainbow Vegetarian Café in the riverside area.'
'name[Giraffe], eatType[pub], food[Fast food], area[city centre], familyFriendly[no], near[Rainbow Vegetarian Café]'	'Giraffe is a fast food pub located near Rainbow Vegetarian Café in the city centre. It is not family-friendly.'
'name[Giraffe], eatType[pub], food[Fast food], area[city centre], familyFriendly[yes], near[Rainbow Vegetarian Café]'	'Giraffe is a family-friendly fast food pub in the city centre near Rainbow Vegetarian Café.'
'name[Giraffe], eatType[pub], food[Fast food], area[riverside], familyFriendly[no], near[Rainbow Vegetarian Café]'	'Giraffe is a fast food pub near Rainbow Vegetarian Café in the riverside area. It is not family-friendly.'
'name[Giraffe], eatType[pub], food[Fast food], area[riverside], familyFriendly[yes], near[Rainbow Vegetarian Café]'	'Giraffe is a family friendly fast food pub in the riverside area near Rainbow Vegetarian Café.'
'name[Giraffe], eatType[pub], food[Fast food], area[riverside], familyFriendly[yes], near[Raja Indian Cuisine]'	'Giraffe is a family friendly fast food pub in the riverside area near Raja Indian Cuisine.'
'name[Giraffe], eatType[pub], food[French], area[city centre], familyFriendly[no], near[Raja Indian Cuisine]'	'Giraffe is a non-family-friendly french pub near Raja Indian Cuisine in the city centre.'
'name[Giraffe], eatType[pub], food[French], area[city centre], familyFriendly[yes], near[Raja Indian Cuisine]'	'Giraffe is a family-friendly french pub in the city centre near Raja Indian Cuisine.'
'name[Giraffe], eatType[pub], food[French], area[riverside], familyFriendly[no], near[Raja Indian Cuisine]'	'Giraffe is a french pub near Raja Indian Cuisine in the riverside area. It is not family-friendly.'
'name[Giraffe], eatType[pub], food[French], area[riverside], familyFriendly[yes], near[Raja Indian Cuisine]'	'Giraffe is a family friendly french pub in riverside near Raja Indian Cuisine.'
'name[Giraffe], eatType[pub], near[The Bakers]'	'Giraffe is a pub near The Bakers.'
'name[Giraffe], eatType[pub], near[The Rice Boat]'	'Giraffe is a pub near The Rice Boat.'
'name[Giraffe], eatType[restaurant], food[English], area[riverside], familyFriendly[yes], near[Rainbow Vegetarian Café]'	'Giraffe is a family friendly english restaurant in the riverside area near Rainbow Vegetarian Café.'
'name[Giraffe], eatType[restaurant], food[Fast food], area[city centre], familyFriendly[no], near[Rainbow Vegetarian Café]'	'Giraffe is a non-family-friendly fast food restaurant in the city centre near Rainbow Vegetarian Café.'
'name[Giraffe], eatType[restaurant], food[Fast food], area[city centre], familyFriendly[yes], near[Rainbow Vegetarian Café]'	'Giraffe is a family-friendly fast food restaurant in the city centre near Rainbow Vegetarian Café.'
'name[Giraffe], eatType[restaurant], food[Fast food], area[riverside], familyFriendly[no], near[Rainbow Vegetarian Café]'	'Giraffe is a fast food restaurant near Rainbow Vegetarian Café in the riverside area. It is not family-friendly.'
'name[Giraffe], eatType[restaurant], food[Fast food], area[riverside], familyFriendly[yes], near[Rainbow Vegetarian Café]'	'Giraffe is a family friendly fast food restaurant in the riverside area near Rainbow Vegetarian Café.'
'name[Giraffe], eatType[restaurant], food[Fast food], area[riverside], familyFriendly[yes], near[Raja Indian Cuisine]'	'Giraffe is a family friendly fast food restaurant in the riverside area near Raja Indian Cuisine.'
'name[Giraffe], eatType[restaurant], food[French], area[city centre], familyFriendly[no], near[Raja Indian Cuisine]'	'Giraffe is a non-family-friendly french restaurant in the city centre near Raja Indian Cuisine.'
'name[Giraffe], eatType[restaurant], food[French], area[city centre], familyFriendly[yes], near[Raja Indian Cuisine]'	'Giraffe is a family-friendly french restaurant located near Raja Indian Cuisine in the city centre.'
'name[Giraffe], eatType[restaurant], food[French], area[riverside], familyFriendly[no], near[Raja Indian Cuisine]'	'Giraffe is a non-family-friendly french restaurant in the riverside area near Raja Indian Cuisine.'
'name[Giraffe], eatType[restaurant], food[French], area[riverside], familyFriendly[yes], near[Raja Indian Cuisine]'	'Giraffe is a family friendly french restaurant in riverside near Raja Indian Cuisine.'
'name[Green Man], eatType[coffee shop], customer rating[1 out of 5], near[All Bar One]'	'Green Man is a 1 out of 5 rated coffee shop near All Bar One.'
'name[Green Man], eatType[coffee shop], customer rating[3 out of 5], near[All Bar One]'	'With a customer rating of 3 out of 5, Green Man is a coffee shop near All Bar One.'
'name[Green Man], eatType[pub], customer rating[1 out of 5], near[All Bar One]'	'Green Man is a pub near All Bar One. It has a customer rating of 1 out of 5.'
'name[Green Man], eatType[pub], customer rating[3 out of 5], near[All Bar One]'	'Green Man is a pub near All Bar One with a customer rating of 3 out of 5.'
'name[Green Man], eatType[pub], food[Italian], area[riverside], familyFriendly[yes], near[Express by Holiday Inn]'	'Green Man is a family friendly italian pub near Express by Holiday Inn in riverside.'
'name[Green Man], eatType[pub], food[Italian], area[riverside], familyFriendly[yes], near[Raja Indian Cuisine]'	'Green Man is a family friendly italian pub in riverside near Raja Indian Cuisine.'
'name[Green Man], eatType[pub], food[Japanese], area[city centre], familyFriendly[no], near[Express by Holiday Inn]'	'Green Man is a non-family-friendly pub serving japanese food near Express by Holiday Inn in the city centre.'
'name[Green Man], eatType[pub], food[Japanese], area[city centre], familyFriendly[yes], near[Express by Holiday Inn]'	'Green Man is a family-friendly japanese pub near Express by Holiday Inn in the city centre.'
'name[Green Man], eatType[pub], food[Japanese], area[riverside], familyFriendly[no], near[Express by Holiday Inn]'	'Green Man is a japanese pub near Express by Holiday Inn in the riverside area. It is not family-friendly.'
'name[Green Man], eatType[pub], food[Japanese], area[riverside], familyFriendly[yes], near[Express by Holiday Inn]'	'Green Man is a family friendly japanese pub near Express by Holiday Inn in the riverside area.'
'name[Green Man], eatType[restaurant], food[Italian], area[riverside], familyFriendly[yes], near[Express by Holiday Inn]'	'Green Man is a family friendly italian restaurant in riverside near Express by Holiday Inn.'
'name[Green Man], eatType[restaurant], food[Italian], area[riverside], familyFriendly[yes], near[Raja Indian Cuisine]'	'Green Man is a family friendly italian restaurant in riverside near Raja Indian Cuisine.'
'name[Green Man], eatType[restaurant], food[Japanese], area[city centre], familyFriendly[no], near[Express by Holiday Inn]'	'Green Man is a non-family-friendly japanese restaurant in the city centre near Express by Holiday Inn.'
'name[Green Man], eatType[restaurant], food[Japanese], area[city centre], familyFriendly[yes], near[Express by Holiday Inn]'	'Green Man is a family-friendly japanese restaurant located in the city centre near Express by Holiday Inn.'
'name[Green Man], eatType[restaurant], food[Japanese], area[riverside], familyFriendly[no], near[Express by Holiday Inn]'	'Green Man is a non-family-friendly japanese restaurant near Express by Holiday Inn in the riverside area.'
'name[Green Man], eatType[restaurant], food[Japanese], area[riverside], familyFriendly[yes], near[Express by Holiday Inn]'	'Green Man is a family friendly japanese restaurant in riverside near Express by Holiday Inn.'
'name[Loch Fyne], eatType[coffee shop], area[riverside]'	'In the riverside area, Loch Fyne is a coffee shop.'
'name[Loch Fyne], eatType[pub], area[riverside]'	'By the riverside is a pub called Loch Fyne.'
'name[Strada], eatType[coffee shop], area[city centre]'	'The city centre is a coffee shop called Strada.'
'name[Strada], eatType[coffee shop], customer rating[1 out of 5], near[All Bar One]'	'Strada is a 1 out of 5 coffee shop near All Bar One.'
'name[Strada], eatType[coffee shop], customer rating[1 out of 5], near[Rainbow Vegetarian Café]'	'Strada is a 1 out of 5 rated coffee shop near Rainbow Vegetarian Café.'
'name[Strada], eatType[coffee shop], customer rating[low], near[Express by Holiday Inn]'	'With a low customer rating, Strada is a coffee shop near Express by Holiday Inn.'
'name[Strada], eatType[pub], area[city centre]'	'The pub in the city centre is Strada.'
'name[Strada], eatType[pub], customer rating[1 out of 5], near[All Bar One]'	'Strada is a pub near All Bar One with a customer rating of 1 out of 5.'
'name[Strada], eatType[pub], customer rating[1 out of 5], near[Rainbow Vegetarian Café]'	'Strada is a pub near Rainbow Vegetarian Café with a customer rating of 1 out of 5.'
'name[Strada], eatType[pub], customer rating[low], near[Express by Holiday Inn]'	'Strada is a pub near Express by Holiday Inn with a low customer rating.'
'name[The Cricketers], eatType[coffee shop], customer rating[1 out of 5], familyFriendly[yes], near[Avalon]'	'The Cricketers is a child friendly coffee shop near Avalon with a customer rating of 1 out of 5.'
'name[The Cricketers], eatType[coffee shop], customer rating[3 out of 5], familyFriendly[yes], near[Avalon]'	'With a customer rating of 3 out of 5, The Cricketers is a child friendly coffee shop near Avalon.'
'name[The Cricketers], eatType[coffee shop], customer rating[3 out of 5], familyFriendly[yes], near[Crowne Plaza Hotel]'	'The Cricketers is a child friendly coffee shop near Crowne Plaza Hotel with a customer rating of 3 out of 5.'
'name[The Cricketers], eatType[coffee shop], customer rating[5 out of 5], familyFriendly[no], near[Crowne Plaza Hotel]'	'The Cricketers is a coffee shop near Crowne Plaza Hotel with a customer rating of 5 out of 5 and is not family-friendly.'
'name[The Cricketers], eatType[coffee shop], customer rating[5 out of 5], familyFriendly[yes], near[Crowne Plaza Hotel]'	'The Cricketers is a family friendly coffee shop near Crowne Plaza Hotel. It has a customer rating of 5 out of 5.'
'name[The Cricketers], eatType[coffee shop], customer rating[average], familyFriendly[no], near[Café Sicilia]'	'The Cricketers is a coffee shop near Café Sicilia that has an average customer rating and is not family-friendly.'
'name[The Cricketers], eatType[coffee shop], customer rating[average], familyFriendly[no], near[Crowne Plaza Hotel]'	'The Cricketers is a coffee shop near Crowne Plaza Hotel that has an average customer rating and is not family-friendly.'
'name[The Cricketers], eatType[coffee shop], customer rating[average], familyFriendly[yes], near[Café Sicilia]'	'The Cricketers is a family friendly coffee shop near Café Sicilia. It has an average customer rating.'
'name[The Cricketers], eatType[coffee shop], customer rating[high], familyFriendly[yes], near[Café Sicilia]'	'The Cricketers is a child friendly coffee shop near Café Sicilia with a high customer rating.'
'name[The Cricketers], eatType[coffee shop], customer rating[high], familyFriendly[yes], near[Express by Holiday Inn]'	'The Cricketers is a child friendly coffee shop near Express by Holiday Inn with a high customer rating.'
'name[The Cricketers], eatType[coffee shop], customer rating[low], familyFriendly[no], near[Express by Holiday Inn]'	'The Cricketers is a coffee shop near Express by Holiday Inn. It is not family-friendly and has a low customer rating.'
'name[The Cricketers], eatType[coffee shop], customer rating[low], familyFriendly[no], near[Ranch]'	'The Cricketers is a coffee shop near Ranch. It is not family-friendly and has a low customer rating.'
'name[The Cricketers], eatType[coffee shop], customer rating[low], familyFriendly[yes], near[Ranch]'	'The Cricketers is a family friendly coffee shop with a low customer rating near Ranch.'
'name[The Cricketers], eatType[restaurant], customer rating[1 out of 5], familyFriendly[yes], near[Avalon]'	'The Cricketers is a kid friendly restaurant near Avalon with a customer rating of 1 out of 5.'
'name[The Cricketers], eatType[restaurant], customer rating[3 out of 5], familyFriendly[yes], near[Avalon]'	'The Cricketers is a children friendly restaurant near Avalon with a customer rating of 3 out of 5.'
'name[The Cricketers], eatType[restaurant], customer rating[3 out of 5], familyFriendly[yes], near[Crowne Plaza Hotel]'	'With a customer rating of 3 out of 5, The Cricketers is a child friendly restaurant near Crowne Plaza Hotel.'
'name[The Cricketers], eatType[restaurant], customer rating[5 out of 5], familyFriendly[no], near[Crowne Plaza Hotel]'	'The Cricketers is a restaurant near Crowne Plaza Hotel that has a 5 out of 5 customer rating and is not family-friendly.'
'name[The Cricketers], eatType[restaurant], customer rating[5 out of 5], familyFriendly[yes], near[Crowne Plaza Hotel]'	'The Cricketers is a child friendly restaurant near Crowne Plaza Hotel with a customer rating of 5 out of 5.'
'name[The Cricketers], eatType[restaurant], customer rating[average], familyFriendly[no], near[Café Sicilia]'	'The Cricketers is a restaurant near Café Sicilia that has an average customer rating and is not family-friendly.'
'name[The Cricketers], eatType[restaurant], customer rating[average], familyFriendly[no], near[Crowne Plaza Hotel]'	'The Cricketers is a restaurant near Crowne Plaza Hotel that has an average customer rating and is not family-friendly.'
'name[The Cricketers], eatType[restaurant], customer rating[average], familyFriendly[yes], near[Café Sicilia]'	'The Cricketers is a family friendly restaurant with an average customer rating near Café Sicilia.'
'name[The Cricketers], eatType[restaurant], customer rating[high], familyFriendly[yes], near[Café Sicilia]'	'The Cricketers is a child friendly restaurant near Café Sicilia with a high customer rating.'
'name[The Cricketers], eatType[restaurant], customer rating[high], familyFriendly[yes], near[Express by Holiday Inn]'	'The Cricketers is a kid friendly restaurant near Express by Holiday Inn with a high customer rating.'
'name[The Cricketers], eatType[restaurant], customer rating[low], familyFriendly[no], near[Express by Holiday Inn]'	'The Cricketers is a restaurant near Express by Holiday Inn that is not family-friendly and has a low customer rating.'
'name[The Cricketers], eatType[restaurant], customer rating[low], familyFriendly[no], near[Ranch]'	'The Cricketers is a restaurant near Ranch that is not family-friendly and has a low customer rating.'
'name[The Cricketers], eatType[restaurant], customer rating[low], familyFriendly[yes], near[Ranch]'	'The Cricketers is a family friendly restaurant with a low customer rating near Ranch.'
'name[The Cricketers], eatType[restaurant], food[Chinese], priceRange[£20-25], customer rating[high], area[city centre], familyFriendly[no], near[All Bar One]'	'The Cricketers provides chinese food in the £20-25 price range. It is located in the city centre. It is near All Bar One. Its customer rating is high.'
'name[The Cricketers], eatType[restaurant], food[Chinese], priceRange[£20-25], customer rating[high], area[city centre], familyFriendly[yes], near[All Bar One]'	'The Cricketers is a restaurant providing chinese food in the £20-25 price range. It is located in the city centre. It is near All Bar One. Its customer rating is high.'
'name[The Cricketers], eatType[restaurant], food[Chinese], priceRange[£20-25], customer rating[high], area[riverside], familyFriendly[no], near[All Bar One]'	'The Cricketers provides chinese food in the £20-25 price range. It is located in the riverside. It is near All Bar One. Its customer rating is high.'
'name[The Cricketers], eatType[restaurant], food[Chinese], priceRange[£20-25], customer rating[high], area[riverside], familyFriendly[yes], near[All Bar One]'	'The Cricketers is a restaurant providing chinese food in the £20-25 price range. It is located in the riverside. It is near All Bar One. Its customer rating is high.'
'name[The Cricketers], eatType[restaurant], food[Chinese], priceRange[cheap], customer rating[5 out of 5], area[city centre], familyFriendly[no], near[All Bar One]'	'The Cricketers provides chinese food in the cheap price range. It is located in the city centre. It is near All Bar One. Its customer rating is 5 out of 5.'
'name[The Cricketers], eatType[restaurant], food[Chinese], priceRange[cheap], customer rating[5 out of 5], area[city centre], familyFriendly[yes], near[All Bar One]'	'The Cricketers provides chinese food in the cheap price range. It is located in the city centre near All Bar One. Its customer rating is 5 out of 5.'
'name[The Cricketers], eatType[restaurant], food[Chinese], priceRange[cheap], customer rating[5 out of 5], area[riverside], familyFriendly[no], near[All Bar One]'	'The Cricketers provides chinese food in the cheap price range. It is located in the riverside. It is near All Bar One. Its customer rating is 5 out of 5.'
'name[The Cricketers], eatType[restaurant], food[Chinese], priceRange[cheap], customer rating[5 out of 5], area[riverside], familyFriendly[yes], near[All Bar One]'	'The Cricketers is a cheap chinese restaurant in the riverside area near All Bar One. It has a 5 out of 5 customer rating and is family friendly.'
'name[The Cricketers], eatType[restaurant], food[Chinese], priceRange[cheap], customer rating[average], area[city centre], familyFriendly[no], near[All Bar One]'	'The Cricketers provides chinese food in the cheap price range. It is located in the city centre. It is near All Bar One. Its customer rating is average.'
'name[The Cricketers], eatType[restaurant], food[Chinese], priceRange[cheap], customer rating[average], area[city centre], familyFriendly[yes], near[All Bar One]'	'The Cricketers is a chinese restaurant located in the city centre near All Bar One. It is family friendly and has an average customer rating.'
'name[The Cricketers], eatType[restaurant], food[Chinese], priceRange[cheap], customer rating[average], area[riverside], familyFriendly[no], near[All Bar One]'	'The Cricketers provides chinese food in the cheap price range. It is located in the riverside. It is near All Bar One. Its customer rating is average.'
'name[The Cricketers], eatType[restaurant], food[Chinese], priceRange[cheap], customer rating[average], area[riverside], familyFriendly[yes], near[All Bar One]'	'The Cricketers provides chinese food in the cheap price range. It is located in the riverside. It is near All Bar One. Its customer rating is average.'
'name[The Cricketers], eatType[restaurant], food[Chinese], priceRange[high], customer rating[1 out of 5], area[city centre], familyFriendly[no], near[All Bar One]'	'The Cricketers provides chinese food in the high price range. It is located in the city centre. It is near All Bar One. Its customer rating is 1 out of 5.'
'name[The Cricketers], eatType[restaurant], food[Chinese], priceRange[high], customer rating[1 out of 5], area[city centre], familyFriendly[yes], near[All Bar One]'	'The Cricketers is a restaurant providing chinese food in the high price range. It is located in the city centre. It is near All Bar One. Its customer rating is 1 out of 5.'
'name[The Cricketers], eatType[restaurant], food[Chinese], priceRange[high], customer rating[1 out of 5], area[riverside], familyFriendly[no], near[All Bar One]'	'The Cricketers is a restaurant providing chinese food in the high price range. It is located in the riverside. It is near All Bar One. Its customer rating is 1 out of 5.'
'name[The Cricketers], eatType[restaurant], food[Chinese], priceRange[high], customer rating[1 out of 5], area[riverside], familyFriendly[yes], near[All Bar One]'	'The Cricketers is a restaurant providing chinese food in the high price range. It is located in the city centre. It is near All Bar One. Its customer rating is 1 out of 5.'
'name[The Cricketers], eatType[restaurant], food[Chinese], priceRange[high], customer rating[average], area[city centre], familyFriendly[no], near[All Bar One]'	'The Cricketers provides chinese food in the high price range. It is located in the city centre. It is near All Bar One. Its customer rating is average.'
'name[The Cricketers], eatType[restaurant], food[Chinese], priceRange[high], customer rating[average], area[city centre], familyFriendly[yes], near[All Bar One]'	'The Cricketers provides chinese food in the high price range. It is located in the city centre near All Bar One. Its customer rating is average.'
'name[The Cricketers], eatType[restaurant], food[Chinese], priceRange[high], customer rating[average], area[riverside], familyFriendly[no], near[All Bar One]'	'The Cricketers provides chinese food in the high price range. It is located in the riverside. It is near All Bar One. Its customer rating is average.'
'name[The Cricketers], eatType[restaurant], food[Chinese], priceRange[high], customer rating[average], area[riverside], familyFriendly[yes], near[All Bar One]'	'The Cricketers provides chinese food in the high price range. It is located in the riverside. It is near All Bar One. Its customer rating is average.'
'name[The Cricketers], eatType[restaurant], food[Chinese], priceRange[less than £20], customer rating[low], area[city centre], familyFriendly[no], near[All Bar One]'	'The Cricketers provides chinese food in the less than £20 price range. It is located in the city centre. It is near All Bar One. Its customer rating is low.'
'name[The Cricketers], eatType[restaurant], food[Chinese], priceRange[less than £20], customer rating[low], area[city centre], familyFriendly[yes], near[All Bar One]'	'The Cricketers is a chinese restaurant located in the city centre near All Bar One. It is family friendly and has a low customer rating.'
'name[The Cricketers], eatType[restaurant], food[Chinese], priceRange[less than £20], customer rating[low], area[riverside], familyFriendly[no], near[All Bar One]'	'The Cricketers provides chinese food in the less than £20 price range. It is located in the riverside. It is near All Bar One. Its customer rating is low.'
'name[The Cricketers], eatType[restaurant], food[Chinese], priceRange[less than £20], customer rating[low], area[riverside], familyFriendly[yes], near[All Bar One]'	'The Cricketers is a restaurant providing chinese food in the low price range. It is located in the riverside. Its customer rating is low. It is near All Bar One.'
'name[The Cricketers], eatType[restaurant], food[Chinese], priceRange[moderate], customer rating[1 out of 5], area[city centre], familyFriendly[no], near[All Bar One]'	'The Cricketers provides chinese food in the moderate price range. It is located in the city centre near All Bar One. Its customer rating is 1 out of 5.'
'name[The Cricketers], eatType[restaurant], food[Chinese], priceRange[moderate], customer rating[1 out of 5], area[city centre], familyFriendly[yes], near[All Bar One]'	'The Cricketers provides chinese food in the moderate price range. It is located in the city centre. It is near All Bar One. Its customer rating is 1 out of 5.'
'name[The Cricketers], eatType[restaurant], food[Chinese], priceRange[moderate], customer rating[1 out of 5], area[riverside], familyFriendly[no], near[All Bar One]'	'The Cricketers is a restaurant providing chinese food in the moderate price range. It is located in the riverside. It is near All Bar One. Its customer rating is 1 out of 5.'
'name[The Cricketers], eatType[restaurant], food[Chinese], priceRange[moderate], customer rating[1 out of 5], area[riverside], familyFriendly[yes], near[All Bar One]'	'The Cricketers provides chinese food in the moderate price range. It is located in the riverside. It is near All Bar One. Its customer rating is 1 out of 5.'
'name[The Cricketers], eatType[restaurant], food[Chinese], priceRange[moderate], customer rating[3 out of 5], area[city centre], familyFriendly[no], near[All Bar One]'	'The Cricketers is a restaurant providing chinese food in the moderate price range. It is located in the city centre. It is near All Bar One. Its customer rating is 3 out of 5.'
'name[The Cricketers], eatType[restaurant], food[Chinese], priceRange[moderate], customer rating[3 out of 5], area[city centre], familyFriendly[yes], near[All Bar One]'	'The Cricketers is a restaurant that provides chinese food in the moderate price range. It is located in the city centre. It is near All Bar One. Its customer rating is 3 out of 5.'
'name[The Cricketers], eatType[restaurant], food[Chinese], priceRange[moderate], customer rating[3 out of 5], area[riverside], familyFriendly[no], near[All Bar One]'	'The Cricketers is a restaurant providing chinese food in the moderate price range. It is located in the riverside. It is near All Bar One. Its customer rating is 3 out of 5.'
'name[The Cricketers], eatType[restaurant], food[Chinese], priceRange[moderate], customer rating[3 out of 5], area[riverside], familyFriendly[yes], near[All Bar One]'	'The Cricketers is a restaurant that provides chinese food in the moderate price range. It is located in the riverside. It is near All Bar One. Its customer rating is 3 out of 5.'
'name[The Cricketers], eatType[restaurant], food[Chinese], priceRange[more than £30], customer rating[high], area[city centre], familyFriendly[no], near[All Bar One]'	'The Cricketers provides chinese food in the more than £30 price range. It is located in the city centre. It is near All Bar One. Its customer rating is high.'
'name[The Cricketers], eatType[restaurant], food[Chinese], priceRange[more than £30], customer rating[high], area[city centre], familyFriendly[yes], near[All Bar One]'	'The Cricketers is a restaurant that provides chinese food in the more than £30 price range. It is located in the city centre. It is near All Bar One. Its customer rating is high.'
'name[The Cricketers], eatType[restaurant], food[Chinese], priceRange[more than £30], customer rating[high], area[riverside], familyFriendly[no], near[All Bar One]'	'The Cricketers provides chinese food in the more than £30 price range. It is located in the riverside. It is near All Bar One. Its customer rating is high.'
'name[The Cricketers], eatType[restaurant], food[Chinese], priceRange[more than £30], customer rating[high], area[riverside], familyFriendly[yes], near[All Bar One]'	'The Cricketers provides chinese food in the more than £30 price range. It is located in the riverside. It is near All Bar One. Its customer rating is high.'
'name[The Cricketers], eatType[restaurant], food[English], priceRange[£20-25], customer rating[high], area[city centre], familyFriendly[no], near[All Bar One]'	'The Cricketers is a restaurant providing english food in the £20-25 price range. It is located in the city centre. It is near All Bar One. Its customer rating is high.'
'name[The Cricketers], eatType[restaurant], food[English], priceRange[£20-25], customer rating[high], area[city centre], familyFriendly[yes], near[All Bar One]'	'The Cricketers is a restaurant providing english food in the £20-25 price range. It is located in the city centre. It is near All Bar One. Its customer rating is high.'
'name[The Cricketers], eatType[restaurant], food[English], priceRange[£20-25], customer rating[high], area[riverside], familyFriendly[no], near[All Bar One]'	'The Cricketers is a restaurant providing english food in the £20-25 price range. It is located in the riverside. It is near All Bar One. Its customer rating is high.'
'name[The Cricketers], eatType[restaurant], food[English], priceRange[£20-25], customer rating[high], area[riverside], familyFriendly[yes], near[All Bar One]'	'The Cricketers is a restaurant providing english food in the £20-25 price range. It is located in the riverside. It is near All Bar One. Its customer rating is high.'
'name[The Cricketers], eatType[restaurant], food[English], priceRange[cheap], customer rating[5 out of 5], area[city centre], familyFriendly[no], near[Café Rouge]'	'The Cricketers is a restaurant providing english food in the cheap price range. It is located in the city centre. It is near Café Rouge. Its customer rating is 5 out of 5.'
'name[The Cricketers], eatType[restaurant], food[English], priceRange[cheap], customer rating[5 out of 5], area[city centre], familyFriendly[yes], near[Café Rouge]'	'The Cricketers is a family-friendly english restaurant with a cheap price range and a customer rating of 5 out of 5. It is located in the city centre near Café Rouge.'
'name[The Cricketers], eatType[restaurant], food[English], priceRange[cheap], customer rating[5 out of 5], area[riverside], familyFriendly[no], near[Café Rouge]'	'The Cricketers is a restaurant providing english food in the cheap price range. It is located in the riverside area near Café Rouge. Its customer rating is 5 out of 5.'
'name[The Cricketers], eatType[restaurant], food[English], priceRange[cheap], customer rating[5 out of 5], area[riverside], familyFriendly[yes], near[Café Rouge]'	'The Cricketers is a restaurant providing english food in the low price range. It is located in the riverside area near Café Rouge. It has a 5 out of 5 customer rating and is family friendly.'
'name[The Cricketers], eatType[restaurant], food[English], priceRange[cheap], customer rating[average], area[city centre], familyFriendly[no], near[Café Rouge]'	'The Cricketers is a restaurant providing english food in the cheap price range. It is located in the city centre near Café Rouge. Its customer rating is average.'
'name[The Cricketers], eatType[restaurant], food[English], priceRange[cheap], customer rating[average], area[city centre], familyFriendly[yes], near[Café Rouge]'	'The Cricketers is a family-friendly restaurant located in the city centre near Café Rouge. It serves english food and has an average customer rating.'
'name[The Cricketers], eatType[restaurant], food[English], priceRange[cheap], customer rating[average], area[riverside], familyFriendly[no], near[Café Rouge]'	'The Cricketers is an english restaurant near Café Rouge in the riverside area. It has an average customer rating and a cheap price range. It is not family-friendly.'
'name[The Cricketers], eatType[restaurant], food[English], priceRange[cheap], customer rating[average], area[riverside], familyFriendly[yes], near[Café Rouge]'	'The Cricketers is a restaurant providing english food in the low price range. It is located in the riverside area near Café Rouge. It has an average customer rating and is family friendly.'
'name[The Cricketers], eatType[restaurant], food[English], priceRange[high], customer rating[1 out of 5], area[city centre], familyFriendly[no], near[Café Rouge]'	'The Cricketers is a restaurant providing english food in the high price range. It is located in the city centre near Café Rouge. It is not child friendly and has a customer rating of 1 out of 5.'
'name[The Cricketers], eatType[restaurant], food[English], priceRange[high], customer rating[1 out of 5], area[city centre], familyFriendly[yes], near[Café Rouge]'	'The Cricketers is a restaurant providing english food in the high price range. It is located in the city centre near Café Rouge. It is child friendly and has a customer rating of 1 out of 5.'
'name[The Cricketers], eatType[restaurant], food[English], priceRange[high], customer rating[1 out of 5], area[riverside], familyFriendly[no], near[Café Rouge]'	'The Cricketers is a restaurant providing english food in the high price range. It is located near Café Rouge. It is not child friendly and has a customer rating of 1 out of 5.'
'name[The Cricketers], eatType[restaurant], food[English], priceRange[high], customer rating[1 out of 5], area[riverside], familyFriendly[yes], near[Café Rouge]'	'The Cricketers is a restaurant providing english food in the high price range. It is located in the riverside area near Café Rouge. It has a customer rating of 1 out of 5 and is children friendly.'
'name[The Cricketers], eatType[restaurant], food[English], priceRange[high], customer rating[average], area[city centre], familyFriendly[no], near[Café Rouge]'	'The Cricketers is a restaurant providing english food in the high price range. It is located in the city centre near Café Rouge. It has an average customer rating and is not child friendly.'
'name[The Cricketers], eatType[restaurant], food[English], priceRange[high], customer rating[average], area[city centre], familyFriendly[yes], near[Café Rouge]'	'The Cricketers is a restaurant providing english food in the high price range. It is located in the city centre near Café Rouge. It has an average customer rating and is child friendly.'
'name[The Cricketers], eatType[restaurant], food[English], priceRange[high], customer rating[average], area[riverside], familyFriendly[no], near[Café Rouge]'	'The Cricketers is a restaurant providing english food in the high price range. It is located in the riverside area near Café Rouge. It has an average customer rating and is not child friendly.'
'name[The Mill], eatType[pub], food[English], priceRange[high], area[riverside], familyFriendly[yes], near[Raja Indian Cuisine]'	'The Mill is a child friendly english pub in the riverside area near Raja Indian Cuisine. It has a high price range.'
'name[The Mill], eatType[pub], food[English], priceRange[less than £20], area[city centre], familyFriendly[no], near[Raja Indian Cuisine]'	'The Mill is a pub providing english food in the less than £20 price range. It is located in the city centre near Raja Indian Cuisine. It is not family-friendly.'
'name[The Mill], eatType[pub], food[English], priceRange[less than £20], area[city centre], familyFriendly[yes], near[Raja Indian Cuisine]'	'The Mill is a family-friendly pub serving english food in the less than £20 price range. It is located in the city centre near Raja Indian Cuisine.'
'name[The Mill], eatType[pub], food[English], priceRange[less than £20], area[riverside], familyFriendly[no], near[Raja Indian Cuisine]'	'The Mill is an english pub near Raja Indian Cuisine in the riverside area. It is not family-friendly and has a price range of less than £20.'
'name[The Mill], eatType[pub], food[English], priceRange[less than £20], area[riverside], familyFriendly[yes], near[Raja Indian Cuisine]'	'The Mill is a family friendly pub that serves english food for less than £20 near Raja Indian Cuisine in the riverside area.'
'name[The Mill], eatType[pub], food[English], priceRange[moderate], area[city centre], familyFriendly[no], near[Raja Indian Cuisine]'	'The Mill is a pub providing english food in the moderate price range. It is located in the city centre near Raja Indian Cuisine. It is not kids friendly.'
'name[The Mill], eatType[pub], food[English], priceRange[moderate], area[city centre], familyFriendly[yes], near[Raja Indian Cuisine]'	'The Mill is a kid-friendly pub serving english food in the moderate price range. It is located near Raja Indian Cuisine in the city centre.'
'name[The Mill], eatType[pub], food[English], priceRange[moderate], area[riverside], familyFriendly[no], near[Raja Indian Cuisine]'	'The Mill is a moderately priced english pub in the riverside area near Raja Indian Cuisine. It is not kid friendly.'
'name[The Mill], eatType[pub], food[English], priceRange[moderate], area[riverside], familyFriendly[yes], near[Raja Indian Cuisine]'	'The Mill is a moderately priced, kid friendly english pub near Raja Indian Cuisine in the riverside area.'
'name[The Mill], eatType[pub], food[English], priceRange[more than £30], area[riverside], familyFriendly[yes], near[Raja Indian Cuisine]'	'The Mill is a child friendly english pub near Raja Indian Cuisine in the riverside area with a price range of more than £30.'
'name[The Mill], eatType[pub], food[Fast food], priceRange[£20-25], area[riverside], familyFriendly[yes], near[Raja Indian Cuisine]'	'The Mill is a kid friendly fast food pub in the riverside area near Raja Indian Cuisine. It has a price range of £20-25.'
'name[The Mill], eatType[pub], food[Fast food], priceRange[£20-25], customer rating[high], area[city centre], familyFriendly[no], near[Café Rouge]'	'The Mill is a fast food pub located in the city centre near Café Rouge. It is not child friendly and has a high customer rating and a price range of £20-25.'
'name[The Mill], eatType[pub], food[Fast food], priceRange[£20-25], customer rating[high], area[city centre], familyFriendly[yes], near[Café Rouge]'	'The Mill is a kid friendly fast food restaurant located in the city centre near Café Rouge. It has a high customer rating and a price range of £20-25.'
'name[The Mill], eatType[pub], food[Fast food], priceRange[£20-25], customer rating[high], area[riverside], familyFriendly[no], near[Café Rouge]'	'The Mill is a fast food pub in the riverside area near Café Rouge. It has a high customer rating and a price range of £20-25 and is not kid friendly.'
'name[The Mill], eatType[pub], food[Fast food], priceRange[£20-25], customer rating[high], area[riverside], familyFriendly[yes], near[Café Rouge]'	'The Mill is a kid friendly fast food pub with a price range of £20-25 and a high customer rating. It is located in the riverside area near Café Rouge.'
'name[The Mill], eatType[pub], food[Fast food], priceRange[£20-25], customer rating[high], area[riverside], familyFriendly[yes], near[Café Sicilia]'	'The Mill is a kid friendly fast food pub with a price range of £20-25 and a high customer rating. It is located in the riverside area near Café Sicilia.'
'name[The Mill], eatType[pub], food[Fast food], priceRange[cheap], area[riverside], familyFriendly[yes], near[Raja Indian Cuisine]'	'The Mill is a cheap, family friendly fast food pub in the riverside area near Raja Indian Cuisine.'
'name[The Mill], eatType[pub], food[Fast food], priceRange[cheap], customer rating[5 out of 5], area[city centre], familyFriendly[no], near[Café Sicilia]'	'The Mill is a cheap, highly rated, non-family-friendly italian pub in the city centre near Café Sicilia.'
'name[The Mill], eatType[pub], food[Fast food], priceRange[cheap], customer rating[5 out of 5], area[city centre], familyFriendly[yes], near[Café Sicilia]'	'The Mill is a cheap, family-friendly fast food restaurant located in the city centre near Café Sicilia. It has a customer rating of 5 out of 5.'
'name[The Mill], eatType[pub], food[Fast food], priceRange[cheap], customer rating[5 out of 5], area[riverside], familyFriendly[no], near[Café Sicilia]'	'The Mill is a cheap fast food restaurant located near Café Sicilia. It is not family-friendly and has a customer rating of 5 out of 5.'
'name[The Mill], eatType[pub], food[Fast food], priceRange[cheap], customer rating[5 out of 5], area[riverside], familyFriendly[yes], near[Café Sicilia]'	'The Mill is a cheap, family friendly fast food restaurant with a 5 out of 5 customer rating. It is located in riverside near Café Sicilia.'
'name[The Mill], eatType[pub], food[Fast food], priceRange[cheap], customer rating[average], area[city centre], familyFriendly[no], near[Café Sicilia]'	'The Mill is a cheap fast food pub with an average customer rating. It is located in the city centre near Café Sicilia and is not family-friendly.'
'name[The Mill], eatType[pub], food[Fast food], priceRange[cheap], customer rating[average], area[city centre], familyFriendly[yes], near[Café Sicilia]'	'The Mill is a cheap, family-friendly fast food pub located in the city centre near Café Sicilia.'
'name[The Mill], eatType[pub], food[Fast food], priceRange[cheap], customer rating[average], area[riverside], familyFriendly[no], near[Café Sicilia]'	'The Mill is a cheap fast food restaurant near Café Sicilia in the riverside area. It has an average customer rating and is not family-friendly.'
'name[The Mill], eatType[pub], food[Fast food], priceRange[cheap], customer rating[average], area[riverside], familyFriendly[yes], near[Café Sicilia]'	'The Mill is a cheap, family friendly, fast food restaurant with an average customer rating. It is located in the riverside area near Café Sicilia.'
'name[The Mill], eatType[pub], food[Fast food], priceRange[high], customer rating[1 out of 5], area[city centre], familyFriendly[no], near[Café Sicilia]'	'The Mill is a fast food pub located in the city centre near Café Sicilia. It has a high price range and a customer rating of 1 out of 5 and is not child friendly.'
'name[The Mill], eatType[pub], food[Fast food], priceRange[high], customer rating[1 out of 5], area[city centre], familyFriendly[yes], near[Café Sicilia]'	'The Mill is a fast food pub located in the city centre near Café Sicilia. It is child friendly and has a customer rating of 1 out of 5.'
'name[The Mill], eatType[pub], food[Fast food], priceRange[high], customer rating[1 out of 5], area[riverside], familyFriendly[no], near[Café Sicilia]'	'The Mill is a fast food restaurant near Café Sicilia in the riverside area. It is not child friendly and has a high price range and a customer rating of 1 out of 5.'
'name[The Mill], eatType[pub], food[Fast food], priceRange[high], customer rating[1 out of 5], area[riverside], familyFriendly[yes], near[Café Sicilia]'	'The Mill is a fast food restaurant in the riverside area near Café Sicilia. It is child friendly and has a customer rating of 1 out of 5 and a high price range.'
'name[The Mill], eatType[pub], food[Fast food], priceRange[high], customer rating[average], area[city centre], familyFriendly[no], near[Café Sicilia]'	'The Mill is a fast food pub located in the city centre near Café Sicilia. It is not child friendly and has a high price range and an average customer rating.'
'name[The Mill], eatType[pub], food[Fast food], priceRange[high], customer rating[average], area[city centre], familyFriendly[yes], near[Café Sicilia]'	'The Mill is a children friendly fast food restaurant in the city centre near Café Sicilia. It has a high price range and an average customer rating.'
'name[The Mill], eatType[pub], food[Fast food], priceRange[high], customer rating[average], area[riverside], familyFriendly[no], near[Café Sicilia]'	'The Mill is a fast food restaurant near Café Sicilia in the riverside area. It is not child friendly and has a high price range and an average customer rating.'
'name[The Mill], eatType[pub], food[Fast food], priceRange[high], customer rating[average], area[riverside], familyFriendly[yes], near[Café Sicilia]'	'The Mill is a children friendly fast food restaurant with a high price range and an average customer rating. It is located in the riverside area near Café Sicilia.'
'name[The Mill], eatType[pub], food[Fast food], priceRange[less than £20], customer rating[low], area[city centre], familyFriendly[no], near[Café Sicilia]'	'The Mill is a fast food pub with a price range of less than £20 near Café Sicilia in the city centre. It is not family-friendly and has a low customer rating.'
'name[The Mill], eatType[pub], food[Fast food], priceRange[less than £20], customer rating[low], area[city centre], familyFriendly[yes], near[Café Sicilia]'	'The Mill is a family-friendly fast food restaurant located in the city centre near Café Sicilia. It has a low customer rating and a price range of less than £20.'
'name[The Mill], eatType[pub], food[Fast food], priceRange[less than £20], customer rating[low], area[riverside], familyFriendly[no], near[Café Sicilia]'	'The Mill is a cheap fast food pub located near the Café Sicilia. It is not family-friendly and has a low customer rating.'
'name[The Mill], eatType[pub], food[Fast food], priceRange[less than £20], customer rating[low], area[riverside], familyFriendly[yes], near[Café Sicilia]'	'The Mill is a family friendly pub that serves fast food. It has a low customer rating and a price range of less than £20. It is located in the riverside area near Café Sicilia.'
'name[The Mill], eatType[pub], food[Fast food], priceRange[moderate], customer rating[1 out of 5], area[city centre], familyFriendly[no], near[Café Sicilia]'	'The Mill is a fast food pub located in the city centre near Café Sicilia. It has a moderate price range and a customer rating of 1 out of 5. It is not kid friendly.'
'name[The Mill], eatType[pub], food[Fast food], priceRange[moderate], customer rating[1 out of 5], area[city centre], familyFriendly[yes], near[Café Sicilia]'	'The Mill is a kid friendly fast food pub in the city centre near Café Sicilia. It has a moderate price range and a customer rating of 1 out of 5.'
'name[The Mill], eatType[pub], food[Fast food], priceRange[moderate], customer rating[1 out of 5], area[riverside], familyFriendly[no], near[Café Sicilia]'	'The Mill is a fast food restaurant located in the riverside area near Café Sicilia. It is not kid friendly and has a moderate price range and a customer rating of 1 out of 5.'
'name[The Mill], eatType[pub], food[Fast food], priceRange[moderate], customer rating[1 out of 5], area[riverside], familyFriendly[yes], near[Café Sicilia]'	'The Mill is a fast food restaurant located in the riverside area near Café Sicilia. It is kid friendly and has a moderate price range and a customer rating of 1 out of 5.'
'name[The Mill], eatType[pub], food[Fast food], priceRange[moderate], customer rating[3 out of 5], area[city centre], familyFriendly[no], near[Café Sicilia]'	'The Mill is a fast food pub located near Café Sicilia. It is not kid friendly and has a moderate price range and a customer rating of 3 out of 5.'
'name[The Mill], eatType[pub], food[Fast food], priceRange[moderate], customer rating[3 out of 5], area[city centre], familyFriendly[yes], near[Café Sicilia]'	'The Mill is a kid friendly fast food restaurant in the city centre near Café Sicilia. It has a moderate price range and a customer rating of 3 out of 5.'
'name[The Mill], eatType[pub], food[Fast food], priceRange[moderate], customer rating[3 out of 5], area[riverside], familyFriendly[no], near[Café Sicilia]'	'The Mill is a fast food pub located near Café Sicilia in the riverside area. It is not kid friendly and has a moderate price range and a customer rating of 3 out of 5.'
'name[The Mill], eatType[pub], food[Fast food], priceRange[moderate], customer rating[3 out of 5], area[riverside], familyFriendly[yes], near[Café Sicilia]'	'The Mill is a fast food restaurant located near Café Sicilia in the riverside area. It is kid friendly and has a moderate price range and a customer rating of 3 out of 5.'
'name[The Mill], eatType[restaurant], food[English], priceRange[high], area[riverside], familyFriendly[yes], near[Raja Indian Cuisine]'	'The Mill is a children friendly english restaurant in the riverside area near Raja Indian Cuisine. It has a high price range.'
'name[The Mill], eatType[restaurant], food[English], priceRange[high], customer rating[average], area[riverside], familyFriendly[yes], near[Café Rouge]'	'The Mill is an english restaurant near Café Rouge in the riverside area. It is child friendly and has an average customer rating and a high price range.'
'name[The Mill], eatType[restaurant], food[English], priceRange[less than £20], area[city centre], familyFriendly[no], near[Raja Indian Cuisine]'	'The Mill is a restaurant providing english food in the less than £20 price range. It is located in the city centre near Raja Indian Cuisine.'
'name[The Mill], eatType[restaurant], food[English], priceRange[less than £20], area[city centre], familyFriendly[yes], near[Raja Indian Cuisine]'	'The Mill is a family-friendly english restaurant in the city centre near Raja Indian Cuisine. It has a price range of less than £20.'
'name[The Mill], eatType[restaurant], food[English], priceRange[less than £20], area[riverside], familyFriendly[no], near[Raja Indian Cuisine]'	'The Mill is a non-family-friendly english restaurant with a price range of less than £20 near Raja Indian Cuisine in the riverside area.'
'name[The Mill], eatType[restaurant], food[English], priceRange[less than £20], area[riverside], familyFriendly[yes], near[Raja Indian Cuisine]'	'The Mill is a family friendly restaurant that serves english food for less than £20 near Raja Indian Cuisine in the riverside area.'
'name[The Mill], eatType[restaurant], food[English], priceRange[less than £20], customer rating[low], area[city centre], familyFriendly[no], near[Café Rouge]'	'The Mill is a restaurant providing english food in the less than £20 price range. It is located in the city centre near Café Rouge. It is not family-friendly and has a low customer rating.'
'name[The Mill], eatType[restaurant], food[English], priceRange[less than £20], customer rating[low], area[city centre], familyFriendly[yes], near[Café Rouge]'	'The Mill is a family-friendly restaurant providing english food in the less than £20 price range. It is located in the city centre near Café Rouge.'
'name[The Mill], eatType[restaurant], food[English], priceRange[less than £20], customer rating[low], area[riverside], familyFriendly[no], near[Café Rouge]'	'The Mill is a non-family-friendly english restaurant in the riverside area near Café Rouge. It has a low customer rating and a price range of less than £20.'
'name[The Mill], eatType[restaurant], food[English], priceRange[less than £20], customer rating[low], area[riverside], familyFriendly[yes], near[Café Rouge]'	'The Mill is a family friendly restaurant that serves english food for less than £20 near Café Rouge in the riverside area and has a low customer rating.'
'name[The Mill], eatType[restaurant], food[English], priceRange[moderate], area[city centre], familyFriendly[no], near[Raja Indian Cuisine]'	'The Mill is a restaurant providing english food in the moderate price range. It is located in the city centre near Raja Indian Cuisine. It is not kids friendly.'
'name[The Mill], eatType[restaurant], food[English], priceRange[moderate], area[city centre], familyFriendly[yes], near[Raja Indian Cuisine]'	'The Mill is a restaurant providing english food in the moderate price range. It is located in the city centre near Raja Indian Cuisine and is kids friendly.'
'name[The Mill], eatType[restaurant], food[English], priceRange[moderate], area[riverside], familyFriendly[no], near[Raja Indian Cuisine]'	'The Mill is a moderately priced english restaurant near Raja Indian Cuisine in the riverside area. It is not kids friendly.'
'name[The Mill], eatType[restaurant], food[English], priceRange[moderate], area[riverside], familyFriendly[yes], near[Raja Indian Cuisine]'	'The Mill is a moderately priced, kid friendly english restaurant in the riverside area near Raja Indian Cuisine.'
'name[The Mill], eatType[restaurant], food[English], priceRange[moderate], customer rating[1 out of 5], area[city centre], familyFriendly[no], near[Café Rouge]'	'The Mill is a restaurant providing english food in the moderate price range. It is located in the city centre near Café Rouge. It is not child friendly and has a customer rating of 1 out of 5.'
'name[The Mill], eatType[restaurant], food[English], priceRange[moderate], customer rating[1 out of 5], area[city centre], familyFriendly[yes], near[Café Rouge]'	'The Mill is a restaurant providing english food in the moderate price range. It is located in the city centre near Café Rouge. It has a customer rating of 1 out of 5 and is kid friendly.'
'name[The Mill], eatType[restaurant], food[English], priceRange[moderate], customer rating[1 out of 5], area[riverside], familyFriendly[no], near[Café Rouge]'	'The Mill is a restaurant providing english food in the moderate price range. It is located in the riverside area near Café Rouge. Its customer rating is 1 out of 5.'
'name[The Mill], eatType[restaurant], food[English], priceRange[moderate], customer rating[1 out of 5], area[riverside], familyFriendly[yes], near[Café Rouge]'	'The Mill is an english restaurant in the riverside area near Café Rouge. It has a moderate price range and a customer rating of 1 out of 5. It is kid friendly.'
'name[The Mill], eatType[restaurant], food[English], priceRange[moderate], customer rating[3 out of 5], area[city centre], familyFriendly[no], near[Café Rouge]'	'The Mill is a restaurant providing english food in the moderate price range. It is located in the city centre near Café Rouge. Its customer rating is 3 out of 5.'
'name[The Mill], eatType[restaurant], food[English], priceRange[moderate], customer rating[3 out of 5], area[city centre], familyFriendly[yes], near[Café Rouge]'	'The Mill is a restaurant providing english food in the moderate price range. It has a customer rating of 3 out of 5. It is located in the city centre near the Café Rouge and is kid friendly.'
'name[The Mill], eatType[restaurant], food[English], priceRange[moderate], customer rating[3 out of 5], area[riverside], familyFriendly[no], near[Café Rouge]'	'The Mill is a restaurant providing english food in the moderate price range. It is located in the riverside area near Café Rouge. It is not kids friendly and has a customer rating of 3 out of 5.'
'name[The Mill], eatType[restaurant], food[English], priceRange[moderate], customer rating[3 out of 5], area[riverside], familyFriendly[yes], near[Café Rouge]'	'The Mill is an english restaurant in the riverside area near Café Rouge. It is kid friendly and has a moderate price range and a customer rating of 3 out of 5.'
'name[The Mill], eatType[restaurant], food[English], priceRange[more than £30], area[riverside], familyFriendly[yes], near[Raja Indian Cuisine]'	'The Mill is a children friendly english restaurant in the riverside area near Raja Indian Cuisine. It has a price range of more than £30.'
'name[The Mill], eatType[restaurant], food[English], priceRange[more than £30], customer rating[high], area[city centre], familyFriendly[no], near[Café Rouge]'	'The Mill is a restaurant providing english food in the more than £30 price range. It is located in the city centre. It is near Café Rouge. Its customer rating is high.'
'name[The Mill], eatType[restaurant], food[English], priceRange[more than £30], customer rating[high], area[city centre], familyFriendly[yes], near[Café Rouge]'	'The Mill is a children friendly english restaurant located in the city centre near Café Rouge. It has a high customer rating and a price range of more than £30.'
'name[The Mill], eatType[restaurant], food[English], priceRange[more than £30], customer rating[high], area[riverside], familyFriendly[no], near[Café Rouge]'	'The Mill is a restaurant providing english food in the more than £30 price range. It is located in the riverside. It is near Café Rouge. Its customer rating is high.'
'name[The Mill], eatType[restaurant], food[English], priceRange[more than £30], customer rating[high], area[riverside], familyFriendly[yes], near[Café Rouge]'	'The Mill is a child friendly restaurant that serves english food. It has a high customer rating and a price range of more than £30. It is located near Café Rouge in the riverside area.'
'name[The Mill], eatType[restaurant], food[Fast food], priceRange[£20-25], area[riverside], familyFriendly[yes], near[Raja Indian Cuisine]'	'The Mill is a kid friendly fast food restaurant in riverside near Raja Indian Cuisine. It has a price range of £20-25.'
'name[The Mill], eatType[restaurant], food[Fast food], priceRange[cheap], area[riverside], familyFriendly[yes], near[Raja Indian Cuisine]'	'The Mill is a cheap, family friendly fast food restaurant in riverside near Raja Indian Cuisine.'
'name[The Phoenix], eatType[pub], food[Fast food], priceRange[cheap], area[riverside], familyFriendly[yes], near[Raja Indian Cuisine]'	'The Phoenix is a cheap, family friendly fast food pub in riverside near Raja Indian Cuisine.'
'name[The Phoenix], eatType[pub], food[Fast food], priceRange[high], area[city centre], familyFriendly[no], near[Raja Indian Cuisine]'	'The Phoenix is a fast food pub located in the city centre near Raja Indian Cuisine. It is not child friendly and has a high price range.'
'name[The Phoenix], eatType[pub], food[Fast food], priceRange[high], area[city centre], familyFriendly[yes], near[Raja Indian Cuisine]'	'The Phoenix is a child friendly fast food pub in the city centre near Raja Indian Cuisine. It has a high price range.'
'name[The Phoenix], eatType[pub], food[Fast food], priceRange[high], area[riverside], familyFriendly[no], near[Raja Indian Cuisine]'	'The Phoenix is a fast food pub located near Raja Indian Cuisine in the riverside area. It is not child friendly and has a high price range.'
'name[The Phoenix], eatType[pub], food[Fast food], priceRange[high], area[riverside], familyFriendly[yes], near[Raja Indian Cuisine]'	'The Phoenix is a child friendly fast food pub in riverside near Raja Indian Cuisine. It has a high price range.'
'name[The Phoenix], eatType[pub], food[Fast food], priceRange[less than £20], area[city centre], familyFriendly[no], near[Raja Indian Cuisine]'	'The Phoenix is a fast food pub located in the city centre near Raja Indian Cuisine. It is not family-friendly and has a price range of less than £20.'
'name[The Phoenix], eatType[pub], food[Fast food], priceRange[less than £20], area[city centre], familyFriendly[yes], near[Raja Indian Cuisine]'	'The Phoenix is a family-friendly fast food pub in the city centre near Raja Indian Cuisine. It has a price range of less than £20.'
'name[The Phoenix], eatType[pub], food[Fast food], priceRange[less than £20], area[riverside], familyFriendly[no], near[Raja Indian Cuisine]'	'The Phoenix is a fast food pub near Raja Indian Cuisine in the riverside area. It is not family-friendly and has a price range of less than £20.'
'name[The Phoenix], eatType[pub], food[Fast food], priceRange[less than £20], area[riverside], familyFriendly[yes], near[Raja Indian Cuisine]'	'The Phoenix is a family friendly fast food pub near Raja Indian Cuisine in the riverside area. It has a price range of less than £20.'
'name[The Phoenix], eatType[pub], food[Fast food], priceRange[moderate], area[city centre], familyFriendly[no], near[Raja Indian Cuisine]'	'The Phoenix is a fast food pub located in the city centre near Raja Indian Cuisine. It is not child friendly and has a moderate price range.'
'name[The Phoenix], eatType[pub], food[Fast food], priceRange[moderate], area[city centre], familyFriendly[yes], near[Raja Indian Cuisine]'	'The Phoenix is a kid friendly fast food pub in the city centre near Raja Indian Cuisine. It has a moderate price range.'
'name[The Phoenix], eatType[pub], food[Fast food], priceRange[moderate], area[riverside], familyFriendly[no], near[Raja Indian Cuisine]'	'The Phoenix is a fast food pub near Raja Indian Cuisine in the riverside area. It is not child friendly and has a moderate price range.'
'name[The Phoenix], eatType[pub], food[Fast food], priceRange[moderate], area[riverside], familyFriendly[yes], near[Raja Indian Cuisine]'	'The Phoenix is a moderately priced, kid friendly fast food pub in the riverside area near Raja Indian Cuisine.'
'name[The Phoenix], eatType[pub], food[Fast food], priceRange[moderate], customer rating[3 out of 5], area[riverside], familyFriendly[yes], near[Café Sicilia]'	'The Phoenix is a fast food restaurant located near Café Sicilia in the riverside area. It is kid friendly and has a moderate price range and a customer rating of 3 out of 5.'
'name[The Phoenix], eatType[pub], food[Fast food], priceRange[more than £30], area[riverside], familyFriendly[yes], near[Raja Indian Cuisine]'	'The Phoenix is a children friendly fast food pub in riverside near Raja Indian Cuisine. It has a price range of more than £30.'
'name[The Phoenix], eatType[pub], food[Fast food], priceRange[more than £30], customer rating[high], area[city centre], familyFriendly[no], near[Café Sicilia]'	'The Phoenix is a fast food pub located in the city centre near Café Sicilia. It has a high customer rating and a price range of more than £30. It is not child friendly.'
'name[The Phoenix], eatType[pub], food[Fast food], priceRange[more than £30], customer rating[high], area[city centre], familyFriendly[yes], near[Café Sicilia]'	'The Phoenix is a children friendly fast food pub with a high customer rating. It is located in the city centre near Café Sicilia.'
'name[The Phoenix], eatType[pub], food[Fast food], priceRange[more than £30], customer rating[high], area[riverside], familyFriendly[no], near[Café Sicilia]'	'The Phoenix is a fast food restaurant located in the riverside area near Café Sicilia. It is not child friendly and has a high customer rating.'
'name[The Phoenix], eatType[pub], food[Fast food], priceRange[more than £30], customer rating[high], area[riverside], familyFriendly[yes], near[Café Sicilia]'	'The Phoenix is a children friendly fast food pub near the Café Sicilia. It has a high customer rating and a price range of more than £30.'
'name[The Phoenix], eatType[pub], food[French], priceRange[£20-25], area[riverside], familyFriendly[yes], near[Raja Indian Cuisine]'	'The Phoenix is a kid friendly french pub in the riverside area near Raja Indian Cuisine with a price range of £20-25.'
'name[The Phoenix], eatType[pub], food[French], priceRange[£20-25], customer rating[3 out of 5], area[city centre], familyFriendly[no], near[Café Sicilia]'	'The Phoenix is a french pub located in the city centre near Café Sicilia. It is not child friendly and has a customer rating of 3 out of 5 and has a moderate price range.'
'name[The Phoenix], eatType[pub], food[French], priceRange[£20-25], customer rating[3 out of 5], area[city centre], familyFriendly[yes], near[Café Sicilia]'	'The Phoenix is a family-friendly french pub in the city centre near Café Sicilia. It has a customer rating of 3 out of 5 and a price range of £20-25.'
'name[The Phoenix], eatType[pub], food[French], priceRange[£20-25], customer rating[3 out of 5], area[riverside], familyFriendly[no], near[Café Sicilia]'	'The Phoenix is a french pub near Café Sicilia in riverside. It has a customer rating of 3 out of 5 and a moderate price range. It is not kid friendly.'
'name[The Phoenix], eatType[pub], food[French], priceRange[£20-25], customer rating[3 out of 5], area[riverside], familyFriendly[yes], near[Café Sicilia]'	'With a customer rating of 3 out of 5, The Phoenix is a kid friendly french pub in riverside near Café Sicilia.'
'name[The Phoenix], eatType[pub], food[French], priceRange[£20-25], customer rating[3 out of 5], area[riverside], familyFriendly[yes], near[Crowne Plaza Hotel]'	'With a price range of £20-25, The Phoenix is a kid friendly pub serving french food. It has a customer rating of 3 out of 5 and is located near Crowne Plaza Hotel in riverside.'
'name[The Phoenix], eatType[pub], food[French], priceRange[£20-25], customer rating[high], area[city centre], familyFriendly[no], near[Crowne Plaza Hotel]'	'The Phoenix is a pub providing french food in the £20-25 price range. It is located in the city centre. It is near Crowne Plaza Hotel. Its customer rating is high.'
'name[The Phoenix], eatType[pub], food[French], priceRange[£20-25], customer rating[high], area[city centre], familyFriendly[yes], near[Crowne Plaza Hotel]'	'The Phoenix is a kid friendly french pub with a price range of £20-25 and a high customer rating. It is located in the city centre near the Crowne Plaza Hotel.'
'name[The Phoenix], eatType[pub], food[French], priceRange[£20-25], customer rating[high], area[riverside], familyFriendly[no], near[Crowne Plaza Hotel]'	'The Phoenix is a french pub near the Crowne Plaza Hotel in the riverside area. It has a high customer rating and a price range of £20-25 and is not kid friendly.'
'name[The Phoenix], eatType[pub], food[French], priceRange[£20-25], customer rating[high], area[riverside], familyFriendly[yes], near[Crowne Plaza Hotel]'	'The Phoenix is a kid friendly french pub with a price range of £20-25 and a high customer rating. It is located in the riverside area near Crowne Plaza Hotel.'
'name[The Phoenix], eatType[pub], food[French], priceRange[cheap], area[riverside], familyFriendly[yes], near[Raja Indian Cuisine]'	'The Phoenix is a cheap, family friendly french pub near Raja Indian Cuisine in the riverside area.'
'name[The Phoenix], eatType[pub], food[French], priceRange[cheap], customer rating[5 out of 5], area[city centre], familyFriendly[no], near[Crowne Plaza Hotel]'	'The Phoenix is a cheap french pub near the Crowne Plaza Hotel. It is not family-friendly and has a customer rating of 5 out of 5.'
'name[The Phoenix], eatType[pub], food[French], priceRange[cheap], customer rating[5 out of 5], area[city centre], familyFriendly[yes], near[Crowne Plaza Hotel]'	'The Phoenix is a cheap, family-friendly french pub in the city centre near Crowne Plaza Hotel with a customer rating of 5 out of 5.'
'name[The Phoenix], eatType[pub], food[French], priceRange[cheap], customer rating[5 out of 5], area[riverside], familyFriendly[no], near[Crowne Plaza Hotel]'	'The Phoenix is a cheap french pub near Crowne Plaza Hotel in the riverside area. It has a customer rating of 5 out of 5 and is not family-friendly.'
'name[The Phoenix], eatType[pub], food[French], priceRange[cheap], customer rating[5 out of 5], area[riverside], familyFriendly[yes], near[Crowne Plaza Hotel]'	'The Phoenix is a cheap, family-friendly french pub with a customer rating of 5 out of 5. It is located in the riverside area near Crowne Plaza Hotel.'
'name[The Phoenix], eatType[pub], food[French], priceRange[high], area[riverside], familyFriendly[yes], near[Raja Indian Cuisine]'	'The Phoenix is a children friendly french pub near Raja Indian Cuisine in the riverside area with a high price range.'
'name[The Phoenix], eatType[pub], food[French], priceRange[high], customer rating[3 out of 5], area[city centre], familyFriendly[no], near[Crowne Plaza Hotel]'	'The Phoenix is a high priced french restaurant located in the city centre near Crowne Plaza Hotel. It is not child friendly and has a customer rating of 3 out of 5.'
'name[The Phoenix], eatType[pub], food[French], priceRange[high], customer rating[3 out of 5], area[city centre], familyFriendly[yes], near[Crowne Plaza Hotel]'	'The Phoenix is a children friendly french pub in the city centre near Crowne Plaza Hotel. It has a high price range and a customer rating of 3 out of 5.'
'name[The Phoenix], eatType[pub], food[French], priceRange[high], customer rating[3 out of 5], area[riverside], familyFriendly[no], near[Crowne Plaza Hotel]'	'The Phoenix is a french pub near Crowne Plaza Hotel in riverside. It has a customer rating of 3 out of 5 and a high price range. It is not child friendly.'
'name[The Phoenix], eatType[pub], food[French], priceRange[high], customer rating[3 out of 5], area[riverside], familyFriendly[yes], near[Crowne Plaza Hotel]'	'The Phoenix is a children friendly french pub in riverside near Crowne Plaza Hotel. It has a customer rating of 3 out of 5 and a high price range.'
'name[The Phoenix], eatType[pub], food[French], priceRange[less than £20], customer rating[average], area[city centre], familyFriendly[no], near[Crowne Plaza Hotel]'	'The Phoenix is a pub providing french food in the less than £20 price range. It is located in the riverside. It is not family-friendly and has an average customer rating. It is located near the Crowne Plaza Hotel.'
'name[The Phoenix], eatType[pub], food[French], priceRange[less than £20], customer rating[average], area[city centre], familyFriendly[yes], near[Crowne Plaza Hotel]'	'The Phoenix is a family-friendly pub located in the city centre near the Crowne Plaza Hotel. It serves french food for less than £20 and has an average customer rating.'
'name[The Phoenix], eatType[pub], food[French], priceRange[less than £20], customer rating[average], area[riverside], familyFriendly[no], near[Crowne Plaza Hotel]'	'The Phoenix is a french pub in the riverside area near Crowne Plaza Hotel. It has an average customer rating and a price range of less than £20 and is not family-friendly.'
'name[The Phoenix], eatType[pub], food[French], priceRange[less than £20], customer rating[average], area[riverside], familyFriendly[yes], near[Crowne Plaza Hotel]'	'The Phoenix is a family friendly pub located near the Crowne Plaza Hotel in the riverside area. It serves french food for less than £20 and has an average customer rating.'
'name[The Phoenix], eatType[pub], food[French], priceRange[less than £20], customer rating[low], area[city centre], familyFriendly[no], near[Crowne Plaza Hotel]'	'The Phoenix is a french pub with a price range of less than £20 near Crowne Plaza Hotel in the city centre. It has a low customer rating and is not family-friendly.'
'name[The Phoenix], eatType[pub], food[French], priceRange[less than £20], customer rating[low], area[city centre], familyFriendly[yes], near[Crowne Plaza Hotel]'	'The Phoenix is a family-friendly french pub in the city centre near Crowne Plaza Hotel. It has a low customer rating and a price range of less than £20.'
'name[The Phoenix], eatType[pub], food[French], priceRange[less than £20], customer rating[low], area[riverside], familyFriendly[no], near[Crowne Plaza Hotel]'	'The Phoenix is a french pub near Crowne Plaza Hotel in the riverside area. It is not family-friendly and has a low customer rating and a price range of less than £20.'
'name[The Phoenix], eatType[pub], food[French], priceRange[less than £20], customer rating[low], area[riverside], familyFriendly[yes], near[Crowne Plaza Hotel]'	'The Phoenix is a family friendly pub that serves french food for less than £20 near Crowne Plaza Hotel in the riverside area. It has a low customer rating.'
'name[The Phoenix], eatType[pub], food[French], priceRange[moderate], customer rating[1 out of 5], area[city centre], familyFriendly[no], near[Crowne Plaza Hotel]'	'The Phoenix is a moderately priced french pub in the city centre near Crowne Plaza Hotel. It has a customer rating of 1 out of 5 and is not kid friendly.'
'name[The Phoenix], eatType[pub], food[French], priceRange[moderate], customer rating[1 out of 5], area[city centre], familyFriendly[yes], near[Crowne Plaza Hotel]'	'The Phoenix is a pub providing french food in the moderate price range. It is located in the city centre near Crowne Plaza Hotel. It has a customer rating of 1 out of 5 and is kid friendly.'
'name[The Phoenix], eatType[pub], food[French], priceRange[moderate], customer rating[1 out of 5], area[riverside], familyFriendly[no], near[Crowne Plaza Hotel]'	'The Phoenix is a moderately priced french pub in the riverside area near Crowne Plaza Hotel. It has a customer rating of 1 out of 5 and is not kid friendly.'
'name[The Phoenix], eatType[pub], food[French], priceRange[moderate], customer rating[1 out of 5], area[riverside], familyFriendly[yes], near[Crowne Plaza Hotel]'	'The Phoenix is a moderately priced, kid friendly french pub near the Crowne Plaza Hotel. It has a customer rating of 1 out of 5.'
'name[The Phoenix], eatType[pub], food[French], priceRange[more than £30], customer rating[5 out of 5], area[city centre], familyFriendly[no], near[Crowne Plaza Hotel]'	'The Phoenix is a french pub located in the city centre near Crowne Plaza Hotel. It has a high price range and a customer rating of 5 out of 5. It is not child friendly.'
'name[The Phoenix], eatType[pub], food[French], priceRange[more than £30], customer rating[5 out of 5], area[city centre], familyFriendly[yes], near[Crowne Plaza Hotel]'	'The Phoenix is a french pub located in the city centre near Crowne Plaza Hotel. It has a high price range and a customer rating of 5 out of 5. It is family-friendly.'
'name[The Phoenix], eatType[pub], food[French], priceRange[more than £30], customer rating[5 out of 5], area[riverside], familyFriendly[no], near[Crowne Plaza Hotel]'	'The Phoenix is a french pub in the riverside area near Crowne Plaza Hotel. It has a customer rating of 5 out of 5 and a price range of more than £30. It is not child friendly.'
'name[The Phoenix], eatType[pub], food[French], priceRange[more than £30], customer rating[5 out of 5], area[riverside], familyFriendly[yes], near[Crowne Plaza Hotel]'	'The Phoenix is a children friendly french pub with a price range of more than £30. It has a customer rating of 5 out of 5 and is located near Crowne Plaza Hotel in the riverside area.'
'name[The Phoenix], eatType[pub], food[French], priceRange[more than £30], customer rating[low], area[city centre], familyFriendly[no], near[Crowne Plaza Hotel]'	'The Phoenix is a french pub located in the city centre near Crowne Plaza Hotel. It is not child friendly and has a low customer rating and a price range of more than £30.'
'name[The Phoenix], eatType[pub], food[French], priceRange[more than £30], customer rating[low], area[city centre], familyFriendly[yes], near[Crowne Plaza Hotel]'	'The Phoenix is a french pub in the city centre near Crowne Plaza Hotel. It is child friendly and has a low customer rating and a price range of more than £30.'
'name[The Phoenix], eatType[pub], food[French], priceRange[more than £30], customer rating[low], area[riverside], familyFriendly[no], near[Crowne Plaza Hotel]'	'The Phoenix is a french pub near Crowne Plaza Hotel in the riverside area. It is not child friendly and has a low customer rating and a price range of more than £30.'
'name[The Phoenix], eatType[pub], food[French], priceRange[more than £30], customer rating[low], area[riverside], familyFriendly[yes], near[Crowne Plaza Hotel]'	'Located near the Crowne Plaza Hotel in the riverside area is a child friendly french pub called The Phoenix. It has a low customer rating and a price range of more than £30.'
'name[The Phoenix], eatType[restaurant], food[Fast food], priceRange[cheap], area[riverside], familyFriendly[yes], near[Raja Indian Cuisine]'	'The Phoenix is a cheap, family friendly fast food restaurant in riverside near Raja Indian Cuisine.'
'name[The Phoenix], eatType[restaurant], food[Fast food], priceRange[high], area[city centre], familyFriendly[no], near[Raja Indian Cuisine]'	'The Phoenix is a fast food restaurant located in the city centre near Raja Indian Cuisine. It is not child friendly and has a high price range.'
'name[The Phoenix], eatType[restaurant], food[Fast food], priceRange[high], area[city centre], familyFriendly[yes], near[Raja Indian Cuisine]'	'The Phoenix is a children friendly fast food restaurant in the city centre near Raja Indian Cuisine. It has a high price range.'
'name[The Phoenix], eatType[restaurant], food[Fast food], priceRange[high], area[riverside], familyFriendly[no], near[Raja Indian Cuisine]'	'The Phoenix is a fast food restaurant located near Raja Indian Cuisine in the riverside area. It is not child friendly and has a high price range.'
'name[The Phoenix], eatType[restaurant], food[Fast food], priceRange[high], area[riverside], familyFriendly[yes], near[Raja Indian Cuisine]'	'The Phoenix is a children friendly fast food restaurant in riverside near Raja Indian Cuisine. It has a high price range.'
'name[The Phoenix], eatType[restaurant], food[Fast food], priceRange[less than £20], area[city centre], familyFriendly[no], near[Raja Indian Cuisine]'	'The Phoenix is a fast food restaurant located in the city centre near Raja Indian Cuisine. It is not family-friendly and has a price range of less than £20.'
'name[The Phoenix], eatType[restaurant], food[Fast food], priceRange[less than £20], area[city centre], familyFriendly[yes], near[Raja Indian Cuisine]'	'The Phoenix is a family-friendly fast food restaurant in the city centre near Raja Indian Cuisine. It has a price range of less than £20.'
'name[The Phoenix], eatType[restaurant], food[Fast food], priceRange[less than £20], area[riverside], familyFriendly[no], near[Raja Indian Cuisine]'	'The Phoenix is a fast food restaurant near Raja Indian Cuisine in the riverside area. It is not family-friendly and has a price range of less than £20.'
'name[The Phoenix], eatType[restaurant], food[Fast food], priceRange[less than £20], area[riverside], familyFriendly[yes], near[Raja Indian Cuisine]'	'The Phoenix is a family friendly fast food restaurant in riverside near Raja Indian Cuisine.'
'name[The Phoenix], eatType[restaurant], food[Fast food], priceRange[moderate], area[city centre], familyFriendly[no], near[Raja Indian Cuisine]'	'The Phoenix is a moderately priced fast food restaurant in the city centre near Raja Indian Cuisine. It is not child friendly.'
'name[The Phoenix], eatType[restaurant], food[Fast food], priceRange[moderate], area[city centre], familyFriendly[yes], near[Raja Indian Cuisine]'	'The Phoenix is a moderately priced, kid friendly fast food restaurant in the city centre near Raja Indian Cuisine.'
'name[The Phoenix], eatType[restaurant], food[Fast food], priceRange[moderate], area[riverside], familyFriendly[no], near[Raja Indian Cuisine]'	'The Phoenix is a moderately priced fast food restaurant in the riverside area near Raja Indian Cuisine. It is not kid friendly.'
'name[The Phoenix], eatType[restaurant], food[Fast food], priceRange[moderate], area[riverside], familyFriendly[yes], near[Raja Indian Cuisine]'	'The Phoenix is a moderately priced, kid friendly fast food restaurant in riverside near Raja Indian Cuisine.'
'name[The Phoenix], eatType[restaurant], food[Fast food], priceRange[more than £30], area[riverside], familyFriendly[yes], near[Raja Indian Cuisine]'	'The Phoenix is a children friendly fast food restaurant in riverside near Raja Indian Cuisine. It has a price range of more than £30.'
'name[The Phoenix], eatType[restaurant], food[French], priceRange[£20-25], area[riverside], familyFriendly[yes], near[Raja Indian Cuisine]'	'The Phoenix is a kid friendly french restaurant in riverside near Raja Indian Cuisine. It has a price range of £20-25.'
'name[The Phoenix], eatType[restaurant], food[French], priceRange[cheap], area[riverside], familyFriendly[yes], near[Raja Indian Cuisine]'	'The Phoenix is a cheap, family friendly french restaurant in riverside near Raja Indian Cuisine.'
'name[The Phoenix], eatType[restaurant], food[French], priceRange[high], area[riverside], familyFriendly[yes], near[Raja Indian Cuisine]'	'The Phoenix is a children friendly french restaurant in the riverside area near Raja Indian Cuisine. It has a high price range.'
'name[The Phoenix], eatType[restaurant], food[Indian], priceRange[£20-25], customer rating[high], area[city centre], familyFriendly[no], near[Crowne Plaza Hotel]'	'The Phoenix is a restaurant that provides indian food in the £20-25 price range. It is located in the city centre. It is near Crowne Plaza Hotel. Its customer rating is high.'
'name[The Phoenix], eatType[restaurant], food[Indian], priceRange[£20-25], customer rating[high], area[city centre], familyFriendly[yes], near[Crowne Plaza Hotel]'	'The Phoenix is a restaurant providing indian food in the £20-25 price range. It is located in the city centre. It is near Crowne Plaza Hotel. Its customer rating is high.'
'name[The Phoenix], eatType[restaurant], food[Indian], priceRange[£20-25], customer rating[high], area[riverside], familyFriendly[no], near[Crowne Plaza Hotel]'	'The Phoenix is a restaurant providing indian food in the £20-25 price range. It is located in the riverside. It is near Crowne Plaza Hotel. Its customer rating is high.'
'name[The Phoenix], eatType[restaurant], food[Indian], priceRange[£20-25], customer rating[high], area[riverside], familyFriendly[yes], near[Crowne Plaza Hotel]'	'The Phoenix is a restaurant providing indian food in the £20-25 range. It is located in the riverside. It is near Crowne Plaza Hotel. Its customer rating is high.'
'name[The Phoenix], eatType[restaurant], food[Indian], priceRange[cheap], customer rating[5 out of 5], area[city centre], familyFriendly[no], near[Crowne Plaza Hotel]'	'The Phoenix is a restaurant providing indian food in the cheap price range. It is located in the city centre. It is near Crowne Plaza Hotel. Its customer rating is 5 out of 5.'
'name[The Phoenix], eatType[restaurant], food[Indian], priceRange[cheap], customer rating[5 out of 5], area[city centre], familyFriendly[yes], near[Crowne Plaza Hotel]'	'The Phoenix provides indian food in the cheap price range. It is located in the city centre near Crowne Plaza Hotel. Its customer rating is 5 out of 5.'
'name[The Phoenix], eatType[restaurant], food[Indian], priceRange[cheap], customer rating[5 out of 5], area[riverside], familyFriendly[no], near[Crowne Plaza Hotel]'	'The Phoenix is a restaurant providing indian food in the cheap price range. It is located in the riverside. It is near Crowne Plaza Hotel. Its customer rating is 5 out of 5.'
'name[The Phoenix], eatType[restaurant], food[Indian], priceRange[cheap], customer rating[5 out of 5], area[riverside], familyFriendly[no], near[Express by Holiday Inn]'	'The Phoenix is a restaurant providing indian food in the cheap price range. It is located in the riverside. It is near Express by Holiday Inn. Its customer rating is 5 out of 5.'
'name[The Phoenix], eatType[restaurant], food[Indian], priceRange[cheap], customer rating[5 out of 5], area[riverside], familyFriendly[yes], near[Express by Holiday Inn]'	'The Phoenix is a cheap indian restaurant in the riverside area near Express by Holiday Inn. It has a 5 out of 5 customer rating and is family friendly.'
'name[The Phoenix], eatType[restaurant], food[Indian], priceRange[cheap], customer rating[average], area[city centre], familyFriendly[no], near[Express by Holiday Inn]'	'The Phoenix is a restaurant providing indian food in the cheap price range. It is located in the city centre. It is near Express by Holiday Inn. Its customer rating is average.'
'name[The Plough], eatType[pub], food[Chinese], priceRange[£20-25], area[riverside], familyFriendly[yes], near[Raja Indian Cuisine]'	'The Plough is a pub providing chinese food in the £20-25 price range. It is located in the riverside. It is near Raja Indian Cuisine.'
'name[The Plough], eatType[pub], food[Chinese], priceRange[cheap], area[riverside], familyFriendly[yes], near[Raja Indian Cuisine]'	'The Plough is a cheap, family friendly chinese pub in the riverside area near Raja Indian Cuisine.'
'name[The Plough], eatType[pub], food[Chinese], priceRange[high], area[city centre], familyFriendly[no], near[Raja Indian Cuisine]'	'The Plough is a chinese pub located in the city centre near Raja Indian Cuisine. It is not child friendly and has a high price range.'
'name[The Plough], eatType[pub], food[Chinese], priceRange[high], area[city centre], familyFriendly[yes], near[Raja Indian Cuisine]'	'The Plough is a pub that provides chinese food in the high price range. It is located in the city centre near Raja Indian Cuisine.'
'name[The Plough], eatType[pub], food[Chinese], priceRange[high], area[riverside], familyFriendly[no], near[Raja Indian Cuisine]'	'The Plough is a pub providing chinese food in the high price range. It is located in the riverside. It is near Raja Indian Cuisine.'
'name[The Plough], eatType[pub], food[Chinese], priceRange[high], area[riverside], familyFriendly[yes], near[Raja Indian Cuisine]'	'The Plough is a child friendly chinese pub in the riverside area near Raja Indian Cuisine. It has a high price range.'
'name[The Plough], eatType[pub], food[Chinese], priceRange[less than £20], area[city centre], familyFriendly[no], near[Raja Indian Cuisine]'	'The Plough is a chinese pub located near Raja Indian Cuisine in the city centre. It is not family friendly and has a price range of less than £20.'
'name[The Plough], eatType[restaurant], food[Chinese], priceRange[£20-25], area[riverside], familyFriendly[yes], near[Raja Indian Cuisine]'	'The Plough is a restaurant providing chinese food in the £20-25 price range. It is located in the riverside. It is near Raja Indian Cuisine.'
'name[The Plough], eatType[restaurant], food[Chinese], priceRange[cheap], area[riverside], familyFriendly[yes], near[Raja Indian Cuisine]'	'The Plough is a cheap, family friendly chinese restaurant in riverside near Raja Indian Cuisine.'
'name[The Plough], eatType[restaurant], food[Chinese], priceRange[high], area[city centre], familyFriendly[no], near[Raja Indian Cuisine]'	'The Plough is a chinese restaurant located in the city centre near Raja Indian Cuisine. It is not child friendly and has a high price range.'
'name[The Plough], eatType[restaurant], food[Chinese], priceRange[high], area[city centre], familyFriendly[yes], near[Raja Indian Cuisine]'	'The Plough is a restaurant that provides chinese food in the high price range. It is located in the city centre. It is near Raja Indian Cuisine.'
'name[The Plough], eatType[restaurant], food[Chinese], priceRange[high], area[riverside], familyFriendly[no], near[Raja Indian Cuisine]'	'The Plough is a restaurant providing chinese food in the high price range. It is located in the riverside. It is near Raja Indian Cuisine.'
'name[The Plough], eatType[restaurant], food[Chinese], priceRange[high], area[riverside], familyFriendly[yes], near[Raja Indian Cuisine]'	'The Plough is a chinese restaurant in the riverside area near Raja Indian Cuisine. It is child friendly and has a high price range.'
'name[The Plough], eatType[restaurant], food[Chinese], priceRange[less than £20], area[city centre], familyFriendly[no], near[Raja Indian Cuisine]'	'The Plough is a restaurant providing chinese food in the less than £20 price range. It is located in the city centre. It is near Raja Indian Cuisine.'
'name[The Punter], eatType[pub], food[Chinese], priceRange[less than £20], area[city centre], familyFriendly[yes], near[Raja Indian Cuisine]'	'The Punter is a family friendly pub that provides chinese food in the less than £20 price range. It is located in the city centre. It is near Raja Indian Cuisine.'
'name[The Punter], eatType[pub], food[Chinese], priceRange[less than £20], area[riverside], familyFriendly[no], near[Raja Indian Cuisine]'	'The Punter is a pub providing chinese food in the less than £20 price range. It is located in the riverside. It is near Raja Indian Cuisine.'
'name[The Punter], eatType[pub], food[Chinese], priceRange[less than £20], area[riverside], familyFriendly[yes], near[Raja Indian Cuisine]'	'The Punter is a pub providing chinese food in the less than £20 price range. It is located in the riverside. It is near Raja Indian Cuisine.'
'name[The Punter], eatType[pub], food[Chinese], priceRange[moderate], area[city centre], familyFriendly[no], near[Raja Indian Cuisine]'	'The Punter is a moderately priced chinese pub in the city centre near Raja Indian Cuisine. It is not kid friendly.'
'name[The Punter], eatType[pub], food[Chinese], priceRange[moderate], area[city centre], familyFriendly[yes], near[Raja Indian Cuisine]'	'The Punter is a pub providing chinese food in the moderate price range. It is located in the city centre. It is near Raja Indian Cuisine.'
'name[The Punter], eatType[pub], food[Chinese], priceRange[moderate], area[riverside], familyFriendly[no], near[Raja Indian Cuisine]'	'The Punter is a moderately priced chinese pub in the riverside area near Raja Indian Cuisine. It is not kid friendly.'
'name[The Punter], eatType[pub], food[Chinese], priceRange[moderate], area[riverside], familyFriendly[yes], near[Raja Indian Cuisine]'	'The Punter is a moderately priced chinese pub in the riverside area near Raja Indian Cuisine. It is kid friendly.'
'name[The Punter], eatType[pub], food[Chinese], priceRange[more than £30], area[riverside], familyFriendly[yes], near[Raja Indian Cuisine]'	'The Punter is a pub providing chinese food in the more than £30 price range. It is located in the riverside. It is near Raja Indian Cuisine.'
'name[The Punter], eatType[pub], food[English], priceRange[£20-25], area[riverside], familyFriendly[yes], near[Raja Indian Cuisine]'	'The Punter is a kid friendly pub in the riverside area near Raja Indian Cuisine. It serves english food and has a price range of £20-25.'
'name[The Punter], eatType[pub], food[English], priceRange[cheap], area[riverside], familyFriendly[yes], near[Raja Indian Cuisine]'	'The Punter is a cheap, family friendly english pub near Raja Indian Cuisine in the riverside area.'
'name[The Punter], eatType[pub], food[English], priceRange[high], area[city centre], familyFriendly[no], near[Raja Indian Cuisine]'	'The Punter is a high priced english pub located in the city centre near Raja Indian Cuisine. It is not child friendly.'
'name[The Punter], eatType[pub], food[English], priceRange[high], area[city centre], familyFriendly[yes], near[Raja Indian Cuisine]'	'The Punter is a children friendly english pub in the city centre near Raja Indian Cuisine. It has a high price range.'
'name[The Punter], eatType[pub], food[English], priceRange[high], area[riverside], familyFriendly[no], near[Raja Indian Cuisine]'	'The Punter is a high priced english pub near Raja Indian Cuisine in the riverside area. It is not child friendly.'
'name[The Punter], eatType[pub], food[English], priceRange[high], area[riverside], familyFriendly[yes], near[Raja Indian Cuisine]'	'The Punter is a children friendly english pub near Raja Indian Cuisine in the riverside area. It has a high price range.'
'name[The Punter], eatType[pub], food[Italian], priceRange[high], customer rating[average], area[city centre], familyFriendly[no], near[Rainbow Vegetarian Café]'	'The Punter is an italian pub located in the city centre near Rainbow Vegetarian Café. It is not child friendly and has a high price range and an average customer rating.'
'name[The Punter], eatType[restaurant], food[Chinese], priceRange[less than £20], area[city centre], familyFriendly[yes], near[Raja Indian Cuisine]'	'The Punter is a cheap chinese restaurant in the city centre near Raja Indian Cuisine. It is family friendly.'
'name[The Punter], eatType[restaurant], food[Chinese], priceRange[less than £20], area[riverside], familyFriendly[no], near[Raja Indian Cuisine]'	'The Punter is a restaurant providing chinese food in the less than £20 price range. It is located in the riverside. It is near Raja Indian Cuisine.'
'name[The Punter], eatType[restaurant], food[Chinese], priceRange[less than £20], area[riverside], familyFriendly[yes], near[Raja Indian Cuisine]'	'The Punter is a chinese restaurant in the riverside area near Raja Indian Cuisine. It is family friendly and has a price range of less than £20.'
'name[The Punter], eatType[restaurant], food[Chinese], priceRange[moderate], area[city centre], familyFriendly[no], near[Raja Indian Cuisine]'	'The Punter is a restaurant providing chinese food in the moderate price range. It is located in the city centre near Raja Indian Cuisine.'
'name[The Punter], eatType[restaurant], food[Chinese], priceRange[moderate], area[city centre], familyFriendly[yes], near[Raja Indian Cuisine]'	'The Punter is a moderately priced, kid friendly chinese restaurant in the city centre near Raja Indian Cuisine.'
'name[The Punter], eatType[restaurant], food[Chinese], priceRange[moderate], area[riverside], familyFriendly[no], near[Raja Indian Cuisine]'	'The Punter is a restaurant providing chinese food in the moderate price range. It is located in the riverside. It is near Raja Indian Cuisine.'
'name[The Punter], eatType[restaurant], food[Chinese], priceRange[moderate], area[riverside], familyFriendly[yes], near[Raja Indian Cuisine]'	'The Punter is a chinese restaurant in the riverside area near Raja Indian Cuisine. It is kid friendly and has a moderate price range.'
'name[The Punter], eatType[restaurant], food[Chinese], priceRange[more than £30], area[riverside], familyFriendly[yes], near[Raja Indian Cuisine]'	'The Punter is a restaurant that provides chinese food in the more than £30 price range. It is located in the riverside. It is near Raja Indian Cuisine. Its children friendly.'
'name[The Punter], eatType[restaurant], food[English], priceRange[£20-25], area[riverside], familyFriendly[yes], near[Raja Indian Cuisine]'	'The Punter is a kid friendly english restaurant in the riverside area near Raja Indian Cuisine with a price range of £20-25.'
'name[The Punter], eatType[restaurant], food[English], priceRange[cheap], area[riverside], familyFriendly[yes], near[Raja Indian Cuisine]'	'The Punter is a cheap, family friendly english restaurant located near Raja Indian Cuisine in the riverside area.'
'name[The Punter], eatType[restaurant], food[English], priceRange[high], area[city centre], familyFriendly[no], near[Raja Indian Cuisine]'	'The Punter is an english restaurant located in the city centre near Raja Indian Cuisine. It is not child friendly and has a high price range.'
'name[The Punter], eatType[restaurant], food[English], priceRange[high], area[city centre], familyFriendly[yes], near[Raja Indian Cuisine]'	'The Punter is a children friendly english restaurant in the city centre near Raja Indian Cuisine. It has a high price range.'
'name[The Punter], eatType[restaurant], food[English], priceRange[high], area[riverside], familyFriendly[no], near[Raja Indian Cuisine]'	'The Punter is an english restaurant near Raja Indian Cuisine in the riverside area. It is not child friendly and has a high price range.'
'name[The Punter], eatType[restaurant], food[English], priceRange[high], area[riverside], familyFriendly[yes], near[Raja Indian Cuisine]'	'The Punter is a children friendly english restaurant in the riverside area near Raja Indian Cuisine. It has a high price range.'
'name[The Punter], eatType[restaurant], food[Indian], priceRange[cheap], customer rating[average], area[city centre], familyFriendly[yes], near[Express by Holiday Inn]'	'The Punter provides indian food in the cheap price range. It is located in the city centre. It is near Express by Holiday Inn. Its customer rating is average.'
'name[The Punter], eatType[restaurant], food[Indian], priceRange[cheap], customer rating[average], area[riverside], familyFriendly[no], near[Express by Holiday Inn]'	'The Punter is a restaurant providing indian food in the cheap price range. It is located in the riverside. It is near Express by Holiday Inn. Its customer rating is average.'
'name[The Punter], eatType[restaurant], food[Indian], priceRange[cheap], customer rating[average], area[riverside], familyFriendly[yes], near[Express by Holiday Inn]'	'The Punter is a restaurant providing indian food in the cheap price range. It is located in the riverside. It is near Express by Holiday Inn. Its customer rating is average.'
'name[The Punter], eatType[restaurant], food[Indian], priceRange[high], customer rating[1 out of 5], area[city centre], familyFriendly[no], near[Express by Holiday Inn]'	'The Punter is a restaurant providing indian food in the high price range. It is located in the city centre. It is near Express by Holiday Inn. Its customer rating is 1 out of 5.'
'name[The Punter], eatType[restaurant], food[Indian], priceRange[high], customer rating[1 out of 5], area[city centre], familyFriendly[yes], near[Express by Holiday Inn]'	'The Punter provides indian food in the high price range. It is located in the city centre near Express by Holiday Inn. Its customer rating is 1 out of 5.'
'name[The Punter], eatType[restaurant], food[Indian], priceRange[high], customer rating[1 out of 5], area[riverside], familyFriendly[no], near[Express by Holiday Inn]'	'The Punter is a restaurant providing indian food in the high price range. It is located in the riverside. It is near Express by Holiday Inn. Its customer rating is 1 out of 5.'
'name[The Punter], eatType[restaurant], food[Indian], priceRange[high], customer rating[1 out of 5], area[riverside], familyFriendly[yes], near[Express by Holiday Inn]'	'The Punter is a restaurant providing indian food in the high price range. It is located in the riverside. It is near Express by Holiday Inn. Its customer rating is 1 out of 5.'
'name[The Punter], eatType[restaurant], food[Indian], priceRange[high], customer rating[average], area[city centre], familyFriendly[no], near[Express by Holiday Inn]'	'The Punter provides indian food in the high price range. It is located in the city centre. It is near Express by Holiday Inn. Its customer rating is average.'
'name[The Punter], eatType[restaurant], food[Indian], priceRange[high], customer rating[average], area[city centre], familyFriendly[yes], near[Express by Holiday Inn]'	'The Punter provides indian food in the more than £30 price range. It is located in the city centre. It is near Express by Holiday Inn. Its customer rating is average.'
'name[The Punter], eatType[restaurant], food[Indian], priceRange[high], customer rating[average], area[riverside], familyFriendly[no], near[Express by Holiday Inn]'	'The Punter provides indian food in the high price range. It is located in the riverside. It is near Express by Holiday Inn. Its customer rating is average.'
'name[The Punter], eatType[restaurant], food[Indian], priceRange[high], customer rating[average], area[riverside], familyFriendly[yes], near[Express by Holiday Inn]'	'The Punter provides indian food in the high price range. It is located in the riverside. It is near Express by Holiday Inn. Its customer rating is average.'
'name[The Punter], eatType[restaurant], food[Indian], priceRange[less than £20], customer rating[low], area[city centre], familyFriendly[no], near[Express by Holiday Inn]'	'The Punter is a restaurant providing indian food in the less than £20 price range. It is located in the city centre. It is near Express by Holiday Inn. Its customer rating is low.'
'name[The Punter], eatType[restaurant], food[Indian], priceRange[less than £20], customer rating[low], area[city centre], familyFriendly[yes], near[Express by Holiday Inn]'	'The Punter is a restaurant providing indian food in the less than £20 price range. It is located in the city centre. It is near Express by Holiday Inn. Its customer rating is low.'
'name[The Punter], eatType[restaurant], food[Indian], priceRange[less than £20], customer rating[low], area[riverside], familyFriendly[no], near[Express by Holiday Inn]'	'The Punter is a restaurant providing indian food in the less than £20 price range. It is located in the riverside. It is near Express by Holiday Inn. Its customer rating is low.'
'name[The Punter], eatType[restaurant], food[Indian], priceRange[less than £20], customer rating[low], area[riverside], familyFriendly[yes], near[Express by Holiday Inn]'	'The Punter is a restaurant providing indian food in the less than £20 price range. It is located in the riverside. It is near Express by Holiday Inn. Its customer rating is low.'
'name[The Punter], eatType[restaurant], food[Indian], priceRange[moderate], customer rating[1 out of 5], area[city centre], familyFriendly[no], near[Express by Holiday Inn]'	'The Punter is a restaurant providing indian food in the moderate price range. It is located in the city centre. It is near Express by Holiday Inn. Its customer rating is 1 out of 5.'
'name[The Punter], eatType[restaurant], food[Indian], priceRange[moderate], customer rating[1 out of 5], area[city centre], familyFriendly[yes], near[Express by Holiday Inn]'	'The Punter provides indian food in the moderate price range. It is located in the city centre. It is near Express by Holiday Inn. Its customer rating is 1 out of 5.'
'name[The Punter], eatType[restaurant], food[Indian], priceRange[moderate], customer rating[1 out of 5], area[riverside], familyFriendly[no], near[Express by Holiday Inn]'	'The Punter is a restaurant providing indian food in the moderate price range. It is located in the riverside. It is near Express by Holiday Inn. Its customer rating is 1 out of 5.'
'name[The Punter], eatType[restaurant], food[Indian], priceRange[moderate], customer rating[1 out of 5], area[riverside], familyFriendly[yes], near[Express by Holiday Inn]'	'The Punter is a restaurant that provides indian food in the moderate price range. It is located in the riverside. It is near Express by Holiday Inn. Its customer rating is 1 out of 5.'
'name[The Punter], eatType[restaurant], food[Indian], priceRange[moderate], customer rating[3 out of 5], area[city centre], familyFriendly[no], near[Express by Holiday Inn]'	'The Punter is a restaurant providing indian food in the moderate price range. It is located in the city centre. It is near Express by Holiday Inn. Its customer rating is 3 out of 5.'
'name[The Punter], eatType[restaurant], food[Indian], priceRange[moderate], customer rating[3 out of 5], area[city centre], familyFriendly[yes], near[Express by Holiday Inn]'	'The Punter is a restaurant that provides indian food in the moderate price range. It is located in the city centre. It is near Express by Holiday Inn. Its customer rating is 3 out of 5.'
'name[The Punter], eatType[restaurant], food[Indian], priceRange[moderate], customer rating[3 out of 5], area[riverside], familyFriendly[no], near[Express by Holiday Inn]'	'The Punter is a restaurant providing indian food in the moderate price range. It is located in the riverside. It is near Express by Holiday Inn. Its customer rating is 3 out of 5.'
'name[The Punter], eatType[restaurant], food[Indian], priceRange[moderate], customer rating[3 out of 5], area[riverside], familyFriendly[yes], near[Express by Holiday Inn]'	'The Punter is a restaurant providing indian food in the moderate price range. It is located in the riverside. It is near Express by Holiday Inn. Its customer rating is 3 out of 5.'
'name[The Punter], eatType[restaurant], food[Indian], priceRange[more than £30], customer rating[high], area[city centre], familyFriendly[no], near[Express by Holiday Inn]'	'The Punter is a restaurant providing indian food in the more than £30 price range. It is located in the city centre. It is near Express by Holiday Inn. Its customer rating is high.'
'name[The Punter], eatType[restaurant], food[Indian], priceRange[more than £30], customer rating[high], area[city centre], familyFriendly[yes], near[Express by Holiday Inn]'	'The Punter is a restaurant that provides indian food in the more than £30 price range. It is located in the city centre. It is near Express by Holiday Inn. Its customer rating is high.'
'name[The Punter], eatType[restaurant], food[Indian], priceRange[more than £30], customer rating[high], area[riverside], familyFriendly[no], near[Express by Holiday Inn]'	'The Punter is a restaurant providing indian food in the more than £30 price range. It is located in the riverside. It is near Express by Holiday Inn. Its customer rating is high.'
'name[The Punter], eatType[restaurant], food[Indian], priceRange[more than £30], customer rating[high], area[riverside], familyFriendly[yes], near[Express by Holiday Inn]'	'The Punter provides indian food in the more than £30 price range. It is near Express by Holiday Inn. Its customer rating is high.'
'name[The Punter], eatType[restaurant], food[Italian], priceRange[£20-25], customer rating[high], area[city centre], familyFriendly[no], near[Express by Holiday Inn]'	'The Punter is a restaurant providing italian food in the £20-25 price range. It is located in the centre of the city centre. It is near Express by Holiday Inn. Its customer rating is high.'
'name[The Punter], eatType[restaurant], food[Italian], priceRange[£20-25], customer rating[high], area[city centre], familyFriendly[yes], near[Express by Holiday Inn]'	'The Punter is a kid friendly italian restaurant in the city centre near Express by Holiday Inn. It has a high customer rating and a price range of £20-25.'
'name[The Punter], eatType[restaurant], food[Italian], priceRange[£20-25], customer rating[high], area[riverside], familyFriendly[no], near[Express by Holiday Inn]'	'The Punter is a restaurant providing italian food in the £20-25 price range. It is located in the riverside near Express by Holiday Inn. Its customer rating is high.'
'name[The Punter], eatType[restaurant], food[Italian], priceRange[£20-25], customer rating[high], area[riverside], familyFriendly[yes], near[Express by Holiday Inn]'	'The Punter is a kid friendly italian restaurant in the riverside area near Express by Holiday Inn. It has a high customer rating and a price range of £20-25.'
'name[The Punter], eatType[restaurant], food[Italian], priceRange[cheap], customer rating[5 out of 5], area[city centre], familyFriendly[no], near[Express by Holiday Inn]'	'The Punter is a cheap italian restaurant located in the city centre near Express by Holiday Inn. It is not family-friendly and has a customer rating of 5 out of 5.'
'name[The Punter], eatType[restaurant], food[Italian], priceRange[cheap], customer rating[5 out of 5], area[city centre], familyFriendly[no], near[Rainbow Vegetarian Café]'	'The Punter is a restaurant providing italian food in the cheap price range. It is located in the city centre. It is near Rainbow Vegetarian Café. Its customer rating is 5 out of 5.'
'name[The Punter], eatType[restaurant], food[Italian], priceRange[cheap], customer rating[5 out of 5], area[city centre], familyFriendly[yes], near[Rainbow Vegetarian Café]'	'The Punter is a cheap italian restaurant in the city centre near Rainbow Vegetarian Café. It is family-friendly and has a customer rating of 5 out of 5.'
'name[The Punter], eatType[restaurant], food[Italian], priceRange[cheap], customer rating[5 out of 5], area[riverside], familyFriendly[no], near[Rainbow Vegetarian Café]'	'The Punter is a cheap italian restaurant near Rainbow Vegetarian Café in riverside. It is not family-friendly and has a customer rating of 5 out of 5.'
'name[The Punter], eatType[restaurant], food[Italian], priceRange[cheap], customer rating[5 out of 5], area[riverside], familyFriendly[yes], near[Rainbow Vegetarian Café]'	'The Punter is a family friendly italian restaurant with a cheap price range and a customer rating of 5 out of 5. It is located in the riverside area near Rainbow Vegetarian Café.'
'name[The Punter], eatType[restaurant], food[Italian], priceRange[cheap], customer rating[average], area[city centre], familyFriendly[no], near[Rainbow Vegetarian Café]'	'The Punter is a restaurant providing italian food in the cheap price range. It is located in the city centre. It is near Rainbow Vegetarian Café. Its customer rating is average.'
'name[The Punter], eatType[restaurant], food[Italian], priceRange[cheap], customer rating[average], area[city centre], familyFriendly[yes], near[Rainbow Vegetarian Café]'	'The Punter is a cheap italian restaurant located in the city centre near Rainbow Vegetarian Café. It has an average customer rating and is family-friendly.'
'name[The Punter], eatType[restaurant], food[Italian], priceRange[cheap], customer rating[average], area[riverside], familyFriendly[no], near[Rainbow Vegetarian Café]'	'The Punter is a cheap italian restaurant near Rainbow Vegetarian Café in the riverside area. It is not family-friendly and has an average customer rating.'
'name[The Punter], eatType[restaurant], food[Italian], priceRange[cheap], customer rating[average], area[riverside], familyFriendly[yes], near[Rainbow Vegetarian Café]'	'The Punter is a family friendly italian restaurant in the riverside area near Rainbow Vegetarian Café. It has an average customer rating and a cheap price range.'
'name[The Punter], eatType[restaurant], food[Italian], priceRange[high], customer rating[1 out of 5], area[city centre], familyFriendly[no], near[Rainbow Vegetarian Café]'	'The Punter is a restaurant providing italian food in the high price range. It is located in the city centre. It is near Rainbow Vegetarian Café. Its customer rating is 1 out of 5.'
'name[The Punter], eatType[restaurant], food[Italian], priceRange[high], customer rating[1 out of 5], area[city centre], familyFriendly[yes], near[Rainbow Vegetarian Café]'	'The Punter is a children friendly italian restaurant in the city centre near Rainbow Vegetarian Café. It has a high price range and a customer rating of 1 out of 5.'
'name[The Punter], eatType[restaurant], food[Italian], priceRange[high], customer rating[1 out of 5], area[riverside], familyFriendly[no], near[Rainbow Vegetarian Café]'	'The Punter is a restaurant providing italian food in the high price range. It is located in the riverside area near Rainbow Vegetarian Café. Its customer rating is 1 out of 5.'
'name[The Punter], eatType[restaurant], food[Italian], priceRange[high], customer rating[1 out of 5], area[riverside], familyFriendly[yes], near[Rainbow Vegetarian Café]'	'The Punter is a child friendly italian restaurant in the riverside area near Rainbow Vegetarian Café. It has a customer rating of 1 out of 5 and a high price range.'
'name[The Vaults], eatType[pub], food[French], priceRange[high], area[riverside], familyFriendly[yes], near[Raja Indian Cuisine]'	'The Vaults is a children friendly french pub near Raja Indian Cuisine in the riverside area. It has a high price range.'
'name[The Vaults], eatType[pub], food[French], priceRange[less than £20], area[city centre], familyFriendly[no], near[Raja Indian Cuisine]'	'The Vaults is a pub providing french food in the less than £20 price range. It is located in the city centre near Raja Indian Cuisine. It is not family-friendly.'
'name[The Vaults], eatType[pub], food[French], priceRange[less than £20], area[city centre], familyFriendly[yes], near[Raja Indian Cuisine]'	'The Vaults is a family-friendly french pub in the city centre near Raja Indian Cuisine. It has a price range of less than £20.'
'name[The Vaults], eatType[pub], food[French], priceRange[less than £20], area[riverside], familyFriendly[no], near[Raja Indian Cuisine]'	'The Vaults is a french pub near Raja Indian Cuisine in the riverside area. It is not family-friendly and has a price range of less than £20.'
'name[The Vaults], eatType[pub], food[French], priceRange[less than £20], area[riverside], familyFriendly[yes], near[Raja Indian Cuisine]'	'The Vaults is a family friendly french pub near Raja Indian Cuisine in the riverside area. It has a price range of less than £20.'
'name[The Vaults], eatType[pub], food[French], priceRange[moderate], area[city centre], familyFriendly[no], near[Raja Indian Cuisine]'	'The Vaults is a moderately priced french pub in the city centre near Raja Indian Cuisine. It is not child friendly.'
'name[The Vaults], eatType[pub], food[French], priceRange[moderate], area[city centre], familyFriendly[yes], near[Raja Indian Cuisine]'	'The Vaults is a kid friendly pub serving french food in the moderate price range. It is located in the city centre near Raja Indian Cuisine.'
'name[The Vaults], eatType[pub], food[French], priceRange[moderate], area[riverside], familyFriendly[no], near[Raja Indian Cuisine]'	'The Vaults is a moderately priced french pub near Raja Indian Cuisine in riverside. It is not kid friendly.'
'name[The Vaults], eatType[pub], food[French], priceRange[moderate], area[riverside], familyFriendly[yes], near[Raja Indian Cuisine]'	'The Vaults is a moderately priced, kid friendly french pub near Raja Indian Cuisine in the riverside area.'
'name[The Vaults], eatType[pub], food[French], priceRange[more than £30], area[city centre], familyFriendly[no], near[Raja Indian Cuisine]'	'The Vaults is a french pub in the city centre near Raja Indian Cuisine. It is not child friendly and has a price range of more than £30.'
'name[The Vaults], eatType[pub], food[French], priceRange[more than £30], area[city centre], familyFriendly[yes], near[Raja Indian Cuisine]'	'The Vaults is a children friendly french pub in the city centre near Raja Indian Cuisine. It has a price range of more than £30.'
'name[The Vaults], eatType[pub], food[French], priceRange[more than £30], area[riverside], familyFriendly[no], near[Raja Indian Cuisine]'	'The Vaults is a french pub near Raja Indian Cuisine in riverside. It is not child friendly and has a price range of more than £30.'
'name[The Vaults], eatType[pub], food[French], priceRange[more than £30], area[riverside], familyFriendly[yes], near[Raja Indian Cuisine]'	'The Vaults is a child friendly pub serving french food in the riverside area near Raja Indian Cuisine. It has a price range of more than £30.'
'name[The Vaults], eatType[pub], food[Indian], priceRange[£20-25], area[riverside], familyFriendly[yes], near[Raja Indian Cuisine]'	'The Vaults is a kid friendly pub that provides indian food in the £20-25 price range. It is located in the riverside. It is near Raja Indian Cuisine.'
'name[The Vaults], eatType[pub], food[Indian], priceRange[cheap], area[riverside], familyFriendly[yes], near[Raja Indian Cuisine]'	'The Vaults is a cheap, family friendly indian pub near Raja Indian Cuisine in the riverside area.'
'name[The Vaults], eatType[pub], food[Indian], priceRange[high], area[city centre], familyFriendly[no], near[Raja Indian Cuisine]'	'The Vaults is a pub that provides indian food in the high price range. It is located in the city centre. It is near Raja Indian Cuisine. It is not children friendly.'
'name[The Vaults], eatType[pub], food[Indian], priceRange[high], area[city centre], familyFriendly[yes], near[Raja Indian Cuisine]'	'The Vaults is a pub that provides indian food in the high price range. It is located in the city centre near Raja Indian Cuisine.'
'name[The Vaults], eatType[pub], food[Italian], priceRange[high], customer rating[average], area[city centre], familyFriendly[no], near[Rainbow Vegetarian Café]'	'The Vaults is an italian pub located in the city centre near Rainbow Vegetarian Café. It is not child friendly and has an average customer rating and a high price range.'
'name[The Vaults], eatType[pub], food[Italian], priceRange[high], customer rating[average], area[city centre], familyFriendly[yes], near[Rainbow Vegetarian Café]'	'The Vaults is a children friendly italian pub in the city centre near Rainbow Vegetarian Café. It has an average customer rating and a high price range.'
'name[The Vaults], eatType[pub], food[Italian], priceRange[high], customer rating[average], area[riverside], familyFriendly[no], near[Rainbow Vegetarian Café]'	'The Vaults is a high-priced italian pub near Rainbow Vegetarian Café in the riverside area. It has an average customer rating and is not child friendly.'
'name[The Vaults], eatType[pub], food[Italian], priceRange[high], customer rating[average], area[riverside], familyFriendly[yes], near[Rainbow Vegetarian Café]'	'The Vaults is a children friendly italian pub near Rainbow Vegetarian Café in the riverside area. It has a high price range and an average customer rating.'
'name[The Vaults], eatType[pub], food[Italian], priceRange[less than £20], customer rating[low], area[city centre], familyFriendly[no], near[Rainbow Vegetarian Café]'	'The Vaults is an italian pub located in the city centre near Rainbow Vegetarian Café. It is not family-friendly and has a price range of less than £20 and a low customer rating.'
'name[The Vaults], eatType[pub], food[Italian], priceRange[less than £20], customer rating[low], area[city centre], familyFriendly[yes], near[Rainbow Vegetarian Café]'	'The Vaults is a family-friendly italian pub in the city centre near Rainbow Vegetarian Café. It has a low customer rating and a price range of less than £20.'
'name[The Vaults], eatType[pub], food[Italian], priceRange[less than £20], customer rating[low], area[riverside], familyFriendly[no], near[Rainbow Vegetarian Café]'	'The Vaults is an italian pub located near Rainbow Vegetarian Café in the riverside area. It has a low customer rating and a price range of less than £20. It is not family-friendly.'
'name[The Vaults], eatType[pub], food[Italian], priceRange[less than £20], customer rating[low], area[riverside], familyFriendly[yes], near[Rainbow Vegetarian Café]'	'The Vaults is a family friendly italian pub located near the Rainbow Vegetarian Café in the riverside area. It has a low customer rating and a price range of less than £20.'
'name[The Vaults], eatType[pub], food[Italian], priceRange[moderate], customer rating[1 out of 5], area[city centre], familyFriendly[no], near[Rainbow Vegetarian Café]'	'The Vaults is a pub providing italian food in the moderate price range. It is located in the city centre. It is near Rainbow Vegetarian Café. Its customer rating is 1 out of 5.'
'name[The Vaults], eatType[pub], food[Italian], priceRange[moderate], customer rating[1 out of 5], area[city centre], familyFriendly[yes], near[Rainbow Vegetarian Café]'	'The Vaults is a kid friendly italian pub in the moderate price range. It is located in the city centre near Rainbow Vegetarian Café and has a customer rating of 1 out of 5.'
'name[The Vaults], eatType[pub], food[Italian], priceRange[moderate], customer rating[1 out of 5], area[riverside], familyFriendly[no], near[Rainbow Vegetarian Café]'	'The Vaults is a moderately priced italian pub in the riverside area near Rainbow Vegetarian Café. It has a customer rating of 1 out of 5 and is not kid friendly.'
'name[The Vaults], eatType[pub], food[Italian], priceRange[moderate], customer rating[1 out of 5], area[riverside], familyFriendly[yes], near[Rainbow Vegetarian Café]'	'The Vaults is a kid friendly italian pub near Rainbow Vegetarian Café in the riverside area. It has a moderate price range and a customer rating of 1 out of 5.'
'name[The Vaults], eatType[pub], food[Italian], priceRange[moderate], customer rating[3 out of 5], area[city centre], familyFriendly[no], near[Rainbow Vegetarian Café]'	'The Vaults is a moderately priced italian restaurant located in the city centre near Rainbow Vegetarian Café. It is not kid friendly and has a customer rating of 3 out of 5.'
'name[The Vaults], eatType[pub], food[Italian], priceRange[moderate], customer rating[3 out of 5], area[city centre], familyFriendly[yes], near[Rainbow Vegetarian Café]'	'The Vaults is a family-friendly italian pub in the city centre near Rainbow Vegetarian Café. It has a moderate price range and a customer rating of 3 out of 5.'
'name[The Vaults], eatType[pub], food[Italian], priceRange[moderate], customer rating[3 out of 5], area[riverside], familyFriendly[no], near[Rainbow Vegetarian Café]'	'The Vaults is a moderately priced italian restaurant in the riverside area near Rainbow Vegetarian Café. It is not kid friendly and has a customer rating of 3 out of 5.'
'name[The Vaults], eatType[pub], food[Italian], priceRange[moderate], customer rating[3 out of 5], area[riverside], familyFriendly[yes], near[Rainbow Vegetarian Café]'	'The Vaults is a kid friendly italian pub in the riverside area near Rainbow Vegetarian Café. It has a moderate price range and a customer rating of 3 out of 5.'
'name[The Vaults], eatType[pub], food[Italian], priceRange[more than £30], customer rating[high], area[city centre], familyFriendly[no], near[Rainbow Vegetarian Café]'	'The Vaults is an italian pub in the city centre near Rainbow Vegetarian Café. It has a high customer rating and a price range of more than £30. It is not child friendly.'
'name[The Vaults], eatType[pub], food[Italian], priceRange[more than £30], customer rating[high], area[city centre], familyFriendly[yes], near[Rainbow Vegetarian Café]'	'The Vaults is an italian pub in the city centre near Rainbow Vegetarian Café. It has a high customer rating and a price range of more than £30. It is children friendly.'
'name[The Vaults], eatType[pub], food[Italian], priceRange[more than £30], customer rating[high], area[riverside], familyFriendly[no], near[Rainbow Vegetarian Café]'	'The Vaults is a high-priced, highly rated italian pub located near Rainbow Vegetarian Café in the riverside area. It is not child friendly.'
'name[The Vaults], eatType[pub], food[Italian], priceRange[more than £30], customer rating[high], area[riverside], familyFriendly[yes], near[Rainbow Vegetarian Café]'	'The Vaults is a children friendly italian pub near Rainbow Vegetarian Café in the riverside area with a high customer rating and a price range of more than £30.'
'name[The Vaults], eatType[pub], food[Japanese], priceRange[£20-25], customer rating[3 out of 5], area[city centre], familyFriendly[no], near[Rainbow Vegetarian Café]'	'The Vaults is a pub providing japanese food in the £20-25 price range. It is located in the city centre near Rainbow Vegetarian Café. Its customer rating is 3 out of 5.'
'name[The Vaults], eatType[pub], food[Japanese], priceRange[£20-25], customer rating[3 out of 5], area[city centre], familyFriendly[yes], near[Rainbow Vegetarian Café]'	'The Vaults is a pub providing japanese food in the £20-25 price range. It is located in the city centre near Rainbow Vegetarian Café. Its customer rating is 3 out of 5.'
'name[The Vaults], eatType[pub], food[Japanese], priceRange[£20-25], customer rating[3 out of 5], area[riverside], familyFriendly[no], near[Rainbow Vegetarian Café]'	'The Vaults is a japanese pub with a price range of £20-25 near Rainbow Vegetarian Café in riverside. It has a customer rating of 3 out of 5 and is not kid friendly.'
'name[The Vaults], eatType[pub], food[Japanese], priceRange[£20-25], customer rating[3 out of 5], area[riverside], familyFriendly[yes], near[Rainbow Vegetarian Café]'	'The Vaults is a kid friendly japanese pub in the riverside area near Rainbow Vegetarian Café. It has a moderate price range and a customer rating of 3 out of 5.'
'name[The Vaults], eatType[pub], food[Japanese], priceRange[£20-25], customer rating[high], area[city centre], familyFriendly[no], near[Rainbow Vegetarian Café]'	'The Vaults is a japanese pub located in the city centre near Rainbow Vegetarian Café. It has a high customer rating and a price range of £20-25 and is not child friendly.'
'name[The Vaults], eatType[pub], food[Japanese], priceRange[£20-25], customer rating[high], area[city centre], familyFriendly[yes], near[Rainbow Vegetarian Café]'	'The Vaults is a japanese pub located in the city centre near Rainbow Vegetarian Café. It has a high customer rating and a price range of £20-25 and is kids friendly.'
'name[The Vaults], eatType[pub], food[Japanese], priceRange[£20-25], customer rating[high], area[riverside], familyFriendly[no], near[Rainbow Vegetarian Café]'	'The Vaults is a japanese pub near Rainbow Vegetarian Café in the riverside area. It has a high customer rating and a price range of £20-25 and is not kid friendly.'
'name[The Vaults], eatType[pub], food[Japanese], priceRange[£20-25], customer rating[high], area[riverside], familyFriendly[no], near[Raja Indian Cuisine]'	'The Vaults is a japanese pub near Raja Indian Cuisine in the riverside area. It has a high customer rating and a price range of £20-25 and is not kid friendly.'
'name[The Vaults], eatType[pub], food[Japanese], priceRange[£20-25], customer rating[high], area[riverside], familyFriendly[yes], near[Raja Indian Cuisine]'	'The Vaults is a kid friendly japanese pub in the riverside area near Raja Indian Cuisine. It has a high customer rating and a price range of £20-25.'
'name[The Vaults], eatType[pub], food[Japanese], priceRange[cheap], customer rating[5 out of 5], area[city centre], familyFriendly[no], near[Raja Indian Cuisine]'	'The Vaults is a cheap japanese restaurant located in the city centre near Raja Indian Cuisine. It is not family-friendly and has a customer rating of 5 out of 5.'
'name[The Vaults], eatType[pub], food[Japanese], priceRange[cheap], customer rating[5 out of 5], area[city centre], familyFriendly[yes], near[Raja Indian Cuisine]'	'The Vaults is a family-friendly japanese pub with a cheap price range and a customer rating of 5 out of 5. It is located near Raja Indian Cuisine in the city centre.'
'name[The Vaults], eatType[pub], food[Japanese], priceRange[cheap], customer rating[5 out of 5], area[riverside], familyFriendly[no], near[Raja Indian Cuisine]'	'The Vaults is a cheap japanese pub in the riverside area near Raja Indian Cuisine. It is not family-friendly and has a customer rating of 5 out of 5.'
'name[The Vaults], eatType[pub], food[Japanese], priceRange[cheap], customer rating[5 out of 5], area[riverside], familyFriendly[yes], near[Raja Indian Cuisine]'	'The Vaults is a family friendly japanese pub with a cheap price range and a customer rating of 5 out of 5. It is located in the riverside area near Raja Indian Cuisine.'
'name[The Vaults], eatType[pub], food[Japanese], priceRange[high], customer rating[3 out of 5], area[city centre], familyFriendly[no], near[Raja Indian Cuisine]'	'The Vaults is a japanese pub located in the city centre near Raja Indian Cuisine. It is not child friendly and has a high price range and a customer rating of 3 out of 5.'
'name[The Vaults], eatType[pub], food[Japanese], priceRange[high], customer rating[3 out of 5], area[city centre], familyFriendly[yes], near[Raja Indian Cuisine]'	'The Vaults is a children friendly japanese pub in the city centre near Raja Indian Cuisine. It has a high price range and a customer rating of 3 out of 5.'
'name[The Vaults], eatType[pub], food[Japanese], priceRange[high], customer rating[3 out of 5], area[riverside], familyFriendly[no], near[Raja Indian Cuisine]'	'The Vaults is a japanese pub located near Raja Indian Cuisine in the riverside area. It is not child friendly and has a high price range and a customer rating of 3 out of 5.'
'name[The Vaults], eatType[pub], food[Japanese], priceRange[high], customer rating[3 out of 5], area[riverside], familyFriendly[yes], near[Raja Indian Cuisine]'	'The Vaults is a children friendly japanese pub near Raja Indian Cuisine in the riverside area. It has a high price range and a customer rating of 3 out of 5.'
'name[The Vaults], eatType[pub], food[Japanese], priceRange[less than £20], customer rating[average], area[city centre], familyFriendly[no], near[Raja Indian Cuisine]'	'The Vaults is a cheap japanese pub in the city centre near Raja Indian Cuisine. It is not family-friendly and has an average customer rating.'
'name[The Vaults], eatType[pub], food[Japanese], priceRange[less than £20], customer rating[average], area[city centre], familyFriendly[yes], near[Raja Indian Cuisine]'	'The Vaults is a family-friendly japanese pub in the city centre near Raja Indian Cuisine. It has an average customer rating and a price range of less than £20.'
'name[The Vaults], eatType[pub], food[Japanese], priceRange[less than £20], customer rating[average], area[riverside], familyFriendly[no], near[Raja Indian Cuisine]'	'The Vaults is a japanese pub located near Raja Indian Cuisine in the riverside area. It is not family-friendly and has an average customer rating.'
'name[The Vaults], eatType[pub], food[Japanese], priceRange[less than £20], customer rating[average], area[riverside], familyFriendly[yes], near[Raja Indian Cuisine]'	'The Vaults is a family friendly japanese pub in the riverside area near Raja Indian Cuisine. It has an average customer rating and prices less than £20.'
'name[The Vaults], eatType[pub], food[Japanese], priceRange[less than £20], customer rating[low], area[city centre], familyFriendly[no], near[Raja Indian Cuisine]'	'The Vaults is a japanese pub located near Raja Indian Cuisine in the city centre. It has a low customer rating and a price range of less than £20 and is not family-friendly.'
'name[The Vaults], eatType[pub], food[Japanese], priceRange[less than £20], customer rating[low], area[city centre], familyFriendly[yes], near[Raja Indian Cuisine]'	'The Vaults is a family-friendly japanese pub in the city centre near Raja Indian Cuisine. It has a low customer rating and a price range of less than £20.'
'name[The Vaults], eatType[pub], food[Japanese], priceRange[less than £20], customer rating[low], area[riverside], familyFriendly[no], near[Raja Indian Cuisine]'	'The Vaults is a cheap japanese pub near Raja Indian Cuisine in the riverside area. It is not family-friendly and has a low customer rating.'
'name[The Vaults], eatType[pub], food[Japanese], priceRange[less than £20], customer rating[low], area[riverside], familyFriendly[yes], near[Raja Indian Cuisine]'	'The Vaults is a family friendly japanese pub near the Raja Indian Cuisine in the riverside area with a low customer rating and a price range of less than £20.'
'name[The Vaults], eatType[pub], food[Japanese], priceRange[moderate], customer rating[1 out of 5], area[city centre], familyFriendly[no], near[Raja Indian Cuisine]'	'The Vaults is a moderately priced japanese pub located in the city centre near Raja Indian Cuisine. It has a customer rating of 1 out of 5 and is not kid friendly.'
'name[The Vaults], eatType[pub], food[Japanese], priceRange[moderate], customer rating[1 out of 5], area[city centre], familyFriendly[yes], near[Raja Indian Cuisine]'	'The Vaults is a japanese pub located in the city centre near Raja Indian Cuisine. It is child friendly and has a moderate price range and a customer rating of 1 out of 5.'
'name[The Vaults], eatType[restaurant], food[French], priceRange[high], area[riverside], familyFriendly[yes], near[Raja Indian Cuisine]'	'The Vaults is a children friendly french restaurant in riverside near Raja Indian Cuisine. It has a high price range.'
'name[The Vaults], eatType[restaurant], food[French], priceRange[less than £20], area[city centre], familyFriendly[no], near[Raja Indian Cuisine]'	'The Vaults is a french restaurant located in the city centre near Raja Indian Cuisine. It is not family-friendly and has a price range of less than £20.'
'name[The Vaults], eatType[restaurant], food[French], priceRange[less than £20], area[city centre], familyFriendly[yes], near[Raja Indian Cuisine]'	'The Vaults is a family-friendly french restaurant in the city centre near Raja Indian Cuisine. It has a price range of less than £20.'
'name[The Vaults], eatType[restaurant], food[French], priceRange[less than £20], area[riverside], familyFriendly[no], near[Raja Indian Cuisine]'	'The Vaults is a french restaurant near Raja Indian Cuisine in the riverside area. It is not family-friendly and has a price range of less than £20.'
'name[The Vaults], eatType[restaurant], food[French], priceRange[less than £20], area[riverside], familyFriendly[yes], near[Raja Indian Cuisine]'	'The Vaults is a family friendly french restaurant in the riverside area near Raja Indian Cuisine. It has a price range of less than £20.'
'name[The Vaults], eatType[restaurant], food[French], priceRange[moderate], area[city centre], familyFriendly[no], near[Raja Indian Cuisine]'	'The Vaults is a restaurant providing french food in the moderate price range. It is located in the city centre near Raja Indian Cuisine. It is not kids friendly.'
'name[The Vaults], eatType[restaurant], food[French], priceRange[moderate], area[city centre], familyFriendly[yes], near[Raja Indian Cuisine]'	'The Vaults is a moderately priced french restaurant in the city centre near Raja Indian Cuisine. It is kid friendly.'
'name[The Vaults], eatType[restaurant], food[French], priceRange[moderate], area[riverside], familyFriendly[no], near[Raja Indian Cuisine]'	'The Vaults is a moderately priced french restaurant near Raja Indian Cuisine in riverside. It is not kid friendly.'
'name[The Vaults], eatType[restaurant], food[French], priceRange[moderate], area[riverside], familyFriendly[yes], near[Raja Indian Cuisine]'	'The Vaults is a kid friendly french restaurant near Raja Indian Cuisine in the riverside area. It has a moderate price range.'
'name[The Vaults], eatType[restaurant], food[French], priceRange[more than £30], area[city centre], familyFriendly[no], near[Raja Indian Cuisine]'	'The Vaults is a french restaurant located in the city centre near Raja Indian Cuisine. It is not child friendly and has a price range of more than £30.'
'name[The Vaults], eatType[restaurant], food[French], priceRange[more than £30], area[city centre], familyFriendly[yes], near[Raja Indian Cuisine]'	'The Vaults is a children friendly french restaurant in the city centre near Raja Indian Cuisine. It has a price range of more than £30.'
'name[The Vaults], eatType[restaurant], food[French], priceRange[more than £30], area[riverside], familyFriendly[no], near[Raja Indian Cuisine]'	'The Vaults is a french restaurant near Raja Indian Cuisine in riverside. It is not child friendly and has a price range of more than £30.'
'name[The Vaults], eatType[restaurant], food[French], priceRange[more than £30], area[riverside], familyFriendly[yes], near[Raja Indian Cuisine]'	'The Vaults is a children friendly french restaurant in riverside near Raja Indian Cuisine. It has a price range of more than £30.'
'name[The Vaults], eatType[restaurant], food[Indian], priceRange[£20-25], area[riverside], familyFriendly[yes], near[Raja Indian Cuisine]'	'The Vaults provides indian food in the £20-25 price range. It is located in the riverside. It is near Raja Indian Cuisine.'
'name[The Vaults], eatType[restaurant], food[Indian], priceRange[cheap], area[riverside], familyFriendly[yes], near[Raja Indian Cuisine]'	'The Vaults is a cheap, family friendly indian restaurant in riverside near Raja Indian Cuisine.'
'name[The Vaults], eatType[restaurant], food[Indian], priceRange[high], area[city centre], familyFriendly[no], near[Raja Indian Cuisine]'	'The Vaults is an indian restaurant located in the city centre near Raja Indian Cuisine. It is not child friendly and has a high price range.'
'name[The Vaults], eatType[restaurant], food[Indian], priceRange[high], area[city centre], familyFriendly[yes], near[Raja Indian Cuisine]'	'The Vaults provides indian food in the high price range. It is located in the city centre. It is near Raja Indian Cuisine.'
'name[The Waterman], eatType[pub], food[Indian], priceRange[high], area[city centre], familyFriendly[yes], near[Raja Indian Cuisine]'	'The Waterman is a pub that provides indian food in the high price range. It is located in the city centre near Raja Indian Cuisine.'
'name[The Waterman], eatType[pub], food[Indian], priceRange[high], area[riverside], familyFriendly[no], near[Raja Indian Cuisine]'	'The Waterman is a pub providing indian food in the high price range. It is located in the riverside. It is near Raja Indian Cuisine.'
'name[The Waterman], eatType[pub], food[Indian], priceRange[high], area[riverside], familyFriendly[yes], near[Raja Indian Cuisine]'	'The Waterman is a pub providing indian food in the high price range. It is located in the riverside. It is near Raja Indian Cuisine.'
'name[The Waterman], eatType[pub], food[Indian], priceRange[less than £20], area[city centre], familyFriendly[no], near[Raja Indian Cuisine]'	'The Waterman is a pub providing indian food in the less than £20 price range. It is located in the city centre. It is near Raja Indian Cuisine.'
'name[The Waterman], eatType[pub], food[Indian], priceRange[less than £20], area[city centre], familyFriendly[yes], near[Raja Indian Cuisine]'	'The Waterman is a family friendly pub that provides indian food in the less than £20 price range. It is located in the city centre. It is near Raja Indian Cuisine.'
'name[The Waterman], eatType[pub], food[Indian], priceRange[less than £20], area[riverside], familyFriendly[no], near[Raja Indian Cuisine]'	'The Waterman is a cheap indian pub near Raja Indian Cuisine in the riverside area. It is not family friendly.'
'name[The Waterman], eatType[pub], food[Indian], priceRange[less than £20], area[riverside], familyFriendly[yes], near[Raja Indian Cuisine]'	'The Waterman is a family friendly pub that provides indian food in the less than £20 price range. It is located in the riverside. It is near Raja Indian Cuisine.'
'name[The Waterman], eatType[pub], food[Indian], priceRange[moderate], area[city centre], familyFriendly[no], near[Raja Indian Cuisine]'	'The Waterman is a pub providing indian food in the moderate price range. It is located in the city centre. It is near Raja Indian Cuisine.'
'name[The Waterman], eatType[pub], food[Indian], priceRange[moderate], area[city centre], familyFriendly[yes], near[Raja Indian Cuisine]'	'The Waterman is a pub providing indian food in the moderate price range. It is located in the city centre. It is near Raja Indian Cuisine.'
'name[The Waterman], eatType[pub], food[Indian], priceRange[moderate], area[riverside], familyFriendly[no], near[Raja Indian Cuisine]'	'The Waterman is a moderately priced indian pub in the riverside area near Raja Indian Cuisine. It is not kid friendly.'
'name[The Waterman], eatType[pub], food[Indian], priceRange[moderate], area[riverside], familyFriendly[yes], near[Raja Indian Cuisine]'	'The Waterman is a moderately priced indian pub in riverside near Raja Indian Cuisine. It is kid friendly.'
'name[The Waterman], eatType[pub], food[Indian], priceRange[more than £30], area[riverside], familyFriendly[yes], near[Raja Indian Cuisine]'	'The Waterman is a children friendly pub that provides indian food in the more than £30 price range. It is located in the riverside. It is near Raja Indian Cuisine.'
'name[The Waterman], eatType[pub], food[Italian], priceRange[£20-25], area[riverside], familyFriendly[yes], near[Raja Indian Cuisine]'	'The Waterman is a kid friendly italian pub in the riverside area near Raja Indian Cuisine. The price range is £20-25.'
'name[The Waterman], eatType[pub], food[Italian], priceRange[cheap], area[riverside], familyFriendly[yes], near[Raja Indian Cuisine]'	'The Waterman is a cheap, family friendly italian pub near Raja Indian Cuisine in the riverside area.'
'name[The Waterman], eatType[pub], food[Italian], priceRange[high], area[city centre], familyFriendly[no], near[Raja Indian Cuisine]'	'The Waterman is an italian pub located in the city centre near Raja Indian Cuisine. It is not child friendly and has a high price range.'
'name[The Waterman], eatType[pub], food[Italian], priceRange[high], area[city centre], familyFriendly[yes], near[Raja Indian Cuisine]'	'The Waterman is a children friendly italian pub in the city centre near Raja Indian Cuisine. It has a high price range.'
'name[The Waterman], eatType[pub], food[Italian], priceRange[high], area[riverside], familyFriendly[no], near[Raja Indian Cuisine]'	'The Waterman is an italian pub near Raja Indian Cuisine in the riverside area. It is not child friendly and has a high price range.'
'name[The Waterman], eatType[pub], food[Italian], priceRange[high], area[riverside], familyFriendly[yes], near[Raja Indian Cuisine]'	'The Waterman is a children friendly italian pub near Raja Indian Cuisine in the riverside area. It has a high price range.'
'name[The Waterman], eatType[pub], food[Italian], priceRange[less than £20], area[city centre], familyFriendly[no], near[Raja Indian Cuisine]'	'The Waterman is an italian pub located in the city centre near Raja Indian Cuisine. It is not family-friendly and has a price range of less than £20.'
'name[The Waterman], eatType[pub], food[Italian], priceRange[less than £20], area[city centre], familyFriendly[yes], near[Raja Indian Cuisine]'	'The Waterman is a family-friendly pub serving italian food in the less than £20 price range. It is located in the city centre near Raja Indian Cuisine.'
'name[The Waterman], eatType[pub], food[Italian], priceRange[less than £20], area[riverside], familyFriendly[no], near[Raja Indian Cuisine]'	'The Waterman is a cheap italian pub near Raja Indian Cuisine in riverside. It is not family-friendly.'
'name[The Waterman], eatType[restaurant], food[Indian], priceRange[high], area[city centre], familyFriendly[yes], near[Raja Indian Cuisine]'	'The Waterman is a restaurant that provides indian food in the high price range. It is located in the city centre. It is near Raja Indian Cuisine.'
'name[The Waterman], eatType[restaurant], food[Indian], priceRange[high], area[riverside], familyFriendly[no], near[Raja Indian Cuisine]'	'The Waterman is a restaurant providing indian food in the high price range. It is located in the riverside. It is near Raja Indian Cuisine.'
'name[The Waterman], eatType[restaurant], food[Indian], priceRange[high], area[riverside], familyFriendly[yes], near[Raja Indian Cuisine]'	'The Waterman is a children friendly indian restaurant in the riverside area near Raja Indian Cuisine. It has a high price range.'
'name[The Waterman], eatType[restaurant], food[Indian], priceRange[less than £20], area[city centre], familyFriendly[no], near[Raja Indian Cuisine]'	'The Waterman is a restaurant providing indian food in the less than £20 price range. It is located in the city centre. It is near Raja Indian Cuisine.'
'name[The Waterman], eatType[restaurant], food[Indian], priceRange[less than £20], area[city centre], familyFriendly[yes], near[Raja Indian Cuisine]'	'The Waterman is a family friendly restaurant that provides indian food in the less than £20 price range. It is located in the city centre. It is near Raja Indian Cuisine.'
'name[The Waterman], eatType[restaurant], food[Indian], priceRange[less than £20], area[riverside], familyFriendly[no], near[Raja Indian Cuisine]'	'The Waterman is a restaurant providing indian food in the less than £20 price range. It is located in the riverside. It is near Raja Indian Cuisine.'
'name[The Waterman], eatType[restaurant], food[Indian], priceRange[less than £20], area[riverside], familyFriendly[yes], near[Raja Indian Cuisine]'	'The Waterman is a family friendly indian restaurant in the riverside area near Raja Indian Cuisine. It has a price range of less than £20.'
'name[The Waterman], eatType[restaurant], food[Indian], priceRange[moderate], area[city centre], familyFriendly[no], near[Raja Indian Cuisine]'	'The Waterman is a moderately priced indian restaurant in the city centre near Raja Indian Cuisine. It is not kid friendly.'
'name[The Waterman], eatType[restaurant], food[Indian], priceRange[moderate], area[city centre], familyFriendly[yes], near[Raja Indian Cuisine]'	'The Waterman is a moderately priced, kid friendly indian restaurant in the city centre near Raja Indian Cuisine.'
'name[The Waterman], eatType[restaurant], food[Indian], priceRange[moderate], area[riverside], familyFriendly[no], near[Raja Indian Cuisine]'	'The Waterman is a restaurant providing indian food in the moderate price range. It is located in the riverside. It is near Raja Indian Cuisine.'
'name[The Waterman], eatType[restaurant], food[Indian], priceRange[moderate], area[riverside], familyFriendly[yes], near[Raja Indian Cuisine]'	'The Waterman is a moderately priced indian restaurant in riverside near Raja Indian Cuisine. It is kid friendly.'
'name[The Waterman], eatType[restaurant], food[Indian], priceRange[more than £30], area[riverside], familyFriendly[yes], near[Raja Indian Cuisine]'	'The Waterman is a restaurant that provides indian food in the more than £30 price range. It is located in the riverside. It is near Raja Indian Cuisine.'
'name[The Waterman], eatType[restaurant], food[Italian], priceRange[£20-25], area[riverside], familyFriendly[yes], near[Raja Indian Cuisine]'	'The Waterman is a kid friendly italian restaurant in riverside near Raja Indian Cuisine. It has a price range of £20-25.'
'name[The Waterman], eatType[restaurant], food[Italian], priceRange[cheap], area[riverside], familyFriendly[yes], near[Raja Indian Cuisine]'	'The Waterman is a cheap, family friendly italian restaurant near Raja Indian Cuisine in riverside.'
'name[The Waterman], eatType[restaurant], food[Italian], priceRange[high], area[city centre], familyFriendly[no], near[Raja Indian Cuisine]'	'The Waterman is an italian restaurant located in the city centre near Raja Indian Cuisine. It is not child friendly and has a high price range.'
'name[The Waterman], eatType[restaurant], food[Italian], priceRange[high], area[city centre], familyFriendly[yes], near[Raja Indian Cuisine]'	'The Waterman is a children friendly italian restaurant in the city centre near Raja Indian Cuisine. It has a high price range.'
'name[The Waterman], eatType[restaurant], food[Italian], priceRange[high], area[riverside], familyFriendly[no], near[Raja Indian Cuisine]'	'The Waterman is an italian restaurant near Raja Indian Cuisine in the riverside area. It is not child friendly and has a high price range.'
'name[The Waterman], eatType[restaurant], food[Italian], priceRange[high], area[riverside], familyFriendly[yes], near[Raja Indian Cuisine]'	'The Waterman is a children friendly italian restaurant in the riverside area near Raja Indian Cuisine. It has a high price range.'
'name[The Waterman], eatType[restaurant], food[Italian], priceRange[less than £20], area[city centre], familyFriendly[no], near[Raja Indian Cuisine]'	'The Waterman is a cheap italian restaurant in the city centre near Raja Indian Cuisine. It is not family-friendly.'
'name[The Waterman], eatType[restaurant], food[Italian], priceRange[less than £20], area[city centre], familyFriendly[yes], near[Raja Indian Cuisine]'	'The Waterman is a family-friendly italian restaurant in the city centre near Raja Indian Cuisine. The price range is less than £20.'
'name[The Waterman], eatType[restaurant], food[Italian], priceRange[less than £20], area[riverside], familyFriendly[no], near[Raja Indian Cuisine]'	'The Waterman is an italian restaurant near Raja Indian Cuisine in the riverside area. It is not family-friendly and has a price range of less than £20.'
'name[The Wrestlers], eatType[pub], food[Italian], priceRange[less than £20], area[riverside], familyFriendly[no], near[Raja Indian Cuisine]'	'The Wrestlers is a cheap italian pub located near Raja Indian Cuisine in the riverside area. It is not family-friendly.'
'name[The Wrestlers], eatType[pub], food[Italian], priceRange[less than £20], area[riverside], familyFriendly[yes], near[Raja Indian Cuisine]'	'The Wrestlers is a family friendly italian pub in the riverside area near Raja Indian Cuisine. It has a price range of less than £20.'
'name[The Wrestlers], eatType[pub], food[Italian], priceRange[moderate], area[city centre], familyFriendly[no], near[Raja Indian Cuisine]'	'The Wrestlers is a moderately priced italian pub in the city centre near Raja Indian Cuisine. It is not child friendly.'
'name[The Wrestlers], eatType[pub], food[Italian], priceRange[moderate], area[city centre], familyFriendly[yes], near[Raja Indian Cuisine]'	'The Wrestlers is a moderately priced, kid-friendly italian pub located in the city centre near Raja Indian Cuisine.'
'name[The Wrestlers], eatType[pub], food[Italian], priceRange[moderate], area[riverside], familyFriendly[no], near[Raja Indian Cuisine]'	'The Wrestlers is a moderately priced italian pub in the riverside area near Raja Indian Cuisine. It is not kid friendly.'
'name[The Wrestlers], eatType[pub], food[Italian], priceRange[moderate], area[riverside], familyFriendly[yes], near[Raja Indian Cuisine]'	'The Wrestlers is a moderately priced, kid friendly italian pub near Raja Indian Cuisine in the riverside area.'
'name[The Wrestlers], eatType[pub], food[Italian], priceRange[more than £30], area[riverside], familyFriendly[yes], near[Raja Indian Cuisine]'	'The Wrestlers is a child friendly italian pub in riverside near Raja Indian Cuisine. It has a price range of more than £30.'
'name[The Wrestlers], eatType[pub], food[Japanese], priceRange[£20-25], area[riverside], familyFriendly[yes], near[Raja Indian Cuisine]'	'The Wrestlers is a kid friendly japanese pub in the riverside area near Raja Indian Cuisine. It has a price range of £20-25.'
'name[The Wrestlers], eatType[pub], food[Japanese], priceRange[cheap], area[riverside], familyFriendly[yes], near[Raja Indian Cuisine]'	'The Wrestlers is a cheap, family friendly, japanese pub near Raja Indian Cuisine in the riverside area.'
'name[The Wrestlers], eatType[pub], food[Japanese], priceRange[high], area[riverside], familyFriendly[yes], near[Raja Indian Cuisine]'	'The Wrestlers is a child friendly japanese pub near Raja Indian Cuisine in the riverside area with a high price range.'
'name[The Wrestlers], eatType[pub], food[Japanese], priceRange[less than £20], area[city centre], familyFriendly[no], near[Raja Indian Cuisine]'	'The Wrestlers is a japanese pub located in the city centre near Raja Indian Cuisine. It is not family-friendly and has a price range of less than £20.'
'name[The Wrestlers], eatType[pub], food[Japanese], priceRange[less than £20], area[city centre], familyFriendly[yes], near[Raja Indian Cuisine]'	'The Wrestlers is a family-friendly japanese pub in the city centre near Raja Indian Cuisine. It has a price range of less than £20.'
'name[The Wrestlers], eatType[pub], food[Japanese], priceRange[less than £20], area[riverside], familyFriendly[no], near[Raja Indian Cuisine]'	'The Wrestlers is a japanese pub near Raja Indian Cuisine in the riverside area. It is not family-friendly and has a price range of less than £20.'
'name[The Wrestlers], eatType[pub], food[Japanese], priceRange[less than £20], area[riverside], familyFriendly[yes], near[Raja Indian Cuisine]'	'The Wrestlers is a family friendly japanese pub in the riverside area near Raja Indian Cuisine. It has a price range of less than £20.'
'name[The Wrestlers], eatType[pub], food[Japanese], priceRange[moderate], area[city centre], familyFriendly[no], near[Raja Indian Cuisine]'	'The Wrestlers is a japanese pub located in the city centre near Raja Indian Cuisine. It has a moderate price range and is not kid friendly.'
'name[The Wrestlers], eatType[pub], food[Japanese], priceRange[moderate], area[city centre], familyFriendly[yes], near[Raja Indian Cuisine]'	'The Wrestlers is a moderately priced, family-friendly japanese pub located near Raja Indian Cuisine in the city centre.'
'name[The Wrestlers], eatType[pub], food[Japanese], priceRange[moderate], area[riverside], familyFriendly[no], near[Raja Indian Cuisine]'	'The Wrestlers is a moderately priced japanese pub near Raja Indian Cuisine in the riverside area. It is not kid friendly.'
'name[The Wrestlers], eatType[pub], food[Japanese], priceRange[moderate], area[riverside], familyFriendly[yes], near[Raja Indian Cuisine]'	'The Wrestlers is a moderately priced, kid friendly japanese pub near Raja Indian Cuisine in the riverside area.'
'name[The Wrestlers], eatType[pub], food[Japanese], priceRange[moderate], customer rating[1 out of 5], area[city centre], familyFriendly[yes], near[Raja Indian Cuisine]'	'The Wrestlers is a japanese pub located in the city centre near Raja Indian Cuisine. It is kid friendly and has a moderate price range and a customer rating of 1 out of 5.'
'name[The Wrestlers], eatType[pub], food[Japanese], priceRange[moderate], customer rating[1 out of 5], area[riverside], familyFriendly[no], near[Raja Indian Cuisine]'	'The Wrestlers is a japanese pub located near the Raja Indian Cuisine in the riverside area. It has a moderate price range and a customer rating of 1 out of 5. It is not kid friendly.'
'name[The Wrestlers], eatType[pub], food[Japanese], priceRange[moderate], customer rating[1 out of 5], area[riverside], familyFriendly[yes], near[Raja Indian Cuisine]'	'The Wrestlers is a kid friendly japanese pub in the riverside area near Raja Indian Cuisine with a moderate price range and a customer rating of 1 out of 5.'
'name[The Wrestlers], eatType[pub], food[Japanese], priceRange[more than £30], area[city centre], familyFriendly[no], near[Raja Indian Cuisine]'	'The Wrestlers is a japanese pub located in the city centre near Raja Indian Cuisine. It is not child friendly and has a price range of more than £30.'
'name[The Wrestlers], eatType[pub], food[Japanese], priceRange[more than £30], area[city centre], familyFriendly[yes], near[Raja Indian Cuisine]'	'The Wrestlers is a children friendly japanese pub in the city centre near Raja Indian Cuisine. It has a high price range.'
'name[The Wrestlers], eatType[pub], food[Japanese], priceRange[more than £30], area[riverside], familyFriendly[no], near[Raja Indian Cuisine]'	'The Wrestlers is a japanese pub located near Raja Indian Cuisine in the riverside area. It is not child friendly and has a price range of more than £30.'
'name[The Wrestlers], eatType[pub], food[Japanese], priceRange[more than £30], area[riverside], familyFriendly[yes], near[Raja Indian Cuisine]'	'The Wrestlers is a children friendly japanese pub near Raja Indian Cuisine in the riverside area. It has a price range of more than £30.'
'name[The Wrestlers], eatType[pub], food[Japanese], priceRange[more than £30], customer rating[5 out of 5], area[city centre], familyFriendly[no], near[Raja Indian Cuisine]'	'The Wrestlers is a japanese pub located in the city centre near Raja Indian Cuisine. It is not child friendly and has a high customer rating.'
'name[The Wrestlers], eatType[pub], food[Japanese], priceRange[more than £30], customer rating[5 out of 5], area[city centre], familyFriendly[yes], near[Raja Indian Cuisine]'	'The Wrestlers is a child-friendly japanese pub in the city centre near Raja Indian Cuisine. It has a high price range and a customer rating of 5 out of 5.'
'name[The Wrestlers], eatType[pub], food[Japanese], priceRange[more than £30], customer rating[5 out of 5], area[riverside], familyFriendly[no], near[Raja Indian Cuisine]'	'The Wrestlers is a japanese pub near Raja Indian Cuisine in the riverside area. It has a high customer rating and a price range of more than £30 and is not child friendly.'
'name[The Wrestlers], eatType[pub], food[Japanese], priceRange[more than £30], customer rating[5 out of 5], area[riverside], familyFriendly[yes], near[Raja Indian Cuisine]'	'The Wrestlers is a child friendly japanese pub with a high price range and a customer rating of 5 out of 5. It is located near Raja Indian Cuisine in the riverside area.'
'name[The Wrestlers], eatType[pub], food[Japanese], priceRange[more than £30], customer rating[low], area[city centre], familyFriendly[no], near[Raja Indian Cuisine]'	'The Wrestlers is a japanese pub located in the city centre near Raja Indian Cuisine. It is not child friendly and has a high price range and a high customer rating.'
'name[The Wrestlers], eatType[pub], food[Japanese], priceRange[more than £30], customer rating[low], area[city centre], familyFriendly[yes], near[Raja Indian Cuisine]'	'The Wrestlers is a family-friendly japanese pub in the city centre near Raja Indian Cuisine with a low customer rating and a price range of more than £30.'
'name[The Wrestlers], eatType[pub], food[Japanese], priceRange[more than £30], customer rating[low], area[riverside], familyFriendly[no], near[Raja Indian Cuisine]'	'The Wrestlers is a japanese pub near Raja Indian Cuisine in the riverside area. It is not child friendly and has a low customer rating and a price range of more than £30.'
'name[The Wrestlers], eatType[pub], food[Japanese], priceRange[more than £30], customer rating[low], area[riverside], familyFriendly[yes], near[Raja Indian Cuisine]'	'The Wrestlers is a children friendly japanese pub near Raja Indian Cuisine in the riverside area with a low customer rating and a price range of more than £30.'
'name[The Wrestlers], eatType[restaurant], food[Italian], priceRange[less than £20], area[riverside], familyFriendly[no], near[Raja Indian Cuisine]'	'The Wrestlers is a cheap italian restaurant located near Raja Indian Cuisine in the riverside area. It is not family-friendly.'
'name[The Wrestlers], eatType[restaurant], food[Italian], priceRange[less than £20], area[riverside], familyFriendly[yes], near[Raja Indian Cuisine]'	'The Wrestlers is a family friendly italian restaurant in the riverside area near Raja Indian Cuisine. It has a price range of less than £20.'
'name[The Wrestlers], eatType[restaurant], food[Italian], priceRange[moderate], area[city centre], familyFriendly[no], near[Raja Indian Cuisine]'	'The Wrestlers is a moderately priced italian restaurant in the city centre near Raja Indian Cuisine. It is not kid friendly.'
'name[The Wrestlers], eatType[restaurant], food[Italian], priceRange[moderate], area[city centre], familyFriendly[yes], near[Raja Indian Cuisine]'	'The Wrestlers is a moderately priced italian restaurant in the city centre near Raja Indian Cuisine. It is kid friendly.'
'name[The Wrestlers], eatType[restaurant], food[Italian], priceRange[moderate], area[riverside], familyFriendly[no], near[Raja Indian Cuisine]'	'The Wrestlers is a moderately priced italian restaurant in the riverside area near Raja Indian Cuisine. It is not kid friendly.'
'name[The Wrestlers], eatType[restaurant], food[Italian], priceRange[moderate], area[riverside], familyFriendly[yes], near[Raja Indian Cuisine]'	'The Wrestlers is a moderately priced italian restaurant in the riverside area near Raja Indian Cuisine. It is kid friendly.'
'name[The Wrestlers], eatType[restaurant], food[Italian], priceRange[more than £30], area[riverside], familyFriendly[yes], near[Raja Indian Cuisine]'	'The Wrestlers is a child friendly italian restaurant in riverside near Raja Indian Cuisine. It has a price range of more than £30.'
'name[The Wrestlers], eatType[restaurant], food[Japanese], priceRange[£20-25], area[riverside], familyFriendly[yes], near[Raja Indian Cuisine]'	'The Wrestlers is a kid friendly japanese restaurant in riverside near Raja Indian Cuisine. It has a price range of £20-25.'
'name[The Wrestlers], eatType[restaurant], food[Japanese], priceRange[cheap], area[riverside], familyFriendly[yes], near[Raja Indian Cuisine]'	'The Wrestlers is a cheap, family friendly japanese restaurant in riverside near Raja Indian Cuisine.'
'name[The Wrestlers], eatType[restaurant], food[Japanese], priceRange[high], area[riverside], familyFriendly[yes], near[Raja Indian Cuisine]'	'The Wrestlers is a children friendly japanese restaurant near Raja Indian Cuisine in the riverside area. It has a high price range.'
'name[The Wrestlers], eatType[restaurant], food[Japanese], priceRange[less than £20], area[city centre], familyFriendly[no], near[Raja Indian Cuisine]'	'The Wrestlers is a restaurant providing japanese food in the less than £20 price range. It is located in the city centre. It is near Raja Indian Cuisine.'
'name[The Wrestlers], eatType[restaurant], food[Japanese], priceRange[less than £20], area[city centre], familyFriendly[yes], near[Raja Indian Cuisine]'	'The Wrestlers is a family-friendly japanese restaurant in the city centre near Raja Indian Cuisine. It has a price range of less than £20.'
'name[The Wrestlers], eatType[restaurant], food[Japanese], priceRange[less than £20], area[riverside], familyFriendly[no], near[Raja Indian Cuisine]'	'The Wrestlers is a japanese restaurant near Raja Indian Cuisine in the riverside area. It is not family-friendly and has a price range of less than £20.'
'name[The Wrestlers], eatType[restaurant], food[Japanese], priceRange[less than £20], area[riverside], familyFriendly[yes], near[Raja Indian Cuisine]'	'The Wrestlers is a family friendly sushi restaurant located near Raja Indian Cuisine.'
'name[The Wrestlers], eatType[restaurant], food[Japanese], priceRange[moderate], area[city centre], familyFriendly[no], near[Raja Indian Cuisine]'	'The Wrestlers is a moderately priced japanese restaurant in the city centre near Raja Indian Cuisine. It is not child friendly.'
'name[The Wrestlers], eatType[restaurant], food[Japanese], priceRange[moderate], area[city centre], familyFriendly[yes], near[Raja Indian Cuisine]'	'The Wrestlers is a moderately priced, kid-friendly japanese restaurant in the city centre near Raja Indian Cuisine.'
'name[The Wrestlers], eatType[restaurant], food[Japanese], priceRange[moderate], area[riverside], familyFriendly[no], near[Raja Indian Cuisine]'	'The Wrestlers is a japanese restaurant near Raja Indian Cuisine in riverside. It is not kid friendly and has a moderate price range.'
'name[The Wrestlers], eatType[restaurant], food[Japanese], priceRange[moderate], area[riverside], familyFriendly[yes], near[Raja Indian Cuisine]'	'The Wrestlers is a moderately priced, kid friendly japanese restaurant near Raja Indian Cuisine in the riverside area.'
'name[The Wrestlers], eatType[restaurant], food[Japanese], priceRange[more than £30], area[city centre], familyFriendly[no], near[Raja Indian Cuisine]'	'The Wrestlers is a japanese restaurant located in the city centre near Raja Indian Cuisine. It is not child friendly and has a price range of more than £30.'
'name[The Wrestlers], eatType[restaurant], food[Japanese], priceRange[more than £30], area[city centre], familyFriendly[yes], near[Raja Indian Cuisine]'	'The Wrestlers is a children friendly japanese restaurant located in the city centre near Raja Indian Cuisine.'
'name[The Wrestlers], eatType[restaurant], food[Japanese], priceRange[more than £30], area[riverside], familyFriendly[no], near[Raja Indian Cuisine]'	'The Wrestlers is a restaurant providing japanese food in the more than £30 price range. It is located in the riverside. It is near Raja Indian Cuisine.'
'name[The Wrestlers], eatType[restaurant], food[Japanese], priceRange[more than £30], area[riverside], familyFriendly[yes], near[Raja Indian Cuisine]'	'The Wrestlers is a children friendly japanese restaurant in riverside near Raja Indian Cuisine. It has a high price range.'
'name[Wildwood], eatType[coffee shop], area[riverside]'	'In the riverside area, Wildwood is a coffee shop.'
'name[Wildwood], eatType[pub], area[riverside]'	'By the riverside is a pub called Wildwood.'
'name[Wildwood], eatType[pub], food[French], area[riverside], familyFriendly[yes], near[Raja Indian Cuisine]'	'Wildwood is a family friendly french pub in the riverside area near Raja Indian Cuisine.'
'name[Wildwood], eatType[pub], food[Indian], area[city centre], familyFriendly[no], near[Raja Indian Cuisine]'	'Wildwood is a pub serving indian food in the city centre near Raja Indian Cuisine. It is not family friendly.'
'name[Wildwood], eatType[pub], food[Indian], area[city centre], familyFriendly[yes], near[Raja Indian Cuisine]'	'Wildwood is a family-friendly pub serving indian food. It is located in the city centre near Raja Indian Cuisine.'
'name[Wildwood], eatType[pub], food[Indian], area[riverside], familyFriendly[no], near[Raja Indian Cuisine]'	'Wildwood is an indian pub near Raja Indian Cuisine in the riverside area. It is not family friendly.'
'name[Wildwood], eatType[pub], food[Indian], area[riverside], familyFriendly[yes], near[Raja Indian Cuisine]'	'Wildwood is a family friendly indian pub near Raja Indian Cuisine in riverside.'
'name[Wildwood], eatType[pub], food[Italian], area[city centre], familyFriendly[no], near[Raja Indian Cuisine]'	'Wildwood is an italian pub located in the city centre near Raja Indian Cuisine. It is not family-friendly.'
'name[Wildwood], eatType[pub], food[Italian], area[city centre], familyFriendly[yes], near[Raja Indian Cuisine]'	'Wildwood is a family-friendly italian pub in the city centre near Raja Indian Cuisine.'
'name[Wildwood], eatType[pub], food[Italian], area[riverside], familyFriendly[no], near[Raja Indian Cuisine]'	'Wildwood is an italian pub near Raja Indian Cuisine in riverside. It is not family-friendly.'
'name[Wildwood], eatType[pub], food[Italian], area[riverside], familyFriendly[yes], near[Raja Indian Cuisine]'	'Wildwood is a family friendly italian pub in riverside near Raja Indian Cuisine.'
'name[Wildwood], eatType[restaurant], food[French], area[riverside], familyFriendly[yes], near[Raja Indian Cuisine]'	'Wildwood is a family friendly french restaurant in riverside near Raja Indian Cuisine.'
'name[Wildwood], eatType[restaurant], food[Indian], area[city centre], familyFriendly[no], near[Raja Indian Cuisine]'	'Wildwood is an indian restaurant located in the city centre near Raja Indian Cuisine. It is not family friendly.'
'name[Wildwood], eatType[restaurant], food[Indian], area[city centre], familyFriendly[yes], near[Raja Indian Cuisine]'	'Wildwood is a family friendly indian restaurant located in the city centre near Raja Indian Cuisine.'
'name[Wildwood], eatType[restaurant], food[Indian], area[riverside], familyFriendly[no], near[Raja Indian Cuisine]'	'Wildwood is a restaurant providing indian food it is located in the riverside. It is near Raja Indian Cuisine. It is not family friendly.'
'name[Wildwood], eatType[restaurant], food[Indian], area[riverside], familyFriendly[yes], near[Raja Indian Cuisine]'	'Wildwood is a family friendly indian restaurant in riverside near Raja Indian Cuisine.'
'name[Wildwood], eatType[restaurant], food[Italian], area[city centre], familyFriendly[no], near[Raja Indian Cuisine]'	'Wildwood is a non-family-friendly italian restaurant in the city centre near Raja Indian Cuisine.'
'name[Wildwood], eatType[restaurant], food[Italian], area[city centre], familyFriendly[yes], near[Raja Indian Cuisine]'	'Wildwood is a family-friendly italian restaurant located near Raja Indian Cuisine in the city centre.'
'name[Wildwood], eatType[restaurant], food[Italian], area[riverside], familyFriendly[no], near[Raja Indian Cuisine]'	'Wildwood is an italian restaurant in the riverside area near Raja Indian Cuisine. It is not family-friendly.'
'name[Wildwood], eatType[restaurant], food[Italian], area[riverside], familyFriendly[yes], near[Raja Indian Cuisine]'	'Wildwood is a family friendly italian restaurant in riverside near Raja Indian Cuisine.'
'name[Zizzi], eatType[coffee shop], area[riverside]'	'In the riverside area, Zizzi is a coffee shop.'
'name[Zizzi], eatType[coffee shop], customer rating[average], near[Burger King]'	'With an average customer rating, Zizzi is a coffee shop near Burger King.'
'name[Zizzi], eatType[coffee shop], customer rating[high], near[Burger King]'	'Zizzi is a high customer rating coffee shop near Burger King.'
'name[Zizzi], eatType[coffee shop], near[The Sorrento]'	'Near The Sorrento is Zizzi. It is a coffee shop.'
'name[Zizzi], eatType[pub], area[riverside]'	'By the riverside is a pub called Zizzi.'
'name[Zizzi], eatType[pub], customer rating[average], near[Burger King]'	'Zizzi is a pub near Burger King with an average customer rating.'
'name[Zizzi], eatType[pub], customer rating[high], near[Burger King]'	'Zizzi is a pub near Burger King with a high customer rating.'
'name[Zizzi], eatType[pub], near[The Sorrento]'	'Zizzi is a pub near The Sorrento.'
