MR	output
"name[Blue Spice], eatType[coffee shop], area[city centre]"	"In city centre is a coffee shop called Blue Spice."
"name[Blue Spice], eatType[coffee shop], area[riverside]"	"Blue Spice is located down by the riverside of Cambridge. It is also a coffee shop."
"name[Blue Spice], eatType[coffee shop], customer rating[5 out of 5], near[Crowne Plaza Hotel]"	"Welcome to the Blue Spice. Situated close to Crowne Plaza Hotel. It's a coffee shop. Its customer rating is 5 out of 5."
"name[Blue Spice], eatType[coffee shop], customer rating[average], near[Burger King]"	"Blue Spice is located near to Burger King. It has an average rating and there is a coffee shop."
"name[Blue Spice], eatType[coffee shop], customer rating[average], near[Crowne Plaza Hotel]"	"The Blue Spice coffee shop, near Crowne Plaza Hotel, has a customer rating of average."
"name[Blue Spice], eatType[pub], area[city centre]"	"There is a restaurant called Blue Spice. It's a pub. It is located in the city centre."
"name[Blue Spice], eatType[pub], area[riverside]"	"There is a venue called Blue Spice in Cambridge, it is in the riverside area. It's a pub."
"name[Blue Spice], eatType[pub], customer rating[5 out of 5], near[Crowne Plaza Hotel]"	"Near Crowne Plaza Hotel you can try the 5 out of 5 Blue Spice pub."
"name[Blue Spice], eatType[pub], customer rating[average], near[Burger King]"	"Customers rate Blue Spice an average. You will find this pub near Burger King."
"name[Blue Spice], eatType[pub], customer rating[average], near[Crowne Plaza Hotel]"	"Near Crowne Plaza Hotel the Blue Spice pub is rated average."
"name[Blue Spice], eatType[pub], food[Chinese], area[city centre], familyFriendly[no], near[Rainbow Vegetarian Café]"	"Blue Spice is near Rainbow Vegetarian Café. It is located in city centre. It is not child-friendly. It is a pub serving Chinese food."
"name[Blue Spice], eatType[pub], food[Chinese], area[city centre], familyFriendly[yes], near[Rainbow Vegetarian Café]"	"Near the Rainbow Vegetarian Café in the city centre area is a family friendly pub called Blue Spice which serves Chinese."
"name[Blue Spice], eatType[pub], food[Chinese], area[riverside], familyFriendly[no], near[Rainbow Vegetarian Café]"	"Pub and Chinese food venue, Blue Spice, is located in the riverside near the Rainbow Vegetarian Café and is not considered family friendly."
"name[Blue Spice], eatType[pub], food[Chinese], area[riverside], familyFriendly[yes], near[Rainbow Vegetarian Café]"	"Blue Spice is a family oriented pub that serves Chinese food. It is located Near Rainbow Vegetarian Café in riverside."
"name[Blue Spice], eatType[pub], food[English], area[city centre], familyFriendly[no], near[Rainbow Vegetarian Café]"	"Blue Spice near Rainbow Vegetarian Café is not a family friendly pub. It is located in the city centre. Also offers English food."
"name[Blue Spice], eatType[pub], food[English], area[city centre], familyFriendly[yes], near[Rainbow Vegetarian Café]"	"Blue Spice is a child friendly pub specializing in English cuisine in the city centre area near Rainbow Vegetarian Café."
"name[Blue Spice], eatType[pub], food[English], area[riverside], familyFriendly[no], near[Rainbow Vegetarian Café]"	"Blue Spice is not child friendly. It is located in the riverside. Have you ever been to a Rainbow Vegetarian Café that sells English food. This restaurant is has a pub style setup."
"name[Blue Spice], eatType[pub], food[English], area[riverside], familyFriendly[yes], near[Rainbow Vegetarian Café]"	"Blue Spice is an English pub and kid friendly, is located near Rainbow Vegetarian Café, in the riverside area."
"name[Blue Spice], eatType[restaurant], food[Chinese], area[city centre], familyFriendly[no], near[Rainbow Vegetarian Café]"	"Blue Spice is not a family-friendly arena and is located in the city centre. There is restaurant with Chinese near the Rainbow Vegetarian Café."
"name[Blue Spice], eatType[restaurant], food[Chinese], area[city centre], familyFriendly[yes], near[Rainbow Vegetarian Café]"	"Blue Spice is a city centre restaurant which serves Chinese. It is located near Rainbow Vegetarian Café. Children are welcome."
"name[Blue Spice], eatType[restaurant], food[Chinese], area[riverside], familyFriendly[no], near[Rainbow Vegetarian Café]"	"Blue Spice restaurant is located at the riverside near Rainbow Vegetarian Café. It does not welcome families. It serves Chinese food."
"name[Blue Spice], eatType[restaurant], food[Chinese], area[riverside], familyFriendly[yes], near[Rainbow Vegetarian Café]"	"Near the Rainbow Vegetarian Café in the riverside area is a kid-friendly restaurant with Chinese food. It is the Blue Spice."
"name[Blue Spice], eatType[restaurant], food[English], area[city centre], familyFriendly[no], near[Rainbow Vegetarian Café]"	"The Blue Spice is a restaurant serving English food. It's near the Rainbow Vegetarian Café in city centre. Just don't bring the kids."
"name[Blue Spice], eatType[restaurant], food[English], area[city centre], familyFriendly[yes], near[Rainbow Vegetarian Café]"	"Blue Spice is a family friendly English restaurant in the city centre area close to Rainbow Vegetarian Café."
"name[Blue Spice], eatType[restaurant], food[English], area[riverside], familyFriendly[no], near[Rainbow Vegetarian Café]"	"The Blue Spice is a restaurant near Rainbow Vegetarian Café in the riverside which serves English food. It is not family-friendly."
"name[Blue Spice], eatType[restaurant], food[English], area[riverside], familyFriendly[yes], near[Rainbow Vegetarian Café]"	"Near the Rainbow Vegetarian Café in riverside is the family-friendly Blue Spice. This restaurant serves English food."
"name[Clowns], eatType[coffee shop], customer rating[3 out of 5], near[All Bar One]"	"Near All Bar One you can visit coffee shop called Clowns. Its customer rating is 3 out of 5."
"name[Clowns], eatType[coffee shop], customer rating[5 out of 5], near[Crowne Plaza Hotel]"	"Near Crowne Plaza Hotel is the Clowns coffee shop with a customer rating of 5 out of 5."
"name[Clowns], eatType[coffee shop], near[The Sorrento]"	"Clowns is a coffee shop placed near to The Sorrento."
"name[Clowns], eatType[pub], customer rating[3 out of 5], near[All Bar One]"	"Pub located near All Bar One called Clowns with a 3 out of 5 customer rating."
"name[Clowns], eatType[pub], customer rating[5 out of 5], near[Crowne Plaza Hotel]"	"The name of the restaurant is Clowns. It is a pub. Rated 5 out of 5. It is near Crowne Plaza Hotel."
"name[Clowns], eatType[pub], near[The Sorrento]"	"Clowns is a pub located near The Sorrento."
"name[Cocum], eatType[coffee shop], customer rating[high], near[Burger King]"	"For a coffee shop with a high rating, check out Cocum near Burger King."
"name[Cocum], eatType[coffee shop], customer rating[high], near[Café Sicilia]"	"Cocum is a coffee shop. It is located near Café Sicilia with a high customer rating."
"name[Cocum], eatType[coffee shop], customer rating[low], near[Café Sicilia]"	"Customers rate Cocum as low. It is near Café Sicilia. Eat at this coffee shop."
"name[Cocum], eatType[coffee shop], customer rating[low], near[Express by Holiday Inn]"	"If you're nearby Express by Holiday Inn, you can give the coffee shop Cocum a try, although it currently gets low ratings from other customers - a low."
"name[Cocum], eatType[coffee shop], near[The Rice Boat]"	"Check out Cocum. It is near The Rice Boat. The food is coffee shop like."
"name[Cocum], eatType[coffee shop], near[The Sorrento]"	"Near The Sorrento, there is a coffee shop called Cocum."
"name[Cocum], eatType[pub], customer rating[high], near[Burger King]"	"Located near Burger King is Cocum which has been rated high by customers. The food is pub like."
"name[Cocum], eatType[pub], customer rating[high], near[Café Sicilia]"	"A high rated pub called Cocum is nearby Café Sicilia."
"name[Cocum], eatType[pub], customer rating[low], near[Café Sicilia]"	"Cocum is a pub. It is located near Café Sicilia and has a low customer rating."
"name[Cocum], eatType[pub], customer rating[low], near[Express by Holiday Inn]"	"If you're nearby Express by Holiday Inn, you can give the pub Cocum a try, although it currently gets low ratings from other customers - a low."
"name[Cocum], eatType[pub], near[The Rice Boat]"	"Cocum is a sit-down restaurant in Cambridge. It is near The Rice Boat. It is a pub."
"name[Cocum], eatType[pub], near[The Sorrento]"	"Cocum is a pub near the The Sorrento."
"name[Cotto], eatType[coffee shop], near[The Bakers]"	"Cotto is a coffee shop located near The Bakers."
"name[Cotto], eatType[pub], near[The Bakers]"	"We are Cotto, a pub close to The Bakers."
"name[Giraffe], eatType[coffee shop], near[The Bakers]"	"Giraffe is a coffee shop is near The Bakers."
"name[Giraffe], eatType[coffee shop], near[The Rice Boat]"	"There is a coffee shop called Giraffe. It is near The Rice Boat."
"name[Giraffe], eatType[pub], food[English], area[riverside], familyFriendly[yes], near[Rainbow Vegetarian Café]"	"Giraffe, is a family friendly riverside pub near the Rainbow Vegetarian Café, that serves English food."
"name[Giraffe], eatType[pub], food[Fast food], area[city centre], familyFriendly[no], near[Rainbow Vegetarian Café]"	"Giraffe is near Rainbow Vegetarian Café. It is a pub. It also serves Fast food food. It is located in the city centre. It is not kid friendly."
"name[Giraffe], eatType[pub], food[Fast food], area[city centre], familyFriendly[yes], near[Rainbow Vegetarian Café]"	"Giraffe is a pub located on the city centre near Rainbow Vegetarian Café. They serve Fast food food and it is kids friendly."
"name[Giraffe], eatType[pub], food[Fast food], area[riverside], familyFriendly[no], near[Rainbow Vegetarian Café]"	"There is a pub named Giraffe in the riverside that provides Fast food food near Rainbow Vegetarian Café and they are not family friendly."
"name[Giraffe], eatType[pub], food[Fast food], area[riverside], familyFriendly[yes], near[Rainbow Vegetarian Café]"	"Giraffe is a pub serving Fast food food, located riverside near Rainbow Vegetarian Café and is child-friendly."
"name[Giraffe], eatType[pub], food[Fast food], area[riverside], familyFriendly[yes], near[Raja Indian Cuisine]"	"Located near Raja Indian Cuisine the pub Giraffe serves Fast food food and coffee to families of all ages in the riverside."
"name[Giraffe], eatType[pub], food[French], area[city centre], familyFriendly[no], near[Raja Indian Cuisine]"	"Giraffe, located near Raja Indian Cuisine in the city centre, is a pub that also sells French food. Children should not visit."
"name[Giraffe], eatType[pub], food[French], area[city centre], familyFriendly[yes], near[Raja Indian Cuisine]"	"Giraffe is a family friendly pub. It serves French food in city centre setting, near the Raja Indian Cuisine."
"name[Giraffe], eatType[pub], food[French], area[riverside], familyFriendly[no], near[Raja Indian Cuisine]"	"Giraffe is a French restaurant in the riverside near Raja Indian Cuisine, it is not family-friendly. It is a pub."
"name[Giraffe], eatType[pub], food[French], area[riverside], familyFriendly[yes], near[Raja Indian Cuisine]"	"There is a pub Giraffe that is located in riverside that serves French food. It is children friendly and near Raja Indian Cuisine."
"name[Giraffe], eatType[pub], near[The Bakers]"	"The name of the place is Giraffe. It is a pub near The Bakers."
"name[Giraffe], eatType[pub], near[The Rice Boat]"	"Giraffe is a venue. They are a pub. Located near The Rice Boat."
"name[Giraffe], eatType[restaurant], food[English], area[riverside], familyFriendly[yes], near[Rainbow Vegetarian Café]"	"Giraffe is a child-friendly English restaurant near Rainbow Vegetarian Café in riverside."
"name[Giraffe], eatType[restaurant], food[Fast food], area[city centre], familyFriendly[no], near[Rainbow Vegetarian Café]"	"Try Giraffe today. The restaurant is located in the city centre area and is not friendly for kids. There is a venue near the Rainbow Vegetarian Café that offers Fast food Food."
"name[Giraffe], eatType[restaurant], food[Fast food], area[city centre], familyFriendly[yes], near[Rainbow Vegetarian Café]"	"Located on the city centre, near Rainbow Vegetarian Café, the restaurant Giraffe serves Fast food and is family friendly."
"name[Giraffe], eatType[restaurant], food[Fast food], area[riverside], familyFriendly[no], near[Rainbow Vegetarian Café]"	"The Giraffe is a great restaurant along the riverside, and is located near Rainbow Vegetarian Café. It is not family friendly, but serves Fast food food."
"name[Giraffe], eatType[restaurant], food[Fast food], area[riverside], familyFriendly[yes], near[Rainbow Vegetarian Café]"	"Giraffe is a family friendly Fast food restaurant located on the riverside near Rainbow Vegetarian Café."
"name[Giraffe], eatType[restaurant], food[Fast food], area[riverside], familyFriendly[yes], near[Raja Indian Cuisine]"	"The Giraffe, a child-friendly, Fast food restaurant, is located in riverside area, near Raja Indian Cuisine."
"name[Giraffe], eatType[restaurant], food[French], area[city centre], familyFriendly[no], near[Raja Indian Cuisine]"	"If you are in city centre, near the Raja Indian Cuisine you will find an adult French restaurant called the Giraffe."
"name[Giraffe], eatType[restaurant], food[French], area[city centre], familyFriendly[yes], near[Raja Indian Cuisine]"	"Giraffe is a restaurant that serves French food at the city centre. It is kids-friendly and is near Raja Indian Cuisine."
"name[Giraffe], eatType[restaurant], food[French], area[riverside], familyFriendly[no], near[Raja Indian Cuisine]"	"The Giraffe is a restaurant near Raja Indian Cuisine in the riverside which serves French food. It is not family-friendly."
"name[Giraffe], eatType[restaurant], food[French], area[riverside], familyFriendly[yes], near[Raja Indian Cuisine]"	"Near the Raja Indian Cuisine on the riverside is a family friendly French restaurant called Giraffe."
"name[Green Man], eatType[coffee shop], customer rating[1 out of 5], near[All Bar One]"	"The Green Man coffee shop is located near All Bar One. It has a 1 out of 5 customer rating."
"name[Green Man], eatType[coffee shop], customer rating[3 out of 5], near[All Bar One]"	"Situated nearby All Bar One, is the 3 out of 5 rated Green Man coffee shop."
"name[Green Man], eatType[pub], customer rating[1 out of 5], near[All Bar One]"	"Green Man has a 1 out of 5 customer rating and is located near All Bar One. It is a pub."
"name[Green Man], eatType[pub], customer rating[3 out of 5], near[All Bar One]"	"Nearby All Bar One is Green Man. It is a pub with a customer rating of 3 out of 5."
"name[Green Man], eatType[pub], food[Italian], area[riverside], familyFriendly[yes], near[Express by Holiday Inn]"	"Green Man is a pub serving Italian food, located riverside near Express by Holiday Inn and is child-friendly."
"name[Green Man], eatType[pub], food[Italian], area[riverside], familyFriendly[yes], near[Raja Indian Cuisine]"	"Green Man is a family-friendly Italian pub. It is located in the riverside near Raja Indian Cuisine."
"name[Green Man], eatType[pub], food[Japanese], area[city centre], familyFriendly[no], near[Express by Holiday Inn]"	"Located by the city centre near the Express by Holiday Inn is a pub named Green Man offering Japanese food in a non-family-friendly environment."
"name[Green Man], eatType[pub], food[Japanese], area[city centre], familyFriendly[yes], near[Express by Holiday Inn]"	"Located in city centre near Express by Holiday Inn, Green Man is a family-friendly pub serving Japanese."
"name[Green Man], eatType[pub], food[Japanese], area[riverside], familyFriendly[no], near[Express by Holiday Inn]"	"There is a riverside pub near the Express by Holiday Inn called Green Man. It serves Japanese food but is not family-friendly."
"name[Green Man], eatType[pub], food[Japanese], area[riverside], familyFriendly[yes], near[Express by Holiday Inn]"	"There is a child friendly Japanese pub called the Green Man by the riverside, near the Express by Holiday Inn."
"name[Green Man], eatType[restaurant], food[Italian], area[riverside], familyFriendly[yes], near[Express by Holiday Inn]"	"Green Man is in the riverside area near Express by Holiday Inn. It is a restaurant that serves Italian food and is family friendly."
"name[Green Man], eatType[restaurant], food[Italian], area[riverside], familyFriendly[yes], near[Raja Indian Cuisine]"	"Green Man is a children-friendly riverside restaurant that you can also get Italian food in, it is located near the Raja Indian Cuisine."
"name[Green Man], eatType[restaurant], food[Japanese], area[city centre], familyFriendly[no], near[Express by Holiday Inn]"	"Near Express by Holiday Inn in city centre is the adult establishment Green Man. They are a restaurant. It serves Japanese food."
"name[Green Man], eatType[restaurant], food[Japanese], area[city centre], familyFriendly[yes], near[Express by Holiday Inn]"	"The children friendly restaurant that has Japanese food near Express by Holiday Inn on the city centre is Green Man."
"name[Green Man], eatType[restaurant], food[Japanese], area[riverside], familyFriendly[no], near[Express by Holiday Inn]"	"Green Man is located near to Express by Holiday Inn. They do not presently cater for families with small children. Key places to eat are restaurants and the local restaurant. It serves Japanese food. It is located in the riverside."
"name[Green Man], eatType[restaurant], food[Japanese], area[riverside], familyFriendly[yes], near[Express by Holiday Inn]"	"Located in riverside near Express by Holiday Inn is Green Man. It is a family friendly restaurant offering Japanese food."
"name[Loch Fyne], eatType[coffee shop], area[riverside]"	"There is a venue in riverside called Loch Fyne. It's a coffee shop."
"name[Loch Fyne], eatType[pub], area[riverside]"	"Loch Fyne is located by the riverside. It's a pub."
"name[Strada], eatType[coffee shop], area[city centre]"	"Strada is coffee shop type restaurant. The venue is located by city centre."
"name[Strada], eatType[coffee shop], customer rating[1 out of 5], near[All Bar One]"	"The Strada coffee shop, near All Bar One, has a customer rating of 1 out of 5."
"name[Strada], eatType[coffee shop], customer rating[1 out of 5], near[Rainbow Vegetarian Café]"	"Strada is located near Rainbow Vegetarian Café. It is a coffee shop with a customer rating of 1 out of 5."
"name[Strada], eatType[coffee shop], customer rating[low], near[Express by Holiday Inn]"	"If you're nearby Express by Holiday Inn, you can give the coffee shop Strada a try, although it currently gets low ratings from other customers - a low."
"name[Strada], eatType[pub], area[city centre]"	"Strada is in the city centre area. It is a pub."
"name[Strada], eatType[pub], customer rating[1 out of 5], near[All Bar One]"	"Strada is a pub. It has a 1 out of 5 customer rating and it is located near to All Bar One."
"name[Strada], eatType[pub], customer rating[1 out of 5], near[Rainbow Vegetarian Café]"	"Located near Rainbow Vegetarian Café is a pub named Strada that has a 1 out of 5 customer rating."
"name[Strada], eatType[pub], customer rating[low], near[Express by Holiday Inn]"	"Near to Express by Holiday Inn there is a pub called Strada. The place is rated as 'low' by customers."
"name[The Cricketers], eatType[coffee shop], customer rating[1 out of 5], familyFriendly[yes], near[Avalon]"	"Known as '1 out of 5' and 'Family Friendly' , The Cricketers offers coffee shop food near the Avalon."
"name[The Cricketers], eatType[coffee shop], customer rating[3 out of 5], familyFriendly[yes], near[Avalon]"	"Located near Avalon, The Cricketers is a coffee shop with a 3 out of 5 customer rating. They are children friendly."
"name[The Cricketers], eatType[coffee shop], customer rating[3 out of 5], familyFriendly[yes], near[Crowne Plaza Hotel]"	"The Cricketers is a kid-friendly coffee shop near Crowne Plaza Hotel, and has a customer rating of 3 out of 5."
"name[The Cricketers], eatType[coffee shop], customer rating[5 out of 5], familyFriendly[no], near[Crowne Plaza Hotel]"	"The Cricketers is an adult audience coffee shop 5 out of 5 Ratings. It is near Crowne Plaza Hotel."
"name[The Cricketers], eatType[coffee shop], customer rating[5 out of 5], familyFriendly[yes], near[Crowne Plaza Hotel]"	"Given 5 out of 5, The Cricketers is a kid friendly coffee shop near Crowne Plaza Hotel."
"name[The Cricketers], eatType[coffee shop], customer rating[average], familyFriendly[no], near[Café Sicilia]"	"The Cricketers is non family-friendly coffee shop. It has an average customer rating and is near Café Sicilia."
"name[The Cricketers], eatType[coffee shop], customer rating[average], familyFriendly[no], near[Crowne Plaza Hotel]"	"No families at The Cricketers. Rated average near Crowne Plaza Hotel. It is a coffee shop."
"name[The Cricketers], eatType[coffee shop], customer rating[average], familyFriendly[yes], near[Café Sicilia]"	"The Cricketers is a children Friendly coffee shop, with average customer rating it's near Café Sicilia."
"name[The Cricketers], eatType[coffee shop], customer rating[high], familyFriendly[yes], near[Café Sicilia]"	"The Cricketers can be found near the Café Sicilia. Customers give this coffee shop a high rating. It's family friendly."
"name[The Cricketers], eatType[coffee shop], customer rating[high], familyFriendly[yes], near[Express by Holiday Inn]"	"The Cricketers is a family friendly coffee shop located near the Express by Holiday Inn. It gets a high customer rating."
"name[The Cricketers], eatType[coffee shop], customer rating[low], familyFriendly[no], near[Express by Holiday Inn]"	"Near Express by Holiday Inn you can visit coffee shop called The Cricketers. It is not family-friendly, but receives a low rating."
"name[The Cricketers], eatType[coffee shop], customer rating[low], familyFriendly[no], near[Ranch]"	"The Cricketers is a coffee shop. It has a low rating and is not kid friendly. It is near Ranch."
"name[The Cricketers], eatType[coffee shop], customer rating[low], familyFriendly[yes], near[Ranch]"	"The Cricketers is a family coffee shop near the Ranch with a rating low."
"name[The Cricketers], eatType[restaurant], customer rating[1 out of 5], familyFriendly[yes], near[Avalon]"	"Kids can eat at The Cricketers. There is a restaurant with a 1 out of 5 rating near Avalon."
"name[The Cricketers], eatType[restaurant], customer rating[3 out of 5], familyFriendly[yes], near[Avalon]"	"3 out of 5 restaurant named The Cricketers. It is family friendly and near the Avalon."
"name[The Cricketers], eatType[restaurant], customer rating[3 out of 5], familyFriendly[yes], near[Crowne Plaza Hotel]"	"The name of the dining place is The Cricketers. It is near Crowne Plaza Hotel. It's a restaurant. It is kid friendly. It has a 3 out of 5 customer rating."
"name[The Cricketers], eatType[restaurant], customer rating[5 out of 5], familyFriendly[no], near[Crowne Plaza Hotel]"	"Opposite that there is a restaurant called The Cricketers. It is children friendly with a 5 out of 5 customer rating. It is located near Crowne Plaza Hotel."
"name[The Cricketers], eatType[restaurant], customer rating[5 out of 5], familyFriendly[yes], near[Crowne Plaza Hotel]"	"The Cricketers is a 5 out of 5 rated but family friendly restaurant near Crowne Plaza Hotel."
"name[The Cricketers], eatType[restaurant], customer rating[average], familyFriendly[no], near[Café Sicilia]"	"The Cricketers is a restaurant. It is not family-friendly. It is near Café Sicilia and is average."
"name[The Cricketers], eatType[restaurant], customer rating[average], familyFriendly[no], near[Crowne Plaza Hotel]"	"You will be dining at The Cricketers. They are not family-friendly. Customer rating is average. It is a restaurant near Crowne Plaza Hotel."
"name[The Cricketers], eatType[restaurant], customer rating[average], familyFriendly[yes], near[Café Sicilia]"	"The Cricketers is a restaurant located next to the Café Sicilia. It has an average customer rating and child friendly environment."
"name[The Cricketers], eatType[restaurant], customer rating[high], familyFriendly[yes], near[Café Sicilia]"	"The Cricketers is a child-friendly restaurant located near Café Sicilia with a high customer rating."
"name[The Cricketers], eatType[restaurant], customer rating[high], familyFriendly[yes], near[Express by Holiday Inn]"	"The Cricketers is a family restaurant near the Express by Holiday Inn with a rating high."
"name[The Cricketers], eatType[restaurant], customer rating[low], familyFriendly[no], near[Express by Holiday Inn]"	"The Cricketers is a restaurant. It is located near Express by Holiday Inn. It is not children friendly, but it has a low customer rating."
"name[The Cricketers], eatType[restaurant], customer rating[low], familyFriendly[no], near[Ranch]"	"Restaurant The Cricketers has a low customer rating and is located near Ranch. It is not kid friendly."
"name[The Cricketers], eatType[restaurant], customer rating[low], familyFriendly[yes], near[Ranch]"	"The Cricketers is a restaurant located near the Ranch. It is child friendly, but it has a low customer rating."
"name[The Cricketers], eatType[restaurant], food[Chinese], priceRange[£20-25], customer rating[high], area[city centre], familyFriendly[no], near[All Bar One]"	"The Cricketers is a restaurant with Chinese food ranging in £20-£25 pounds. This establishment has high customer ratings. They are located in the city centre near All Bar One and do not allow children."
"name[The Cricketers], eatType[restaurant], food[Chinese], priceRange[£20-25], customer rating[high], area[city centre], familyFriendly[yes], near[All Bar One]"	"The Cricketers is a family-friendly restaurant near the All Bar One in the city centre. They serve Chinese food that costs £20-£25 and have a high customer rating."
"name[The Cricketers], eatType[restaurant], food[Chinese], priceRange[£20-25], customer rating[high], area[riverside], familyFriendly[no], near[All Bar One]"	"The Cricketers is a high, £20-£25, Chinese restaurant, near All Bar One in the riverside. They are not family-friendly."
"name[The Cricketers], eatType[restaurant], food[Chinese], priceRange[£20-25], customer rating[high], area[riverside], familyFriendly[yes], near[All Bar One]"	"There is a restaurant called The Cricketers. Its is located near All Bar One in the riverside area. It is child friendly and serves Chinese food at a £20-£25 price range. It has a high customer rating."
"name[The Cricketers], eatType[restaurant], food[Chinese], priceRange[cheap], customer rating[5 out of 5], area[city centre], familyFriendly[no], near[All Bar One]"	"The Cricketers is a non-kids-friendly restaurant with a 5 out of 5 customer rating. Serving Chinese food at around cheap, it's located on city centre, near All Bar One."
"name[The Cricketers], eatType[restaurant], food[Chinese], priceRange[cheap], customer rating[5 out of 5], area[city centre], familyFriendly[yes], near[All Bar One]"	"If you're looking for a cheap, family-friendly Chinese restaurant, with an excellent customer rating of 5 out of 5, then go to The Cricketers located near All Bar One in the city centre."
"name[The Cricketers], eatType[restaurant], food[Chinese], priceRange[cheap], customer rating[5 out of 5], area[riverside], familyFriendly[no], near[All Bar One]"	"In riverside near All Bar One, is a Chinese restaurant called The Cricketers. It is not kid friendly, but it has a 5 out of 5 rating and an average price range of cheap."
"name[The Cricketers], eatType[restaurant], food[Chinese], priceRange[cheap], customer rating[5 out of 5], area[riverside], familyFriendly[yes], near[All Bar One]"	"The Cricketers a restaurant that serves Chinese food that is located in the riverside area near All Bar One was rated a 5 out of 5 by their customers. The Cricketers is a kid friendly establishment and the pricing is cheap."
"name[The Cricketers], eatType[restaurant], food[Chinese], priceRange[cheap], customer rating[average], area[city centre], familyFriendly[no], near[All Bar One]"	"The Cricketers is a Chinese restaurant near All Bar One in city centre with has a cheap price range, is not kids friendly, and has an average customer rating."
"name[The Cricketers], eatType[restaurant], food[Chinese], priceRange[cheap], customer rating[average], area[city centre], familyFriendly[yes], near[All Bar One]"	"The Cricketers serves cheaply priced Chinese in a kids friendly restaurant. It is rated average and is found near All Bar One in the city centre area."
"name[The Cricketers], eatType[restaurant], food[Chinese], priceRange[cheap], customer rating[average], area[riverside], familyFriendly[no], near[All Bar One]"	"The Cricketers is a Chinese restaurant on the riverside. It is near All Bar One. It is not family-friendly. The customer rating is average and the price range is cheap."
"name[The Cricketers], eatType[restaurant], food[Chinese], priceRange[cheap], customer rating[average], area[riverside], familyFriendly[yes], near[All Bar One]"	"The Cricketers is a restaurant that serves Chinese food with a cheap price range, a 5 out average customer rating, and is also kid friendly located near All Bar One in the riverside."
"name[The Cricketers], eatType[restaurant], food[Chinese], priceRange[high], customer rating[1 out of 5], area[city centre], familyFriendly[no], near[All Bar One]"	"The Cricketers is a restaurant that serves Chinese. It has a 1 out of 5 customer rating and a high price range. It is not child friendly and you can find it in the city centre near All Bar One."
"name[The Cricketers], eatType[restaurant], food[Chinese], priceRange[high], customer rating[1 out of 5], area[city centre], familyFriendly[yes], near[All Bar One]"	"A restaurant serving Chinese food in the high price range with a customer rating of 1 out of 5 but is child friendly is The Cricketers, located near All Bar One in city centre."
"name[The Cricketers], eatType[restaurant], food[Chinese], priceRange[high], customer rating[1 out of 5], area[riverside], familyFriendly[no], near[All Bar One]"	"The Cricketers is a Chinese restaurant located on the riverside near All Bar One. Though it is not family-friendly and has a 1 out of 5 customer rating it has cheap food with prices high."
"name[The Cricketers], eatType[restaurant], food[Chinese], priceRange[high], customer rating[1 out of 5], area[riverside], familyFriendly[yes], near[All Bar One]"	"The Cricketers restaurant serves Chinese food for high in the riverside near All Bar One. It is children friendly but has a 1 out of 5 customer rating."
"name[The Cricketers], eatType[restaurant], food[Chinese], priceRange[high], customer rating[average], area[city centre], familyFriendly[no], near[All Bar One]"	"The Cricketers is a restaurant serving Chinese food in the city centre area near All Bar One, It has a high price range with an average customer rating and is not child friendly."
"name[The Cricketers], eatType[restaurant], food[Chinese], priceRange[high], customer rating[average], area[city centre], familyFriendly[yes], near[All Bar One]"	"A family friendly Chinese restaurant that is high priced is located near All Bar One in city centre. The Cricketers has an average customer rating."
"name[The Cricketers], eatType[restaurant], food[Chinese], priceRange[high], customer rating[average], area[riverside], familyFriendly[no], near[All Bar One]"	"Not for families, The Cricketers is a restaurant in the riverside near All Bar One where you can enjoy high Chinese food with an average rating."
"name[The Cricketers], eatType[restaurant], food[Chinese], priceRange[high], customer rating[average], area[riverside], familyFriendly[yes], near[All Bar One]"	"On the riverside area near All Bar One you can visit high family friendly restaurant called The Cricketers that serves Chinese food. Customer rated average."
"name[The Cricketers], eatType[restaurant], food[Chinese], priceRange[less than £20], customer rating[low], area[city centre], familyFriendly[no], near[All Bar One]"	"The Cricketers is not child-friendly but boasts a low rating, less than £20 prices in city centre. It is near All Bar One. Though considered a restaurant, it also offers Chinese food."
"name[The Cricketers], eatType[restaurant], food[Chinese], priceRange[less than £20], customer rating[low], area[city centre], familyFriendly[yes], near[All Bar One]"	"The Cricketers, a family-friendly Chinese restaurant in the city centre near All Bar One, is less than £20 priced and but has a lower customer service rating of low."
"name[The Cricketers], eatType[restaurant], food[Chinese], priceRange[less than £20], customer rating[low], area[riverside], familyFriendly[no], near[All Bar One]"	"The Cricketers is a low Chinese restaurant located in the riverside near All Bar One, they are adult only and less than £20."
"name[The Cricketers], eatType[restaurant], food[Chinese], priceRange[less than £20], customer rating[low], area[riverside], familyFriendly[yes], near[All Bar One]"	"The Cricketers is a 1 out of 5 Chinese restaurant near All Bar One in the riverside. It is in the less than £20 price range, but is children friendly."
"name[The Cricketers], eatType[restaurant], food[Chinese], priceRange[moderate], customer rating[1 out of 5], area[city centre], familyFriendly[no], near[All Bar One]"	"Costing moderate and located in city centre near All Bar One , The Cricketers is a Chinese restaurant. It is not kid friendly and has a 1 out of 5 customer rating."
"name[The Cricketers], eatType[restaurant], food[Chinese], priceRange[moderate], customer rating[1 out of 5], area[city centre], familyFriendly[yes], near[All Bar One]"	"There is a Chinese restaurant called The Cricketers in city centre near All Bar One. The price range is moderate, a 1 out of 5 customer rating but children are welcome."
"name[The Cricketers], eatType[restaurant], food[Chinese], priceRange[moderate], customer rating[1 out of 5], area[riverside], familyFriendly[no], near[All Bar One]"	"Costing moderate and located in riverside near All Bar One , The Cricketers is a Chinese restaurant. It is not kid friendly and has a 1 out of 5 customer rating."
"name[The Cricketers], eatType[restaurant], food[Chinese], priceRange[moderate], customer rating[1 out of 5], area[riverside], familyFriendly[yes], near[All Bar One]"	"Chinese food at The Cricketers restaurant by the riverside near All Bar One, is children friendly and the price range is moderate, although it has a 1 out of 5 customer rating."
"name[The Cricketers], eatType[restaurant], food[Chinese], priceRange[moderate], customer rating[3 out of 5], area[city centre], familyFriendly[no], near[All Bar One]"	"Near All Bar One in city centre there is a Chinese restaurant called The Cricketers. It is not kid friendly, has a price range of moderate and has a 3 out of 5 customer rating."
"name[The Cricketers], eatType[restaurant], food[Chinese], priceRange[moderate], customer rating[3 out of 5], area[city centre], familyFriendly[yes], near[All Bar One]"	"In the city centre situated near All Bar One is a Chinese restaurant called The Cricketers, it is family-friendly and reasonably priced at moderate per person, it has a 3 out of 5 customer rating."
"name[The Cricketers], eatType[restaurant], food[Chinese], priceRange[moderate], customer rating[3 out of 5], area[riverside], familyFriendly[no], near[All Bar One]"	"The Cricketers is a Chinese restaurant. It is not family-friendly. It is in the riverside area near All Bar One. The customer rating is 3 out of 5. The price range is moderate."
"name[The Cricketers], eatType[restaurant], food[Chinese], priceRange[moderate], customer rating[3 out of 5], area[riverside], familyFriendly[yes], near[All Bar One]"	"In the riverside area near All Bar One is a Chinese restaurant called The Cricketers that has a 3 out of 5 customer rating but is child friendly and is moderate dollars."
"name[The Cricketers], eatType[restaurant], food[Chinese], priceRange[more than £30], customer rating[high], area[city centre], familyFriendly[no], near[All Bar One]"	"The Cricketers is a Chinese restaurant near All Bar One in the city centre. It is not family-friendly and has a high customer rating and a price range of more than £30."
"name[The Cricketers], eatType[restaurant], food[Chinese], priceRange[more than £30], customer rating[high], area[city centre], familyFriendly[yes], near[All Bar One]"	"A restaurant with Chinese food is The Cricketers which is in the city centre near All Bar One. It is children-friendly , with a high customer rating, and is in the more than £30 price range."
"name[The Cricketers], eatType[restaurant], food[Chinese], priceRange[more than £30], customer rating[high], area[riverside], familyFriendly[no], near[All Bar One]"	"If you're looking for a children-free restaurant, check out The Cricketers. Located near the All Bar One at the riverside. The Cricketers offers Chinese ranging more than £30. Rated high by customers."
"name[The Cricketers], eatType[restaurant], food[Chinese], priceRange[more than £30], customer rating[high], area[riverside], familyFriendly[yes], near[All Bar One]"	"The Cricketers, located in the riverside, is a Chinese food and restaurant located near All Bar One. Customers have rated it as high, with a more than £30 price range, and the establishment is kid-friendly."
"name[The Cricketers], eatType[restaurant], food[English], priceRange[£20-25], customer rating[high], area[city centre], familyFriendly[no], near[All Bar One]"	"The Cricketers serves English food in the city centre near All Bar One. This adults only restaurant has a £20-£25 price range and a customer rating of high."
"name[The Cricketers], eatType[restaurant], food[English], priceRange[£20-25], customer rating[high], area[city centre], familyFriendly[yes], near[All Bar One]"	"The Cricketers, a kids friendly restaurant with a £20-£25 price range, with a rating of high. It serves English food and is in city centre near All Bar One."
"name[The Cricketers], eatType[restaurant], food[English], priceRange[£20-25], customer rating[high], area[riverside], familyFriendly[no], near[All Bar One]"	"Located near All Bar One at the riverside is The Cricketers English restaurant which has a £20-£25 price Range and is rated high with being not children Friendly."
"name[The Cricketers], eatType[restaurant], food[English], priceRange[£20-25], customer rating[high], area[riverside], familyFriendly[yes], near[All Bar One]"	"The Cricketers, restaurant and English food is near All Bar One in the riverside, family friendly, £20-£25 price with a Rating of high."
"name[The Cricketers], eatType[restaurant], food[English], priceRange[cheap], customer rating[5 out of 5], area[city centre], familyFriendly[no], near[Café Rouge]"	"In the city centre, near Café Rouge, you will find The Cricketers. It is a non children-friendly restaurant that serves English food. While its price range is quite 5 out of 5, cheap, it has a 5 out of 5 customer ratings."
"name[The Cricketers], eatType[restaurant], food[English], priceRange[cheap], customer rating[5 out of 5], area[city centre], familyFriendly[yes], near[Café Rouge]"	"The Cricketers is a restaurant that is family-friendly. Prices range cheap. It offers English food and is located in the city centre near Café Rouge. It has a 5 out of 5 customer rating."
"name[The Cricketers], eatType[restaurant], food[English], priceRange[cheap], customer rating[5 out of 5], area[riverside], familyFriendly[no], near[Café Rouge]"	"The English restaurant called The Cricketers located in riverside near Café Rouge is not family-friendly but is cheap and has a 5 out of 5 customer rating."
"name[The Cricketers], eatType[restaurant], food[English], priceRange[cheap], customer rating[5 out of 5], area[riverside], familyFriendly[yes], near[Café Rouge]"	"The Cricketers is an English restaurant offering food with price range cheap for family and is located along riverside near Café Rouge but has 5 out of 5 customer rating."
"name[The Cricketers], eatType[restaurant], food[English], priceRange[cheap], customer rating[average], area[city centre], familyFriendly[no], near[Café Rouge]"	"In the city centre near Café Rouge, there is an English restaurant called The Cricketers. It is not family-friendly and has an average customer rating and a price range of cheap."
"name[The Cricketers], eatType[restaurant], food[English], priceRange[cheap], customer rating[average], area[city centre], familyFriendly[yes], near[Café Rouge]"	"The Cricketers is a family friendly restaurant that serves English food at cheap in city centre, near Café Rouge; though it has an average customer rating."
"name[The Cricketers], eatType[restaurant], food[English], priceRange[cheap], customer rating[average], area[riverside], familyFriendly[no], near[Café Rouge]"	"The Cricketers is a non-kid friendly restaurant located in the riverside near Café Rouge. They offer English food at a cheap price with an average rating among customers."
"name[The Cricketers], eatType[restaurant], food[English], priceRange[cheap], customer rating[average], area[riverside], familyFriendly[yes], near[Café Rouge]"	"The Cricketers is a restaurant, which also serves English cuisine at cheap prices. Customers have rated the food average. The Cricketers is situated near the riverside and Café Rouge. Children are welcome."
"name[The Cricketers], eatType[restaurant], food[English], priceRange[high], customer rating[1 out of 5], area[city centre], familyFriendly[no], near[Café Rouge]"	"At city centre, near Café Rouge, eat at a choice restaurant that isn't kid-friendly, with a high price range called The Cricketers. Customer rating: 1 out of 5. Food: English."
"name[The Cricketers], eatType[restaurant], food[English], priceRange[high], customer rating[1 out of 5], area[city centre], familyFriendly[yes], near[Café Rouge]"	"There is an English restaurant called The Cricketers, near the city centre Café Rouge. It is family-friendly but has a 1 out of 5 customer rating and costs high pounds."
"name[The Cricketers], eatType[restaurant], food[English], priceRange[high], customer rating[1 out of 5], area[riverside], familyFriendly[no], near[Café Rouge]"	"High English food is served at The Cricketers, a restaurant with a 1 out of 5 rating. It is not family friendly and located near Café Rouge at the riverside."
"name[The Cricketers], eatType[restaurant], food[English], priceRange[high], customer rating[1 out of 5], area[riverside], familyFriendly[yes], near[Café Rouge]"	"Yes it loves to have children. Serving English food, called The Cricketers, although has a 1 out of 5 customer review, situated close to Café Rouge near the riverside is a restaurant but quite expensive at high."
"name[The Cricketers], eatType[restaurant], food[English], priceRange[high], customer rating[average], area[city centre], familyFriendly[no], near[Café Rouge]"	"There is a restaurant called The Cricketers that serves English at high prices. While not kid friendly, the location is convenient if close to Café Rouge near city centre. The Cricketers is rated average by customers."
"name[The Cricketers], eatType[restaurant], food[English], priceRange[high], customer rating[average], area[city centre], familyFriendly[yes], near[Café Rouge]"	"The Cricketers is an average rated restaurant, but friendly with the families that serves English food at high. It is close to the city centre and Café Rouge."
"name[The Cricketers], eatType[restaurant], food[English], priceRange[high], customer rating[average], area[riverside], familyFriendly[no], near[Café Rouge]"	"There is a high priced English restaurant in riverside called The Cricketers. It is near Café Rouge and it is not children friendly. It has an average customer rating."
"name[The Mill], eatType[pub], food[English], priceRange[high], area[riverside], familyFriendly[yes], near[Raja Indian Cuisine]"	"Near the Raja Indian Cuisine is children-friendly in the riverside area. It is a pub with English food with a high price range named The Mill."
"name[The Mill], eatType[pub], food[English], priceRange[less than £20], area[city centre], familyFriendly[no], near[Raja Indian Cuisine]"	"Near Raja Indian Cuisine in city centre there is a less than £20 priced English pub named The Mill. It is not kids friendly."
"name[The Mill], eatType[pub], food[English], priceRange[less than £20], area[city centre], familyFriendly[yes], near[Raja Indian Cuisine]"	"The Mill is an English pub and is child friendly, they are in the less than £20 price range. It is located in city centre near Raja Indian Cuisine."
"name[The Mill], eatType[pub], food[English], priceRange[less than £20], area[riverside], familyFriendly[no], near[Raja Indian Cuisine]"	"The Mill is a non family-friendly pub in the riverside. It is located near to Raja Indian Cuisine and serves English for less than £20."
"name[The Mill], eatType[pub], food[English], priceRange[less than £20], area[riverside], familyFriendly[yes], near[Raja Indian Cuisine]"	"The Mill is an English pub suitable for family. It is located near Raja Indian Cuisine at riverside and charges less than £20."
"name[The Mill], eatType[pub], food[English], priceRange[moderate], area[city centre], familyFriendly[no], near[Raja Indian Cuisine]"	"The Mill is a pub that also serves English at a moderate price range and is not children friendly, It is located in city centre near Raja Indian Cuisine."
"name[The Mill], eatType[pub], food[English], priceRange[moderate], area[city centre], familyFriendly[yes], near[Raja Indian Cuisine]"	"The Mill is a moderately priced, family friendly English pub in city centre, near Raja Indian Cuisine."
"name[The Mill], eatType[pub], food[English], priceRange[moderate], area[riverside], familyFriendly[no], near[Raja Indian Cuisine]"	"There is a pub, The Mill, serving English food along the riverside near Raja Indian Cuisine. It is not kids friendly and is moderately priced."
"name[The Mill], eatType[pub], food[English], priceRange[moderate], area[riverside], familyFriendly[yes], near[Raja Indian Cuisine]"	"A Children Friendly English restaurant located near Raja Indian Cuisine in the riverside named The Mill has moderate price range for a pub."
"name[The Mill], eatType[pub], food[English], priceRange[more than £30], area[riverside], familyFriendly[yes], near[Raja Indian Cuisine]"	"An English pub called The Mill is located along a riverside. Its near Raja Indian Cuisine, price range is more than £30, and kid friendly."
"name[The Mill], eatType[pub], food[Fast food], priceRange[£20-25], area[riverside], familyFriendly[yes], near[Raja Indian Cuisine]"	"A Children Friendly Fast food restaurant located near Raja Indian Cuisine in the riverside named The Mill has £20-£25 price range for a pub."
"name[The Mill], eatType[pub], food[Fast food], priceRange[£20-25], customer rating[high], area[city centre], familyFriendly[no], near[Café Rouge]"	"The Mill is a pub that serves Fast food. It is located near Café Rouge in the city centre. It is not kid friendly. The price range is £20-£25 and the customer rating is high."
"name[The Mill], eatType[pub], food[Fast food], priceRange[£20-25], customer rating[high], area[city centre], familyFriendly[yes], near[Café Rouge]"	"A pub serving Fast food food that is child friendly is The Mill. Located near Café Rouge in the city centre , customers have rated it high and the price range is £20-£25."
"name[The Mill], eatType[pub], food[Fast food], priceRange[£20-25], customer rating[high], area[riverside], familyFriendly[no], near[Café Rouge]"	"The Mill is a pub near Café Rouge and the riverside. It is not family-friendly and the price range is £20-£25. It serves Fast food food and the customer rating is high."
"name[The Mill], eatType[pub], food[Fast food], priceRange[£20-25], customer rating[high], area[riverside], familyFriendly[yes], near[Café Rouge]"	"The Mill, located riverside, is a child-friendly pub offering Fast food cuisine ranging from £20-£25. It is located near Café Rouge. It has a high customer rating."
"name[The Mill], eatType[pub], food[Fast food], priceRange[£20-25], customer rating[high], area[riverside], familyFriendly[yes], near[Café Sicilia]"	"The Mill is a pub. It that is family-friendly. T offers Fast food food and is located in the riverside near Café Sicilia. Prices range £20-£25 and the customer rating is high."
"name[The Mill], eatType[pub], food[Fast food], priceRange[cheap], area[riverside], familyFriendly[yes], near[Raja Indian Cuisine]"	"A family-friendly Fast food pub is The Mill. It has prices cheap and is located near Raja Indian Cuisine, in riverside."
"name[The Mill], eatType[pub], food[Fast food], priceRange[cheap], customer rating[5 out of 5], area[city centre], familyFriendly[no], near[Café Sicilia]"	"The Mill is a children friendly pub in city centre near Café Sicilia. It has a 5 out of 5 customer rating with the prince range for their Fast food food is cheap."
"name[The Mill], eatType[pub], food[Fast food], priceRange[cheap], customer rating[5 out of 5], area[city centre], familyFriendly[yes], near[Café Sicilia]"	"The Mill, located near Café Sicilia in the city centre, is a Fast food pub with has a 5 out of 5 customer rating, a cheap price range, but is family-friendly."
"name[The Mill], eatType[pub], food[Fast food], priceRange[cheap], customer rating[5 out of 5], area[riverside], familyFriendly[no], near[Café Sicilia]"	"The Mill is a trendy pub with about 5 out of 5 ratings. They offer cheaper priced Fast food items. This is an adult only establishment. It is located in the riverside near the Café Sicilia."
"name[The Mill], eatType[pub], food[Fast food], priceRange[cheap], customer rating[5 out of 5], area[riverside], familyFriendly[yes], near[Café Sicilia]"	"The Mill is a pub serving Fast food food in the cheap price range with 5 out of 5 customer ratings in the riverside area near Café Sicilia and is family friendly."
"name[The Mill], eatType[pub], food[Fast food], priceRange[cheap], customer rating[average], area[city centre], familyFriendly[no], near[Café Sicilia]"	"On the city centre, near Café Sicilia, you will find The Mill. It is a cheap, non family-friendly pub that also serves Fast food food. It has an excellent customer rating of average."
"name[The Mill], eatType[pub], food[Fast food], priceRange[cheap], customer rating[average], area[city centre], familyFriendly[yes], near[Café Sicilia]"	"The Mill is a Fast food pub located in the city centre near Café Sicilia. Its prices are cheap euros, and it has an average customer rating. It is also family-friendly."
"name[The Mill], eatType[pub], food[Fast food], priceRange[cheap], customer rating[average], area[riverside], familyFriendly[no], near[Café Sicilia]"	"The Mill is a pub providing Fast food food in the cheap price range. It is located at the riverside, near Café Sicilia. The customer rating is average and it is not children friendly."
"name[The Mill], eatType[pub], food[Fast food], priceRange[cheap], customer rating[average], area[riverside], familyFriendly[yes], near[Café Sicilia]"	"There is a pub called The Mill that serves Fast food food The price range is cheap and the customer rating is average. It is child friendly and is near Café Sicilia in the riverside."
"name[The Mill], eatType[pub], food[Fast food], priceRange[high], customer rating[1 out of 5], area[city centre], familyFriendly[no], near[Café Sicilia]"	"The Mill is a high price range Fast food pub near Café Sicilia in city centre. It is not kid friendly and has a customer rating 1 out of 5."
"name[The Mill], eatType[pub], food[Fast food], priceRange[high], customer rating[1 out of 5], area[city centre], familyFriendly[yes], near[Café Sicilia]"	"The Mill is a Fast food pub offering food with price range high for family and is located along city centre near Café Sicilia but has 1 out of 5 customer rating."
"name[The Mill], eatType[pub], food[Fast food], priceRange[high], customer rating[1 out of 5], area[riverside], familyFriendly[no], near[Café Sicilia]"	"In the riverside near Café Sicilia there is a pub serving Fast food food. It is not child friendly and is called The Mill and has a high price range with an average customer rating of 1 out of 5."
"name[The Mill], eatType[pub], food[Fast food], priceRange[high], customer rating[1 out of 5], area[riverside], familyFriendly[yes], near[Café Sicilia]"	"The Mill, a Fast food pub in the riverside area near Café Sicilia is child-friendly with a high price range but a 1 out of 5 rating."
"name[The Mill], eatType[pub], food[Fast food], priceRange[high], customer rating[average], area[city centre], familyFriendly[no], near[Café Sicilia]"	"The Mill, a pub that serves Fast food food, has a price range of high. The Mill has an average customer rating and it is situated in the city centre by Café Sicilia. The Mill is not child friendly."
"name[The Mill], eatType[pub], food[Fast food], priceRange[high], customer rating[average], area[city centre], familyFriendly[yes], near[Café Sicilia]"	"Despite having an average customer rating, The Mill is a family-friendly Fast food pub with meals high pounds. It is located in the city centre near Café Sicilia."
"name[The Mill], eatType[pub], food[Fast food], priceRange[high], customer rating[average], area[riverside], familyFriendly[no], near[Café Sicilia]"	"Located near Café Sicilia at the riverside is The Mill Fast food pub which has a high price Range and is rated average with being not children Friendly."
"name[The Mill], eatType[pub], food[Fast food], priceRange[high], customer rating[average], area[riverside], familyFriendly[yes], near[Café Sicilia]"	"The Mill is a kid friendly Fast food pub in the riverside near Café Sicilia with a customer rating of average and has a high price range."
"name[The Mill], eatType[pub], food[Fast food], priceRange[less than £20], customer rating[low], area[city centre], familyFriendly[no], near[Café Sicilia]"	"The Mill pub serves less than £20 Fast food food. It has a low customer rating and is located on the city centre. It is not family friendly and is near Café Sicilia."
"name[The Mill], eatType[pub], food[Fast food], priceRange[less than £20], customer rating[low], area[city centre], familyFriendly[yes], near[Café Sicilia]"	"The Mill is a less than £20 priced pub with Fast food food. They are rated a low and children are permitted. The can be located in city centre near Café Sicilia."
"name[The Mill], eatType[pub], food[Fast food], priceRange[less than £20], customer rating[low], area[riverside], familyFriendly[no], near[Café Sicilia]"	"For a less than £20 priced Fast food pub with a low rating that is based in the riverside near to Café Sicilia that isn't children-friendly then The Mill is the place to go."
"name[The Mill], eatType[pub], food[Fast food], priceRange[less than £20], customer rating[low], area[riverside], familyFriendly[yes], near[Café Sicilia]"	"The Mill is a pub in the riverside area that has a low customer rating. Although it has a less than £20 price range, it is children friendly, serves Fast food food and is near the Café Sicilia."
"name[The Mill], eatType[pub], food[Fast food], priceRange[moderate], customer rating[1 out of 5], area[city centre], familyFriendly[no], near[Café Sicilia]"	"The Mill is a Fast food pub. It is located in city centre, near Café Sicilia. It has 1 out of 5 customer rating since it is not family-friendly, but offer dishes for moderate."
"name[The Mill], eatType[pub], food[Fast food], priceRange[moderate], customer rating[1 out of 5], area[city centre], familyFriendly[yes], near[Café Sicilia]"	"The Mill pub is located near Café Sicilia in the city centre, It is family-friendly with Fast food costing moderate but has a 1 out of 5 customer rating."
"name[The Mill], eatType[pub], food[Fast food], priceRange[moderate], customer rating[1 out of 5], area[riverside], familyFriendly[no], near[Café Sicilia]"	"There is a Fast food pub in riverside near Café Sicilia called The Mill. It has a moderate price range and a 1 out of 5 customer rating, but it is not kids friendly."
"name[The Mill], eatType[pub], food[Fast food], priceRange[moderate], customer rating[1 out of 5], area[riverside], familyFriendly[yes], near[Café Sicilia]"	"In the riverside, The Mill is a Fast food pub with a family atmosphere. It is located next to the Café Sicilia with a 1 out of 5 customer rating and a price point of moderate."
"name[The Mill], eatType[pub], food[Fast food], priceRange[moderate], customer rating[3 out of 5], area[city centre], familyFriendly[no], near[Café Sicilia]"	"Moderate, 3 out of 5 pub called The Mill is not a family-friendly place but sells Fast food food in the area of city centre near Café Sicilia."
"name[The Mill], eatType[pub], food[Fast food], priceRange[moderate], customer rating[3 out of 5], area[city centre], familyFriendly[yes], near[Café Sicilia]"	"The Mill is a pub that serves Fast food food in the city centre, near Café Sicilia. It is family friendly and has a moderate price range and 3 out of 5 customer rating."
"name[The Mill], eatType[pub], food[Fast food], priceRange[moderate], customer rating[3 out of 5], area[riverside], familyFriendly[no], near[Café Sicilia]"	"The Mill is a Fast food pub near Café Sicilia in the riverside. It is not family-friendly and has a 3 out of 5 customer rating and a price range of moderate."
"name[The Mill], eatType[pub], food[Fast food], priceRange[moderate], customer rating[3 out of 5], area[riverside], familyFriendly[yes], near[Café Sicilia]"	"The Mill a pub that serves Fast food food that is located in the riverside area near Café Sicilia was rated a 3 out of 5 by their customers. The Mill is a kid friendly establishment and the pricing is moderate."
"name[The Mill], eatType[restaurant], food[English], priceRange[high], area[riverside], familyFriendly[yes], near[Raja Indian Cuisine]"	"The Mill is a children friendly English restaurant with a high price range located in the riverside near Raja Indian Cuisine."
"name[The Mill], eatType[restaurant], food[English], priceRange[high], customer rating[average], area[riverside], familyFriendly[yes], near[Café Rouge]"	"Located in the riverside area, The Mill is a restaurant that also sells English food. It is good for kids and families as it is kids friendly, and is within a high price range. This restaurant has an overall customer rating of average. It can be found near Café Rouge in the riverside area."
"name[The Mill], eatType[restaurant], food[English], priceRange[less than £20], area[city centre], familyFriendly[no], near[Raja Indian Cuisine]"	"There is a city centre restaurant near Raja Indian Cuisine called The Mill, that serves English food in the less than £20 price range. This venue is not suited for families with children."
"name[The Mill], eatType[restaurant], food[English], priceRange[less than £20], area[city centre], familyFriendly[yes], near[Raja Indian Cuisine]"	"For less than £20, The Mill is a family friendly city centre English restaurant near Raja Indian Cuisine."
"name[The Mill], eatType[restaurant], food[English], priceRange[less than £20], area[riverside], familyFriendly[no], near[Raja Indian Cuisine]"	"There is a restaurant called The Mill located near Raja Indian Cuisine. It is not family-friendly and is in the less than £20 price range. They offer English food and are located in the riverside."
"name[The Mill], eatType[restaurant], food[English], priceRange[less than £20], area[riverside], familyFriendly[yes], near[Raja Indian Cuisine]"	"With a less than £20 price range along the riverside, the restaurant named The Mill is family friendly and serves English Raja Indian Cuisine."
"name[The Mill], eatType[restaurant], food[English], priceRange[less than £20], customer rating[low], area[city centre], familyFriendly[no], near[Café Rouge]"	"The Mill is a less than £20 priced English restaurant with a low rating thats based in the city centre near to Café Rouge that isn't really children-friendly."
"name[The Mill], eatType[restaurant], food[English], priceRange[less than £20], customer rating[low], area[city centre], familyFriendly[yes], near[Café Rouge]"	"The English restaurant named The Mill is a restaurant in the city centre, near Café Rouge is a place for kids with price range from less than £20 with a customer rating of low."
"name[The Mill], eatType[restaurant], food[English], priceRange[less than £20], customer rating[low], area[riverside], familyFriendly[no], near[Café Rouge]"	"A restaurant named The Mill with less than £20 prices selling English food, not for kids, with a rating of low. It is near Café Rouge in the riverside."
"name[The Mill], eatType[restaurant], food[English], priceRange[less than £20], customer rating[low], area[riverside], familyFriendly[yes], near[Café Rouge]"	"The Mill is a family friendly restaurant serving English food with a less than £20 price range with a customer rating of 5 out lowts. It is located on the riverside near Café Rouge."
"name[The Mill], eatType[restaurant], food[English], priceRange[moderate], area[city centre], familyFriendly[no], near[Raja Indian Cuisine]"	"The Mill is in city centre with prices in the moderate range. It is a restaurant located near Raja Indian Cuisine. They are not children friendly. It serves English food."
"name[The Mill], eatType[restaurant], food[English], priceRange[moderate], area[city centre], familyFriendly[yes], near[Raja Indian Cuisine]"	"English food can be found at The Mill which is near Raja Indian Cuisine in the city centre. It is a family-friendly restaurant and has a price range of moderate."
"name[The Mill], eatType[restaurant], food[English], priceRange[moderate], area[riverside], familyFriendly[no], near[Raja Indian Cuisine]"	"The Mill is an English restaurant near Raja Indian Cuisine on the riverside. Its prices lie within the moderate range. No families."
"name[The Mill], eatType[restaurant], food[English], priceRange[moderate], area[riverside], familyFriendly[yes], near[Raja Indian Cuisine]"	"The Mill is children friendly restaurant that serves English food with a moderate price range near Raja Indian Cuisine around riverside."
"name[The Mill], eatType[restaurant], food[English], priceRange[moderate], customer rating[1 out of 5], area[city centre], familyFriendly[no], near[Café Rouge]"	"The Mill is a restaurant providing not a family-friendly atmosphere. It serves English food for moderate. It is located near Café Rouge in the city centre. It has a 1 out of 5 customer rating."
"name[The Mill], eatType[restaurant], food[English], priceRange[moderate], customer rating[1 out of 5], area[city centre], familyFriendly[yes], near[Café Rouge]"	"In city centre near the Café Rouge is a 1 out of 5 family friendly English restaurant called The Mill, that is not only moderate but family friendly."
"name[The Mill], eatType[restaurant], food[English], priceRange[moderate], customer rating[1 out of 5], area[riverside], familyFriendly[no], near[Café Rouge]"	"The Mill is a restaurant with English food. This establishment has earned a 1 out of 5 customer rating. They charge moderate pounds. They are located in the riverside near Café Rouge and are not family friendly."
"name[The Mill], eatType[restaurant], food[English], priceRange[moderate], customer rating[1 out of 5], area[riverside], familyFriendly[yes], near[Café Rouge]"	"The Mill is a restaurant serving English food in the riverside near Café Rouge. It's price range is moderate and has a 1 out of 5 customer rating. It's suitable for children."
"name[The Mill], eatType[restaurant], food[English], priceRange[moderate], customer rating[3 out of 5], area[city centre], familyFriendly[no], near[Café Rouge]"	"The Mill, a restaurant that serves English food, has a price range of moderate. The Mill has a 3 out of 5 customer rating and it is situated in the city centre by Café Rouge. The Mill is not child friendly."
"name[The Mill], eatType[restaurant], food[English], priceRange[moderate], customer rating[3 out of 5], area[city centre], familyFriendly[yes], near[Café Rouge]"	"There is a friendly for kids restaurant called The Mill which provides English food in the moderate prices. It is situated in the city centre near to the Café Rouge with 3 out of 5 customer rating."
"name[The Mill], eatType[restaurant], food[English], priceRange[moderate], customer rating[3 out of 5], area[riverside], familyFriendly[no], near[Café Rouge]"	"The Mill is a 3 out of 5 rated restaurant that serves English food in the riverside area near Café Rouge. The Mill has a price range of moderate, and is not family friendly."
"name[The Mill], eatType[restaurant], food[English], priceRange[moderate], customer rating[3 out of 5], area[riverside], familyFriendly[yes], near[Café Rouge]"	"The Mill is a restaurant that provides English food with moderate price ranges. They have a 3 out of 5 customer rating in located near Café Rouge in riverside. The Mill is child friendly."
"name[The Mill], eatType[restaurant], food[English], priceRange[more than £30], area[riverside], familyFriendly[yes], near[Raja Indian Cuisine]"	"There is a kid-friendly restaurant offering English food located near Raja Indian Cuisine in the riverside area. It is called The Mill, and is more than £30 priced."
"name[The Mill], eatType[restaurant], food[English], priceRange[more than £30], customer rating[high], area[city centre], familyFriendly[no], near[Café Rouge]"	"English high rated restaurant in the city centre where you pay more than £30. The Mill, non family, near Café Rouge."
"name[The Mill], eatType[restaurant], food[English], priceRange[more than £30], customer rating[high], area[city centre], familyFriendly[yes], near[Café Rouge]"	"More than £30 priced family-friendly restaurant, The Mill has a high customer rating and offers an English menu. It is located at the city centre near the Café Rouge."
"name[The Mill], eatType[restaurant], food[English], priceRange[more than £30], customer rating[high], area[riverside], familyFriendly[no], near[Café Rouge]"	"The Mill, restaurant and English, is near Café Rouge in riverside. Children not allowed. High customer rating and price range more than £30."
"name[The Mill], eatType[restaurant], food[English], priceRange[more than £30], customer rating[high], area[riverside], familyFriendly[yes], near[Café Rouge]"	"Restaurant The Mill is child friendly with a price range of more than £30. Serving English food, it is located near Café Rouge in riverside and has a high customer rating."
"name[The Mill], eatType[restaurant], food[Fast food], priceRange[£20-25], area[riverside], familyFriendly[yes], near[Raja Indian Cuisine]"	"The Mill is a child-friendly Fast food restaurant in the £20-£25 price range. It is located in the riverside, near Raja Indian Cuisine."
"name[The Mill], eatType[restaurant], food[Fast food], priceRange[cheap], area[riverside], familyFriendly[yes], near[Raja Indian Cuisine]"	"The Mill is a restaurant that sells Fast food food. IT is a cheap price range in the riverside area near Raja Indian Cuisine. It is children Friendly."
"name[The Phoenix], eatType[pub], food[Fast food], priceRange[cheap], area[riverside], familyFriendly[yes], near[Raja Indian Cuisine]"	"For Fast food food in riverside there is a cheaply priced pub that is kid friendly named The Phoenix near Raja Indian Cuisine."
"name[The Phoenix], eatType[pub], food[Fast food], priceRange[high], area[city centre], familyFriendly[no], near[Raja Indian Cuisine]"	"The Phoenix is a pub that offers Fast food food for high. It is located in the city centre near Raja Indian Cuisine and is not child friendly."
"name[The Phoenix], eatType[pub], food[Fast food], priceRange[high], area[city centre], familyFriendly[yes], near[Raja Indian Cuisine]"	"Fast food food can be found at The Phoenix which is near Raja Indian Cuisine in the city centre. It is a family-friendly pub and has a price range of high."
"name[The Phoenix], eatType[pub], food[Fast food], priceRange[high], area[riverside], familyFriendly[no], near[Raja Indian Cuisine]"	"Catering a traditional Fast food menu, The Phoenix pub sits on the riverside, and offers a highly priced alternative to the nearby Raja Indian Cuisine. The Phoenix is not considered child friendly."
"name[The Phoenix], eatType[pub], food[Fast food], priceRange[high], area[riverside], familyFriendly[yes], near[Raja Indian Cuisine]"	"Children friendly Fast food restaurant The Phoenix is located near Raja Indian Cuisine in riverside. It is a high priced pub high."
"name[The Phoenix], eatType[pub], food[Fast food], priceRange[less than £20], area[city centre], familyFriendly[no], near[Raja Indian Cuisine]"	"The Phoenix is a pub near Raja Indian Cuisine in the city centre. They serve Fast food, no children menus or services, in a less than £20 price range."
"name[The Phoenix], eatType[pub], food[Fast food], priceRange[less than £20], area[city centre], familyFriendly[yes], near[Raja Indian Cuisine]"	"There is a Fast food, family friendly pub in city centre near Raja Indian Cuisine called The Phoenix and is less than £20 priced."
"name[The Phoenix], eatType[pub], food[Fast food], priceRange[less than £20], area[riverside], familyFriendly[no], near[Raja Indian Cuisine]"	"The Phoenix is a less than £20 priced Fast food pub. It is near Raja Indian Cuisine, is not kids friendly, and is in the riverside."
"name[The Phoenix], eatType[pub], food[Fast food], priceRange[less than £20], area[riverside], familyFriendly[yes], near[Raja Indian Cuisine]"	"The Phoenix is a family friendly pub located in the riverside near Raja Indian Cuisine. It serves Fast food food with a price range get of less than £20."
"name[The Phoenix], eatType[pub], food[Fast food], priceRange[moderate], area[city centre], familyFriendly[no], near[Raja Indian Cuisine]"	"There is a pub by the name of The Phoenix. Their price range is moderate and they serve Fast food. They are not kid friendly and they are at the city centre near Raja Indian Cuisine."
"name[The Phoenix], eatType[pub], food[Fast food], priceRange[moderate], area[city centre], familyFriendly[yes], near[Raja Indian Cuisine]"	"A Fast food restaurant called The Phoenix is a pub in the area of city centre located near Raja Indian Cuisine. It is a children friendly place with a high price range of moderate."
"name[The Phoenix], eatType[pub], food[Fast food], priceRange[moderate], area[riverside], familyFriendly[no], near[Raja Indian Cuisine]"	"There is a Fast food pub near Raja Indian Cuisine in the riverside area called The Phoenix. It has a moderate price range and is not child-friendly."
"name[The Phoenix], eatType[pub], food[Fast food], priceRange[moderate], area[riverside], familyFriendly[yes], near[Raja Indian Cuisine]"	"For moderate The Phoenix is a children friendly Fast food restaurant near Raja Indian Cuisine at riverside is a pub."
"name[The Phoenix], eatType[pub], food[Fast food], priceRange[moderate], customer rating[3 out of 5], area[riverside], familyFriendly[yes], near[Café Sicilia]"	"The Phoenix, a Fast food pub located in riverside near Café Sicilia, offers a children friendly atmosphere with prices on the moderateer end. The Phoenix has a 3 out of 5 customer rating."
"name[The Phoenix], eatType[pub], food[Fast food], priceRange[more than £30], area[riverside], familyFriendly[yes], near[Raja Indian Cuisine]"	"The Phoenix is a pub offering Fast food food with a price range of more than £30 pounds. This restaurant is located in riverside near the Raja Indian Cuisine restaurant. It is kids friendly."
"name[The Phoenix], eatType[pub], food[Fast food], priceRange[more than £30], customer rating[high], area[city centre], familyFriendly[no], near[Café Sicilia]"	"In the city centre, near Café Sicilia, you will find The Phoenix. It is a non children-friendly pub that serves Fast food food. While its price range is quite high, more than £30, it has a high customer ratings."
"name[The Phoenix], eatType[pub], food[Fast food], priceRange[more than £30], customer rating[high], area[city centre], familyFriendly[yes], near[Café Sicilia]"	"In the city centre, The Phoenix is a Fast food pub with a family atmosphere. It is located next to the Café Sicilia with a high customer rating and a price point of more than £30."
"name[The Phoenix], eatType[pub], food[Fast food], priceRange[more than £30], customer rating[high], area[riverside], familyFriendly[no], near[Café Sicilia]"	"The Phoenix is a Fast food pub which is near Café Sicilia by riverside. It is in the more than £30 price range and has a customer rating of high. The Phoenix is not child friendly."
"name[The Phoenix], eatType[pub], food[Fast food], priceRange[more than £30], customer rating[high], area[riverside], familyFriendly[yes], near[Café Sicilia]"	"For a more than £30 Fast food pub check out the high family friendly The Phoenix, located in the riverside area near Café Sicilia."
"name[The Phoenix], eatType[pub], food[French], priceRange[£20-25], area[riverside], familyFriendly[yes], near[Raja Indian Cuisine]"	"There is a French, pub located near Raja Indian Cuisine in riverside called The Phoenix. The pub is in the £20-£25 price range and is children friendly."
"name[The Phoenix], eatType[pub], food[French], priceRange[£20-25], customer rating[3 out of 5], area[city centre], familyFriendly[no], near[Café Sicilia]"	"The Phoenix is located in the city centre area near Café Sicilia. This £20-£25-priced pub serves French food with a 3 out of 5 customer rating. This is not a family-friendly pub."
"name[The Phoenix], eatType[pub], food[French], priceRange[£20-25], customer rating[3 out of 5], area[city centre], familyFriendly[yes], near[Café Sicilia]"	"The Phoenix is a pub located near Café Sicilia in the city centre. They serve French food with prices ranging from £20-£25. They are kid friendly and have a rating of 3 out of 5."
"name[The Phoenix], eatType[pub], food[French], priceRange[£20-25], customer rating[3 out of 5], area[riverside], familyFriendly[no], near[Café Sicilia]"	"The Phoenix is a pub that offers French food for a £20-£25 price with a 3 out of 5 rating. In the area of riverside near Café Sicilia, not family friendly."
"name[The Phoenix], eatType[pub], food[French], priceRange[£20-25], customer rating[3 out of 5], area[riverside], familyFriendly[yes], near[Café Sicilia]"	"The Phoenix is a kid friendly French pub in the riverside near Café Sicilia with a £20-£25 price range and has a customer rating of 3 out of 5."
"name[The Phoenix], eatType[pub], food[French], priceRange[£20-25], customer rating[3 out of 5], area[riverside], familyFriendly[yes], near[Crowne Plaza Hotel]"	"The Phoenix is a pub that serves French food for £20-£25 euros, it is in the riverside area near a Crowne Plaza Hotel and is kid friendly with 3 out of 5 customer rating."
"name[The Phoenix], eatType[pub], food[French], priceRange[£20-25], customer rating[high], area[city centre], familyFriendly[no], near[Crowne Plaza Hotel]"	"The Phoenix is a pub near the Crowne Plaza Hotel in the city centre. The price range is £20-£25 and the customer ratings are high for this French establishment. Bringing children is not recommended."
"name[The Phoenix], eatType[pub], food[French], priceRange[£20-25], customer rating[high], area[city centre], familyFriendly[yes], near[Crowne Plaza Hotel]"	"A pub with French food is The Phoenix which is in the city centre near Crowne Plaza Hotel. It is children-friendly , with a high customer rating, and is in the £20-£25 price range."
"name[The Phoenix], eatType[pub], food[French], priceRange[£20-25], customer rating[high], area[riverside], familyFriendly[no], near[Crowne Plaza Hotel]"	"The Phoenix is a non-children friendly French pub in the riverside near Crowne Plaza Hotel with a customer rating of high and has a £20-£25 price range."
"name[The Phoenix], eatType[pub], food[French], priceRange[£20-25], customer rating[high], area[riverside], familyFriendly[yes], near[Crowne Plaza Hotel]"	"The French place with a high customer rating, The Phoenix, is near Crowne Plaza Hotel in the riverside, has a £20-£25 price range and is a family-friendly pub."
"name[The Phoenix], eatType[pub], food[French], priceRange[cheap], area[riverside], familyFriendly[yes], near[Raja Indian Cuisine]"	"The kids friendly pub is called The Phoenix. This restaurant is located in riverside near the Raja Indian Cuisine restaurant and offers French cuisine. Meals at The Phoenix cost cheap pounds."
"name[The Phoenix], eatType[pub], food[French], priceRange[cheap], customer rating[5 out of 5], area[city centre], familyFriendly[no], near[Crowne Plaza Hotel]"	"On the city centre, near Crowne Plaza Hotel, you will find The Phoenix. It is a cheap, non family-friendly pub that also serves French food. It has an excellent customer rating of 5 out of 5."
"name[The Phoenix], eatType[pub], food[French], priceRange[cheap], customer rating[5 out of 5], area[city centre], familyFriendly[yes], near[Crowne Plaza Hotel]"	"Serving French food, The Phoenix is a pub in the city centre, near Crowne Plaza Hotel. It has a cheap price range and is family-friendly. Customers rate is 5 out of 5."
"name[The Phoenix], eatType[pub], food[French], priceRange[cheap], customer rating[5 out of 5], area[riverside], familyFriendly[no], near[Crowne Plaza Hotel]"	"The Phoenix, pub and French, is near Crowne Plaza Hotel in riverside. Children not allowed. 5 out of 5 customer rating and price range cheap."
"name[The Phoenix], eatType[pub], food[French], priceRange[cheap], customer rating[5 out of 5], area[riverside], familyFriendly[yes], near[Crowne Plaza Hotel]"	"There is a pub called The Phoenix that serves French food The price range is cheap and the customer rating is 5 out of 5. it is child friendly and is near Crowne Plaza Hotel in the riverside."
"name[The Phoenix], eatType[pub], food[French], priceRange[high], area[riverside], familyFriendly[yes], near[Raja Indian Cuisine]"	"Come to The Phoenix where they serve highly priced French food. It is a riverside pub near Raja Indian Cuisine and is great for children."
"name[The Phoenix], eatType[pub], food[French], priceRange[high], customer rating[3 out of 5], area[city centre], familyFriendly[no], near[Crowne Plaza Hotel]"	"For an adult oriented French pub, The Phoenix has a 3 out of 5 customer rating, but the price range is high, and is conveniently located in the city centre, near Crowne Plaza Hotel."
"name[The Phoenix], eatType[pub], food[French], priceRange[high], customer rating[3 out of 5], area[city centre], familyFriendly[yes], near[Crowne Plaza Hotel]"	"The Phoenix is a pub serving French food located in the city centre near Crowne Plaza Hotel. They have 3 out of 5 customer ratings, and are child friendly Prices are in the range of high."
"name[The Phoenix], eatType[pub], food[French], priceRange[high], customer rating[3 out of 5], area[riverside], familyFriendly[no], near[Crowne Plaza Hotel]"	"The Phoenix, an adult oriented pub serving French food, in riverside near Crowne Plaza Hotel, has high prices and customer ratings of 3 out of 5."
"name[The Phoenix], eatType[pub], food[French], priceRange[high], customer rating[3 out of 5], area[riverside], familyFriendly[yes], near[Crowne Plaza Hotel]"	"The Phoenix is a riverside pub that is kid friendly, has a high price range, serves French food, and has a 3 out of 5 rating. It is near the Crowne Plaza Hotel."
"name[The Phoenix], eatType[pub], food[French], priceRange[less than £20], customer rating[average], area[city centre], familyFriendly[no], near[Crowne Plaza Hotel]"	"The Phoenix is a French pub near Crowne Plaza Hotel in the city centre. It is not family-friendly and has an average customer rating and a price range of less than £20."
"name[The Phoenix], eatType[pub], food[French], priceRange[less than £20], customer rating[average], area[city centre], familyFriendly[yes], near[Crowne Plaza Hotel]"	"The Phoenix is an 3 out of 5 French pub near Crowne Plaza Hotel in the city centre. It is in the less than £20 price range, but is children friendly."
"name[The Phoenix], eatType[pub], food[French], priceRange[less than £20], customer rating[average], area[riverside], familyFriendly[no], near[Crowne Plaza Hotel]"	"The Phoenix, is a French pub - not child friendly, with a less than £20 price range and average customer rating in the riverside area, near Crowne Plaza Hotel."
"name[The Phoenix], eatType[pub], food[French], priceRange[less than £20], customer rating[average], area[riverside], familyFriendly[yes], near[Crowne Plaza Hotel]"	"The Phoenix is a pub that serves French food. It is family friendly and the price range is less than £20. It is situated in riverside, near Crowne Plaza Hotel; it has an average customer rating."
"name[The Phoenix], eatType[pub], food[French], priceRange[less than £20], customer rating[low], area[city centre], familyFriendly[no], near[Crowne Plaza Hotel]"	"The Phoenix is a pub with French food ranging in less than £20 pounds. This establishment has low customer ratings. They are located in the city centre near Crowne Plaza Hotel and do not allow children."
"name[The Phoenix], eatType[pub], food[French], priceRange[less than £20], customer rating[low], area[city centre], familyFriendly[yes], near[Crowne Plaza Hotel]"	"There is a pub that serves French food located near Crowne Plaza Hotel in the city centre area called The Phoenix. While it is children friendly it ranges in price for less than £20 and low customer ratings."
"name[The Phoenix], eatType[pub], food[French], priceRange[less than £20], customer rating[low], area[riverside], familyFriendly[no], near[Crowne Plaza Hotel]"	"The Phoenix, rated at a low and located on the riverside near Crowne Plaza Hotel, is a pub that also serves French food at a less than £20 price but is not a kid friendly place."
"name[The Phoenix], eatType[pub], food[French], priceRange[less than £20], customer rating[low], area[riverside], familyFriendly[yes], near[Crowne Plaza Hotel]"	"The Phoenix, a French pub located near Crowne Plaza Hotel in the riverside, offers food at less than £20 price range. Although it has a customer rating of low, it also is children friendly."
"name[The Phoenix], eatType[pub], food[French], priceRange[moderate], customer rating[1 out of 5], area[city centre], familyFriendly[no], near[Crowne Plaza Hotel]"	"The Phoenix is a moderate priced, 1 out of 5 rated, adult only French pub located near Crowne Plaza Hotel in the city centre."
"name[The Phoenix], eatType[pub], food[French], priceRange[moderate], customer rating[1 out of 5], area[city centre], familyFriendly[yes], near[Crowne Plaza Hotel]"	"The Phoenix, a French pub in the city centre area near Crowne Plaza Hotel is child-friendly with a moderate price range but a 1 out of 5 rating."
"name[The Phoenix], eatType[pub], food[French], priceRange[moderate], customer rating[1 out of 5], area[riverside], familyFriendly[no], near[Crowne Plaza Hotel]"	"Located in the riverside The Phoenix pub, with a customer rating of 1 out of 5, offers French food for a moderate price. While it is not kid friendly there is a Crowne Plaza Hotel nearby."
"name[The Phoenix], eatType[pub], food[French], priceRange[moderate], customer rating[1 out of 5], area[riverside], familyFriendly[yes], near[Crowne Plaza Hotel]"	"The Phoenix is a family-friendly, French, pub located in the riverside near the Crowne Plaza Hotel. However, it has a 1 out of 5 customer rating and the meals cost moderate pounds."
"name[The Phoenix], eatType[pub], food[French], priceRange[more than £30], customer rating[5 out of 5], area[city centre], familyFriendly[no], near[Crowne Plaza Hotel]"	"The Phoenix is a non- child friendly pub near Crowne Plaza Hotel in the city centre area that serves French food. It has a more than £30 price range and a customer rating of 5 out of 5."
"name[The Phoenix], eatType[pub], food[French], priceRange[more than £30], customer rating[5 out of 5], area[city centre], familyFriendly[yes], near[Crowne Plaza Hotel]"	"There is a French family friendly pub called The Phoenix on the city centre. It is near Crowne Plaza Hotel. It has a more than £30 price range and 5 out of 5 customer rating."
"name[The Phoenix], eatType[pub], food[French], priceRange[more than £30], customer rating[5 out of 5], area[riverside], familyFriendly[no], near[Crowne Plaza Hotel]"	"There's a pub that serves French food at riverside called The Phoenix. It's near Crowne Plaza Hotel. The price range is about more than £30 and it's not kids-friendly, but the customer rating is 5 out of 5."
"name[The Phoenix], eatType[pub], food[French], priceRange[more than £30], customer rating[5 out of 5], area[riverside], familyFriendly[yes], near[Crowne Plaza Hotel]"	"The Phoenix is a pub that offers French food. Its prices are more than £30 but it has a 5 out of 5 customer rating. It is located in the riverside near Crowne Plaza Hotel and it is children Friendly."
"name[The Phoenix], eatType[pub], food[French], priceRange[more than £30], customer rating[low], area[city centre], familyFriendly[no], near[Crowne Plaza Hotel]"	"The Phoenix French pub, is more than £30 in price with a low customer rating, not kid friendly on the city centre near Crowne Plaza Hotel."
"name[The Phoenix], eatType[pub], food[French], priceRange[more than £30], customer rating[low], area[city centre], familyFriendly[yes], near[Crowne Plaza Hotel]"	"The Phoenix, a French pub in the city centre area near Crowne Plaza Hotel is child-friendly with a more than £30 price range but a low rating."
"name[The Phoenix], eatType[pub], food[French], priceRange[more than £30], customer rating[low], area[riverside], familyFriendly[no], near[Crowne Plaza Hotel]"	"The Phoenix pub, near Crowne Plaza Hotel, serves more than £30-end French food, It has a riverside location, low reviews and is not suitable for children."
"name[The Phoenix], eatType[pub], food[French], priceRange[more than £30], customer rating[low], area[riverside], familyFriendly[yes], near[Crowne Plaza Hotel]"	"The Phoenix pub serves French food at a more than £30 price while providing excellence in customer service rating low, located in the riverside this family friendly pub is located right near Crowne Plaza Hotel."
"name[The Phoenix], eatType[restaurant], food[Fast food], priceRange[cheap], area[riverside], familyFriendly[yes], near[Raja Indian Cuisine]"	"On the riverside near Raja Indian Cuisine is a cheap Fast food establishment with a restaurant called The Phoenix and yes it is family friendly."
"name[The Phoenix], eatType[restaurant], food[Fast food], priceRange[high], area[city centre], familyFriendly[no], near[Raja Indian Cuisine]"	"The Phoenix is a highly priced restaurant located in the city centre. It provides Fast food food. It is not kids friendly and is located near Raja Indian Cuisine."
"name[The Phoenix], eatType[restaurant], food[Fast food], priceRange[high], area[city centre], familyFriendly[yes], near[Raja Indian Cuisine]"	"The Phoenix is a Fast food, restaurant located near Raja Indian Cuisine in city centre. The restaurant is children friendly and is in the higher price range."
"name[The Phoenix], eatType[restaurant], food[Fast food], priceRange[high], area[riverside], familyFriendly[no], near[Raja Indian Cuisine]"	"The place you will be traveling to is The Phoenix. Where our price range for you is high. There is restaurant with Fast food near the Raja Indian Cuisine. Located in the riverside area. It is not kid friendly."
"name[The Phoenix], eatType[restaurant], food[Fast food], priceRange[high], area[riverside], familyFriendly[yes], near[Raja Indian Cuisine]"	"The Phoenix is a restaurant that serves Fast food food located in the riverside area near Raja Indian Cuisine. It is kid friendly with a price range of high."
"name[The Phoenix], eatType[restaurant], food[Fast food], priceRange[less than £20], area[city centre], familyFriendly[no], near[Raja Indian Cuisine]"	"A less than £20 priced restaurant that serves Fast food is The Phoenix , but has a non-children friendly atmosphere. It is located in the city centre near Raja Indian Cuisine."
"name[The Phoenix], eatType[restaurant], food[Fast food], priceRange[less than £20], area[city centre], familyFriendly[yes], near[Raja Indian Cuisine]"	"Located at city centre near Raja Indian Cuisine there is a restaurant called The Phoenix that serves Fast food food that has a price range of less than £20 and a children friendly place."
"name[The Phoenix], eatType[restaurant], food[Fast food], priceRange[less than £20], area[riverside], familyFriendly[no], near[Raja Indian Cuisine]"	"Near Raja Indian Cuisine in the riverside is a Fast food restaurant called The Phoenix. It has a price range of less than £20 and is not kid-friendly."
"name[The Phoenix], eatType[restaurant], food[Fast food], priceRange[less than £20], area[riverside], familyFriendly[yes], near[Raja Indian Cuisine]"	"The Phoenix is a restaurant located at riverside near Raja Indian Cuisine serves Fast food food and a Family friendly place that a less than £20 price range of food."
"name[The Phoenix], eatType[restaurant], food[Fast food], priceRange[moderate], area[city centre], familyFriendly[no], near[Raja Indian Cuisine]"	"The Phoenix is a restaurant. There price range is moderate. They serve Fast food. They are not kids friendly. Located near the Raja Indian Cuisine, in the city centre area."
"name[The Phoenix], eatType[restaurant], food[Fast food], priceRange[moderate], area[city centre], familyFriendly[yes], near[Raja Indian Cuisine]"	"The Phoenix is a moderately priced restaurant that serves Fast food food. It is located in the city centre near Raja Indian Cuisine. Great place to bring your family."
"name[The Phoenix], eatType[restaurant], food[Fast food], priceRange[moderate], area[riverside], familyFriendly[no], near[Raja Indian Cuisine]"	"The Phoenix restaurant serves Fast food food and is near the riverside and the Raja Indian Cuisine. It is not family-friendly and is priced in the moderate pound range."
"name[The Phoenix], eatType[restaurant], food[Fast food], priceRange[moderate], area[riverside], familyFriendly[yes], near[Raja Indian Cuisine]"	"Family friendly Fast food restaurant, The Phoenix, is located riverside near Raja Indian Cuisine with a price range moderate."
"name[The Phoenix], eatType[restaurant], food[Fast food], priceRange[more than £30], area[riverside], familyFriendly[yes], near[Raja Indian Cuisine]"	"The Phoenix is a restaurant serving Fast food food near Raja Indian Cuisine in the riverside area. It is kids friendly and in the more than £30 price range."
"name[The Phoenix], eatType[restaurant], food[French], priceRange[£20-25], area[riverside], familyFriendly[yes], near[Raja Indian Cuisine]"	"A £20-£25 priced French restaurant and restaurant that is children friendly is called The Phoenix. It is in the riverside near Raja Indian Cuisine."
"name[The Phoenix], eatType[restaurant], food[French], priceRange[cheap], area[riverside], familyFriendly[yes], near[Raja Indian Cuisine]"	"The Phoenix is a kids friendly restaurant near Raja Indian Cuisine in the riverside. It serves cheaply priced French food."
"name[The Phoenix], eatType[restaurant], food[French], priceRange[high], area[riverside], familyFriendly[yes], near[Raja Indian Cuisine]"	"A restaurant with French, near Raja Indian Cuisine on the riverside is family friendly and high euros is known as, The Phoenix."
"name[The Phoenix], eatType[restaurant], food[Indian], priceRange[£20-25], customer rating[high], area[city centre], familyFriendly[no], near[Crowne Plaza Hotel]"	"The Phoenix is a restaurant that also serves Indian food. The price range is £20-£25 and rated a high by customers. The Phoenix is not a kid friendly place but if you would like to try it, it is located by the city centre area near Crowne Plaza Hotel."
"name[The Phoenix], eatType[restaurant], food[Indian], priceRange[£20-25], customer rating[high], area[city centre], familyFriendly[yes], near[Crowne Plaza Hotel]"	"If you're looking for a £20-£25, family-friendly Indian restaurant, with an excellent customer rating of high, then go to The Phoenix located near Crowne Plaza Hotel in the city centre."
"name[The Phoenix], eatType[restaurant], food[Indian], priceRange[£20-25], customer rating[high], area[riverside], familyFriendly[no], near[Crowne Plaza Hotel]"	"A high rated, £20-£25 Indian restaurant is called The Phoenix. It is in the riverside area near Crowne Plaza Hotel and isn't family-friendly."
"name[The Phoenix], eatType[restaurant], food[Indian], priceRange[£20-25], customer rating[high], area[riverside], familyFriendly[yes], near[Crowne Plaza Hotel]"	"The Phoenix is a kid friendly restaurant that also serves Indian food. It has a high customer rating, so if you are interested it is located near Crowne Plaza Hotel in riverside and the bill will be around £20-£25."
"name[The Phoenix], eatType[restaurant], food[Indian], priceRange[cheap], customer rating[5 out of 5], area[city centre], familyFriendly[no], near[Crowne Plaza Hotel]"	"There is a kid friendly restaurant that is 5 out of 5 rated. It serves Indian Food cheap pounds located near Crowne Plaza Hotel called The Phoenix in city centre."
"name[The Phoenix], eatType[restaurant], food[Indian], priceRange[cheap], customer rating[5 out of 5], area[city centre], familyFriendly[yes], near[Crowne Plaza Hotel]"	"Near Crowne Plaza Hotel in city centre is 5 out of 5 rated Indian restaurant The Phoenix. It is child friendly with dishes cheap."
"name[The Phoenix], eatType[restaurant], food[Indian], priceRange[cheap], customer rating[5 out of 5], area[riverside], familyFriendly[no], near[Crowne Plaza Hotel]"	"The Phoenix is a non-kids-friendly restaurant with a 5 out of 5 customer rating. Serving Indian food at around cheap, it's located on riverside, near Crowne Plaza Hotel."
"name[The Phoenix], eatType[restaurant], food[Indian], priceRange[cheap], customer rating[5 out of 5], area[riverside], familyFriendly[no], near[Express by Holiday Inn]"	"The restaurant The Phoenix located in the riverside near Express by Holiday Inn serves 5 out of 5 quality Indian food very cheap but is family-friendly."
"name[The Phoenix], eatType[restaurant], food[Indian], priceRange[cheap], customer rating[5 out of 5], area[riverside], familyFriendly[yes], near[Express by Holiday Inn]"	"The Phoenix is a restaurant located near Express by Holiday Inn in the riverside. They serve Indian food with prices ranging from cheap. They are kid friendly and have a rating of 5 out of 5."
"name[The Phoenix], eatType[restaurant], food[Indian], priceRange[cheap], customer rating[average], area[city centre], familyFriendly[no], near[Express by Holiday Inn]"	"The Phoenix is a cheaply priced adult only restaurant that offers Indian food. It has an average customer rating and is located by Express by Holiday Inn in the city centre area."
"name[The Plough], eatType[pub], food[Chinese], priceRange[£20-25], area[riverside], familyFriendly[yes], near[Raja Indian Cuisine]"	"There is a family friendly Chinese pub The Plough with a price range of £20-£25 near Raja Indian Cuisine in riverside."
"name[The Plough], eatType[pub], food[Chinese], priceRange[cheap], area[riverside], familyFriendly[yes], near[Raja Indian Cuisine]"	"The Plough is a family friendly pub serving Chinese food for cheap. It is located in the riverside near Raja Indian Cuisine."
"name[The Plough], eatType[pub], food[Chinese], priceRange[high], area[city centre], familyFriendly[no], near[Raja Indian Cuisine]"	"In the area of city centre near Raja Indian Cuisine is The Plough, it is a pub. It is not kid friendly and the Chinese is highly expensive."
"name[The Plough], eatType[pub], food[Chinese], priceRange[high], area[city centre], familyFriendly[yes], near[Raja Indian Cuisine]"	"The Plough is a children friendly pub with a price range of high. It also serves Chinese food and is located in the city centre near Raja Indian Cuisine."
"name[The Plough], eatType[pub], food[Chinese], priceRange[high], area[riverside], familyFriendly[no], near[Raja Indian Cuisine]"	"The Plough is a Chinese pub located by the riverside, near Raja Indian Cuisine. It is highly-priced and not kid-friendly."
"name[The Plough], eatType[pub], food[Chinese], priceRange[high], area[riverside], familyFriendly[yes], near[Raja Indian Cuisine]"	"The Plough, a Chinese pub near Raja Indian Cuisine, offers family friendly riverside dining for high."
"name[The Plough], eatType[pub], food[Chinese], priceRange[less than £20], area[city centre], familyFriendly[no], near[Raja Indian Cuisine]"	"At the city centre near Raja Indian Cuisine is The Plough pub that has Chinese less than £20 and is not family-friendly."
"name[The Plough], eatType[restaurant], food[Chinese], priceRange[£20-25], area[riverside], familyFriendly[yes], near[Raja Indian Cuisine]"	"Near Raja Indian Cuisine around riverside there is a restaurant that is £20-£25 price range, children friendly, serves Chinese food called The Plough."
"name[The Plough], eatType[restaurant], food[Chinese], priceRange[cheap], area[riverside], familyFriendly[yes], near[Raja Indian Cuisine]"	"A cheap priced restaurant serving Chinese in the riverside area, near Raja Indian Cuisine, is The Plough. It is children friendly."
"name[The Plough], eatType[restaurant], food[Chinese], priceRange[high], area[city centre], familyFriendly[no], near[Raja Indian Cuisine]"	"The Plough is a restaurant that serves Chinese food. Has a high price range, and is kids friendly. Located in the city centre area near Raja Indian Cuisine."
"name[The Plough], eatType[restaurant], food[Chinese], priceRange[high], area[city centre], familyFriendly[yes], near[Raja Indian Cuisine]"	"A Children Friendly Chinese restaurant located near Raja Indian Cuisine in the city centre named The Plough has high price range for a restaurant."
"name[The Plough], eatType[restaurant], food[Chinese], priceRange[high], area[riverside], familyFriendly[no], near[Raja Indian Cuisine]"	"The Plough is a restaurant that also serves Chinese at a high price range and is not children friendly, It is located in riverside near Raja Indian Cuisine."
"name[The Plough], eatType[restaurant], food[Chinese], priceRange[high], area[riverside], familyFriendly[yes], near[Raja Indian Cuisine]"	"The Chinese restaurant, The Plough, is a highly priced, kid friendly restaurant in riverside near Raja Indian Cuisine."
"name[The Plough], eatType[restaurant], food[Chinese], priceRange[less than £20], area[city centre], familyFriendly[no], near[Raja Indian Cuisine]"	"There's a Chinese and restaurant that's less than £20, near Raja Indian Cuisine along the city centre that's not really family friendly. It's called The Plough."
"name[The Punter], eatType[pub], food[Chinese], priceRange[less than £20], area[city centre], familyFriendly[yes], near[Raja Indian Cuisine]"	"The Punter is a less than £20 cheap pub located in the area of city centre, near the Raja Indian Cuisine. Chinese is sold there and the staff are friendly."
"name[The Punter], eatType[pub], food[Chinese], priceRange[less than £20], area[riverside], familyFriendly[no], near[Raja Indian Cuisine]"	"In the area of riverside near Raja Indian Cuisine is The Punter, it is a pub. It is not kid friendly and the Chinese is less than £20 expensive."
"name[The Punter], eatType[pub], food[Chinese], priceRange[less than £20], area[riverside], familyFriendly[yes], near[Raja Indian Cuisine]"	"There is a less than £20 family friendly Chinese pub, The Punter in riverside, near Raja Indian Cuisine."
"name[The Punter], eatType[pub], food[Chinese], priceRange[moderate], area[city centre], familyFriendly[no], near[Raja Indian Cuisine]"	"Serving Chinese food, the non-family friendly restaurant, The Punter, is a pub in the moderate price range. It is in city centre near Raja Indian Cuisine."
"name[The Punter], eatType[pub], food[Chinese], priceRange[moderate], area[city centre], familyFriendly[yes], near[Raja Indian Cuisine]"	"The Punter is a kids friendly pub near Raja Indian Cuisine in the city centre. It serves moderately priced Chinese food."
"name[The Punter], eatType[pub], food[Chinese], priceRange[moderate], area[riverside], familyFriendly[no], near[Raja Indian Cuisine]"	"The Punter pub serves moderate priced Chinese food in the riverside, near Raja Indian Cuisine. Be advised, The Punter is not children friendly."
"name[The Punter], eatType[pub], food[Chinese], priceRange[moderate], area[riverside], familyFriendly[yes], near[Raja Indian Cuisine]"	"The Punter is a children-friendly pub that serves Chinese food and is found in the riverside area near Raja Indian Cuisine. The price range is moderate."
"name[The Punter], eatType[pub], food[Chinese], priceRange[more than £30], area[riverside], familyFriendly[yes], near[Raja Indian Cuisine]"	"The Punter is a pub that serves kid friendly more than £30 priced Chinese food and is located near Raja Indian Cuisine near the riverside."
"name[The Punter], eatType[pub], food[English], priceRange[£20-25], area[riverside], familyFriendly[yes], near[Raja Indian Cuisine]"	"The Punter is a child friendly pub which serves £20-£25 priced English food. It is near Raja Indian Cuisine in the riverside area."
"name[The Punter], eatType[pub], food[English], priceRange[cheap], area[riverside], familyFriendly[yes], near[Raja Indian Cuisine]"	"There is a kid-friendly pub offering English food located near Raja Indian Cuisine in the riverside area. It is called The Punter, and is cheaply priced."
"name[The Punter], eatType[pub], food[English], priceRange[high], area[city centre], familyFriendly[no], near[Raja Indian Cuisine]"	"The Punter pub and English is along the city centre near Raja Indian Cuisine. It's generally high but isn't family friendly."
"name[The Punter], eatType[pub], food[English], priceRange[high], area[city centre], familyFriendly[yes], near[Raja Indian Cuisine]"	"There is a kid-friendly pub offering English food located near Raja Indian Cuisine in the city centre area. It is called The Punter, and is highly priced."
"name[The Punter], eatType[pub], food[English], priceRange[high], area[riverside], familyFriendly[no], near[Raja Indian Cuisine]"	"The Punter is a high priced pub that serves English but is a non-children friendly atmosphere. It is located near Raja Indian Cuisine both in the riverside."
"name[The Punter], eatType[pub], food[English], priceRange[high], area[riverside], familyFriendly[yes], near[Raja Indian Cuisine]"	"A Children Friendly English restaurant located near Raja Indian Cuisine in the riverside named The Punter has high price range for a pub."
"name[The Punter], eatType[pub], food[Italian], priceRange[high], customer rating[average], area[city centre], familyFriendly[no], near[Rainbow Vegetarian Café]"	"The high priced Italian pub The Punter, is based in the city centre area near to the Rainbow Vegetarian Café. It is not child friendly and has a customer rating of average."
"name[The Punter], eatType[restaurant], food[Chinese], priceRange[less than £20], area[city centre], familyFriendly[yes], near[Raja Indian Cuisine]"	"The Punter restaurant is family-friendly Chinese food in city centre near Raja Indian Cuisine with a price range less than £20."
"name[The Punter], eatType[restaurant], food[Chinese], priceRange[less than £20], area[riverside], familyFriendly[no], near[Raja Indian Cuisine]"	"The Punter is a restaurant. The average cost of a meal is less than £20. It is an adults only location that serves Chinese food. It is located in the riverside, near to Raja Indian Cuisine."
"name[The Punter], eatType[restaurant], food[Chinese], priceRange[less than £20], area[riverside], familyFriendly[yes], near[Raja Indian Cuisine]"	"The Punter is a less than £20 priced, kid friendly Chinese restaurant located in the riverside area near Raja Indian Cuisine."
"name[The Punter], eatType[restaurant], food[Chinese], priceRange[moderate], area[city centre], familyFriendly[no], near[Raja Indian Cuisine]"	"The Punter is a Chinese food restaurant in the moderate pounds price range it is in the city centre near Raja Indian Cuisine not child friendly for adults only."
"name[The Punter], eatType[restaurant], food[Chinese], priceRange[moderate], area[city centre], familyFriendly[yes], near[Raja Indian Cuisine]"	"A children friendly restaurant named The Punter that serves Chinese food. In the city centre area is a restaurant with a price range of moderate. It is near Raja Indian Cuisine."
"name[The Punter], eatType[restaurant], food[Chinese], priceRange[moderate], area[riverside], familyFriendly[no], near[Raja Indian Cuisine]"	"The Punter is by Raja Indian Cuisine. It's located in the riverside and is moderately priced. It is also a restaurant. They serve Chinese and are not child friendly."
"name[The Punter], eatType[restaurant], food[Chinese], priceRange[moderate], area[riverside], familyFriendly[yes], near[Raja Indian Cuisine]"	"On the riverside near Raja Indian Cuisine is a moderate Chinese establishment with a restaurant called The Punter and yes it is family friendly."
"name[The Punter], eatType[restaurant], food[Chinese], priceRange[more than £30], area[riverside], familyFriendly[yes], near[Raja Indian Cuisine]"	"The Punter is a restaurant near Raja Indian Cuisine at riverside for Chinese food good for family. The food cost more than £30."
"name[The Punter], eatType[restaurant], food[English], priceRange[£20-25], area[riverside], familyFriendly[yes], near[Raja Indian Cuisine]"	"The Punter is a £20-£25 restaurant located in riverside near Raja Indian Cuisine, they serve English food and our family friendly."
"name[The Punter], eatType[restaurant], food[English], priceRange[cheap], area[riverside], familyFriendly[yes], near[Raja Indian Cuisine]"	"There is a cheap English restaurant named The Punter that is family friendly in riverside by Raja Indian Cuisine."
"name[The Punter], eatType[restaurant], food[English], priceRange[high], area[city centre], familyFriendly[no], near[Raja Indian Cuisine]"	"There is a restaurant, The Punter, serving English food along the city centre near Raja Indian Cuisine. It is not kids friendly and is highly priced."
"name[The Punter], eatType[restaurant], food[English], priceRange[high], area[city centre], familyFriendly[yes], near[Raja Indian Cuisine]"	"For English food in a kids friendly environment, try The Punter restaurant. Priced between high, it can be found in the city centre area near Raja Indian Cuisine."
"name[The Punter], eatType[restaurant], food[English], priceRange[high], area[riverside], familyFriendly[no], near[Raja Indian Cuisine]"	"The Punter restaurant is not family-friendly, sells English food, and has a price range of high. It is located in the riverside area near Raja Indian Cuisine."
"name[The Punter], eatType[restaurant], food[English], priceRange[high], area[riverside], familyFriendly[yes], near[Raja Indian Cuisine]"	"The Punter is restaurant serving English food with price range high. It is children friendly and is located near Raja Indian Cuisine in the riverside."
"name[The Punter], eatType[restaurant], food[Indian], priceRange[cheap], customer rating[average], area[city centre], familyFriendly[yes], near[Express by Holiday Inn]"	"There is a children-friendly restaurant that serves Indian food with a price range with cheap with a rating of average near Express by Holiday Inn in the city centre called The Punter."
"name[The Punter], eatType[restaurant], food[Indian], priceRange[cheap], customer rating[average], area[riverside], familyFriendly[no], near[Express by Holiday Inn]"	"The Punter is a non-kid friendly restaurant located in the riverside near Express by Holiday Inn. They offer Indian food at a cheap price with an average rating among customers."
"name[The Punter], eatType[restaurant], food[Indian], priceRange[cheap], customer rating[average], area[riverside], familyFriendly[yes], near[Express by Holiday Inn]"	"The Punter is a restaurant which serves Indian food at a cheap price. The Punter has an average rating but it is by Express by Holiday Inn at the riverside. The restaurant is child friendly."
"name[The Punter], eatType[restaurant], food[Indian], priceRange[high], customer rating[1 out of 5], area[city centre], familyFriendly[no], near[Express by Holiday Inn]"	"The Punter is an Indian food restaurant in city centre near the Express by Holiday Inn. While it has high prices, customers only give it 1 out of 5 as it is not kid friendly."
"name[The Punter], eatType[restaurant], food[Indian], priceRange[high], customer rating[1 out of 5], area[city centre], familyFriendly[yes], near[Express by Holiday Inn]"	"There is an Indian restaurant called The Punter that has a 1 out of 5 customer rating but is child friendly and is high dollars and is located in the city centre area near Express by Holiday Inn."
"name[The Punter], eatType[restaurant], food[Indian], priceRange[high], customer rating[1 out of 5], area[riverside], familyFriendly[no], near[Express by Holiday Inn]"	"The Punter is an Indian restaurant near Express by Holiday Inn with a price range between high. It has a 1 out of 5 customer rating and is near the riverside, but it is not kid friendly."
"name[The Punter], eatType[restaurant], food[Indian], priceRange[high], customer rating[1 out of 5], area[riverside], familyFriendly[yes], near[Express by Holiday Inn]"	"Indian food at The Punter restaurant by the riverside near Express by Holiday Inn, is children friendly and the price range is high, although it has a 1 out of 5 customer rating."
"name[The Punter], eatType[restaurant], food[Indian], priceRange[high], customer rating[average], area[city centre], familyFriendly[no], near[Express by Holiday Inn]"	"The Punter is a high priced, average rated, adult only Indian restaurant located near Express by Holiday Inn in the city centre."
"name[The Punter], eatType[restaurant], food[Indian], priceRange[high], customer rating[average], area[city centre], familyFriendly[yes], near[Express by Holiday Inn]"	"The Punter, located near Express by Holiday Inn in the city centre, is an Indian restaurant with has an average customer rating, a high price range, but is family-friendly."
"name[The Punter], eatType[restaurant], food[Indian], priceRange[high], customer rating[average], area[riverside], familyFriendly[no], near[Express by Holiday Inn]"	"Located riverside near Express by Holiday Inn, The Punter is a restaurant offering Indian food with a price range of high. Not children friendly, but it has an average customer rating."
"name[The Punter], eatType[restaurant], food[Indian], priceRange[high], customer rating[average], area[riverside], familyFriendly[yes], near[Express by Holiday Inn]"	"The Punter is a high priced, average rated, kid friendly Indian restaurant near Express by Holiday Inn in riverside."
"name[The Punter], eatType[restaurant], food[Indian], priceRange[less than £20], customer rating[low], area[city centre], familyFriendly[no], near[Express by Holiday Inn]"	"In city centre near Express by Holiday Inn, is an Indian restaurant called The Punter. It is not kid friendly, but it has a low rating and an average price range of less than £20."
"name[The Punter], eatType[restaurant], food[Indian], priceRange[less than £20], customer rating[low], area[city centre], familyFriendly[yes], near[Express by Holiday Inn]"	"There is a restaurant that serves Indian food located near Express by Holiday Inn in the city centre area called The Punter. While it is children friendly it ranges in price for less than £20 and low customer ratings."
"name[The Punter], eatType[restaurant], food[Indian], priceRange[less than £20], customer rating[low], area[riverside], familyFriendly[no], near[Express by Holiday Inn]"	"There is a riverside restaurant near to Express by Holiday Inn called The Punter. It serves Indian cuisine for less than £20 per head but it isn't very family-friendly and has low customer ratings."
"name[The Punter], eatType[restaurant], food[Indian], priceRange[less than £20], customer rating[low], area[riverside], familyFriendly[yes], near[Express by Holiday Inn]"	"There is an Indian restaurant called The Punter that has a low customer rating but is child friendly and is less than £20 dollars and is located in the riverside area near Express by Holiday Inn."
"name[The Punter], eatType[restaurant], food[Indian], priceRange[moderate], customer rating[1 out of 5], area[city centre], familyFriendly[no], near[Express by Holiday Inn]"	"In the city centre, near Express by Holiday Inn, you can find the Indian restaurant The Punter. It is mot kid friendly however provides reasonably priced food ranging from moderate and boasts a rating of 1 out of 5."
"name[The Punter], eatType[restaurant], food[Indian], priceRange[moderate], customer rating[1 out of 5], area[city centre], familyFriendly[yes], near[Express by Holiday Inn]"	"In city centre near the Express by Holiday Inn is a 1 out of 5 family friendly Indian restaurant called The Punter, that is not only moderate but family friendly."
"name[The Punter], eatType[restaurant], food[Indian], priceRange[moderate], customer rating[1 out of 5], area[riverside], familyFriendly[no], near[Express by Holiday Inn]"	"The Indian restaurant called The Punter located in riverside near Express by Holiday Inn is not family-friendly but is moderate and has a 1 out of 5 customer rating."
"name[The Punter], eatType[restaurant], food[Indian], priceRange[moderate], customer rating[1 out of 5], area[riverside], familyFriendly[yes], near[Express by Holiday Inn]"	"A restaurant serving Indian food in the moderate price range with a customer rating of 1 out of 5 but is child friendly is The Punter, located near Express by Holiday Inn in riverside."
"name[The Punter], eatType[restaurant], food[Indian], priceRange[moderate], customer rating[3 out of 5], area[city centre], familyFriendly[no], near[Express by Holiday Inn]"	"The Punter is a moderate priced restaurant in the city centre area near Express by Holiday Inn. It serves Indian food and is not child friendly but has a customer rating of 3 out of 5."
"name[The Punter], eatType[restaurant], food[Indian], priceRange[moderate], customer rating[3 out of 5], area[city centre], familyFriendly[yes], near[Express by Holiday Inn]"	"The Punter is a kids friendly Indian restaurant in the city centre near Express by Holiday Inn. It has a 3 out of 5 customer rating and a price range of moderate."
"name[The Punter], eatType[restaurant], food[Indian], priceRange[moderate], customer rating[3 out of 5], area[riverside], familyFriendly[no], near[Express by Holiday Inn]"	"Perhaps because it isn't place for children or the average price moderate, The Punter restaurant that serves Indian food has a 3 out of 5 customer rating. Located near Express by Holiday Inn in the riverside area."
"name[The Punter], eatType[restaurant], food[Indian], priceRange[moderate], customer rating[3 out of 5], area[riverside], familyFriendly[yes], near[Express by Holiday Inn]"	"The Punter is an Indian restaurant near Express by Holiday Inn. This family-friendly location in the riverside area has a 3 out of 5 rating with moderate prices."
"name[The Punter], eatType[restaurant], food[Indian], priceRange[more than £30], customer rating[high], area[city centre], familyFriendly[no], near[Express by Holiday Inn]"	"The Punter is a more than £30 priced restaurant in the city centre area near Express by Holiday Inn. It serves Indian food and is not child friendly but has a customer rating of high."
"name[The Punter], eatType[restaurant], food[Indian], priceRange[more than £30], customer rating[high], area[city centre], familyFriendly[yes], near[Express by Holiday Inn]"	"Express by Holiday Inn is children friendly, located on the city centre, has a high customer rating, provides restaurant quality food. There is a more than £30 price ranged Indian eatery named The Punter nearby."
"name[The Punter], eatType[restaurant], food[Indian], priceRange[more than £30], customer rating[high], area[riverside], familyFriendly[no], near[Express by Holiday Inn]"	"The Punter is an Indian food restaurant located near Express by Holiday Inn in the riverside. With a price range of more than £30, it is highly rated and is not conducive for kids."
"name[The Punter], eatType[restaurant], food[Indian], priceRange[more than £30], customer rating[high], area[riverside], familyFriendly[yes], near[Express by Holiday Inn]"	"The Punter is a restaurant that serves more than £30 priced Indian. Near Express by Holiday Inn in riverside, the place is children friendly and the customers rate it high."
"name[The Punter], eatType[restaurant], food[Italian], priceRange[£20-25], customer rating[high], area[city centre], familyFriendly[no], near[Express by Holiday Inn]"	"In the city centre you will find a high rated Italian restaurant named The Punter. It is located near Express by Holiday Inn with items averaging £20-£25, however it is not family-friendly."
"name[The Punter], eatType[restaurant], food[Italian], priceRange[£20-25], customer rating[high], area[city centre], familyFriendly[yes], near[Express by Holiday Inn]"	"The Punter is a child friendly restaurant with Italian food. It has a high customer rating and a £20-£25 price range. It is near Express by Holiday Inn in city centre."
"name[The Punter], eatType[restaurant], food[Italian], priceRange[£20-25], customer rating[high], area[riverside], familyFriendly[no], near[Express by Holiday Inn]"	"There is an Italian restaurant in riverside near Express by Holiday Inn called The Punter. It has a £20-£25 price range and a high customer rating, but it is not kids friendly."
"name[The Punter], eatType[restaurant], food[Italian], priceRange[£20-25], customer rating[high], area[riverside], familyFriendly[yes], near[Express by Holiday Inn]"	"A high rated restaurant near Express by Holiday Inn and the riverside that is called The Punter and is family friendly and is £20-£25 for Italian food."
"name[The Punter], eatType[restaurant], food[Italian], priceRange[cheap], customer rating[5 out of 5], area[city centre], familyFriendly[no], near[Express by Holiday Inn]"	"City centre located The Punter serves cheaply priced Italian food in a restaurant environment. Just near Express by Holiday Inn, it's rated 5 out of 5 and serves adult parties only."
"name[The Punter], eatType[restaurant], food[Italian], priceRange[cheap], customer rating[5 out of 5], area[city centre], familyFriendly[no], near[Rainbow Vegetarian Café]"	"For a child free city centre restaurant that serves Italian style food at a cheap price and a customer rating of 5 out of 5 then visit The Punter which is located near to Rainbow Vegetarian Café."
"name[The Punter], eatType[restaurant], food[Italian], priceRange[cheap], customer rating[5 out of 5], area[city centre], familyFriendly[yes], near[Rainbow Vegetarian Café]"	"The Punter is a 5 out of 5 restaurant that serves Italian food in the cheap price range. The Punter is situated at the city centre near Rainbow Vegetarian Café. The Punter is child friendly."
"name[The Punter], eatType[restaurant], food[Italian], priceRange[cheap], customer rating[5 out of 5], area[riverside], familyFriendly[no], near[Rainbow Vegetarian Café]"	"The Punter is located in riverside, near Rainbow Vegetarian Café. It is a restaurant which sells Italian food for cheap. It is rated 5 out of 5 by customers but isn't family-friendly."
"name[The Punter], eatType[restaurant], food[Italian], priceRange[cheap], customer rating[5 out of 5], area[riverside], familyFriendly[yes], near[Rainbow Vegetarian Café]"	"In the riverside area near Rainbow Vegetarian Café is a restaurant called The Punter. The Punter serves Italian food and is children friendly. The Punter has a customer rating of 5 out of 5. It has a cheap price range."
"name[The Punter], eatType[restaurant], food[Italian], priceRange[cheap], customer rating[average], area[city centre], familyFriendly[no], near[Rainbow Vegetarian Café]"	"The Punter restaurant has Italian food in the cheap price range with a customer rating of average in city centre, is not kid friendly and is near Rainbow Vegetarian Café."
"name[The Punter], eatType[restaurant], food[Italian], priceRange[cheap], customer rating[average], area[city centre], familyFriendly[yes], near[Rainbow Vegetarian Café]"	"The Punter restaurant is in the city centre near Rainbow Vegetarian Café. It serves cheap Italian food and is family friendly with average customer ratings."
"name[The Punter], eatType[restaurant], food[Italian], priceRange[cheap], customer rating[average], area[riverside], familyFriendly[no], near[Rainbow Vegetarian Café]"	"The Punter is a restaurant serving Italian food in the cheap price range with a customer rating of average in the riverside area near Rainbow Vegetarian Café is not kid friendly."
"name[The Punter], eatType[restaurant], food[Italian], priceRange[cheap], customer rating[average], area[riverside], familyFriendly[yes], near[Rainbow Vegetarian Café]"	"On the riverside near Rainbow Vegetarian Café is The Punter. A restaurant that serves Italian within a cheap price range. It is kid friendly and has a customer rating of average."
"name[The Punter], eatType[restaurant], food[Italian], priceRange[high], customer rating[1 out of 5], area[city centre], familyFriendly[no], near[Rainbow Vegetarian Café]"	"The Punter is an Italian restaurant in the city centre, near Rainbow Vegetarian Café. It is high price, not child friendly and has a 1 out of 5 customer rating."
"name[The Punter], eatType[restaurant], food[Italian], priceRange[high], customer rating[1 out of 5], area[city centre], familyFriendly[yes], near[Rainbow Vegetarian Café]"	"The Punter is a restaurant with a 1 out of 5 rating. It sells Italian food by the Rainbow Vegetarian Café in the city centre, you can bring your kids and get a high meal."
"name[The Punter], eatType[restaurant], food[Italian], priceRange[high], customer rating[1 out of 5], area[riverside], familyFriendly[no], near[Rainbow Vegetarian Café]"	"Located in riverside near Rainbow Vegetarian Café The Punter restaurant, in the high price range, they serve Italian food. They are not kid friendly they have 1 out of 5 customer rating."
"name[The Punter], eatType[restaurant], food[Italian], priceRange[high], customer rating[1 out of 5], area[riverside], familyFriendly[yes], near[Rainbow Vegetarian Café]"	"The Punter is a restaurant in the riverside area that has a 1 out of 5 customer rating. Although it has a higher price range, it is children friendly, serves Italian food and is near the Rainbow Vegetarian Café."
"name[The Vaults], eatType[pub], food[French], priceRange[high], area[riverside], familyFriendly[yes], near[Raja Indian Cuisine]"	"The Vaults is a kid friendly pub with French food. Located in the riverside area near Raja Indian Cuisine. The price range is high."
"name[The Vaults], eatType[pub], food[French], priceRange[less than £20], area[city centre], familyFriendly[no], near[Raja Indian Cuisine]"	"The Vaults is a pub that serves French food. Has a less than £20 price range, and is kids friendly. Located in the city centre area near Raja Indian Cuisine."
"name[The Vaults], eatType[pub], food[French], priceRange[less than £20], area[city centre], familyFriendly[yes], near[Raja Indian Cuisine]"	"Name The Vaults in the city centre area at a price range of less than £20 it is a family friendly pub near the Raja Indian Cuisine serving French food."
"name[The Vaults], eatType[pub], food[French], priceRange[less than £20], area[riverside], familyFriendly[no], near[Raja Indian Cuisine]"	"There is a pub, The Vaults, serving French food along the riverside near Raja Indian Cuisine. It is not kids friendly and is less than £20 priced."
"name[The Vaults], eatType[pub], food[French], priceRange[less than £20], area[riverside], familyFriendly[yes], near[Raja Indian Cuisine]"	"The Vaults is a pub serving French food on the riverside near Raja Indian Cuisine. It's children friendly and has a price range of less than £20."
"name[The Vaults], eatType[pub], food[French], priceRange[moderate], area[city centre], familyFriendly[no], near[Raja Indian Cuisine]"	"A pub that The Vaults eat at, with a moderate price range, serves French cuisine, but is not kid friendly and is located near Raja Indian Cuisine in the city centre area."
"name[The Vaults], eatType[pub], food[French], priceRange[moderate], area[city centre], familyFriendly[yes], near[Raja Indian Cuisine]"	"There is a moderate French pub named The Vaults that is family friendly in city centre by Raja Indian Cuisine."
"name[The Vaults], eatType[pub], food[French], priceRange[moderate], area[riverside], familyFriendly[no], near[Raja Indian Cuisine]"	"The Vaults is a moderately priced pub located in the riverside. It provides French food. It is not kids friendly and is located near Raja Indian Cuisine."
"name[The Vaults], eatType[pub], food[French], priceRange[moderate], area[riverside], familyFriendly[yes], near[Raja Indian Cuisine]"	"The Vaults is a child-friendly French pub in the moderate price range. It is located in the riverside, near Raja Indian Cuisine."
"name[The Vaults], eatType[pub], food[French], priceRange[more than £30], area[city centre], familyFriendly[no], near[Raja Indian Cuisine]"	"No kids in The Vaults, it is a French pub, on the city centre near the Raja Indian Cuisine, fairly more than £30 prices."
"name[The Vaults], eatType[pub], food[French], priceRange[more than £30], area[city centre], familyFriendly[yes], near[Raja Indian Cuisine]"	"The Vaults is a more than £30 priced kid friendly French pub in they city centre near Raja Indian Cuisine."
"name[The Vaults], eatType[pub], food[French], priceRange[more than £30], area[riverside], familyFriendly[no], near[Raja Indian Cuisine]"	"There is a pub, The Vaults, serving French food along the riverside near Raja Indian Cuisine. It is not kids friendly and is more than £30 priced."
"name[The Vaults], eatType[pub], food[French], priceRange[more than £30], area[riverside], familyFriendly[yes], near[Raja Indian Cuisine]"	"The Vaults is a more than £30 priced French pub in riverside near Raja Indian Cuisine. It is kid friendly."
"name[The Vaults], eatType[pub], food[Indian], priceRange[£20-25], area[riverside], familyFriendly[yes], near[Raja Indian Cuisine]"	"The Vaults is a pub located at riverside near Raja Indian Cuisine serves Indian food and a Family friendly place that a £20-£25 price range of food."
"name[The Vaults], eatType[pub], food[Indian], priceRange[cheap], area[riverside], familyFriendly[yes], near[Raja Indian Cuisine]"	"Near Raja Indian Cuisine around riverside there is a pub that is cheap price range, children friendly, serves Indian food called The Vaults."
"name[The Vaults], eatType[pub], food[Indian], priceRange[high], area[city centre], familyFriendly[no], near[Raja Indian Cuisine]"	"The Vaults is an Indian pub near Raja Indian Cuisine in the city centre. It is highly priced, and is not kids friendly."
"name[The Vaults], eatType[pub], food[Indian], priceRange[high], area[city centre], familyFriendly[yes], near[Raja Indian Cuisine]"	"The Vaults is a pub that serves Indian food. The price range is high but it is children-friendly. It is located near Raja Indian Cuisine in the city centre area."
"name[The Vaults], eatType[pub], food[Italian], priceRange[high], customer rating[average], area[city centre], familyFriendly[no], near[Rainbow Vegetarian Café]"	"The Vaults near Rainbow Vegetarian Café in the city centre centre. Is an Italian food and pub which children friendly and a customer rating of average standard. The price range high."
"name[The Vaults], eatType[pub], food[Italian], priceRange[high], customer rating[average], area[city centre], familyFriendly[yes], near[Rainbow Vegetarian Café]"	"The Vaults is a pub that provides Italian food with prices high. It has an average customer rating and is located on the city centre near Rainbow Vegetarian Café. It is family friendly."
"name[The Vaults], eatType[pub], food[Italian], priceRange[high], customer rating[average], area[riverside], familyFriendly[no], near[Rainbow Vegetarian Café]"	"The Vaults is an Italian restaurant with an average customer rating ad is not child friendly. It is located in riverside near Rainbow Vegetarian Café and a pub, the price range is high."
"name[The Vaults], eatType[pub], food[Italian], priceRange[high], customer rating[average], area[riverside], familyFriendly[yes], near[Rainbow Vegetarian Café]"	"The Vaults is a pub with an average rating. It sells Italian food by the Rainbow Vegetarian Café in the riverside, you can bring your kids and get a high meal."
"name[The Vaults], eatType[pub], food[Italian], priceRange[less than £20], customer rating[low], area[city centre], familyFriendly[no], near[Rainbow Vegetarian Café]"	"An Italian pub in city centre with a low customer rating, The Vaults, is located near Rainbow Vegetarian Café. The price range is less than £20 pounds and is not child friendly."
"name[The Vaults], eatType[pub], food[Italian], priceRange[less than £20], customer rating[low], area[city centre], familyFriendly[yes], near[Rainbow Vegetarian Café]"	"The Italian restaurant named The Vaults is a pub in the city centre, near Rainbow Vegetarian Café is a place for kids with price range from less than £20 with a customer rating of low."
"name[The Vaults], eatType[pub], food[Italian], priceRange[less than £20], customer rating[low], area[riverside], familyFriendly[no], near[Rainbow Vegetarian Café]"	"The Vaults pub is in the riverside near Rainbow Vegetarian Café. It serves Italian food of less than £20 prices. Not being child friendly customers rate it low."
"name[The Vaults], eatType[pub], food[Italian], priceRange[less than £20], customer rating[low], area[riverside], familyFriendly[yes], near[Rainbow Vegetarian Café]"	"The Vaults pub serves Italian food at a less than £20 price while providing excellence in customer service rating low, located in the riverside this family friendly pub is located right near Rainbow Vegetarian Café."
"name[The Vaults], eatType[pub], food[Italian], priceRange[moderate], customer rating[1 out of 5], area[city centre], familyFriendly[no], near[Rainbow Vegetarian Café]"	"The Vaults, is a pub located in the city centre near Rainbow Vegetarian Café; serving Italian in the moderate price range. Is not child-friendly venue and customer ratings are 1 out of 5."
"name[The Vaults], eatType[pub], food[Italian], priceRange[moderate], customer rating[1 out of 5], area[city centre], familyFriendly[yes], near[Rainbow Vegetarian Café]"	"The Vaults is a pub in the city centre area that has a 1 out of 5 customer rating. Although it has a moderateer price range, it is children friendly, serves Italian food and is near the Rainbow Vegetarian Café."
"name[The Vaults], eatType[pub], food[Italian], priceRange[moderate], customer rating[1 out of 5], area[riverside], familyFriendly[no], near[Rainbow Vegetarian Café]"	"The Vaults is a pub which serves moderate priced Italian food. It is located at the riverside near Rainbow Vegetarian Café but is customer rated 1 out of 5 and isn't kid friendly."
"name[The Vaults], eatType[pub], food[Italian], priceRange[moderate], customer rating[1 out of 5], area[riverside], familyFriendly[yes], near[Rainbow Vegetarian Café]"	"The Vaults is a family-friendly, Italian, pub located in the riverside near the Rainbow Vegetarian Café. However, it has a 1 out of 5 customer rating and the meals cost moderate pounds."
"name[The Vaults], eatType[pub], food[Italian], priceRange[moderate], customer rating[3 out of 5], area[city centre], familyFriendly[no], near[Rainbow Vegetarian Café]"	"If you're looking for a children-free pub, check out The Vaults. Located near the Rainbow Vegetarian Café at the city centre. The Vaults offers Italian ranging moderate. Rated 3 out of 5 by customers."
"name[The Vaults], eatType[pub], food[Italian], priceRange[moderate], customer rating[3 out of 5], area[city centre], familyFriendly[yes], near[Rainbow Vegetarian Café]"	"The Vaults is a kids friendly pub in city centre near Rainbow Vegetarian Café that serves Italian food for moderate. It has a 3 out of 5 customer rating."
"name[The Vaults], eatType[pub], food[Italian], priceRange[moderate], customer rating[3 out of 5], area[riverside], familyFriendly[no], near[Rainbow Vegetarian Café]"	"There is a pub called The Vaults providing Italian food located in the riverside near Rainbow Vegetarian Café with 3 out of 5 customer rating and it's price range is moderate, but it is not family friendly."
"name[The Vaults], eatType[pub], food[Italian], priceRange[moderate], customer rating[3 out of 5], area[riverside], familyFriendly[yes], near[Rainbow Vegetarian Café]"	"The Vaults is a pub, which also serves Italian cuisine at moderate prices. Customers have rated the food 3 out of 5. The Vaults is situated near the riverside and Rainbow Vegetarian Café. Children are welcome."
"name[The Vaults], eatType[pub], food[Italian], priceRange[more than £30], customer rating[high], area[city centre], familyFriendly[no], near[Rainbow Vegetarian Café]"	"The Vaults is a pub in the city centre near Rainbow Vegetarian Café serving Italian food at a more than £30 price. It has a customer rating of high and it is not kids-friendly."
"name[The Vaults], eatType[pub], food[Italian], priceRange[more than £30], customer rating[high], area[city centre], familyFriendly[yes], near[Rainbow Vegetarian Café]"	"The Vaults is a family-friendly pub that sells Italian food and has a customer rating of high with more than £30 pricing, It is located in the city centre near Rainbow Vegetarian Café."
"name[The Vaults], eatType[pub], food[Italian], priceRange[more than £30], customer rating[high], area[riverside], familyFriendly[no], near[Rainbow Vegetarian Café]"	"Near the Rainbow Vegetarian Café in the riverside there is a pub called The Vaults that serves Italian food for a more than £30 price range. It is not children friendly and has a high customer rating."
"name[The Vaults], eatType[pub], food[Italian], priceRange[more than £30], customer rating[high], area[riverside], familyFriendly[yes], near[Rainbow Vegetarian Café]"	"The Vaults is a more than £30 price range Italian pub in the riverside area near Rainbow Vegetarian Café. It is child friendly and has a customer rating of high."
"name[The Vaults], eatType[pub], food[Japanese], priceRange[£20-25], customer rating[3 out of 5], area[city centre], familyFriendly[no], near[Rainbow Vegetarian Café]"	"The Vaults is pub that serve Japanese food but is not children friendly and ranges £20-£25 but has a 3 out of 5 rating. It's located in city centre near Rainbow Vegetarian Café."
"name[The Vaults], eatType[pub], food[Japanese], priceRange[£20-25], customer rating[3 out of 5], area[city centre], familyFriendly[yes], near[Rainbow Vegetarian Café]"	"The Vaults, a family friendly pub located by the city centre near Rainbow Vegetarian Café serves Japanese food for £20-£25, it has been 3 out of 5-rated."
"name[The Vaults], eatType[pub], food[Japanese], priceRange[£20-25], customer rating[3 out of 5], area[riverside], familyFriendly[no], near[Rainbow Vegetarian Café]"	"The Vaults is a pub located in the riverside near Rainbow Vegetarian Café that provides Japanese food which has a 3 out of 5 customer rating and the price range is £20-£25. It is not family friendly."
"name[The Vaults], eatType[pub], food[Japanese], priceRange[£20-25], customer rating[3 out of 5], area[riverside], familyFriendly[yes], near[Rainbow Vegetarian Café]"	"The Vaults is located in the riverside area near Rainbow Vegetarian Café. The Vaults is a Japanese, family friendly pub with 3 out of 5 customer rating. Their prices are £20-£25."
"name[The Vaults], eatType[pub], food[Japanese], priceRange[£20-25], customer rating[high], area[city centre], familyFriendly[no], near[Rainbow Vegetarian Café]"	"The Vaults near Rainbow Vegetarian Café in the city centre as a pub with a £20-£25 price range is not children friendly. They provide Japanese food with a customer rating high."
"name[The Vaults], eatType[pub], food[Japanese], priceRange[£20-25], customer rating[high], area[city centre], familyFriendly[yes], near[Rainbow Vegetarian Café]"	"The Vaults is a pub serving Japanese food with a high customer rating with meals £20-£25 and is family friendly in city centre area near Rainbow Vegetarian Café."
"name[The Vaults], eatType[pub], food[Japanese], priceRange[£20-25], customer rating[high], area[riverside], familyFriendly[no], near[Rainbow Vegetarian Café]"	"The Vaults is a pub that serves Japanese food with a price range of £20-£25. It is highly rated by customers and located by the riverside near Rainbow Vegetarian Café. Kids are prohibited."
"name[The Vaults], eatType[pub], food[Japanese], priceRange[£20-25], customer rating[high], area[riverside], familyFriendly[no], near[Raja Indian Cuisine]"	"The Vaults near Raja Indian Cuisine is a Japanese pub in riverside. It has a high rating and is £20-£25. It is not child friendly."
"name[The Vaults], eatType[pub], food[Japanese], priceRange[£20-25], customer rating[high], area[riverside], familyFriendly[yes], near[Raja Indian Cuisine]"	"There is a Japanese pub called The Vaults that has a high customer rating but is child friendly and is £20-£25 dollars and is located in the riverside area near Raja Indian Cuisine."
"name[The Vaults], eatType[pub], food[Japanese], priceRange[cheap], customer rating[5 out of 5], area[city centre], familyFriendly[no], near[Raja Indian Cuisine]"	"A pub, The Vaults, serves Japanese food at a cheap price. It is rated 5 out of 5, and is not kid friendly but is located by the Raja Indian Cuisine by the city centre."
"name[The Vaults], eatType[pub], food[Japanese], priceRange[cheap], customer rating[5 out of 5], area[city centre], familyFriendly[yes], near[Raja Indian Cuisine]"	"The Vaults is a family-friendly Japanese pub in the city centre near Raja Indian Cuisine with a customer rating of 5 out of 5 and has a cheap price range."
"name[The Vaults], eatType[pub], food[Japanese], priceRange[cheap], customer rating[5 out of 5], area[riverside], familyFriendly[no], near[Raja Indian Cuisine]"	"The Vaults is an excellent, non family-friendly pub that also serves Japanese food. It is situated on the riverside, near Raja Indian Cuisine, and has quite cheap prices. It is a customer-favourite with a rating of 5 out of 5."
"name[The Vaults], eatType[pub], food[Japanese], priceRange[cheap], customer rating[5 out of 5], area[riverside], familyFriendly[yes], near[Raja Indian Cuisine]"	"The Japanese pub 'The Vaults', is located in the riverside near Raja Indian Cuisine. It has 5 out of 5 customer reviews with quite cheap prices. It is recommended for kids."
"name[The Vaults], eatType[pub], food[Japanese], priceRange[high], customer rating[3 out of 5], area[city centre], familyFriendly[no], near[Raja Indian Cuisine]"	"There is a high priced pub called The Vaults located in the city centre near Raja Indian Cuisine. It serves Japanese food, has a customer rating of 3 out of 5, and is not child friendly."
"name[The Vaults], eatType[pub], food[Japanese], priceRange[high], customer rating[3 out of 5], area[city centre], familyFriendly[yes], near[Raja Indian Cuisine]"	"Along the city centre, near to Raja Indian Cuisine, there is a family friendly pub, called The Vaults, which serves Japanese food costing high. It has a 3 out of 5 customer rating."
"name[The Vaults], eatType[pub], food[Japanese], priceRange[high], customer rating[3 out of 5], area[riverside], familyFriendly[no], near[Raja Indian Cuisine]"	"The Vaults is a pub serving Japanese food in the high price range with a customer rating of 3 out of 5 in the riverside area near Raja Indian Cuisine is not kid friendly."
"name[The Vaults], eatType[pub], food[Japanese], priceRange[high], customer rating[3 out of 5], area[riverside], familyFriendly[yes], near[Raja Indian Cuisine]"	"The Vaults is a Japanese pub with is kids friendly, and is in high price range located near Raja Indian Cuisine in the riverside. However, it has a customer rating of only 3 out of 5."
"name[The Vaults], eatType[pub], food[Japanese], priceRange[less than £20], customer rating[average], area[city centre], familyFriendly[no], near[Raja Indian Cuisine]"	"The Vaults is an excellent, non family-friendly pub that also serves Japanese food. It is situated on the city centre, near Raja Indian Cuisine, and has quite less than £20 prices. It is a customer-favourite with a rating of average."
"name[The Vaults], eatType[pub], food[Japanese], priceRange[less than £20], customer rating[average], area[city centre], familyFriendly[yes], near[Raja Indian Cuisine]"	"On the city centre near Raja Indian Cuisine is The Vaults. A pub that serves Japanese within a less than £20 price range. It is kid friendly and has a customer rating of average."
"name[The Vaults], eatType[pub], food[Japanese], priceRange[less than £20], customer rating[average], area[riverside], familyFriendly[no], near[Raja Indian Cuisine]"	"Costing less than £20 and located in riverside near Raja Indian Cuisine , The Vaults is a Japanese pub. It is not kid friendly and has an average customer rating."
"name[The Vaults], eatType[pub], food[Japanese], priceRange[less than £20], customer rating[average], area[riverside], familyFriendly[yes], near[Raja Indian Cuisine]"	"The Vaults pub near Raja Indian Cuisine by the riverside serving Japanese food is child friendly. Price range less than £20, rated average by customers."
"name[The Vaults], eatType[pub], food[Japanese], priceRange[less than £20], customer rating[low], area[city centre], familyFriendly[no], near[Raja Indian Cuisine]"	"The Vaults, situated near Raja Indian Cuisine in the city centre, is a Japanese food selling pub, with a low customer rating due to the price range of less than £20, not child friendly."
"name[The Vaults], eatType[pub], food[Japanese], priceRange[less than £20], customer rating[low], area[city centre], familyFriendly[yes], near[Raja Indian Cuisine]"	"Yes it loves to have children. Serving Japanese food, called The Vaults, although has a low customer review, situated close to Raja Indian Cuisine near the city centre is a pub but quite expensive at less than £20."
"name[The Vaults], eatType[pub], food[Japanese], priceRange[less than £20], customer rating[low], area[riverside], familyFriendly[no], near[Raja Indian Cuisine]"	"The Vaults near Raja Indian Cuisine in the riverside as a pub with a less than £20 price range is not children friendly. They provide Japanese food with a customer rating low."
"name[The Vaults], eatType[pub], food[Japanese], priceRange[less than £20], customer rating[low], area[riverside], familyFriendly[yes], near[Raja Indian Cuisine]"	"The Vaults, a family-friendly Japanese pub in the riverside near Raja Indian Cuisine, is less than £20 priced and but has a lower customer service rating of low."
"name[The Vaults], eatType[pub], food[Japanese], priceRange[moderate], customer rating[1 out of 5], area[city centre], familyFriendly[no], near[Raja Indian Cuisine]"	"In the city centre, near Raja Indian Cuisine, you will find The Vaults. It is a non children-friendly pub that serves Japanese food. While its price range is quite 1 out of 5, moderate, it has a 1 out of 5 customer ratings."
"name[The Vaults], eatType[pub], food[Japanese], priceRange[moderate], customer rating[1 out of 5], area[city centre], familyFriendly[yes], near[Raja Indian Cuisine]"	"The Vaults pub serves Japanese food at a moderate price while providing excellence in customer service rating 1 out of 5, located in the city centre this family friendly pub is located right near Raja Indian Cuisine."
"name[The Vaults], eatType[restaurant], food[French], priceRange[high], area[riverside], familyFriendly[yes], near[Raja Indian Cuisine]"	"The Vaults is a highly priced restaurant. It is kids friendly and serves French food, it is located in the riverside near Raja Indian Cuisine."
"name[The Vaults], eatType[restaurant], food[French], priceRange[less than £20], area[city centre], familyFriendly[no], near[Raja Indian Cuisine]"	"The the city centre area, near Raja Indian Cuisine, there is a French restaurant in the less than £20 price range called The Vaults. It is not kids friendly."
"name[The Vaults], eatType[restaurant], food[French], priceRange[less than £20], area[city centre], familyFriendly[yes], near[Raja Indian Cuisine]"	"The Vaults restaurant is family-friendly French food shop in city centre near Raja Indian Cuisine with a price range less than £20."
"name[The Vaults], eatType[restaurant], food[French], priceRange[less than £20], area[riverside], familyFriendly[no], near[Raja Indian Cuisine]"	"The Vaults restaurant serves French food and is near the riverside and the Raja Indian Cuisine. It is not family-friendly and is priced in the less than £20 pound range."
"name[The Vaults], eatType[restaurant], food[French], priceRange[less than £20], area[riverside], familyFriendly[yes], near[Raja Indian Cuisine]"	"The Vaults is a nicely made French restaurant that is kids friendly and located near Raja Indian Cuisine in the riverside area. The price range is less than £20."
"name[The Vaults], eatType[restaurant], food[French], priceRange[moderate], area[city centre], familyFriendly[no], near[Raja Indian Cuisine]"	"There's a restaurant that The Vaults go to, with a moderate price range, serving French food. This restaurant is not kid friendly and is located near Raja Indian Cuisine in the city centre area."
"name[The Vaults], eatType[restaurant], food[French], priceRange[moderate], area[city centre], familyFriendly[yes], near[Raja Indian Cuisine]"	"The Vaults is near Raja Indian Cuisine in the city centre area. It is family-friendly and has a price range of moderate. It serves French food and is a restaurant."
"name[The Vaults], eatType[restaurant], food[French], priceRange[moderate], area[riverside], familyFriendly[no], near[Raja Indian Cuisine]"	"The Vaults is a restaurant. There price range is moderate. They serve French. They are not kids friendly. Located near the Raja Indian Cuisine, in the riverside area."
"name[The Vaults], eatType[restaurant], food[French], priceRange[moderate], area[riverside], familyFriendly[yes], near[Raja Indian Cuisine]"	"A children friendly restaurant near Raja Indian Cuisine named The Vaults is located in riverside and is French food for moderate."
"name[The Vaults], eatType[restaurant], food[French], priceRange[more than £30], area[city centre], familyFriendly[no], near[Raja Indian Cuisine]"	"The Vaults is providing French food in the price range. They are located in the city centre near Raja Indian Cuisine and do not allow children. It is in the more than £30 price range, and a restaurant."
"name[The Vaults], eatType[restaurant], food[French], priceRange[more than £30], area[city centre], familyFriendly[yes], near[Raja Indian Cuisine]"	"The Vaults is a more than £30 priced restaurant providing French food. It's in the city centre near to Raja Indian Cuisine and is kid friendly."
"name[The Vaults], eatType[restaurant], food[French], priceRange[more than £30], area[riverside], familyFriendly[no], near[Raja Indian Cuisine]"	"The Vaults is a non kids friendly restaurant, that has more than £30 price ranged French food. It is located near Raja Indian Cuisine in the riverside."
"name[The Vaults], eatType[restaurant], food[French], priceRange[more than £30], area[riverside], familyFriendly[yes], near[Raja Indian Cuisine]"	"The Vaults is a restaurant located at riverside near Raja Indian Cuisine serves French food and a Family friendly place that a more than £30 price range of food."
"name[The Vaults], eatType[restaurant], food[Indian], priceRange[£20-25], area[riverside], familyFriendly[yes], near[Raja Indian Cuisine]"	"The Vaults is a family-friendly restaurant in the riverside near Raja Indian Cuisine. It serves Indian food and is in the price range of £20-£25."
"name[The Vaults], eatType[restaurant], food[Indian], priceRange[cheap], area[riverside], familyFriendly[yes], near[Raja Indian Cuisine]"	"In the riverside area near Raja Indian Cuisine there is a kid friendly cheaply priced restaurant named The Vaults serving Indian food."
"name[The Vaults], eatType[restaurant], food[Indian], priceRange[high], area[city centre], familyFriendly[no], near[Raja Indian Cuisine]"	"Indian food at The Vaults restaurant features a price range of high. Located in the city centre area near Raja Indian Cuisine. We are not children friendly."
"name[The Vaults], eatType[restaurant], food[Indian], priceRange[high], area[city centre], familyFriendly[yes], near[Raja Indian Cuisine]"	"City centre has a high Indian restaurant near Raja Indian Cuisine named The Vaults. It's family-friendly."
"name[The Waterman], eatType[pub], food[Indian], priceRange[high], area[city centre], familyFriendly[yes], near[Raja Indian Cuisine]"	"Located in the city centre, neighboring Raja Indian Cuisine, is a pub styled joint called The Waterman. This establishment is known for its family friendly atmosphere and highly priced Indian food."
"name[The Waterman], eatType[pub], food[Indian], priceRange[high], area[riverside], familyFriendly[no], near[Raja Indian Cuisine]"	"The Waterman is a highly priced Indian pub. It is near Raja Indian Cuisine, is not kids friendly, and is in the riverside."
"name[The Waterman], eatType[pub], food[Indian], priceRange[high], area[riverside], familyFriendly[yes], near[Raja Indian Cuisine]"	"A children friendly Indian restaurant named The Waterman near Raja Indian Cuisine at riverside is a pub for high."
"name[The Waterman], eatType[pub], food[Indian], priceRange[less than £20], area[city centre], familyFriendly[no], near[Raja Indian Cuisine]"	"The Waterman near the Raja Indian Cuisine on the city centre is an Indian pub. No families. Its prices are within the less than £20 range."
"name[The Waterman], eatType[pub], food[Indian], priceRange[less than £20], area[city centre], familyFriendly[yes], near[Raja Indian Cuisine]"	"The Waterman pub is located in the city centre area near the Raja Indian Cuisine. It serves Indian food with a less than £20 price range and is kids-Friendly."
"name[The Waterman], eatType[pub], food[Indian], priceRange[less than £20], area[riverside], familyFriendly[no], near[Raja Indian Cuisine]"	"The Waterman pub is not family-friendly, sells Indian food, and has a price range of less than £20. It is located in the riverside area near Raja Indian Cuisine."
"name[The Waterman], eatType[pub], food[Indian], priceRange[less than £20], area[riverside], familyFriendly[yes], near[Raja Indian Cuisine]"	"In riverside, is a family friendly, less than £20 priced, Indian pub named The Waterman. The Waterman is near Raja Indian Cuisine."
"name[The Waterman], eatType[pub], food[Indian], priceRange[moderate], area[city centre], familyFriendly[no], near[Raja Indian Cuisine]"	"In the area of city centre near Raja Indian Cuisine is The Waterman, it is a pub. It is not kid friendly and the Indian is moderately expensive."
"name[The Waterman], eatType[pub], food[Indian], priceRange[moderate], area[city centre], familyFriendly[yes], near[Raja Indian Cuisine]"	"On the city centre near Raja Indian Cuisine is a moderate Indian establishment with a pub called The Waterman and yes it is family friendly."
"name[The Waterman], eatType[pub], food[Indian], priceRange[moderate], area[riverside], familyFriendly[no], near[Raja Indian Cuisine]"	"A moderate priced pub that serves Indian is The Waterman , but has a non-children friendly atmosphere. It is located in the riverside near Raja Indian Cuisine."
"name[The Waterman], eatType[pub], food[Indian], priceRange[moderate], area[riverside], familyFriendly[yes], near[Raja Indian Cuisine]"	"The Waterman, located in the riverside area near Raja Indian Cuisine, is a kid-friendly pub serving Indian food. Prices are in the moderate range."
"name[The Waterman], eatType[pub], food[Indian], priceRange[more than £30], area[riverside], familyFriendly[yes], near[Raja Indian Cuisine]"	"The Waterman is an Indian pub in riverside near Raja Indian Cuisine. They offer more than £30 prices and a kid friendly atmosphere."
"name[The Waterman], eatType[pub], food[Italian], priceRange[£20-25], area[riverside], familyFriendly[yes], near[Raja Indian Cuisine]"	"A pub named The Waterman is located near Raja Indian Cuisine in riverside offering £20-£25 priced Italian. It is kid friendly."
"name[The Waterman], eatType[pub], food[Italian], priceRange[cheap], area[riverside], familyFriendly[yes], near[Raja Indian Cuisine]"	"Family friendly Italian pub, The Waterman, is located riverside near Raja Indian Cuisine with a price range cheap."
"name[The Waterman], eatType[pub], food[Italian], priceRange[high], area[city centre], familyFriendly[no], near[Raja Indian Cuisine]"	"The Waterman pub has Italian food and is friendly. It is in the city centre area near Raja Indian Cuisine with a high price range."
"name[The Waterman], eatType[pub], food[Italian], priceRange[high], area[city centre], familyFriendly[yes], near[Raja Indian Cuisine]"	"The Waterman pub is along the city centre near Raja Indian Cuisine that offers Italian food on a price range of high and is also family friendly."
"name[The Waterman], eatType[pub], food[Italian], priceRange[high], area[riverside], familyFriendly[no], near[Raja Indian Cuisine]"	"Located on the riverside, close to Raja Indian Cuisine, you will find the pub The Waterman, serving a traditional Italian menu which is highly priced and not considered child friendly."
"name[The Waterman], eatType[pub], food[Italian], priceRange[high], area[riverside], familyFriendly[yes], near[Raja Indian Cuisine]"	"Situated in the riverside area, near Raja Indian Cuisine, you'll find a child-friendly pub with Italian food on the menu called The Waterman. The prices tend to be high."
"name[The Waterman], eatType[pub], food[Italian], priceRange[less than £20], area[city centre], familyFriendly[no], near[Raja Indian Cuisine]"	"The Waterman is a less than £20 priced pub in the city centre, near Raja Indian Cuisine. It serves Italian food and does not welcome children."
"name[The Waterman], eatType[pub], food[Italian], priceRange[less than £20], area[city centre], familyFriendly[yes], near[Raja Indian Cuisine]"	"The Waterman is the name of a family-friendly pub on the city centre near Raja Indian Cuisine. It serves Italian food for less than £20 prices."
"name[The Waterman], eatType[pub], food[Italian], priceRange[less than £20], area[riverside], familyFriendly[no], near[Raja Indian Cuisine]"	"The Waterman pub serves Italian food and is near the riverside and the Raja Indian Cuisine. It is not family-friendly and is priced in the less than £20 pound range."
"name[The Waterman], eatType[restaurant], food[Indian], priceRange[high], area[city centre], familyFriendly[yes], near[Raja Indian Cuisine]"	"There is an Indian, family friendly restaurant in city centre near Raja Indian Cuisine called The Waterman and is highly priced."
"name[The Waterman], eatType[restaurant], food[Indian], priceRange[high], area[riverside], familyFriendly[no], near[Raja Indian Cuisine]"	"In the high price range and serving Indian food, the non-family friendly restaurant, The Waterman is in riverside near Raja Indian Cuisine."
"name[The Waterman], eatType[restaurant], food[Indian], priceRange[high], area[riverside], familyFriendly[yes], near[Raja Indian Cuisine]"	"The Waterman is a restaurant that serves Indian food located in the riverside area near Raja Indian Cuisine. It is kid friendly with a price range of high."
"name[The Waterman], eatType[restaurant], food[Indian], priceRange[less than £20], area[city centre], familyFriendly[no], near[Raja Indian Cuisine]"	"The Waterman is a family-friendly Indian and restaurant near Raja Indian Cuisine in the city centre where you can eat for less than £20."
"name[The Waterman], eatType[restaurant], food[Indian], priceRange[less than £20], area[city centre], familyFriendly[yes], near[Raja Indian Cuisine]"	"In the city centre near Raja Indian Cuisine is The Waterman. It is a kids friendly restaurant serving less than £20 priced Indian food."
"name[The Waterman], eatType[restaurant], food[Indian], priceRange[less than £20], area[riverside], familyFriendly[no], near[Raja Indian Cuisine]"	"The Waterman restaurant near Raja Indian Cuisine in the riverside sells Indian food and is less than £20 priced no kids allowed."
"name[The Waterman], eatType[restaurant], food[Indian], priceRange[less than £20], area[riverside], familyFriendly[yes], near[Raja Indian Cuisine]"	"There is a children friendly restaurant The Waterman near Raja Indian Cuisine located in the riverside. It serves Indian food for less than £20."
"name[The Waterman], eatType[restaurant], food[Indian], priceRange[moderate], area[city centre], familyFriendly[no], near[Raja Indian Cuisine]"	"The Waterman is a restaurant that offer Indian food also, moderate average and located by the city centre near Raja Indian Cuisine. Kids not welcome."
"name[The Waterman], eatType[restaurant], food[Indian], priceRange[moderate], area[city centre], familyFriendly[yes], near[Raja Indian Cuisine]"	"The Waterman is a child friendly restaurant which serves moderately priced Indian food. It is near Raja Indian Cuisine in the city centre area."
"name[The Waterman], eatType[restaurant], food[Indian], priceRange[moderate], area[riverside], familyFriendly[no], near[Raja Indian Cuisine]"	"The Waterman has a moderate price range. The restaurant is located in the riverside area and is not friendly for kids. It is located near Raja Indian Cuisine. It provides Indian food."
"name[The Waterman], eatType[restaurant], food[Indian], priceRange[moderate], area[riverside], familyFriendly[yes], near[Raja Indian Cuisine]"	"The Waterman is a moderately priced restaurant providing Indian food. It's in the riverside near to Raja Indian Cuisine and is kid friendly."
"name[The Waterman], eatType[restaurant], food[Indian], priceRange[more than £30], area[riverside], familyFriendly[yes], near[Raja Indian Cuisine]"	"A more than £30 priced Indian restaurant and restaurant that is children friendly is called The Waterman. It is in the riverside near Raja Indian Cuisine."
"name[The Waterman], eatType[restaurant], food[Italian], priceRange[£20-25], area[riverside], familyFriendly[yes], near[Raja Indian Cuisine]"	"The Waterman, near Raja Indian Cuisine in riverside, is a children Friendly restaurant that sells Italian food. IT is a £20-£25 price range."
"name[The Waterman], eatType[restaurant], food[Italian], priceRange[cheap], area[riverside], familyFriendly[yes], near[Raja Indian Cuisine]"	"The Waterman is a cheap Italian restaurant located riverside by Raja Indian Cuisine. It is a family friendly establishment."
"name[The Waterman], eatType[restaurant], food[Italian], priceRange[high], area[city centre], familyFriendly[no], near[Raja Indian Cuisine]"	"For high, Italian restaurant The Waterman can be found in city centre near Raja Indian Cuisine. No families."
"name[The Waterman], eatType[restaurant], food[Italian], priceRange[high], area[city centre], familyFriendly[yes], near[Raja Indian Cuisine]"	"Near Raja Indian Cuisine is a city centre restaurant serving Italian food called The Waterman. The prices are high and it is kid friendly."
"name[The Waterman], eatType[restaurant], food[Italian], priceRange[high], area[riverside], familyFriendly[no], near[Raja Indian Cuisine]"	"The Waterman restaurant is not family-friendly, sells Italian food, and has a price range of high. It is located in the riverside area near Raja Indian Cuisine."
"name[The Waterman], eatType[restaurant], food[Italian], priceRange[high], area[riverside], familyFriendly[yes], near[Raja Indian Cuisine]"	"The Waterman restaurant is family-friendly Italian food in riverside near Raja Indian Cuisine with a price range high."
"name[The Waterman], eatType[restaurant], food[Italian], priceRange[less than £20], area[city centre], familyFriendly[no], near[Raja Indian Cuisine]"	"The Waterman is a restaurant. It is not family-friendly. They are Italian and have less than £20 pricing. Its located by the city centre near Raja Indian Cuisine."
"name[The Waterman], eatType[restaurant], food[Italian], priceRange[less than £20], area[city centre], familyFriendly[yes], near[Raja Indian Cuisine]"	"With a less than £20 price range along the city centre, the restaurant 'The Waterman' is family friendly and serves Italian Raja Indian Cuisine."
"name[The Waterman], eatType[restaurant], food[Italian], priceRange[less than £20], area[riverside], familyFriendly[no], near[Raja Indian Cuisine]"	"For Italian food at less than £20 prices that isn't children-friendly go to The Waterman that is a riverside restaurant It is near Raja Indian Cuisine."
"name[The Wrestlers], eatType[pub], food[Italian], priceRange[less than £20], area[riverside], familyFriendly[no], near[Raja Indian Cuisine]"	"The Wrestlers is a pub in riverside near the Raja Indian Cuisine. It's average price range is less than £20. It serves Italian food. It is also family-friendly."
"name[The Wrestlers], eatType[pub], food[Italian], priceRange[less than £20], area[riverside], familyFriendly[yes], near[Raja Indian Cuisine]"	"There is a children friendly Italian pub called The Wrestlers which is located near Raja Indian Cuisine in riverside. The price range is less than £20."
"name[The Wrestlers], eatType[pub], food[Italian], priceRange[moderate], area[city centre], familyFriendly[no], near[Raja Indian Cuisine]"	"There is a city centre pub named The Wrestlers right next to Raja Indian Cuisine. It is not family-friendly. They have a price range of moderate for Italian food."
"name[The Wrestlers], eatType[pub], food[Italian], priceRange[moderate], area[city centre], familyFriendly[yes], near[Raja Indian Cuisine]"	"The Wrestlers pub is along the city centre near Raja Indian Cuisine that offers Italian food on a price range of moderate and is also family friendly."
"name[The Wrestlers], eatType[pub], food[Italian], priceRange[moderate], area[riverside], familyFriendly[no], near[Raja Indian Cuisine]"	"The Wrestlers is a moderately priced Italian pub in the riverside area, near Raja Indian Cuisine. This restaurant is not kid friendly."
"name[The Wrestlers], eatType[pub], food[Italian], priceRange[moderate], area[riverside], familyFriendly[yes], near[Raja Indian Cuisine]"	"The Wrestlers is a moderate priced pub serving Italian cuisine situated on the riverside near Raja Indian Cuisine which is child friendly."
"name[The Wrestlers], eatType[pub], food[Italian], priceRange[more than £30], area[riverside], familyFriendly[yes], near[Raja Indian Cuisine]"	"The Wrestlers is an Italian pub in riverside near Raja Indian Cuisine. They offer more than £30 prices and a kid friendly atmosphere."
"name[The Wrestlers], eatType[pub], food[Japanese], priceRange[£20-25], area[riverside], familyFriendly[yes], near[Raja Indian Cuisine]"	"The Wrestlers is a £20-£25 priced pub providing Japanese food. It's in the riverside near to Raja Indian Cuisine and is kid friendly."
"name[The Wrestlers], eatType[pub], food[Japanese], priceRange[cheap], area[riverside], familyFriendly[yes], near[Raja Indian Cuisine]"	"Kids are welcome at The Wrestlers pub, serving cheaply priced Japanese food in the riverside, near the Raja Indian Cuisine."
"name[The Wrestlers], eatType[pub], food[Japanese], priceRange[high], area[riverside], familyFriendly[yes], near[Raja Indian Cuisine]"	"A pub named The Wrestlers is located near Raja Indian Cuisine in riverside offering highly priced Japanese. It is kid friendly."
"name[The Wrestlers], eatType[pub], food[Japanese], priceRange[less than £20], area[city centre], familyFriendly[no], near[Raja Indian Cuisine]"	"The Wrestlers is a pub providing Japanese food in the less than £20 price range. It is located in the city centre area near Raja Indian Cuisine adults only."
"name[The Wrestlers], eatType[pub], food[Japanese], priceRange[less than £20], area[city centre], familyFriendly[yes], near[Raja Indian Cuisine]"	"The Wrestlers is a pub in city centre located near the Raja Indian Cuisine, where they serve Japanese food, it's average price for a meal is less than £20 euros and it's a children friendly facility."
"name[The Wrestlers], eatType[pub], food[Japanese], priceRange[less than £20], area[riverside], familyFriendly[no], near[Raja Indian Cuisine]"	"Located in the riverside is The Wrestlers. It also has a pub in it. It sells Japanese and is not a kid-friendly place. Price ranges from less than £20. Located near Raja Indian Cuisine."
"name[The Wrestlers], eatType[pub], food[Japanese], priceRange[less than £20], area[riverside], familyFriendly[yes], near[Raja Indian Cuisine]"	"With a less than £20 price range along the riverside, the pub named The Wrestlers is family friendly and serves Japanese Raja Indian Cuisine."
"name[The Wrestlers], eatType[pub], food[Japanese], priceRange[moderate], area[city centre], familyFriendly[no], near[Raja Indian Cuisine]"	"The Wrestlers is located near Raja Indian Cuisine. It is not family-friendly. There is a pub that also serves Japanese food in the city centre area. Price range is moderate."
"name[The Wrestlers], eatType[pub], food[Japanese], priceRange[moderate], area[city centre], familyFriendly[yes], near[Raja Indian Cuisine]"	"A Japanese restaurant called The Wrestlers is a pub in the area of city centre located near Raja Indian Cuisine. It is a children friendly place with a high price range of moderate."
"name[The Wrestlers], eatType[pub], food[Japanese], priceRange[moderate], area[riverside], familyFriendly[no], near[Raja Indian Cuisine]"	"The Wrestlers pub serves Japanese food and is near the riverside and the Raja Indian Cuisine. It is not family-friendly and is priced in the moderate pound range."
"name[The Wrestlers], eatType[pub], food[Japanese], priceRange[moderate], area[riverside], familyFriendly[yes], near[Raja Indian Cuisine]"	"The Wrestlers is pub serving Japanese food with price range moderate. It is children friendly and is located near Raja Indian Cuisine in the riverside."
"name[The Wrestlers], eatType[pub], food[Japanese], priceRange[moderate], customer rating[1 out of 5], area[city centre], familyFriendly[yes], near[Raja Indian Cuisine]"	"The Wrestlers pub serves Japanese food for moderate in the city centre near Raja Indian Cuisine. It is children friendly but has a 1 out of 5 customer rating."
"name[The Wrestlers], eatType[pub], food[Japanese], priceRange[moderate], customer rating[1 out of 5], area[riverside], familyFriendly[no], near[Raja Indian Cuisine]"	"In the riverside, near Raja Indian Cuisine, you will find The Wrestlers. It is a non children-friendly pub that serves Japanese food. While its price range is quite 1 out of 5, moderate, it has a 1 out of 5 customer ratings."
"name[The Wrestlers], eatType[pub], food[Japanese], priceRange[moderate], customer rating[1 out of 5], area[riverside], familyFriendly[yes], near[Raja Indian Cuisine]"	"Conveniently located in riverside near Raja Indian Cuisine there is a moderately priced pub serving Japanese food with a rating of 1 out of 5 called The Wrestlers. Children are permitted."
"name[The Wrestlers], eatType[pub], food[Japanese], priceRange[more than £30], area[city centre], familyFriendly[no], near[Raja Indian Cuisine]"	"The Wrestlers is a non family-friendly pub that serves Japanese food for more than £30. It is located near Raja Indian Cuisine in the city centre area."
"name[The Wrestlers], eatType[pub], food[Japanese], priceRange[more than £30], area[city centre], familyFriendly[yes], near[Raja Indian Cuisine]"	"The Wrestlers is a children-friendly pub that serves Japanese food and is found in the city centre area near Raja Indian Cuisine. The price range is more than £30."
"name[The Wrestlers], eatType[pub], food[Japanese], priceRange[more than £30], area[riverside], familyFriendly[no], near[Raja Indian Cuisine]"	"The Wrestlers is a pub with Japanese food. It is not children friendly. Located near the Raja Indian Cuisine, its price range is more than £30, though located riverside."
"name[The Wrestlers], eatType[pub], food[Japanese], priceRange[more than £30], area[riverside], familyFriendly[yes], near[Raja Indian Cuisine]"	"The Wrestlers, a pub with Japanese, near Raja Indian Cuisine, on the riverside is family friendly and more than £30 euros."
"name[The Wrestlers], eatType[pub], food[Japanese], priceRange[more than £30], customer rating[5 out of 5], area[city centre], familyFriendly[no], near[Raja Indian Cuisine]"	"A more than £30 priced pub, The Wrestlers serves Japanese cuisine in an adult only establishment. Rated 5 out of 5, it is located in the city centre area near Raja Indian Cuisine."
"name[The Wrestlers], eatType[pub], food[Japanese], priceRange[more than £30], customer rating[5 out of 5], area[city centre], familyFriendly[yes], near[Raja Indian Cuisine]"	"Looking for a pub serving Japanese food in the more than £30 price range with 5 out of 5 customer ratings in the city centre area near Raja Indian Cuisine and is family friendly, then visit The Wrestlers."
"name[The Wrestlers], eatType[pub], food[Japanese], priceRange[more than £30], customer rating[5 out of 5], area[riverside], familyFriendly[no], near[Raja Indian Cuisine]"	"Located in the riverside, near Raja Indian Cuisine, The Wrestlers is a non children-friendly pub which serves Japanese food. It has a price range of more than £30 and 5 out of 5 customer ratings."
"name[The Wrestlers], eatType[pub], food[Japanese], priceRange[more than £30], customer rating[5 out of 5], area[riverside], familyFriendly[yes], near[Raja Indian Cuisine]"	"The Wrestlers is a kid friendly Japanese pub in the riverside near Raja Indian Cuisine with a customer rating of 5 out of 5 and has a more than £30 price range."
"name[The Wrestlers], eatType[pub], food[Japanese], priceRange[more than £30], customer rating[low], area[city centre], familyFriendly[no], near[Raja Indian Cuisine]"	"The Wrestlers is a more than £30 priced pub in the city centre area near Raja Indian Cuisine. It serves Japanese food and is not child friendly but has a customer rating of low."
"name[The Wrestlers], eatType[pub], food[Japanese], priceRange[more than £30], customer rating[low], area[city centre], familyFriendly[yes], near[Raja Indian Cuisine]"	"The Wrestlers is a family friendly pub serving Japanese food with a more than £30 price range with a customer rating of 5 out lowts. It is located on the city centre near Raja Indian Cuisine."
"name[The Wrestlers], eatType[pub], food[Japanese], priceRange[more than £30], customer rating[low], area[riverside], familyFriendly[no], near[Raja Indian Cuisine]"	"The Wrestlers, a pub, sells Japanese food with a more than £30 price range and a low rating. It is location in the riverside near Raja Indian Cuisine and isn't child friendly."
"name[The Wrestlers], eatType[pub], food[Japanese], priceRange[more than £30], customer rating[low], area[riverside], familyFriendly[yes], near[Raja Indian Cuisine]"	"The Wrestlers Japanese pub near Raja Indian Cuisine in the riverside welcomes children but is costly at more than £30 and has a low customer review."
"name[The Wrestlers], eatType[restaurant], food[Italian], priceRange[less than £20], area[riverside], familyFriendly[no], near[Raja Indian Cuisine]"	"There's a restaurant that The Wrestlers go to, with a less than £20 price range, serving Italian food. This restaurant is not kid friendly and is located near Raja Indian Cuisine in the riverside area."
"name[The Wrestlers], eatType[restaurant], food[Italian], priceRange[less than £20], area[riverside], familyFriendly[yes], near[Raja Indian Cuisine]"	"There is an Italian, restaurant located near Raja Indian Cuisine in riverside called The Wrestlers. The restaurant is in the less than £20 price range and is children friendly."
"name[The Wrestlers], eatType[restaurant], food[Italian], priceRange[moderate], area[city centre], familyFriendly[no], near[Raja Indian Cuisine]"	"The Wrestlers is a non family-friendly restaurant in the city centre. It is located near to Raja Indian Cuisine and serves Italian for moderate."
"name[The Wrestlers], eatType[restaurant], food[Italian], priceRange[moderate], area[city centre], familyFriendly[yes], near[Raja Indian Cuisine]"	"The Wrestlers is children friendly and serves Italian food. It is near Raja Indian Cuisine in the city centre. It's a restaurant with a moderate price range."
"name[The Wrestlers], eatType[restaurant], food[Italian], priceRange[moderate], area[riverside], familyFriendly[no], near[Raja Indian Cuisine]"	"The Wrestlers Italian restaurant near Raja Indian Cuisine in the riverside has a price range of moderate and is not family-friendly."
"name[The Wrestlers], eatType[restaurant], food[Italian], priceRange[moderate], area[riverside], familyFriendly[yes], near[Raja Indian Cuisine]"	"The Wrestlers is a restaurant with moderate price featuring Italian food and is Kid Friendly and is located near Raja Indian Cuisine in the riverside."
"name[The Wrestlers], eatType[restaurant], food[Italian], priceRange[more than £30], area[riverside], familyFriendly[yes], near[Raja Indian Cuisine]"	"The Wrestlers restaurant in the riverside area serves coffee and Italian food. It is kid friendly and more than £30 priced. Located near Raja Indian Cuisine."
"name[The Wrestlers], eatType[restaurant], food[Japanese], priceRange[£20-25], area[riverside], familyFriendly[yes], near[Raja Indian Cuisine]"	"The Wrestlers located near Raja Indian Cuisine in riverside is a £20-£25 prices but child friendly Japanese restaurant."
"name[The Wrestlers], eatType[restaurant], food[Japanese], priceRange[cheap], area[riverside], familyFriendly[yes], near[Raja Indian Cuisine]"	"The Wrestlers is a kids friendly restaurant they serves Japanese food. It has a cheap price range and is in the riverside near Raja Indian Cuisine."
"name[The Wrestlers], eatType[restaurant], food[Japanese], priceRange[high], area[riverside], familyFriendly[yes], near[Raja Indian Cuisine]"	"Located near Raja Indian Cuisine in the riverside area is an eat type restaurant called the The Wrestlers is a children friendly that serves Japanese food and has a price range high euros."
"name[The Wrestlers], eatType[restaurant], food[Japanese], priceRange[less than £20], area[city centre], familyFriendly[no], near[Raja Indian Cuisine]"	"By the city centre, near Raja Indian Cuisine, there is a Japanese restaurant named The Wrestlers. It is not kid-friendly, and is in the less than £20 price range."
"name[The Wrestlers], eatType[restaurant], food[Japanese], priceRange[less than £20], area[city centre], familyFriendly[yes], near[Raja Indian Cuisine]"	"Near Raja Indian Cuisine around city centre there is a restaurant that is less than £20 price range, children friendly, serves Japanese food called The Wrestlers."
"name[The Wrestlers], eatType[restaurant], food[Japanese], priceRange[less than £20], area[riverside], familyFriendly[no], near[Raja Indian Cuisine]"	"The Wrestlers is a family-friendly Japanese and restaurant near Raja Indian Cuisine in the riverside where you can eat for less than £20."
"name[The Wrestlers], eatType[restaurant], food[Japanese], priceRange[less than £20], area[riverside], familyFriendly[yes], near[Raja Indian Cuisine]"	"Near Raja Indian Cuisine by riverside, there's a restaurant selling Japanese food. It's called The Wrestlers, it's kid friendly and costs around less than £20."
"name[The Wrestlers], eatType[restaurant], food[Japanese], priceRange[moderate], area[city centre], familyFriendly[no], near[Raja Indian Cuisine]"	"In the area of city centre near Raja Indian Cuisine is The Wrestlers, it is a restaurant. It is not kid friendly and the Japanese is moderately expensive."
"name[The Wrestlers], eatType[restaurant], food[Japanese], priceRange[moderate], area[city centre], familyFriendly[yes], near[Raja Indian Cuisine]"	"The Wrestlers is a restaurant with moderate price featuring Japanese food and is Kid Friendly and is located near Raja Indian Cuisine in the city centre."
"name[The Wrestlers], eatType[restaurant], food[Japanese], priceRange[moderate], area[riverside], familyFriendly[no], near[Raja Indian Cuisine]"	"The the riverside area, near Raja Indian Cuisine, there is a Japanese restaurant in the moderate price range called The Wrestlers. It is not kids friendly."
"name[The Wrestlers], eatType[restaurant], food[Japanese], priceRange[moderate], area[riverside], familyFriendly[yes], near[Raja Indian Cuisine]"	"Name The Wrestlers in the riverside area at a price range of moderate it is a family friendly restaurant near the Raja Indian Cuisine serving Japanese food."
"name[The Wrestlers], eatType[restaurant], food[Japanese], priceRange[more than £30], area[city centre], familyFriendly[no], near[Raja Indian Cuisine]"	"The Wrestlers' is a restaurant located on the city centre, near 'Raja Indian Cuisine'. They serve Japanese food and a price range of more than £30, and are not family-friendly."
"name[The Wrestlers], eatType[restaurant], food[Japanese], priceRange[more than £30], area[city centre], familyFriendly[yes], near[Raja Indian Cuisine]"	"In the city centre near Raja Indian Cuisine is The Wrestlers. It is a kids friendly restaurant serving more than £30 priced Japanese food."
"name[The Wrestlers], eatType[restaurant], food[Japanese], priceRange[more than £30], area[riverside], familyFriendly[no], near[Raja Indian Cuisine]"	"The Wrestlers restaurant serves Japanese food and is near the riverside and the Raja Indian Cuisine. It is not family-friendly and is priced in the more than £30 pound range."
"name[The Wrestlers], eatType[restaurant], food[Japanese], priceRange[more than £30], area[riverside], familyFriendly[yes], near[Raja Indian Cuisine]"	"The Wrestlers is a restaurant near Raja Indian Cuisine in the riverside. It serves more than £30 priced Japanese food and is kids friendly."
"name[Wildwood], eatType[coffee shop], area[riverside]"	"At the riverside, you can find Wildwood. It's a coffee shop."
"name[Wildwood], eatType[pub], area[riverside]"	"Wildwood is a pub located on the riverside."
"name[Wildwood], eatType[pub], food[French], area[riverside], familyFriendly[yes], near[Raja Indian Cuisine]"	"Wildwood serves French and is kids-friendly. It is a pub in the area of riverside and is near Raja Indian Cuisine."
"name[Wildwood], eatType[pub], food[Indian], area[city centre], familyFriendly[no], near[Raja Indian Cuisine]"	"A pub named Wildwood is located in the city centre. It is for adults and is close to Raja Indian Cuisine. They offer Indian food."
"name[Wildwood], eatType[pub], food[Indian], area[city centre], familyFriendly[yes], near[Raja Indian Cuisine]"	"A family-friendly serving Indian food in the city centre, near the Raja Indian Cuisine, is The Wildwood, a pub."
"name[Wildwood], eatType[pub], food[Indian], area[riverside], familyFriendly[no], near[Raja Indian Cuisine]"	"Wildwood is an Indian pub situated in the riverside, near the Raja Indian Cuisine. It is not family-friendly."
"name[Wildwood], eatType[pub], food[Indian], area[riverside], familyFriendly[yes], near[Raja Indian Cuisine]"	"Wildwood is an Indian pub located near Raja Indian Cuisine on the riverside. Kids are welcome."
"name[Wildwood], eatType[pub], food[Italian], area[city centre], familyFriendly[no], near[Raja Indian Cuisine]"	"Pub and Italian food venue, Wildwood, is located in the city centre near the Raja Indian Cuisine and is not considered family friendly."
"name[Wildwood], eatType[pub], food[Italian], area[city centre], familyFriendly[yes], near[Raja Indian Cuisine]"	"Wildwood is a family-oriented pub near the Raja Indian Cuisine in the city centre area. Italian food is served at Wildwood."
"name[Wildwood], eatType[pub], food[Italian], area[riverside], familyFriendly[no], near[Raja Indian Cuisine]"	"Located by the riverside near the Raja Indian Cuisine, Wildwood is an Italian pub that is not family friendly."
"name[Wildwood], eatType[pub], food[Italian], area[riverside], familyFriendly[yes], near[Raja Indian Cuisine]"	"Wildwood is a kid friendly Italian pub near Raja Indian Cuisine in riverside."
"name[Wildwood], eatType[restaurant], food[French], area[riverside], familyFriendly[yes], near[Raja Indian Cuisine]"	"Wildwood is a riverside restaurant which serves French. It is located near Raja Indian Cuisine. Children are welcome."
"name[Wildwood], eatType[restaurant], food[Indian], area[city centre], familyFriendly[no], near[Raja Indian Cuisine]"	"Wildwood, located near Raja Indian Cuisine in the city centre, is a restaurant that also sells Indian food. Children should not visit."
"name[Wildwood], eatType[restaurant], food[Indian], area[city centre], familyFriendly[yes], near[Raja Indian Cuisine]"	"Wildwood is a children friendly restaurant that serves Indian food. It is located in city centre near Raja Indian Cuisine."
"name[Wildwood], eatType[restaurant], food[Indian], area[riverside], familyFriendly[no], near[Raja Indian Cuisine]"	"Wildwood is a restaurant that serves Indian food located near Raja Indian Cuisine in the area of riverside. Unfortunately, it is not kid friendly."
"name[Wildwood], eatType[restaurant], food[Indian], area[riverside], familyFriendly[yes], near[Raja Indian Cuisine]"	"By the riverside near the Raja Indian Cuisine, is a children friendly restaurant named Wildwood, which also serves Indian food."
"name[Wildwood], eatType[restaurant], food[Italian], area[city centre], familyFriendly[no], near[Raja Indian Cuisine]"	"You will be going to Wildwood. It serves Italian food. It is located in the city centre. Kid unfriendly It is a restaurant. It is near Raja Indian Cuisine."
"name[Wildwood], eatType[restaurant], food[Italian], area[city centre], familyFriendly[yes], near[Raja Indian Cuisine]"	"Wildwood is an Italian restaurant in city centre. It is convenient to the Raja Indian Cuisine, and offer a child-friendly environment."
"name[Wildwood], eatType[restaurant], food[Italian], area[riverside], familyFriendly[no], near[Raja Indian Cuisine]"	"The Wildwood is a great restaurant along the riverside, and is located near Raja Indian Cuisine. It is not family friendly, but serves Italian food."
"name[Wildwood], eatType[restaurant], food[Italian], area[riverside], familyFriendly[yes], near[Raja Indian Cuisine]"	"Wildwood is a restaurant that serves Italian food in the riverside. It is a kid friendly place near the Raja Indian Cuisine."
"name[Zizzi], eatType[coffee shop], area[riverside]"	"Zizzi is coffee shop in the riverside area."
"name[Zizzi], eatType[coffee shop], customer rating[average], near[Burger King]"	"Zizzi is near Burger King. It has a coffee shop style and has a customer rating of average."
"name[Zizzi], eatType[coffee shop], customer rating[high], near[Burger King]"	"There is a coffee shop named Zizzi located near Burger King. The customer rating is high."
"name[Zizzi], eatType[coffee shop], near[The Sorrento]"	"The Zizzi. Enjoy at this coffee shop. It is located near The Sorrento."
"name[Zizzi], eatType[pub], area[riverside]"	"Zizzi is a pub. They are located at the riverside."
"name[Zizzi], eatType[pub], customer rating[average], near[Burger King]"	"Zizzi is a restaurant near Burger King with an 3 out of 5 rating. They are a pub."
"name[Zizzi], eatType[pub], customer rating[high], near[Burger King]"	"There is a highly recommended pub located near the Burger King called Zizzi."
"name[Zizzi], eatType[pub], near[The Sorrento]"	"There is a pub called Zizzi near The Sorrento."
