MR	output
"name[Blue Spice], eatType[coffee shop], area[city centre]"	"Blue Spice is a coffee shop located in the city centre area."
"name[Blue Spice], eatType[coffee shop], area[riverside]"	"Blue Spice is a coffee shop located in the riverside area."
"name[Blue Spice], eatType[coffee shop], customer rating[5 out of 5], near[Crowne Plaza Hotel]"	"Blue Spice is a coffee shop located near Crowne Plaza Hotel. It has a customer rating of 5 out of 5."
"name[Blue Spice], eatType[coffee shop], customer rating[average], near[Burger King]"	"Blue Spice is a coffee shop located near Burger King. It has an average customer rating."
"name[Blue Spice], eatType[coffee shop], customer rating[average], near[Crowne Plaza Hotel]"	"Blue Spice is a coffee shop located near Crowne Plaza Hotel. It has an average customer rating."
"name[Blue Spice], eatType[pub], area[city centre]"	"Blue Spice is a pub located in the city centre area."
"name[Blue Spice], eatType[pub], area[riverside]"	"Blue Spice is a pub located in the riverside area."
"name[Blue Spice], eatType[pub], customer rating[5 out of 5], near[Crowne Plaza Hotel]"	"Blue Spice is a pub located near Crowne Plaza Hotel. It has a customer rating of 5 out of 5."
"name[Blue Spice], eatType[pub], customer rating[average], near[Burger King]"	"Blue Spice is a pub located near Burger King. It has an average customer rating."
"name[Blue Spice], eatType[pub], customer rating[average], near[Crowne Plaza Hotel]"	"Blue Spice is a pub located near Crowne Plaza Hotel. It has an average customer rating."
"name[Blue Spice], eatType[pub], food[Chinese], area[city centre], familyFriendly[no], near[Rainbow Vegetarian Café]"	"Blue Spice is a pub which serves Chinese food. It is located in the city centre area, near Rainbow Vegetarian Café. It is not family friendly."
"name[Blue Spice], eatType[pub], food[Chinese], area[city centre], familyFriendly[yes], near[Rainbow Vegetarian Café]"	"Blue Spice is a family-friendly pub which serves Chinese food. It is located in the city centre area, near Rainbow Vegetarian Café."
"name[Blue Spice], eatType[pub], food[Chinese], area[riverside], familyFriendly[no], near[Rainbow Vegetarian Café]"	"Blue Spice is a pub which serves Chinese food. It is located in the riverside area, near Rainbow Vegetarian Café. It is not family friendly."
"name[Blue Spice], eatType[pub], food[Chinese], area[riverside], familyFriendly[yes], near[Rainbow Vegetarian Café]"	"Blue Spice is a family-friendly pub which serves Chinese food. It is located in the riverside area, near Rainbow Vegetarian Café."
"name[Blue Spice], eatType[pub], food[English], area[city centre], familyFriendly[no], near[Rainbow Vegetarian Café]"	"Blue Spice is a pub which serves English food. It is located in the city centre area, near Rainbow Vegetarian Café. It is not family friendly."
"name[Blue Spice], eatType[pub], food[English], area[city centre], familyFriendly[yes], near[Rainbow Vegetarian Café]"	"Blue Spice is a family-friendly pub which serves English food. It is located in the city centre area, near Rainbow Vegetarian Café."
"name[Blue Spice], eatType[pub], food[English], area[riverside], familyFriendly[no], near[Rainbow Vegetarian Café]"	"Blue Spice is a pub which serves English food. It is located in the riverside area, near Rainbow Vegetarian Café. It is not family friendly."
"name[Blue Spice], eatType[pub], food[English], area[riverside], familyFriendly[yes], near[Rainbow Vegetarian Café]"	"Blue Spice is a family-friendly pub which serves English food. It is located in the riverside area, near Rainbow Vegetarian Café."
"name[Blue Spice], eatType[restaurant], food[Chinese], area[city centre], familyFriendly[no], near[Rainbow Vegetarian Café]"	"Blue Spice is a restaurant which serves Chinese food. It is located in the city centre area, near Rainbow Vegetarian Café. It is not family friendly."
"name[Blue Spice], eatType[restaurant], food[Chinese], area[city centre], familyFriendly[yes], near[Rainbow Vegetarian Café]"	"Blue Spice is a family-friendly restaurant which serves Chinese food. It is located in the city centre area, near Rainbow Vegetarian Café."
"name[Blue Spice], eatType[restaurant], food[Chinese], area[riverside], familyFriendly[no], near[Rainbow Vegetarian Café]"	"Blue Spice is a restaurant which serves Chinese food. It is located in the riverside area, near Rainbow Vegetarian Café. It is not family friendly."
"name[Blue Spice], eatType[restaurant], food[Chinese], area[riverside], familyFriendly[yes], near[Rainbow Vegetarian Café]"	"Blue Spice is a family-friendly restaurant which serves Chinese food. It is located in the riverside area, near Rainbow Vegetarian Café."
"name[Blue Spice], eatType[restaurant], food[English], area[city centre], familyFriendly[no], near[Rainbow Vegetarian Café]"	"Blue Spice is a restaurant which serves English food. It is located in the city centre area, near Rainbow Vegetarian Café. It is not family friendly."
"name[Blue Spice], eatType[restaurant], food[English], area[city centre], familyFriendly[yes], near[Rainbow Vegetarian Café]"	"Blue Spice is a family-friendly restaurant which serves English food. It is located in the city centre area, near Rainbow Vegetarian Café."
"name[Blue Spice], eatType[restaurant], food[English], area[riverside], familyFriendly[no], near[Rainbow Vegetarian Café]"	"Blue Spice is a restaurant which serves English food. It is located in the riverside area, near Rainbow Vegetarian Café. It is not family friendly."
"name[Blue Spice], eatType[restaurant], food[English], area[riverside], familyFriendly[yes], near[Rainbow Vegetarian Café]"	"Blue Spice is a family-friendly restaurant which serves English food. It is located in the riverside area, near Rainbow Vegetarian Café."
"name[Clowns], eatType[coffee shop], customer rating[3 out of 5], near[All Bar One]"	"Clowns is a coffee shop located near All Bar One. It has a customer rating of 3 out of 5."
"name[Clowns], eatType[coffee shop], customer rating[5 out of 5], near[Crowne Plaza Hotel]"	"Clowns is a coffee shop located near Crowne Plaza Hotel. It has a customer rating of 5 out of 5."
"name[Clowns], eatType[coffee shop], near[The Sorrento]"	"Clowns is a coffee shop located near The Sorrento."
"name[Clowns], eatType[pub], customer rating[3 out of 5], near[All Bar One]"	"Clowns is a pub located near All Bar One. It has a customer rating of 3 out of 5."
"name[Clowns], eatType[pub], customer rating[5 out of 5], near[Crowne Plaza Hotel]"	"Clowns is a pub located near Crowne Plaza Hotel. It has a customer rating of 5 out of 5."
"name[Clowns], eatType[pub], near[The Sorrento]"	"Clowns is a pub located near The Sorrento."
"name[Cocum], eatType[coffee shop], customer rating[high], near[Burger King]"	"Cocum is a coffee shop located near Burger King. It has a high customer rating."
"name[Cocum], eatType[coffee shop], customer rating[high], near[Café Sicilia]"	"Cocum is a coffee shop located near Café Sicilia. It has a high customer rating."
"name[Cocum], eatType[coffee shop], customer rating[low], near[Café Sicilia]"	"Cocum is a coffee shop located near Café Sicilia. It has a low customer rating."
"name[Cocum], eatType[coffee shop], customer rating[low], near[Express by Holiday Inn]"	"Cocum is a coffee shop located near Express by Holiday Inn. It has a low customer rating."
"name[Cocum], eatType[coffee shop], near[The Rice Boat]"	"Cocum is a coffee shop located near The Rice Boat."
"name[Cocum], eatType[coffee shop], near[The Sorrento]"	"Cocum is a coffee shop located near The Sorrento."
"name[Cocum], eatType[pub], customer rating[high], near[Burger King]"	"Cocum is a pub located near Burger King. It has a high customer rating."
"name[Cocum], eatType[pub], customer rating[high], near[Café Sicilia]"	"Cocum is a pub located near Café Sicilia. It has a high customer rating."
"name[Cocum], eatType[pub], customer rating[low], near[Café Sicilia]"	"Cocum is a pub located near Café Sicilia. It has a low customer rating."
"name[Cocum], eatType[pub], customer rating[low], near[Express by Holiday Inn]"	"Cocum is a pub located near Express by Holiday Inn. It has a low customer rating."
"name[Cocum], eatType[pub], near[The Rice Boat]"	"Cocum is a pub located near The Rice Boat."
"name[Cocum], eatType[pub], near[The Sorrento]"	"Cocum is a pub located near The Sorrento."
"name[Cotto], eatType[coffee shop], near[The Bakers]"	"Cotto is a coffee shop located near The Bakers."
"name[Cotto], eatType[pub], near[The Bakers]"	"Cotto is a pub located near The Bakers."
"name[Giraffe], eatType[coffee shop], near[The Bakers]"	"Giraffe is a coffee shop located near The Bakers."
"name[Giraffe], eatType[coffee shop], near[The Rice Boat]"	"Giraffe is a coffee shop located near The Rice Boat."
"name[Giraffe], eatType[pub], food[English], area[riverside], familyFriendly[yes], near[Rainbow Vegetarian Café]"	"Giraffe is a family-friendly pub which serves English food. It is located in the riverside area, near Rainbow Vegetarian Café."
"name[Giraffe], eatType[pub], food[Fast food], area[city centre], familyFriendly[no], near[Rainbow Vegetarian Café]"	"Giraffe is a pub which serves fast food. It is located in the city centre area, near Rainbow Vegetarian Café. It is not family friendly."
"name[Giraffe], eatType[pub], food[Fast food], area[city centre], familyFriendly[yes], near[Rainbow Vegetarian Café]"	"Giraffe is a family-friendly pub which serves fast food. It is located in the city centre area, near Rainbow Vegetarian Café."
"name[Giraffe], eatType[pub], food[Fast food], area[riverside], familyFriendly[no], near[Rainbow Vegetarian Café]"	"Giraffe is a pub which serves fast food. It is located in the riverside area, near Rainbow Vegetarian Café. It is not family friendly."
"name[Giraffe], eatType[pub], food[Fast food], area[riverside], familyFriendly[yes], near[Rainbow Vegetarian Café]"	"Giraffe is a family-friendly pub which serves fast food. It is located in the riverside area, near Rainbow Vegetarian Café."
"name[Giraffe], eatType[pub], food[Fast food], area[riverside], familyFriendly[yes], near[Raja Indian Cuisine]"	"Giraffe is a family-friendly pub which serves fast food. It is located in the riverside area, near Raja Indian Cuisine."
"name[Giraffe], eatType[pub], food[French], area[city centre], familyFriendly[no], near[Raja Indian Cuisine]"	"Giraffe is a pub which serves French food. It is located in the city centre area, near Raja Indian Cuisine. It is not family friendly."
"name[Giraffe], eatType[pub], food[French], area[city centre], familyFriendly[yes], near[Raja Indian Cuisine]"	"Giraffe is a family-friendly pub which serves French food. It is located in the city centre area, near Raja Indian Cuisine."
"name[Giraffe], eatType[pub], food[French], area[riverside], familyFriendly[no], near[Raja Indian Cuisine]"	"Giraffe is a pub which serves French food. It is located in the riverside area, near Raja Indian Cuisine. It is not family friendly."
"name[Giraffe], eatType[pub], food[French], area[riverside], familyFriendly[yes], near[Raja Indian Cuisine]"	"Giraffe is a family-friendly pub which serves French food. It is located in the riverside area, near Raja Indian Cuisine."
"name[Giraffe], eatType[pub], near[The Bakers]"	"Giraffe is a pub located near The Bakers."
"name[Giraffe], eatType[pub], near[The Rice Boat]"	"Giraffe is a pub located near The Rice Boat."
"name[Giraffe], eatType[restaurant], food[English], area[riverside], familyFriendly[yes], near[Rainbow Vegetarian Café]"	"Giraffe is a family-friendly restaurant which serves English food. It is located in the riverside area, near Rainbow Vegetarian Café."
"name[Giraffe], eatType[restaurant], food[Fast food], area[city centre], familyFriendly[no], near[Rainbow Vegetarian Café]"	"Giraffe is a restaurant which serves fast food. It is located in the city centre area, near Rainbow Vegetarian Café. It is not family friendly."
"name[Giraffe], eatType[restaurant], food[Fast food], area[city centre], familyFriendly[yes], near[Rainbow Vegetarian Café]"	"Giraffe is a family-friendly restaurant which serves fast food. It is located in the city centre area, near Rainbow Vegetarian Café."
"name[Giraffe], eatType[restaurant], food[Fast food], area[riverside], familyFriendly[no], near[Rainbow Vegetarian Café]"	"Giraffe is a restaurant which serves fast food. It is located in the riverside area, near Rainbow Vegetarian Café. It is not family friendly."
"name[Giraffe], eatType[restaurant], food[Fast food], area[riverside], familyFriendly[yes], near[Rainbow Vegetarian Café]"	"Giraffe is a family-friendly restaurant which serves fast food. It is located in the riverside area, near Rainbow Vegetarian Café."
"name[Giraffe], eatType[restaurant], food[Fast food], area[riverside], familyFriendly[yes], near[Raja Indian Cuisine]"	"Giraffe is a family-friendly restaurant which serves fast food. It is located in the riverside area, near Raja Indian Cuisine."
"name[Giraffe], eatType[restaurant], food[French], area[city centre], familyFriendly[no], near[Raja Indian Cuisine]"	"Giraffe is a restaurant which serves French food. It is located in the city centre area, near Raja Indian Cuisine. It is not family friendly."
"name[Giraffe], eatType[restaurant], food[French], area[city centre], familyFriendly[yes], near[Raja Indian Cuisine]"	"Giraffe is a family-friendly restaurant which serves French food. It is located in the city centre area, near Raja Indian Cuisine."
"name[Giraffe], eatType[restaurant], food[French], area[riverside], familyFriendly[no], near[Raja Indian Cuisine]"	"Giraffe is a restaurant which serves French food. It is located in the riverside area, near Raja Indian Cuisine. It is not family friendly."
"name[Giraffe], eatType[restaurant], food[French], area[riverside], familyFriendly[yes], near[Raja Indian Cuisine]"	"Giraffe is a family-friendly restaurant which serves French food. It is located in the riverside area, near Raja Indian Cuisine."
"name[Green Man], eatType[coffee shop], customer rating[1 out of 5], near[All Bar One]"	"Green Man is a coffee shop located near All Bar One. It has a customer rating of 1 out of 5."
"name[Green Man], eatType[coffee shop], customer rating[3 out of 5], near[All Bar One]"	"Green Man is a coffee shop located near All Bar One. It has a customer rating of 3 out of 5."
"name[Green Man], eatType[pub], customer rating[1 out of 5], near[All Bar One]"	"Green Man is a pub located near All Bar One. It has a customer rating of 1 out of 5."
"name[Green Man], eatType[pub], customer rating[3 out of 5], near[All Bar One]"	"Green Man is a pub located near All Bar One. It has a customer rating of 3 out of 5."
"name[Green Man], eatType[pub], food[Italian], area[riverside], familyFriendly[yes], near[Express by Holiday Inn]"	"Green Man is a family-friendly pub which serves Italian food. It is located in the riverside area, near Express by Holiday Inn."
"name[Green Man], eatType[pub], food[Italian], area[riverside], familyFriendly[yes], near[Raja Indian Cuisine]"	"Green Man is a family-friendly pub which serves Italian food. It is located in the riverside area, near Raja Indian Cuisine."
"name[Green Man], eatType[pub], food[Japanese], area[city centre], familyFriendly[no], near[Express by Holiday Inn]"	"Green Man is a pub which serves Japanese food. It is located in the city centre area, near Express by Holiday Inn. It is not family friendly."
"name[Green Man], eatType[pub], food[Japanese], area[city centre], familyFriendly[yes], near[Express by Holiday Inn]"	"Green Man is a family-friendly pub which serves Japanese food. It is located in the city centre area, near Express by Holiday Inn."
"name[Green Man], eatType[pub], food[Japanese], area[riverside], familyFriendly[no], near[Express by Holiday Inn]"	"Green Man is a pub which serves Japanese food. It is located in the riverside area, near Express by Holiday Inn. It is not family friendly."
"name[Green Man], eatType[pub], food[Japanese], area[riverside], familyFriendly[yes], near[Express by Holiday Inn]"	"Green Man is a family-friendly pub which serves Japanese food. It is located in the riverside area, near Express by Holiday Inn."
"name[Green Man], eatType[restaurant], food[Italian], area[riverside], familyFriendly[yes], near[Express by Holiday Inn]"	"Green Man is a family-friendly restaurant which serves Italian food. It is located in the riverside area, near Express by Holiday Inn."
"name[Green Man], eatType[restaurant], food[Italian], area[riverside], familyFriendly[yes], near[Raja Indian Cuisine]"	"Green Man is a family-friendly restaurant which serves Italian food. It is located in the riverside area, near Raja Indian Cuisine."
"name[Green Man], eatType[restaurant], food[Japanese], area[city centre], familyFriendly[no], near[Express by Holiday Inn]"	"Green Man is a restaurant which serves Japanese food. It is located in the city centre area, near Express by Holiday Inn. It is not family friendly."
"name[Green Man], eatType[restaurant], food[Japanese], area[city centre], familyFriendly[yes], near[Express by Holiday Inn]"	"Green Man is a family-friendly restaurant which serves Japanese food. It is located in the city centre area, near Express by Holiday Inn."
"name[Green Man], eatType[restaurant], food[Japanese], area[riverside], familyFriendly[no], near[Express by Holiday Inn]"	"Green Man is a restaurant which serves Japanese food. It is located in the riverside area, near Express by Holiday Inn. It is not family friendly."
"name[Green Man], eatType[restaurant], food[Japanese], area[riverside], familyFriendly[yes], near[Express by Holiday Inn]"	"Green Man is a family-friendly restaurant which serves Japanese food. It is located in the riverside area, near Express by Holiday Inn."
"name[Loch Fyne], eatType[coffee shop], area[riverside]"	"Loch Fyne is a coffee shop located in the riverside area."
"name[Loch Fyne], eatType[pub], area[riverside]"	"Loch Fyne is a pub located in the riverside area."
"name[Strada], eatType[coffee shop], area[city centre]"	"Strada is a coffee shop located in the city centre area."
"name[Strada], eatType[coffee shop], customer rating[1 out of 5], near[All Bar One]"	"Strada is a coffee shop located near All Bar One. It has a customer rating of 1 out of 5."
"name[Strada], eatType[coffee shop], customer rating[1 out of 5], near[Rainbow Vegetarian Café]"	"Strada is a coffee shop located near Rainbow Vegetarian Café. It has a customer rating of 1 out of 5."
"name[Strada], eatType[coffee shop], customer rating[low], near[Express by Holiday Inn]"	"Strada is a coffee shop located near Express by Holiday Inn. It has a low customer rating."
"name[Strada], eatType[pub], area[city centre]"	"Strada is a pub located in the city centre area."
"name[Strada], eatType[pub], customer rating[1 out of 5], near[All Bar One]"	"Strada is a pub located near All Bar One. It has a customer rating of 1 out of 5."
"name[Strada], eatType[pub], customer rating[1 out of 5], near[Rainbow Vegetarian Café]"	"Strada is a pub located near Rainbow Vegetarian Café. It has a customer rating of 1 out of 5."
"name[Strada], eatType[pub], customer rating[low], near[Express by Holiday Inn]"	"Strada is a pub located near Express by Holiday Inn. It has a low customer rating."
"name[The Cricketers], eatType[coffee shop], customer rating[1 out of 5], familyFriendly[yes], near[Avalon]"	"The Cricketers is a family-friendly coffee shop located near Avalon. It has a customer rating of 1 out of 5."
"name[The Cricketers], eatType[coffee shop], customer rating[3 out of 5], familyFriendly[yes], near[Avalon]"	"The Cricketers is a family-friendly coffee shop located near Avalon. It has a customer rating of 3 out of 5."
"name[The Cricketers], eatType[coffee shop], customer rating[3 out of 5], familyFriendly[yes], near[Crowne Plaza Hotel]"	"The Cricketers is a family-friendly coffee shop located near Crowne Plaza Hotel. It has a customer rating of 3 out of 5."
"name[The Cricketers], eatType[coffee shop], customer rating[5 out of 5], familyFriendly[no], near[Crowne Plaza Hotel]"	"The Cricketers is a coffee shop located near Crowne Plaza Hotel. It has a customer rating of 5 out of 5. It is not family friendly."
"name[The Cricketers], eatType[coffee shop], customer rating[5 out of 5], familyFriendly[yes], near[Crowne Plaza Hotel]"	"The Cricketers is a family-friendly coffee shop located near Crowne Plaza Hotel. It has a customer rating of 5 out of 5."
"name[The Cricketers], eatType[coffee shop], customer rating[average], familyFriendly[no], near[Café Sicilia]"	"The Cricketers is a coffee shop located near Café Sicilia. It has an average customer rating. It is not family friendly."
"name[The Cricketers], eatType[coffee shop], customer rating[average], familyFriendly[no], near[Crowne Plaza Hotel]"	"The Cricketers is a coffee shop located near Crowne Plaza Hotel. It has an average customer rating. It is not family friendly."
"name[The Cricketers], eatType[coffee shop], customer rating[average], familyFriendly[yes], near[Café Sicilia]"	"The Cricketers is a family-friendly coffee shop located near Café Sicilia. It has an average customer rating."
"name[The Cricketers], eatType[coffee shop], customer rating[high], familyFriendly[yes], near[Café Sicilia]"	"The Cricketers is a family-friendly coffee shop located near Café Sicilia. It has a high customer rating."
"name[The Cricketers], eatType[coffee shop], customer rating[high], familyFriendly[yes], near[Express by Holiday Inn]"	"The Cricketers is a family-friendly coffee shop located near Express by Holiday Inn. It has a high customer rating."
"name[The Cricketers], eatType[coffee shop], customer rating[low], familyFriendly[no], near[Express by Holiday Inn]"	"The Cricketers is a coffee shop located near Express by Holiday Inn. It has a low customer rating. It is not family friendly."
"name[The Cricketers], eatType[coffee shop], customer rating[low], familyFriendly[no], near[Ranch]"	"The Cricketers is a coffee shop located near Ranch. It has a low customer rating. It is not family friendly."
"name[The Cricketers], eatType[coffee shop], customer rating[low], familyFriendly[yes], near[Ranch]"	"The Cricketers is a family-friendly coffee shop located near Ranch. It has a low customer rating."
"name[The Cricketers], eatType[restaurant], customer rating[1 out of 5], familyFriendly[yes], near[Avalon]"	"The Cricketers is a family-friendly restaurant located near Avalon. It has a customer rating of 1 out of 5."
"name[The Cricketers], eatType[restaurant], customer rating[3 out of 5], familyFriendly[yes], near[Avalon]"	"The Cricketers is a family-friendly restaurant located near Avalon. It has a customer rating of 3 out of 5."
"name[The Cricketers], eatType[restaurant], customer rating[3 out of 5], familyFriendly[yes], near[Crowne Plaza Hotel]"	"The Cricketers is a family-friendly restaurant located near Crowne Plaza Hotel. It has a customer rating of 3 out of 5."
"name[The Cricketers], eatType[restaurant], customer rating[5 out of 5], familyFriendly[no], near[Crowne Plaza Hotel]"	"The Cricketers is a restaurant located near Crowne Plaza Hotel. It has a customer rating of 5 out of 5. It is not family friendly."
"name[The Cricketers], eatType[restaurant], customer rating[5 out of 5], familyFriendly[yes], near[Crowne Plaza Hotel]"	"The Cricketers is a family-friendly restaurant located near Crowne Plaza Hotel. It has a customer rating of 5 out of 5."
"name[The Cricketers], eatType[restaurant], customer rating[average], familyFriendly[no], near[Café Sicilia]"	"The Cricketers is a restaurant located near Café Sicilia. It has an average customer rating. It is not family friendly."
"name[The Cricketers], eatType[restaurant], customer rating[average], familyFriendly[no], near[Crowne Plaza Hotel]"	"The Cricketers is a restaurant located near Crowne Plaza Hotel. It has an average customer rating. It is not family friendly."
"name[The Cricketers], eatType[restaurant], customer rating[average], familyFriendly[yes], near[Café Sicilia]"	"The Cricketers is a family-friendly restaurant located near Café Sicilia. It has an average customer rating."
"name[The Cricketers], eatType[restaurant], customer rating[high], familyFriendly[yes], near[Café Sicilia]"	"The Cricketers is a family-friendly restaurant located near Café Sicilia. It has a high customer rating."
"name[The Cricketers], eatType[restaurant], customer rating[high], familyFriendly[yes], near[Express by Holiday Inn]"	"The Cricketers is a family-friendly restaurant located near Express by Holiday Inn. It has a high customer rating."
"name[The Cricketers], eatType[restaurant], customer rating[low], familyFriendly[no], near[Express by Holiday Inn]"	"The Cricketers is a restaurant located near Express by Holiday Inn. It has a low customer rating. It is not family friendly."
"name[The Cricketers], eatType[restaurant], customer rating[low], familyFriendly[no], near[Ranch]"	"The Cricketers is a restaurant located near Ranch. It has a low customer rating. It is not family friendly."
"name[The Cricketers], eatType[restaurant], customer rating[low], familyFriendly[yes], near[Ranch]"	"The Cricketers is a family-friendly restaurant located near Ranch. It has a low customer rating."
"name[The Cricketers], eatType[restaurant], food[Chinese], priceRange[£20-25], customer rating[high], area[city centre], familyFriendly[no], near[All Bar One]"	"The Cricketers is a restaurant which serves Chinese food in the price range of £20-25. It has a high customer rating and is located in the city centre area, near All Bar One. It is not family friendly."
"name[The Cricketers], eatType[restaurant], food[Chinese], priceRange[£20-25], customer rating[high], area[city centre], familyFriendly[yes], near[All Bar One]"	"The Cricketers is a family-friendly restaurant which serves Chinese food in the price range of £20-25. It has a high customer rating and is located in the city centre area, near All Bar One."
"name[The Cricketers], eatType[restaurant], food[Chinese], priceRange[£20-25], customer rating[high], area[riverside], familyFriendly[no], near[All Bar One]"	"The Cricketers is a restaurant which serves Chinese food in the price range of £20-25. It has a high customer rating and is located in the riverside area, near All Bar One. It is not family friendly."
"name[The Cricketers], eatType[restaurant], food[Chinese], priceRange[£20-25], customer rating[high], area[riverside], familyFriendly[yes], near[All Bar One]"	"The Cricketers is a family-friendly restaurant which serves Chinese food in the price range of £20-25. It has a high customer rating and is located in the riverside area, near All Bar One."
"name[The Cricketers], eatType[restaurant], food[Chinese], priceRange[cheap], customer rating[5 out of 5], area[city centre], familyFriendly[no], near[All Bar One]"	"The Cricketers is a restaurant which serves Chinese food in the low price range. It has a customer rating of 5 out of 5 and is located in the city centre area, near All Bar One. It is not family friendly."
"name[The Cricketers], eatType[restaurant], food[Chinese], priceRange[cheap], customer rating[5 out of 5], area[city centre], familyFriendly[yes], near[All Bar One]"	"The Cricketers is a family-friendly restaurant which serves Chinese food in the low price range. It has a customer rating of 5 out of 5 and is located in the city centre area, near All Bar One."
"name[The Cricketers], eatType[restaurant], food[Chinese], priceRange[cheap], customer rating[5 out of 5], area[riverside], familyFriendly[no], near[All Bar One]"	"The Cricketers is a restaurant which serves Chinese food in the low price range. It has a customer rating of 5 out of 5 and is located in the riverside area, near All Bar One. It is not family friendly."
"name[The Cricketers], eatType[restaurant], food[Chinese], priceRange[cheap], customer rating[5 out of 5], area[riverside], familyFriendly[yes], near[All Bar One]"	"The Cricketers is a family-friendly restaurant which serves Chinese food in the low price range. It has a customer rating of 5 out of 5 and is located in the riverside area, near All Bar One."
"name[The Cricketers], eatType[restaurant], food[Chinese], priceRange[cheap], customer rating[average], area[city centre], familyFriendly[no], near[All Bar One]"	"The Cricketers is a restaurant which serves Chinese food in the low price range. It has an average customer rating and is located in the city centre area, near All Bar One. It is not family friendly."
"name[The Cricketers], eatType[restaurant], food[Chinese], priceRange[cheap], customer rating[average], area[city centre], familyFriendly[yes], near[All Bar One]"	"The Cricketers is a family-friendly restaurant which serves Chinese food in the low price range. It has an average customer rating and is located in the city centre area, near All Bar One."
"name[The Cricketers], eatType[restaurant], food[Chinese], priceRange[cheap], customer rating[average], area[riverside], familyFriendly[no], near[All Bar One]"	"The Cricketers is a restaurant which serves Chinese food in the low price range. It has an average customer rating and is located in the riverside area, near All Bar One. It is not family friendly."
"name[The Cricketers], eatType[restaurant], food[Chinese], priceRange[cheap], customer rating[average], area[riverside], familyFriendly[yes], near[All Bar One]"	"The Cricketers is a family-friendly restaurant which serves Chinese food in the low price range. It has an average customer rating and is located in the riverside area, near All Bar One."
"name[The Cricketers], eatType[restaurant], food[Chinese], priceRange[high], customer rating[1 out of 5], area[city centre], familyFriendly[no], near[All Bar One]"	"The Cricketers is a restaurant which serves Chinese food in the high price range. It has a customer rating of 1 out of 5 and is located in the city centre area, near All Bar One. It is not family friendly."
"name[The Cricketers], eatType[restaurant], food[Chinese], priceRange[high], customer rating[1 out of 5], area[city centre], familyFriendly[yes], near[All Bar One]"	"The Cricketers is a family-friendly restaurant which serves Chinese food in the high price range. It has a customer rating of 1 out of 5 and is located in the city centre area, near All Bar One."
"name[The Cricketers], eatType[restaurant], food[Chinese], priceRange[high], customer rating[1 out of 5], area[riverside], familyFriendly[no], near[All Bar One]"	"The Cricketers is a restaurant which serves Chinese food in the high price range. It has a customer rating of 1 out of 5 and is located in the riverside area, near All Bar One. It is not family friendly."
"name[The Cricketers], eatType[restaurant], food[Chinese], priceRange[high], customer rating[1 out of 5], area[riverside], familyFriendly[yes], near[All Bar One]"	"The Cricketers is a family-friendly restaurant which serves Chinese food in the high price range. It has a customer rating of 1 out of 5 and is located in the riverside area, near All Bar One."
"name[The Cricketers], eatType[restaurant], food[Chinese], priceRange[high], customer rating[average], area[city centre], familyFriendly[no], near[All Bar One]"	"The Cricketers is a restaurant which serves Chinese food in the high price range. It has an average customer rating and is located in the city centre area, near All Bar One. It is not family friendly."
"name[The Cricketers], eatType[restaurant], food[Chinese], priceRange[high], customer rating[average], area[city centre], familyFriendly[yes], near[All Bar One]"	"The Cricketers is a family-friendly restaurant which serves Chinese food in the high price range. It has an average customer rating and is located in the city centre area, near All Bar One."
"name[The Cricketers], eatType[restaurant], food[Chinese], priceRange[high], customer rating[average], area[riverside], familyFriendly[no], near[All Bar One]"	"The Cricketers is a restaurant which serves Chinese food in the high price range. It has an average customer rating and is located in the riverside area, near All Bar One. It is not family friendly."
"name[The Cricketers], eatType[restaurant], food[Chinese], priceRange[high], customer rating[average], area[riverside], familyFriendly[yes], near[All Bar One]"	"The Cricketers is a family-friendly restaurant which serves Chinese food in the high price range. It has an average customer rating and is located in the riverside area, near All Bar One."
"name[The Cricketers], eatType[restaurant], food[Chinese], priceRange[less than £20], customer rating[low], area[city centre], familyFriendly[no], near[All Bar One]"	"The Cricketers is a restaurant which serves Chinese food in the price range of less than £20. It has a low customer rating and is located in the city centre area, near All Bar One. It is not family friendly."
"name[The Cricketers], eatType[restaurant], food[Chinese], priceRange[less than £20], customer rating[low], area[city centre], familyFriendly[yes], near[All Bar One]"	"The Cricketers is a family-friendly restaurant which serves Chinese food in the price range of less than £20. It has a low customer rating and is located in the city centre area, near All Bar One."
"name[The Cricketers], eatType[restaurant], food[Chinese], priceRange[less than £20], customer rating[low], area[riverside], familyFriendly[no], near[All Bar One]"	"The Cricketers is a restaurant which serves Chinese food in the price range of less than £20. It has a low customer rating and is located in the riverside area, near All Bar One. It is not family friendly."
"name[The Cricketers], eatType[restaurant], food[Chinese], priceRange[less than £20], customer rating[low], area[riverside], familyFriendly[yes], near[All Bar One]"	"The Cricketers is a family-friendly restaurant which serves Chinese food in the price range of less than £20. It has a low customer rating and is located in the riverside area, near All Bar One."
"name[The Cricketers], eatType[restaurant], food[Chinese], priceRange[moderate], customer rating[1 out of 5], area[city centre], familyFriendly[no], near[All Bar One]"	"The Cricketers is a restaurant which serves Chinese food in the moderate price range. It has a customer rating of 1 out of 5 and is located in the city centre area, near All Bar One. It is not family friendly."
"name[The Cricketers], eatType[restaurant], food[Chinese], priceRange[moderate], customer rating[1 out of 5], area[city centre], familyFriendly[yes], near[All Bar One]"	"The Cricketers is a family-friendly restaurant which serves Chinese food in the moderate price range. It has a customer rating of 1 out of 5 and is located in the city centre area, near All Bar One."
"name[The Cricketers], eatType[restaurant], food[Chinese], priceRange[moderate], customer rating[1 out of 5], area[riverside], familyFriendly[no], near[All Bar One]"	"The Cricketers is a restaurant which serves Chinese food in the moderate price range. It has a customer rating of 1 out of 5 and is located in the riverside area, near All Bar One. It is not family friendly."
"name[The Cricketers], eatType[restaurant], food[Chinese], priceRange[moderate], customer rating[1 out of 5], area[riverside], familyFriendly[yes], near[All Bar One]"	"The Cricketers is a family-friendly restaurant which serves Chinese food in the moderate price range. It has a customer rating of 1 out of 5 and is located in the riverside area, near All Bar One."
"name[The Cricketers], eatType[restaurant], food[Chinese], priceRange[moderate], customer rating[3 out of 5], area[city centre], familyFriendly[no], near[All Bar One]"	"The Cricketers is a restaurant which serves Chinese food in the moderate price range. It has a customer rating of 3 out of 5 and is located in the city centre area, near All Bar One. It is not family friendly."
"name[The Cricketers], eatType[restaurant], food[Chinese], priceRange[moderate], customer rating[3 out of 5], area[city centre], familyFriendly[yes], near[All Bar One]"	"The Cricketers is a family-friendly restaurant which serves Chinese food in the moderate price range. It has a customer rating of 3 out of 5 and is located in the city centre area, near All Bar One."
"name[The Cricketers], eatType[restaurant], food[Chinese], priceRange[moderate], customer rating[3 out of 5], area[riverside], familyFriendly[no], near[All Bar One]"	"The Cricketers is a restaurant which serves Chinese food in the moderate price range. It has a customer rating of 3 out of 5 and is located in the riverside area, near All Bar One. It is not family friendly."
"name[The Cricketers], eatType[restaurant], food[Chinese], priceRange[moderate], customer rating[3 out of 5], area[riverside], familyFriendly[yes], near[All Bar One]"	"The Cricketers is a family-friendly restaurant which serves Chinese food in the moderate price range. It has a customer rating of 3 out of 5 and is located in the riverside area, near All Bar One."
"name[The Cricketers], eatType[restaurant], food[Chinese], priceRange[more than £30], customer rating[high], area[city centre], familyFriendly[no], near[All Bar One]"	"The Cricketers is a restaurant which serves Chinese food in the price range of more than £30. It has a high customer rating and is located in the city centre area, near All Bar One. It is not family friendly."
"name[The Cricketers], eatType[restaurant], food[Chinese], priceRange[more than £30], customer rating[high], area[city centre], familyFriendly[yes], near[All Bar One]"	"The Cricketers is a family-friendly restaurant which serves Chinese food in the price range of more than £30. It has a high customer rating and is located in the city centre area, near All Bar One."
"name[The Cricketers], eatType[restaurant], food[Chinese], priceRange[more than £30], customer rating[high], area[riverside], familyFriendly[no], near[All Bar One]"	"The Cricketers is a restaurant which serves Chinese food in the price range of more than £30. It has a high customer rating and is located in the riverside area, near All Bar One. It is not family friendly."
"name[The Cricketers], eatType[restaurant], food[Chinese], priceRange[more than £30], customer rating[high], area[riverside], familyFriendly[yes], near[All Bar One]"	"The Cricketers is a family-friendly restaurant which serves Chinese food in the price range of more than £30. It has a high customer rating and is located in the riverside area, near All Bar One."
"name[The Cricketers], eatType[restaurant], food[English], priceRange[£20-25], customer rating[high], area[city centre], familyFriendly[no], near[All Bar One]"	"The Cricketers is a restaurant which serves English food in the price range of £20-25. It has a high customer rating and is located in the city centre area, near All Bar One. It is not family friendly."
"name[The Cricketers], eatType[restaurant], food[English], priceRange[£20-25], customer rating[high], area[city centre], familyFriendly[yes], near[All Bar One]"	"The Cricketers is a family-friendly restaurant which serves English food in the price range of £20-25. It has a high customer rating and is located in the city centre area, near All Bar One."
"name[The Cricketers], eatType[restaurant], food[English], priceRange[£20-25], customer rating[high], area[riverside], familyFriendly[no], near[All Bar One]"	"The Cricketers is a restaurant which serves English food in the price range of £20-25. It has a high customer rating and is located in the riverside area, near All Bar One. It is not family friendly."
"name[The Cricketers], eatType[restaurant], food[English], priceRange[£20-25], customer rating[high], area[riverside], familyFriendly[yes], near[All Bar One]"	"The Cricketers is a family-friendly restaurant which serves English food in the price range of £20-25. It has a high customer rating and is located in the riverside area, near All Bar One."
"name[The Cricketers], eatType[restaurant], food[English], priceRange[cheap], customer rating[5 out of 5], area[city centre], familyFriendly[no], near[Café Rouge]"	"The Cricketers is a restaurant which serves English food in the low price range. It has a customer rating of 5 out of 5 and is located in the city centre area, near Café Rouge. It is not family friendly."
"name[The Cricketers], eatType[restaurant], food[English], priceRange[cheap], customer rating[5 out of 5], area[city centre], familyFriendly[yes], near[Café Rouge]"	"The Cricketers is a family-friendly restaurant which serves English food in the low price range. It has a customer rating of 5 out of 5 and is located in the city centre area, near Café Rouge."
"name[The Cricketers], eatType[restaurant], food[English], priceRange[cheap], customer rating[5 out of 5], area[riverside], familyFriendly[no], near[Café Rouge]"	"The Cricketers is a restaurant which serves English food in the low price range. It has a customer rating of 5 out of 5 and is located in the riverside area, near Café Rouge. It is not family friendly."
"name[The Cricketers], eatType[restaurant], food[English], priceRange[cheap], customer rating[5 out of 5], area[riverside], familyFriendly[yes], near[Café Rouge]"	"The Cricketers is a family-friendly restaurant which serves English food in the low price range. It has a customer rating of 5 out of 5 and is located in the riverside area, near Café Rouge."
"name[The Cricketers], eatType[restaurant], food[English], priceRange[cheap], customer rating[average], area[city centre], familyFriendly[no], near[Café Rouge]"	"The Cricketers is a restaurant which serves English food in the low price range. It has an average customer rating and is located in the city centre area, near Café Rouge. It is not family friendly."
"name[The Cricketers], eatType[restaurant], food[English], priceRange[cheap], customer rating[average], area[city centre], familyFriendly[yes], near[Café Rouge]"	"The Cricketers is a family-friendly restaurant which serves English food in the low price range. It has an average customer rating and is located in the city centre area, near Café Rouge."
"name[The Cricketers], eatType[restaurant], food[English], priceRange[cheap], customer rating[average], area[riverside], familyFriendly[no], near[Café Rouge]"	"The Cricketers is a restaurant which serves English food in the low price range. It has an average customer rating and is located in the riverside area, near Café Rouge. It is not family friendly."
"name[The Cricketers], eatType[restaurant], food[English], priceRange[cheap], customer rating[average], area[riverside], familyFriendly[yes], near[Café Rouge]"	"The Cricketers is a family-friendly restaurant which serves English food in the low price range. It has an average customer rating and is located in the riverside area, near Café Rouge."
"name[The Cricketers], eatType[restaurant], food[English], priceRange[high], customer rating[1 out of 5], area[city centre], familyFriendly[no], near[Café Rouge]"	"The Cricketers is a restaurant which serves English food in the high price range. It has a customer rating of 1 out of 5 and is located in the city centre area, near Café Rouge. It is not family friendly."
"name[The Cricketers], eatType[restaurant], food[English], priceRange[high], customer rating[1 out of 5], area[city centre], familyFriendly[yes], near[Café Rouge]"	"The Cricketers is a family-friendly restaurant which serves English food in the high price range. It has a customer rating of 1 out of 5 and is located in the city centre area, near Café Rouge."
"name[The Cricketers], eatType[restaurant], food[English], priceRange[high], customer rating[1 out of 5], area[riverside], familyFriendly[no], near[Café Rouge]"	"The Cricketers is a restaurant which serves English food in the high price range. It has a customer rating of 1 out of 5 and is located in the riverside area, near Café Rouge. It is not family friendly."
"name[The Cricketers], eatType[restaurant], food[English], priceRange[high], customer rating[1 out of 5], area[riverside], familyFriendly[yes], near[Café Rouge]"	"The Cricketers is a family-friendly restaurant which serves English food in the high price range. It has a customer rating of 1 out of 5 and is located in the riverside area, near Café Rouge."
"name[The Cricketers], eatType[restaurant], food[English], priceRange[high], customer rating[average], area[city centre], familyFriendly[no], near[Café Rouge]"	"The Cricketers is a restaurant which serves English food in the high price range. It has an average customer rating and is located in the city centre area, near Café Rouge. It is not family friendly."
"name[The Cricketers], eatType[restaurant], food[English], priceRange[high], customer rating[average], area[city centre], familyFriendly[yes], near[Café Rouge]"	"The Cricketers is a family-friendly restaurant which serves English food in the high price range. It has an average customer rating and is located in the city centre area, near Café Rouge."
"name[The Cricketers], eatType[restaurant], food[English], priceRange[high], customer rating[average], area[riverside], familyFriendly[no], near[Café Rouge]"	"The Cricketers is a restaurant which serves English food in the high price range. It has an average customer rating and is located in the riverside area, near Café Rouge. It is not family friendly."
"name[The Mill], eatType[pub], food[English], priceRange[high], area[riverside], familyFriendly[yes], near[Raja Indian Cuisine]"	"The Mill is a family-friendly pub which serves English food in the high price range. It is located in the riverside area, near Raja Indian Cuisine."
"name[The Mill], eatType[pub], food[English], priceRange[less than £20], area[city centre], familyFriendly[no], near[Raja Indian Cuisine]"	"The Mill is a pub which serves English food in the price range of less than £20. It is located in the city centre area, near Raja Indian Cuisine. It is not family friendly."
"name[The Mill], eatType[pub], food[English], priceRange[less than £20], area[city centre], familyFriendly[yes], near[Raja Indian Cuisine]"	"The Mill is a family-friendly pub which serves English food in the price range of less than £20. It is located in the city centre area, near Raja Indian Cuisine."
"name[The Mill], eatType[pub], food[English], priceRange[less than £20], area[riverside], familyFriendly[no], near[Raja Indian Cuisine]"	"The Mill is a pub which serves English food in the price range of less than £20. It is located in the riverside area, near Raja Indian Cuisine. It is not family friendly."
"name[The Mill], eatType[pub], food[English], priceRange[less than £20], area[riverside], familyFriendly[yes], near[Raja Indian Cuisine]"	"The Mill is a family-friendly pub which serves English food in the price range of less than £20. It is located in the riverside area, near Raja Indian Cuisine."
"name[The Mill], eatType[pub], food[English], priceRange[moderate], area[city centre], familyFriendly[no], near[Raja Indian Cuisine]"	"The Mill is a pub which serves English food in the moderate price range. It is located in the city centre area, near Raja Indian Cuisine. It is not family friendly."
"name[The Mill], eatType[pub], food[English], priceRange[moderate], area[city centre], familyFriendly[yes], near[Raja Indian Cuisine]"	"The Mill is a family-friendly pub which serves English food in the moderate price range. It is located in the city centre area, near Raja Indian Cuisine."
"name[The Mill], eatType[pub], food[English], priceRange[moderate], area[riverside], familyFriendly[no], near[Raja Indian Cuisine]"	"The Mill is a pub which serves English food in the moderate price range. It is located in the riverside area, near Raja Indian Cuisine. It is not family friendly."
"name[The Mill], eatType[pub], food[English], priceRange[moderate], area[riverside], familyFriendly[yes], near[Raja Indian Cuisine]"	"The Mill is a family-friendly pub which serves English food in the moderate price range. It is located in the riverside area, near Raja Indian Cuisine."
"name[The Mill], eatType[pub], food[English], priceRange[more than £30], area[riverside], familyFriendly[yes], near[Raja Indian Cuisine]"	"The Mill is a family-friendly pub which serves English food in the price range of more than £30. It is located in the riverside area, near Raja Indian Cuisine."
"name[The Mill], eatType[pub], food[Fast food], priceRange[£20-25], area[riverside], familyFriendly[yes], near[Raja Indian Cuisine]"	"The Mill is a family-friendly pub which serves fast food in the price range of £20-25. It is located in the riverside area, near Raja Indian Cuisine."
"name[The Mill], eatType[pub], food[Fast food], priceRange[£20-25], customer rating[high], area[city centre], familyFriendly[no], near[Café Rouge]"	"The Mill is a pub which serves fast food in the price range of £20-25. It has a high customer rating and is located in the city centre area, near Café Rouge. It is not family friendly."
"name[The Mill], eatType[pub], food[Fast food], priceRange[£20-25], customer rating[high], area[city centre], familyFriendly[yes], near[Café Rouge]"	"The Mill is a family-friendly pub which serves fast food in the price range of £20-25. It has a high customer rating and is located in the city centre area, near Café Rouge."
"name[The Mill], eatType[pub], food[Fast food], priceRange[£20-25], customer rating[high], area[riverside], familyFriendly[no], near[Café Rouge]"	"The Mill is a pub which serves fast food in the price range of £20-25. It has a high customer rating and is located in the riverside area, near Café Rouge. It is not family friendly."
"name[The Mill], eatType[pub], food[Fast food], priceRange[£20-25], customer rating[high], area[riverside], familyFriendly[yes], near[Café Rouge]"	"The Mill is a family-friendly pub which serves fast food in the price range of £20-25. It has a high customer rating and is located in the riverside area, near Café Rouge."
"name[The Mill], eatType[pub], food[Fast food], priceRange[£20-25], customer rating[high], area[riverside], familyFriendly[yes], near[Café Sicilia]"	"The Mill is a family-friendly pub which serves fast food in the price range of £20-25. It has a high customer rating and is located in the riverside area, near Café Sicilia."
"name[The Mill], eatType[pub], food[Fast food], priceRange[cheap], area[riverside], familyFriendly[yes], near[Raja Indian Cuisine]"	"The Mill is a family-friendly pub which serves fast food in the low price range. It is located in the riverside area, near Raja Indian Cuisine."
"name[The Mill], eatType[pub], food[Fast food], priceRange[cheap], customer rating[5 out of 5], area[city centre], familyFriendly[no], near[Café Sicilia]"	"The Mill is a pub which serves fast food in the low price range. It has a customer rating of 5 out of 5 and is located in the city centre area, near Café Sicilia. It is not family friendly."
"name[The Mill], eatType[pub], food[Fast food], priceRange[cheap], customer rating[5 out of 5], area[city centre], familyFriendly[yes], near[Café Sicilia]"	"The Mill is a family-friendly pub which serves fast food in the low price range. It has a customer rating of 5 out of 5 and is located in the city centre area, near Café Sicilia."
"name[The Mill], eatType[pub], food[Fast food], priceRange[cheap], customer rating[5 out of 5], area[riverside], familyFriendly[no], near[Café Sicilia]"	"The Mill is a pub which serves fast food in the low price range. It has a customer rating of 5 out of 5 and is located in the riverside area, near Café Sicilia. It is not family friendly."
"name[The Mill], eatType[pub], food[Fast food], priceRange[cheap], customer rating[5 out of 5], area[riverside], familyFriendly[yes], near[Café Sicilia]"	"The Mill is a family-friendly pub which serves fast food in the low price range. It has a customer rating of 5 out of 5 and is located in the riverside area, near Café Sicilia."
"name[The Mill], eatType[pub], food[Fast food], priceRange[cheap], customer rating[average], area[city centre], familyFriendly[no], near[Café Sicilia]"	"The Mill is a pub which serves fast food in the low price range. It has an average customer rating and is located in the city centre area, near Café Sicilia. It is not family friendly."
"name[The Mill], eatType[pub], food[Fast food], priceRange[cheap], customer rating[average], area[city centre], familyFriendly[yes], near[Café Sicilia]"	"The Mill is a family-friendly pub which serves fast food in the low price range. It has an average customer rating and is located in the city centre area, near Café Sicilia."
"name[The Mill], eatType[pub], food[Fast food], priceRange[cheap], customer rating[average], area[riverside], familyFriendly[no], near[Café Sicilia]"	"The Mill is a pub which serves fast food in the low price range. It has an average customer rating and is located in the riverside area, near Café Sicilia. It is not family friendly."
"name[The Mill], eatType[pub], food[Fast food], priceRange[cheap], customer rating[average], area[riverside], familyFriendly[yes], near[Café Sicilia]"	"The Mill is a family-friendly pub which serves fast food in the low price range. It has an average customer rating and is located in the riverside area, near Café Sicilia."
"name[The Mill], eatType[pub], food[Fast food], priceRange[high], customer rating[1 out of 5], area[city centre], familyFriendly[no], near[Café Sicilia]"	"The Mill is a pub which serves fast food in the high price range. It has a customer rating of 1 out of 5 and is located in the city centre area, near Café Sicilia. It is not family friendly."
"name[The Mill], eatType[pub], food[Fast food], priceRange[high], customer rating[1 out of 5], area[city centre], familyFriendly[yes], near[Café Sicilia]"	"The Mill is a family-friendly pub which serves fast food in the high price range. It has a customer rating of 1 out of 5 and is located in the city centre area, near Café Sicilia."
"name[The Mill], eatType[pub], food[Fast food], priceRange[high], customer rating[1 out of 5], area[riverside], familyFriendly[no], near[Café Sicilia]"	"The Mill is a pub which serves fast food in the high price range. It has a customer rating of 1 out of 5 and is located in the riverside area, near Café Sicilia. It is not family friendly."
"name[The Mill], eatType[pub], food[Fast food], priceRange[high], customer rating[1 out of 5], area[riverside], familyFriendly[yes], near[Café Sicilia]"	"The Mill is a family-friendly pub which serves fast food in the high price range. It has a customer rating of 1 out of 5 and is located in the riverside area, near Café Sicilia."
"name[The Mill], eatType[pub], food[Fast food], priceRange[high], customer rating[average], area[city centre], familyFriendly[no], near[Café Sicilia]"	"The Mill is a pub which serves fast food in the high price range. It has an average customer rating and is located in the city centre area, near Café Sicilia. It is not family friendly."
"name[The Mill], eatType[pub], food[Fast food], priceRange[high], customer rating[average], area[city centre], familyFriendly[yes], near[Café Sicilia]"	"The Mill is a family-friendly pub which serves fast food in the high price range. It has an average customer rating and is located in the city centre area, near Café Sicilia."
"name[The Mill], eatType[pub], food[Fast food], priceRange[high], customer rating[average], area[riverside], familyFriendly[no], near[Café Sicilia]"	"The Mill is a pub which serves fast food in the high price range. It has an average customer rating and is located in the riverside area, near Café Sicilia. It is not family friendly."
"name[The Mill], eatType[pub], food[Fast food], priceRange[high], customer rating[average], area[riverside], familyFriendly[yes], near[Café Sicilia]"	"The Mill is a family-friendly pub which serves fast food in the high price range. It has an average customer rating and is located in the riverside area, near Café Sicilia."
"name[The Mill], eatType[pub], food[Fast food], priceRange[less than £20], customer rating[low], area[city centre], familyFriendly[no], near[Café Sicilia]"	"The Mill is a pub which serves fast food in the price range of less than £20. It has a low customer rating and is located in the city centre area, near Café Sicilia. It is not family friendly."
"name[The Mill], eatType[pub], food[Fast food], priceRange[less than £20], customer rating[low], area[city centre], familyFriendly[yes], near[Café Sicilia]"	"The Mill is a family-friendly pub which serves fast food in the price range of less than £20. It has a low customer rating and is located in the city centre area, near Café Sicilia."
"name[The Mill], eatType[pub], food[Fast food], priceRange[less than £20], customer rating[low], area[riverside], familyFriendly[no], near[Café Sicilia]"	"The Mill is a pub which serves fast food in the price range of less than £20. It has a low customer rating and is located in the riverside area, near Café Sicilia. It is not family friendly."
"name[The Mill], eatType[pub], food[Fast food], priceRange[less than £20], customer rating[low], area[riverside], familyFriendly[yes], near[Café Sicilia]"	"The Mill is a family-friendly pub which serves fast food in the price range of less than £20. It has a low customer rating and is located in the riverside area, near Café Sicilia."
"name[The Mill], eatType[pub], food[Fast food], priceRange[moderate], customer rating[1 out of 5], area[city centre], familyFriendly[no], near[Café Sicilia]"	"The Mill is a pub which serves fast food in the moderate price range. It has a customer rating of 1 out of 5 and is located in the city centre area, near Café Sicilia. It is not family friendly."
"name[The Mill], eatType[pub], food[Fast food], priceRange[moderate], customer rating[1 out of 5], area[city centre], familyFriendly[yes], near[Café Sicilia]"	"The Mill is a family-friendly pub which serves fast food in the moderate price range. It has a customer rating of 1 out of 5 and is located in the city centre area, near Café Sicilia."
"name[The Mill], eatType[pub], food[Fast food], priceRange[moderate], customer rating[1 out of 5], area[riverside], familyFriendly[no], near[Café Sicilia]"	"The Mill is a pub which serves fast food in the moderate price range. It has a customer rating of 1 out of 5 and is located in the riverside area, near Café Sicilia. It is not family friendly."
"name[The Mill], eatType[pub], food[Fast food], priceRange[moderate], customer rating[1 out of 5], area[riverside], familyFriendly[yes], near[Café Sicilia]"	"The Mill is a family-friendly pub which serves fast food in the moderate price range. It has a customer rating of 1 out of 5 and is located in the riverside area, near Café Sicilia."
"name[The Mill], eatType[pub], food[Fast food], priceRange[moderate], customer rating[3 out of 5], area[city centre], familyFriendly[no], near[Café Sicilia]"	"The Mill is a pub which serves fast food in the moderate price range. It has a customer rating of 3 out of 5 and is located in the city centre area, near Café Sicilia. It is not family friendly."
"name[The Mill], eatType[pub], food[Fast food], priceRange[moderate], customer rating[3 out of 5], area[city centre], familyFriendly[yes], near[Café Sicilia]"	"The Mill is a family-friendly pub which serves fast food in the moderate price range. It has a customer rating of 3 out of 5 and is located in the city centre area, near Café Sicilia."
"name[The Mill], eatType[pub], food[Fast food], priceRange[moderate], customer rating[3 out of 5], area[riverside], familyFriendly[no], near[Café Sicilia]"	"The Mill is a pub which serves fast food in the moderate price range. It has a customer rating of 3 out of 5 and is located in the riverside area, near Café Sicilia. It is not family friendly."
"name[The Mill], eatType[pub], food[Fast food], priceRange[moderate], customer rating[3 out of 5], area[riverside], familyFriendly[yes], near[Café Sicilia]"	"The Mill is a family-friendly pub which serves fast food in the moderate price range. It has a customer rating of 3 out of 5 and is located in the riverside area, near Café Sicilia."
"name[The Mill], eatType[restaurant], food[English], priceRange[high], area[riverside], familyFriendly[yes], near[Raja Indian Cuisine]"	"The Mill is a family-friendly restaurant which serves English food in the high price range. It is located in the riverside area, near Raja Indian Cuisine."
"name[The Mill], eatType[restaurant], food[English], priceRange[high], customer rating[average], area[riverside], familyFriendly[yes], near[Café Rouge]"	"The Mill is a family-friendly restaurant which serves English food in the high price range. It has an average customer rating and is located in the riverside area, near Café Rouge."
"name[The Mill], eatType[restaurant], food[English], priceRange[less than £20], area[city centre], familyFriendly[no], near[Raja Indian Cuisine]"	"The Mill is a restaurant which serves English food in the price range of less than £20. It is located in the city centre area, near Raja Indian Cuisine. It is not family friendly."
"name[The Mill], eatType[restaurant], food[English], priceRange[less than £20], area[city centre], familyFriendly[yes], near[Raja Indian Cuisine]"	"The Mill is a family-friendly restaurant which serves English food in the price range of less than £20. It is located in the city centre area, near Raja Indian Cuisine."
"name[The Mill], eatType[restaurant], food[English], priceRange[less than £20], area[riverside], familyFriendly[no], near[Raja Indian Cuisine]"	"The Mill is a restaurant which serves English food in the price range of less than £20. It is located in the riverside area, near Raja Indian Cuisine. It is not family friendly."
"name[The Mill], eatType[restaurant], food[English], priceRange[less than £20], area[riverside], familyFriendly[yes], near[Raja Indian Cuisine]"	"The Mill is a family-friendly restaurant which serves English food in the price range of less than £20. It is located in the riverside area, near Raja Indian Cuisine."
"name[The Mill], eatType[restaurant], food[English], priceRange[less than £20], customer rating[low], area[city centre], familyFriendly[no], near[Café Rouge]"	"The Mill is a restaurant which serves English food in the price range of less than £20. It has a low customer rating and is located in the city centre area, near Café Rouge. It is not family friendly."
"name[The Mill], eatType[restaurant], food[English], priceRange[less than £20], customer rating[low], area[city centre], familyFriendly[yes], near[Café Rouge]"	"The Mill is a family-friendly restaurant which serves English food in the price range of less than £20. It has a low customer rating and is located in the city centre area, near Café Rouge."
"name[The Mill], eatType[restaurant], food[English], priceRange[less than £20], customer rating[low], area[riverside], familyFriendly[no], near[Café Rouge]"	"The Mill is a restaurant which serves English food in the price range of less than £20. It has a low customer rating and is located in the riverside area, near Café Rouge. It is not family friendly."
"name[The Mill], eatType[restaurant], food[English], priceRange[less than £20], customer rating[low], area[riverside], familyFriendly[yes], near[Café Rouge]"	"The Mill is a family-friendly restaurant which serves English food in the price range of less than £20. It has a low customer rating and is located in the riverside area, near Café Rouge."
"name[The Mill], eatType[restaurant], food[English], priceRange[moderate], area[city centre], familyFriendly[no], near[Raja Indian Cuisine]"	"The Mill is a restaurant which serves English food in the moderate price range. It is located in the city centre area, near Raja Indian Cuisine. It is not family friendly."
"name[The Mill], eatType[restaurant], food[English], priceRange[moderate], area[city centre], familyFriendly[yes], near[Raja Indian Cuisine]"	"The Mill is a family-friendly restaurant which serves English food in the moderate price range. It is located in the city centre area, near Raja Indian Cuisine."
"name[The Mill], eatType[restaurant], food[English], priceRange[moderate], area[riverside], familyFriendly[no], near[Raja Indian Cuisine]"	"The Mill is a restaurant which serves English food in the moderate price range. It is located in the riverside area, near Raja Indian Cuisine. It is not family friendly."
"name[The Mill], eatType[restaurant], food[English], priceRange[moderate], area[riverside], familyFriendly[yes], near[Raja Indian Cuisine]"	"The Mill is a family-friendly restaurant which serves English food in the moderate price range. It is located in the riverside area, near Raja Indian Cuisine."
"name[The Mill], eatType[restaurant], food[English], priceRange[moderate], customer rating[1 out of 5], area[city centre], familyFriendly[no], near[Café Rouge]"	"The Mill is a restaurant which serves English food in the moderate price range. It has a customer rating of 1 out of 5 and is located in the city centre area, near Café Rouge. It is not family friendly."
"name[The Mill], eatType[restaurant], food[English], priceRange[moderate], customer rating[1 out of 5], area[city centre], familyFriendly[yes], near[Café Rouge]"	"The Mill is a family-friendly restaurant which serves English food in the moderate price range. It has a customer rating of 1 out of 5 and is located in the city centre area, near Café Rouge."
"name[The Mill], eatType[restaurant], food[English], priceRange[moderate], customer rating[1 out of 5], area[riverside], familyFriendly[no], near[Café Rouge]"	"The Mill is a restaurant which serves English food in the moderate price range. It has a customer rating of 1 out of 5 and is located in the riverside area, near Café Rouge. It is not family friendly."
"name[The Mill], eatType[restaurant], food[English], priceRange[moderate], customer rating[1 out of 5], area[riverside], familyFriendly[yes], near[Café Rouge]"	"The Mill is a family-friendly restaurant which serves English food in the moderate price range. It has a customer rating of 1 out of 5 and is located in the riverside area, near Café Rouge."
"name[The Mill], eatType[restaurant], food[English], priceRange[moderate], customer rating[3 out of 5], area[city centre], familyFriendly[no], near[Café Rouge]"	"The Mill is a restaurant which serves English food in the moderate price range. It has a customer rating of 3 out of 5 and is located in the city centre area, near Café Rouge. It is not family friendly."
"name[The Mill], eatType[restaurant], food[English], priceRange[moderate], customer rating[3 out of 5], area[city centre], familyFriendly[yes], near[Café Rouge]"	"The Mill is a family-friendly restaurant which serves English food in the moderate price range. It has a customer rating of 3 out of 5 and is located in the city centre area, near Café Rouge."
"name[The Mill], eatType[restaurant], food[English], priceRange[moderate], customer rating[3 out of 5], area[riverside], familyFriendly[no], near[Café Rouge]"	"The Mill is a restaurant which serves English food in the moderate price range. It has a customer rating of 3 out of 5 and is located in the riverside area, near Café Rouge. It is not family friendly."
"name[The Mill], eatType[restaurant], food[English], priceRange[moderate], customer rating[3 out of 5], area[riverside], familyFriendly[yes], near[Café Rouge]"	"The Mill is a family-friendly restaurant which serves English food in the moderate price range. It has a customer rating of 3 out of 5 and is located in the riverside area, near Café Rouge."
"name[The Mill], eatType[restaurant], food[English], priceRange[more than £30], area[riverside], familyFriendly[yes], near[Raja Indian Cuisine]"	"The Mill is a family-friendly restaurant which serves English food in the price range of more than £30. It is located in the riverside area, near Raja Indian Cuisine."
"name[The Mill], eatType[restaurant], food[English], priceRange[more than £30], customer rating[high], area[city centre], familyFriendly[no], near[Café Rouge]"	"The Mill is a restaurant which serves English food in the price range of more than £30. It has a high customer rating and is located in the city centre area, near Café Rouge. It is not family friendly."
"name[The Mill], eatType[restaurant], food[English], priceRange[more than £30], customer rating[high], area[city centre], familyFriendly[yes], near[Café Rouge]"	"The Mill is a family-friendly restaurant which serves English food in the price range of more than £30. It has a high customer rating and is located in the city centre area, near Café Rouge."
"name[The Mill], eatType[restaurant], food[English], priceRange[more than £30], customer rating[high], area[riverside], familyFriendly[no], near[Café Rouge]"	"The Mill is a restaurant which serves English food in the price range of more than £30. It has a high customer rating and is located in the riverside area, near Café Rouge. It is not family friendly."
"name[The Mill], eatType[restaurant], food[English], priceRange[more than £30], customer rating[high], area[riverside], familyFriendly[yes], near[Café Rouge]"	"The Mill is a family-friendly restaurant which serves English food in the price range of more than £30. It has a high customer rating and is located in the riverside area, near Café Rouge."
"name[The Mill], eatType[restaurant], food[Fast food], priceRange[£20-25], area[riverside], familyFriendly[yes], near[Raja Indian Cuisine]"	"The Mill is a family-friendly restaurant which serves fast food in the price range of £20-25. It is located in the riverside area, near Raja Indian Cuisine."
"name[The Mill], eatType[restaurant], food[Fast food], priceRange[cheap], area[riverside], familyFriendly[yes], near[Raja Indian Cuisine]"	"The Mill is a family-friendly restaurant which serves fast food in the low price range. It is located in the riverside area, near Raja Indian Cuisine."
"name[The Phoenix], eatType[pub], food[Fast food], priceRange[cheap], area[riverside], familyFriendly[yes], near[Raja Indian Cuisine]"	"The Phoenix is a family-friendly pub which serves fast food in the low price range. It is located in the riverside area, near Raja Indian Cuisine."
"name[The Phoenix], eatType[pub], food[Fast food], priceRange[high], area[city centre], familyFriendly[no], near[Raja Indian Cuisine]"	"The Phoenix is a pub which serves fast food in the high price range. It is located in the city centre area, near Raja Indian Cuisine. It is not family friendly."
"name[The Phoenix], eatType[pub], food[Fast food], priceRange[high], area[city centre], familyFriendly[yes], near[Raja Indian Cuisine]"	"The Phoenix is a family-friendly pub which serves fast food in the high price range. It is located in the city centre area, near Raja Indian Cuisine."
"name[The Phoenix], eatType[pub], food[Fast food], priceRange[high], area[riverside], familyFriendly[no], near[Raja Indian Cuisine]"	"The Phoenix is a pub which serves fast food in the high price range. It is located in the riverside area, near Raja Indian Cuisine. It is not family friendly."
"name[The Phoenix], eatType[pub], food[Fast food], priceRange[high], area[riverside], familyFriendly[yes], near[Raja Indian Cuisine]"	"The Phoenix is a family-friendly pub which serves fast food in the high price range. It is located in the riverside area, near Raja Indian Cuisine."
"name[The Phoenix], eatType[pub], food[Fast food], priceRange[less than £20], area[city centre], familyFriendly[no], near[Raja Indian Cuisine]"	"The Phoenix is a pub which serves fast food in the price range of less than £20. It is located in the city centre area, near Raja Indian Cuisine. It is not family friendly."
"name[The Phoenix], eatType[pub], food[Fast food], priceRange[less than £20], area[city centre], familyFriendly[yes], near[Raja Indian Cuisine]"	"The Phoenix is a family-friendly pub which serves fast food in the price range of less than £20. It is located in the city centre area, near Raja Indian Cuisine."
"name[The Phoenix], eatType[pub], food[Fast food], priceRange[less than £20], area[riverside], familyFriendly[no], near[Raja Indian Cuisine]"	"The Phoenix is a pub which serves fast food in the price range of less than £20. It is located in the riverside area, near Raja Indian Cuisine. It is not family friendly."
"name[The Phoenix], eatType[pub], food[Fast food], priceRange[less than £20], area[riverside], familyFriendly[yes], near[Raja Indian Cuisine]"	"The Phoenix is a family-friendly pub which serves fast food in the price range of less than £20. It is located in the riverside area, near Raja Indian Cuisine."
"name[The Phoenix], eatType[pub], food[Fast food], priceRange[moderate], area[city centre], familyFriendly[no], near[Raja Indian Cuisine]"	"The Phoenix is a pub which serves fast food in the moderate price range. It is located in the city centre area, near Raja Indian Cuisine. It is not family friendly."
"name[The Phoenix], eatType[pub], food[Fast food], priceRange[moderate], area[city centre], familyFriendly[yes], near[Raja Indian Cuisine]"	"The Phoenix is a family-friendly pub which serves fast food in the moderate price range. It is located in the city centre area, near Raja Indian Cuisine."
"name[The Phoenix], eatType[pub], food[Fast food], priceRange[moderate], area[riverside], familyFriendly[no], near[Raja Indian Cuisine]"	"The Phoenix is a pub which serves fast food in the moderate price range. It is located in the riverside area, near Raja Indian Cuisine. It is not family friendly."
"name[The Phoenix], eatType[pub], food[Fast food], priceRange[moderate], area[riverside], familyFriendly[yes], near[Raja Indian Cuisine]"	"The Phoenix is a family-friendly pub which serves fast food in the moderate price range. It is located in the riverside area, near Raja Indian Cuisine."
"name[The Phoenix], eatType[pub], food[Fast food], priceRange[moderate], customer rating[3 out of 5], area[riverside], familyFriendly[yes], near[Café Sicilia]"	"The Phoenix is a family-friendly pub which serves fast food in the moderate price range. It has a customer rating of 3 out of 5 and is located in the riverside area, near Café Sicilia."
"name[The Phoenix], eatType[pub], food[Fast food], priceRange[more than £30], area[riverside], familyFriendly[yes], near[Raja Indian Cuisine]"	"The Phoenix is a family-friendly pub which serves fast food in the price range of more than £30. It is located in the riverside area, near Raja Indian Cuisine."
"name[The Phoenix], eatType[pub], food[Fast food], priceRange[more than £30], customer rating[high], area[city centre], familyFriendly[no], near[Café Sicilia]"	"The Phoenix is a pub which serves fast food in the price range of more than £30. It has a high customer rating and is located in the city centre area, near Café Sicilia. It is not family friendly."
"name[The Phoenix], eatType[pub], food[Fast food], priceRange[more than £30], customer rating[high], area[city centre], familyFriendly[yes], near[Café Sicilia]"	"The Phoenix is a family-friendly pub which serves fast food in the price range of more than £30. It has a high customer rating and is located in the city centre area, near Café Sicilia."
"name[The Phoenix], eatType[pub], food[Fast food], priceRange[more than £30], customer rating[high], area[riverside], familyFriendly[no], near[Café Sicilia]"	"The Phoenix is a pub which serves fast food in the price range of more than £30. It has a high customer rating and is located in the riverside area, near Café Sicilia. It is not family friendly."
"name[The Phoenix], eatType[pub], food[Fast food], priceRange[more than £30], customer rating[high], area[riverside], familyFriendly[yes], near[Café Sicilia]"	"The Phoenix is a family-friendly pub which serves fast food in the price range of more than £30. It has a high customer rating and is located in the riverside area, near Café Sicilia."
"name[The Phoenix], eatType[pub], food[French], priceRange[£20-25], area[riverside], familyFriendly[yes], near[Raja Indian Cuisine]"	"The Phoenix is a family-friendly pub which serves French food in the price range of £20-25. It is located in the riverside area, near Raja Indian Cuisine."
"name[The Phoenix], eatType[pub], food[French], priceRange[£20-25], customer rating[3 out of 5], area[city centre], familyFriendly[no], near[Café Sicilia]"	"The Phoenix is a pub which serves French food in the price range of £20-25. It has a customer rating of 3 out of 5 and is located in the city centre area, near Café Sicilia. It is not family friendly."
"name[The Phoenix], eatType[pub], food[French], priceRange[£20-25], customer rating[3 out of 5], area[city centre], familyFriendly[yes], near[Café Sicilia]"	"The Phoenix is a family-friendly pub which serves French food in the price range of £20-25. It has a customer rating of 3 out of 5 and is located in the city centre area, near Café Sicilia."
"name[The Phoenix], eatType[pub], food[French], priceRange[£20-25], customer rating[3 out of 5], area[riverside], familyFriendly[no], near[Café Sicilia]"	"The Phoenix is a pub which serves French food in the price range of £20-25. It has a customer rating of 3 out of 5 and is located in the riverside area, near Café Sicilia. It is not family friendly."
"name[The Phoenix], eatType[pub], food[French], priceRange[£20-25], customer rating[3 out of 5], area[riverside], familyFriendly[yes], near[Café Sicilia]"	"The Phoenix is a family-friendly pub which serves French food in the price range of £20-25. It has a customer rating of 3 out of 5 and is located in the riverside area, near Café Sicilia."
"name[The Phoenix], eatType[pub], food[French], priceRange[£20-25], customer rating[3 out of 5], area[riverside], familyFriendly[yes], near[Crowne Plaza Hotel]"	"The Phoenix is a family-friendly pub which serves French food in the price range of £20-25. It has a customer rating of 3 out of 5 and is located in the riverside area, near Crowne Plaza Hotel."
"name[The Phoenix], eatType[pub], food[French], priceRange[£20-25], customer rating[high], area[city centre], familyFriendly[no], near[Crowne Plaza Hotel]"	"The Phoenix is a pub which serves French food in the price range of £20-25. It has a high customer rating and is located in the city centre area, near Crowne Plaza Hotel. It is not family friendly."
"name[The Phoenix], eatType[pub], food[French], priceRange[£20-25], customer rating[high], area[city centre], familyFriendly[yes], near[Crowne Plaza Hotel]"	"The Phoenix is a family-friendly pub which serves French food in the price range of £20-25. It has a high customer rating and is located in the city centre area, near Crowne Plaza Hotel."
"name[The Phoenix], eatType[pub], food[French], priceRange[£20-25], customer rating[high], area[riverside], familyFriendly[no], near[Crowne Plaza Hotel]"	"The Phoenix is a pub which serves French food in the price range of £20-25. It has a high customer rating and is located in the riverside area, near Crowne Plaza Hotel. It is not family friendly."
"name[The Phoenix], eatType[pub], food[French], priceRange[£20-25], customer rating[high], area[riverside], familyFriendly[yes], near[Crowne Plaza Hotel]"	"The Phoenix is a family-friendly pub which serves French food in the price range of £20-25. It has a high customer rating and is located in the riverside area, near Crowne Plaza Hotel."
"name[The Phoenix], eatType[pub], food[French], priceRange[cheap], area[riverside], familyFriendly[yes], near[Raja Indian Cuisine]"	"The Phoenix is a family-friendly pub which serves French food in the low price range. It is located in the riverside area, near Raja Indian Cuisine."
"name[The Phoenix], eatType[pub], food[French], priceRange[cheap], customer rating[5 out of 5], area[city centre], familyFriendly[no], near[Crowne Plaza Hotel]"	"The Phoenix is a pub which serves French food in the low price range. It has a customer rating of 5 out of 5 and is located in the city centre area, near Crowne Plaza Hotel. It is not family friendly."
"name[The Phoenix], eatType[pub], food[French], priceRange[cheap], customer rating[5 out of 5], area[city centre], familyFriendly[yes], near[Crowne Plaza Hotel]"	"The Phoenix is a family-friendly pub which serves French food in the low price range. It has a customer rating of 5 out of 5 and is located in the city centre area, near Crowne Plaza Hotel."
"name[The Phoenix], eatType[pub], food[French], priceRange[cheap], customer rating[5 out of 5], area[riverside], familyFriendly[no], near[Crowne Plaza Hotel]"	"The Phoenix is a pub which serves French food in the low price range. It has a customer rating of 5 out of 5 and is located in the riverside area, near Crowne Plaza Hotel. It is not family friendly."
"name[The Phoenix], eatType[pub], food[French], priceRange[cheap], customer rating[5 out of 5], area[riverside], familyFriendly[yes], near[Crowne Plaza Hotel]"	"The Phoenix is a family-friendly pub which serves French food in the low price range. It has a customer rating of 5 out of 5 and is located in the riverside area, near Crowne Plaza Hotel."
"name[The Phoenix], eatType[pub], food[French], priceRange[high], area[riverside], familyFriendly[yes], near[Raja Indian Cuisine]"	"The Phoenix is a family-friendly pub which serves French food in the high price range. It is located in the riverside area, near Raja Indian Cuisine."
"name[The Phoenix], eatType[pub], food[French], priceRange[high], customer rating[3 out of 5], area[city centre], familyFriendly[no], near[Crowne Plaza Hotel]"	"The Phoenix is a pub which serves French food in the high price range. It has a customer rating of 3 out of 5 and is located in the city centre area, near Crowne Plaza Hotel. It is not family friendly."
"name[The Phoenix], eatType[pub], food[French], priceRange[high], customer rating[3 out of 5], area[city centre], familyFriendly[yes], near[Crowne Plaza Hotel]"	"The Phoenix is a family-friendly pub which serves French food in the high price range. It has a customer rating of 3 out of 5 and is located in the city centre area, near Crowne Plaza Hotel."
"name[The Phoenix], eatType[pub], food[French], priceRange[high], customer rating[3 out of 5], area[riverside], familyFriendly[no], near[Crowne Plaza Hotel]"	"The Phoenix is a pub which serves French food in the high price range. It has a customer rating of 3 out of 5 and is located in the riverside area, near Crowne Plaza Hotel. It is not family friendly."
"name[The Phoenix], eatType[pub], food[French], priceRange[high], customer rating[3 out of 5], area[riverside], familyFriendly[yes], near[Crowne Plaza Hotel]"	"The Phoenix is a family-friendly pub which serves French food in the high price range. It has a customer rating of 3 out of 5 and is located in the riverside area, near Crowne Plaza Hotel."
"name[The Phoenix], eatType[pub], food[French], priceRange[less than £20], customer rating[average], area[city centre], familyFriendly[no], near[Crowne Plaza Hotel]"	"The Phoenix is a pub which serves French food in the price range of less than £20. It has an average customer rating and is located in the city centre area, near Crowne Plaza Hotel. It is not family friendly."
"name[The Phoenix], eatType[pub], food[French], priceRange[less than £20], customer rating[average], area[city centre], familyFriendly[yes], near[Crowne Plaza Hotel]"	"The Phoenix is a family-friendly pub which serves French food in the price range of less than £20. It has an average customer rating and is located in the city centre area, near Crowne Plaza Hotel."
"name[The Phoenix], eatType[pub], food[French], priceRange[less than £20], customer rating[average], area[riverside], familyFriendly[no], near[Crowne Plaza Hotel]"	"The Phoenix is a pub which serves French food in the price range of less than £20. It has an average customer rating and is located in the riverside area, near Crowne Plaza Hotel. It is not family friendly."
"name[The Phoenix], eatType[pub], food[French], priceRange[less than £20], customer rating[average], area[riverside], familyFriendly[yes], near[Crowne Plaza Hotel]"	"The Phoenix is a family-friendly pub which serves French food in the price range of less than £20. It has an average customer rating and is located in the riverside area, near Crowne Plaza Hotel."
"name[The Phoenix], eatType[pub], food[French], priceRange[less than £20], customer rating[low], area[city centre], familyFriendly[no], near[Crowne Plaza Hotel]"	"The Phoenix is a pub which serves French food in the price range of less than £20. It has a low customer rating and is located in the city centre area, near Crowne Plaza Hotel. It is not family friendly."
"name[The Phoenix], eatType[pub], food[French], priceRange[less than £20], customer rating[low], area[city centre], familyFriendly[yes], near[Crowne Plaza Hotel]"	"The Phoenix is a family-friendly pub which serves French food in the price range of less than £20. It has a low customer rating and is located in the city centre area, near Crowne Plaza Hotel."
"name[The Phoenix], eatType[pub], food[French], priceRange[less than £20], customer rating[low], area[riverside], familyFriendly[no], near[Crowne Plaza Hotel]"	"The Phoenix is a pub which serves French food in the price range of less than £20. It has a low customer rating and is located in the riverside area, near Crowne Plaza Hotel. It is not family friendly."
"name[The Phoenix], eatType[pub], food[French], priceRange[less than £20], customer rating[low], area[riverside], familyFriendly[yes], near[Crowne Plaza Hotel]"	"The Phoenix is a family-friendly pub which serves French food in the price range of less than £20. It has a low customer rating and is located in the riverside area, near Crowne Plaza Hotel."
"name[The Phoenix], eatType[pub], food[French], priceRange[moderate], customer rating[1 out of 5], area[city centre], familyFriendly[no], near[Crowne Plaza Hotel]"	"The Phoenix is a pub which serves French food in the moderate price range. It has a customer rating of 1 out of 5 and is located in the city centre area, near Crowne Plaza Hotel. It is not family friendly."
"name[The Phoenix], eatType[pub], food[French], priceRange[moderate], customer rating[1 out of 5], area[city centre], familyFriendly[yes], near[Crowne Plaza Hotel]"	"The Phoenix is a family-friendly pub which serves French food in the moderate price range. It has a customer rating of 1 out of 5 and is located in the city centre area, near Crowne Plaza Hotel."
"name[The Phoenix], eatType[pub], food[French], priceRange[moderate], customer rating[1 out of 5], area[riverside], familyFriendly[no], near[Crowne Plaza Hotel]"	"The Phoenix is a pub which serves French food in the moderate price range. It has a customer rating of 1 out of 5 and is located in the riverside area, near Crowne Plaza Hotel. It is not family friendly."
"name[The Phoenix], eatType[pub], food[French], priceRange[moderate], customer rating[1 out of 5], area[riverside], familyFriendly[yes], near[Crowne Plaza Hotel]"	"The Phoenix is a family-friendly pub which serves French food in the moderate price range. It has a customer rating of 1 out of 5 and is located in the riverside area, near Crowne Plaza Hotel."
"name[The Phoenix], eatType[pub], food[French], priceRange[more than £30], customer rating[5 out of 5], area[city centre], familyFriendly[no], near[Crowne Plaza Hotel]"	"The Phoenix is a pub which serves French food in the price range of more than £30. It has a customer rating of 5 out of 5 and is located in the city centre area, near Crowne Plaza Hotel. It is not family friendly."
"name[The Phoenix], eatType[pub], food[French], priceRange[more than £30], customer rating[5 out of 5], area[city centre], familyFriendly[yes], near[Crowne Plaza Hotel]"	"The Phoenix is a family-friendly pub which serves French food in the price range of more than £30. It has a customer rating of 5 out of 5 and is located in the city centre area, near Crowne Plaza Hotel."
"name[The Phoenix], eatType[pub], food[French], priceRange[more than £30], customer rating[5 out of 5], area[riverside], familyFriendly[no], near[Crowne Plaza Hotel]"	"The Phoenix is a pub which serves French food in the price range of more than £30. It has a customer rating of 5 out of 5 and is located in the riverside area, near Crowne Plaza Hotel. It is not family friendly."
"name[The Phoenix], eatType[pub], food[French], priceRange[more than £30], customer rating[5 out of 5], area[riverside], familyFriendly[yes], near[Crowne Plaza Hotel]"	"The Phoenix is a family-friendly pub which serves French food in the price range of more than £30. It has a customer rating of 5 out of 5 and is located in the riverside area, near Crowne Plaza Hotel."
"name[The Phoenix], eatType[pub], food[French], priceRange[more than £30], customer rating[low], area[city centre], familyFriendly[no], near[Crowne Plaza Hotel]"	"The Phoenix is a pub which serves French food in the price range of more than £30. It has a low customer rating and is located in the city centre area, near Crowne Plaza Hotel. It is not family friendly."
"name[The Phoenix], eatType[pub], food[French], priceRange[more than £30], customer rating[low], area[city centre], familyFriendly[yes], near[Crowne Plaza Hotel]"	"The Phoenix is a family-friendly pub which serves French food in the price range of more than £30. It has a low customer rating and is located in the city centre area, near Crowne Plaza Hotel."
"name[The Phoenix], eatType[pub], food[French], priceRange[more than £30], customer rating[low], area[riverside], familyFriendly[no], near[Crowne Plaza Hotel]"	"The Phoenix is a pub which serves French food in the price range of more than £30. It has a low customer rating and is located in the riverside area, near Crowne Plaza Hotel. It is not family friendly."
"name[The Phoenix], eatType[pub], food[French], priceRange[more than £30], customer rating[low], area[riverside], familyFriendly[yes], near[Crowne Plaza Hotel]"	"The Phoenix is a family-friendly pub which serves French food in the price range of more than £30. It has a low customer rating and is located in the riverside area, near Crowne Plaza Hotel."
"name[The Phoenix], eatType[restaurant], food[Fast food], priceRange[cheap], area[riverside], familyFriendly[yes], near[Raja Indian Cuisine]"	"The Phoenix is a family-friendly restaurant which serves fast food in the low price range. It is located in the riverside area, near Raja Indian Cuisine."
"name[The Phoenix], eatType[restaurant], food[Fast food], priceRange[high], area[city centre], familyFriendly[no], near[Raja Indian Cuisine]"	"The Phoenix is a restaurant which serves fast food in the high price range. It is located in the city centre area, near Raja Indian Cuisine. It is not family friendly."
"name[The Phoenix], eatType[restaurant], food[Fast food], priceRange[high], area[city centre], familyFriendly[yes], near[Raja Indian Cuisine]"	"The Phoenix is a family-friendly restaurant which serves fast food in the high price range. It is located in the city centre area, near Raja Indian Cuisine."
"name[The Phoenix], eatType[restaurant], food[Fast food], priceRange[high], area[riverside], familyFriendly[no], near[Raja Indian Cuisine]"	"The Phoenix is a restaurant which serves fast food in the high price range. It is located in the riverside area, near Raja Indian Cuisine. It is not family friendly."
"name[The Phoenix], eatType[restaurant], food[Fast food], priceRange[high], area[riverside], familyFriendly[yes], near[Raja Indian Cuisine]"	"The Phoenix is a family-friendly restaurant which serves fast food in the high price range. It is located in the riverside area, near Raja Indian Cuisine."
"name[The Phoenix], eatType[restaurant], food[Fast food], priceRange[less than £20], area[city centre], familyFriendly[no], near[Raja Indian Cuisine]"	"The Phoenix is a restaurant which serves fast food in the price range of less than £20. It is located in the city centre area, near Raja Indian Cuisine. It is not family friendly."
"name[The Phoenix], eatType[restaurant], food[Fast food], priceRange[less than £20], area[city centre], familyFriendly[yes], near[Raja Indian Cuisine]"	"The Phoenix is a family-friendly restaurant which serves fast food in the price range of less than £20. It is located in the city centre area, near Raja Indian Cuisine."
"name[The Phoenix], eatType[restaurant], food[Fast food], priceRange[less than £20], area[riverside], familyFriendly[no], near[Raja Indian Cuisine]"	"The Phoenix is a restaurant which serves fast food in the price range of less than £20. It is located in the riverside area, near Raja Indian Cuisine. It is not family friendly."
"name[The Phoenix], eatType[restaurant], food[Fast food], priceRange[less than £20], area[riverside], familyFriendly[yes], near[Raja Indian Cuisine]"	"The Phoenix is a family-friendly restaurant which serves fast food in the price range of less than £20. It is located in the riverside area, near Raja Indian Cuisine."
"name[The Phoenix], eatType[restaurant], food[Fast food], priceRange[moderate], area[city centre], familyFriendly[no], near[Raja Indian Cuisine]"	"The Phoenix is a restaurant which serves fast food in the moderate price range. It is located in the city centre area, near Raja Indian Cuisine. It is not family friendly."
"name[The Phoenix], eatType[restaurant], food[Fast food], priceRange[moderate], area[city centre], familyFriendly[yes], near[Raja Indian Cuisine]"	"The Phoenix is a family-friendly restaurant which serves fast food in the moderate price range. It is located in the city centre area, near Raja Indian Cuisine."
"name[The Phoenix], eatType[restaurant], food[Fast food], priceRange[moderate], area[riverside], familyFriendly[no], near[Raja Indian Cuisine]"	"The Phoenix is a restaurant which serves fast food in the moderate price range. It is located in the riverside area, near Raja Indian Cuisine. It is not family friendly."
"name[The Phoenix], eatType[restaurant], food[Fast food], priceRange[moderate], area[riverside], familyFriendly[yes], near[Raja Indian Cuisine]"	"The Phoenix is a family-friendly restaurant which serves fast food in the moderate price range. It is located in the riverside area, near Raja Indian Cuisine."
"name[The Phoenix], eatType[restaurant], food[Fast food], priceRange[more than £30], area[riverside], familyFriendly[yes], near[Raja Indian Cuisine]"	"The Phoenix is a family-friendly restaurant which serves fast food in the price range of more than £30. It is located in the riverside area, near Raja Indian Cuisine."
"name[The Phoenix], eatType[restaurant], food[French], priceRange[£20-25], area[riverside], familyFriendly[yes], near[Raja Indian Cuisine]"	"The Phoenix is a family-friendly restaurant which serves French food in the price range of £20-25. It is located in the riverside area, near Raja Indian Cuisine."
"name[The Phoenix], eatType[restaurant], food[French], priceRange[cheap], area[riverside], familyFriendly[yes], near[Raja Indian Cuisine]"	"The Phoenix is a family-friendly restaurant which serves French food in the low price range. It is located in the riverside area, near Raja Indian Cuisine."
"name[The Phoenix], eatType[restaurant], food[French], priceRange[high], area[riverside], familyFriendly[yes], near[Raja Indian Cuisine]"	"The Phoenix is a family-friendly restaurant which serves French food in the high price range. It is located in the riverside area, near Raja Indian Cuisine."
"name[The Phoenix], eatType[restaurant], food[Indian], priceRange[£20-25], customer rating[high], area[city centre], familyFriendly[no], near[Crowne Plaza Hotel]"	"The Phoenix is a restaurant which serves Indian food in the price range of £20-25. It has a high customer rating and is located in the city centre area, near Crowne Plaza Hotel. It is not family friendly."
"name[The Phoenix], eatType[restaurant], food[Indian], priceRange[£20-25], customer rating[high], area[city centre], familyFriendly[yes], near[Crowne Plaza Hotel]"	"The Phoenix is a family-friendly restaurant which serves Indian food in the price range of £20-25. It has a high customer rating and is located in the city centre area, near Crowne Plaza Hotel."
"name[The Phoenix], eatType[restaurant], food[Indian], priceRange[£20-25], customer rating[high], area[riverside], familyFriendly[no], near[Crowne Plaza Hotel]"	"The Phoenix is a restaurant which serves Indian food in the price range of £20-25. It has a high customer rating and is located in the riverside area, near Crowne Plaza Hotel. It is not family friendly."
"name[The Phoenix], eatType[restaurant], food[Indian], priceRange[£20-25], customer rating[high], area[riverside], familyFriendly[yes], near[Crowne Plaza Hotel]"	"The Phoenix is a family-friendly restaurant which serves Indian food in the price range of £20-25. It has a high customer rating and is located in the riverside area, near Crowne Plaza Hotel."
"name[The Phoenix], eatType[restaurant], food[Indian], priceRange[cheap], customer rating[5 out of 5], area[city centre], familyFriendly[no], near[Crowne Plaza Hotel]"	"The Phoenix is a restaurant which serves Indian food in the low price range. It has a customer rating of 5 out of 5 and is located in the city centre area, near Crowne Plaza Hotel. It is not family friendly."
"name[The Phoenix], eatType[restaurant], food[Indian], priceRange[cheap], customer rating[5 out of 5], area[city centre], familyFriendly[yes], near[Crowne Plaza Hotel]"	"The Phoenix is a family-friendly restaurant which serves Indian food in the low price range. It has a customer rating of 5 out of 5 and is located in the city centre area, near Crowne Plaza Hotel."
"name[The Phoenix], eatType[restaurant], food[Indian], priceRange[cheap], customer rating[5 out of 5], area[riverside], familyFriendly[no], near[Crowne Plaza Hotel]"	"The Phoenix is a restaurant which serves Indian food in the low price range. It has a customer rating of 5 out of 5 and is located in the riverside area, near Crowne Plaza Hotel. It is not family friendly."
"name[The Phoenix], eatType[restaurant], food[Indian], priceRange[cheap], customer rating[5 out of 5], area[riverside], familyFriendly[no], near[Express by Holiday Inn]"	"The Phoenix is a restaurant which serves Indian food in the low price range. It has a customer rating of 5 out of 5 and is located in the riverside area, near Express by Holiday Inn. It is not family friendly."
"name[The Phoenix], eatType[restaurant], food[Indian], priceRange[cheap], customer rating[5 out of 5], area[riverside], familyFriendly[yes], near[Express by Holiday Inn]"	"The Phoenix is a family-friendly restaurant which serves Indian food in the low price range. It has a customer rating of 5 out of 5 and is located in the riverside area, near Express by Holiday Inn."
"name[The Phoenix], eatType[restaurant], food[Indian], priceRange[cheap], customer rating[average], area[city centre], familyFriendly[no], near[Express by Holiday Inn]"	"The Phoenix is a restaurant which serves Indian food in the low price range. It has an average customer rating and is located in the city centre area, near Express by Holiday Inn. It is not family friendly."
"name[The Plough], eatType[pub], food[Chinese], priceRange[£20-25], area[riverside], familyFriendly[yes], near[Raja Indian Cuisine]"	"The Plough is a family-friendly pub which serves Chinese food in the price range of £20-25. It is located in the riverside area, near Raja Indian Cuisine."
"name[The Plough], eatType[pub], food[Chinese], priceRange[cheap], area[riverside], familyFriendly[yes], near[Raja Indian Cuisine]"	"The Plough is a family-friendly pub which serves Chinese food in the low price range. It is located in the riverside area, near Raja Indian Cuisine."
"name[The Plough], eatType[pub], food[Chinese], priceRange[high], area[city centre], familyFriendly[no], near[Raja Indian Cuisine]"	"The Plough is a pub which serves Chinese food in the high price range. It is located in the city centre area, near Raja Indian Cuisine. It is not family friendly."
"name[The Plough], eatType[pub], food[Chinese], priceRange[high], area[city centre], familyFriendly[yes], near[Raja Indian Cuisine]"	"The Plough is a family-friendly pub which serves Chinese food in the high price range. It is located in the city centre area, near Raja Indian Cuisine."
"name[The Plough], eatType[pub], food[Chinese], priceRange[high], area[riverside], familyFriendly[no], near[Raja Indian Cuisine]"	"The Plough is a pub which serves Chinese food in the high price range. It is located in the riverside area, near Raja Indian Cuisine. It is not family friendly."
"name[The Plough], eatType[pub], food[Chinese], priceRange[high], area[riverside], familyFriendly[yes], near[Raja Indian Cuisine]"	"The Plough is a family-friendly pub which serves Chinese food in the high price range. It is located in the riverside area, near Raja Indian Cuisine."
"name[The Plough], eatType[pub], food[Chinese], priceRange[less than £20], area[city centre], familyFriendly[no], near[Raja Indian Cuisine]"	"The Plough is a pub which serves Chinese food in the price range of less than £20. It is located in the city centre area, near Raja Indian Cuisine. It is not family friendly."
"name[The Plough], eatType[restaurant], food[Chinese], priceRange[£20-25], area[riverside], familyFriendly[yes], near[Raja Indian Cuisine]"	"The Plough is a family-friendly restaurant which serves Chinese food in the price range of £20-25. It is located in the riverside area, near Raja Indian Cuisine."
"name[The Plough], eatType[restaurant], food[Chinese], priceRange[cheap], area[riverside], familyFriendly[yes], near[Raja Indian Cuisine]"	"The Plough is a family-friendly restaurant which serves Chinese food in the low price range. It is located in the riverside area, near Raja Indian Cuisine."
"name[The Plough], eatType[restaurant], food[Chinese], priceRange[high], area[city centre], familyFriendly[no], near[Raja Indian Cuisine]"	"The Plough is a restaurant which serves Chinese food in the high price range. It is located in the city centre area, near Raja Indian Cuisine. It is not family friendly."
"name[The Plough], eatType[restaurant], food[Chinese], priceRange[high], area[city centre], familyFriendly[yes], near[Raja Indian Cuisine]"	"The Plough is a family-friendly restaurant which serves Chinese food in the high price range. It is located in the city centre area, near Raja Indian Cuisine."
"name[The Plough], eatType[restaurant], food[Chinese], priceRange[high], area[riverside], familyFriendly[no], near[Raja Indian Cuisine]"	"The Plough is a restaurant which serves Chinese food in the high price range. It is located in the riverside area, near Raja Indian Cuisine. It is not family friendly."
"name[The Plough], eatType[restaurant], food[Chinese], priceRange[high], area[riverside], familyFriendly[yes], near[Raja Indian Cuisine]"	"The Plough is a family-friendly restaurant which serves Chinese food in the high price range. It is located in the riverside area, near Raja Indian Cuisine."
"name[The Plough], eatType[restaurant], food[Chinese], priceRange[less than £20], area[city centre], familyFriendly[no], near[Raja Indian Cuisine]"	"The Plough is a restaurant which serves Chinese food in the price range of less than £20. It is located in the city centre area, near Raja Indian Cuisine. It is not family friendly."
"name[The Punter], eatType[pub], food[Chinese], priceRange[less than £20], area[city centre], familyFriendly[yes], near[Raja Indian Cuisine]"	"The Punter is a family-friendly pub which serves Chinese food in the price range of less than £20. It is located in the city centre area, near Raja Indian Cuisine."
"name[The Punter], eatType[pub], food[Chinese], priceRange[less than £20], area[riverside], familyFriendly[no], near[Raja Indian Cuisine]"	"The Punter is a pub which serves Chinese food in the price range of less than £20. It is located in the riverside area, near Raja Indian Cuisine. It is not family friendly."
"name[The Punter], eatType[pub], food[Chinese], priceRange[less than £20], area[riverside], familyFriendly[yes], near[Raja Indian Cuisine]"	"The Punter is a family-friendly pub which serves Chinese food in the price range of less than £20. It is located in the riverside area, near Raja Indian Cuisine."
"name[The Punter], eatType[pub], food[Chinese], priceRange[moderate], area[city centre], familyFriendly[no], near[Raja Indian Cuisine]"	"The Punter is a pub which serves Chinese food in the moderate price range. It is located in the city centre area, near Raja Indian Cuisine. It is not family friendly."
"name[The Punter], eatType[pub], food[Chinese], priceRange[moderate], area[city centre], familyFriendly[yes], near[Raja Indian Cuisine]"	"The Punter is a family-friendly pub which serves Chinese food in the moderate price range. It is located in the city centre area, near Raja Indian Cuisine."
"name[The Punter], eatType[pub], food[Chinese], priceRange[moderate], area[riverside], familyFriendly[no], near[Raja Indian Cuisine]"	"The Punter is a pub which serves Chinese food in the moderate price range. It is located in the riverside area, near Raja Indian Cuisine. It is not family friendly."
"name[The Punter], eatType[pub], food[Chinese], priceRange[moderate], area[riverside], familyFriendly[yes], near[Raja Indian Cuisine]"	"The Punter is a family-friendly pub which serves Chinese food in the moderate price range. It is located in the riverside area, near Raja Indian Cuisine."
"name[The Punter], eatType[pub], food[Chinese], priceRange[more than £30], area[riverside], familyFriendly[yes], near[Raja Indian Cuisine]"	"The Punter is a family-friendly pub which serves Chinese food in the price range of more than £30. It is located in the riverside area, near Raja Indian Cuisine."
"name[The Punter], eatType[pub], food[English], priceRange[£20-25], area[riverside], familyFriendly[yes], near[Raja Indian Cuisine]"	"The Punter is a family-friendly pub which serves English food in the price range of £20-25. It is located in the riverside area, near Raja Indian Cuisine."
"name[The Punter], eatType[pub], food[English], priceRange[cheap], area[riverside], familyFriendly[yes], near[Raja Indian Cuisine]"	"The Punter is a family-friendly pub which serves English food in the low price range. It is located in the riverside area, near Raja Indian Cuisine."
"name[The Punter], eatType[pub], food[English], priceRange[high], area[city centre], familyFriendly[no], near[Raja Indian Cuisine]"	"The Punter is a pub which serves English food in the high price range. It is located in the city centre area, near Raja Indian Cuisine. It is not family friendly."
"name[The Punter], eatType[pub], food[English], priceRange[high], area[city centre], familyFriendly[yes], near[Raja Indian Cuisine]"	"The Punter is a family-friendly pub which serves English food in the high price range. It is located in the city centre area, near Raja Indian Cuisine."
"name[The Punter], eatType[pub], food[English], priceRange[high], area[riverside], familyFriendly[no], near[Raja Indian Cuisine]"	"The Punter is a pub which serves English food in the high price range. It is located in the riverside area, near Raja Indian Cuisine. It is not family friendly."
"name[The Punter], eatType[pub], food[English], priceRange[high], area[riverside], familyFriendly[yes], near[Raja Indian Cuisine]"	"The Punter is a family-friendly pub which serves English food in the high price range. It is located in the riverside area, near Raja Indian Cuisine."
"name[The Punter], eatType[pub], food[Italian], priceRange[high], customer rating[average], area[city centre], familyFriendly[no], near[Rainbow Vegetarian Café]"	"The Punter is a pub which serves Italian food in the high price range. It has an average customer rating and is located in the city centre area, near Rainbow Vegetarian Café. It is not family friendly."
"name[The Punter], eatType[restaurant], food[Chinese], priceRange[less than £20], area[city centre], familyFriendly[yes], near[Raja Indian Cuisine]"	"The Punter is a family-friendly restaurant which serves Chinese food in the price range of less than £20. It is located in the city centre area, near Raja Indian Cuisine."
"name[The Punter], eatType[restaurant], food[Chinese], priceRange[less than £20], area[riverside], familyFriendly[no], near[Raja Indian Cuisine]"	"The Punter is a restaurant which serves Chinese food in the price range of less than £20. It is located in the riverside area, near Raja Indian Cuisine. It is not family friendly."
"name[The Punter], eatType[restaurant], food[Chinese], priceRange[less than £20], area[riverside], familyFriendly[yes], near[Raja Indian Cuisine]"	"The Punter is a family-friendly restaurant which serves Chinese food in the price range of less than £20. It is located in the riverside area, near Raja Indian Cuisine."
"name[The Punter], eatType[restaurant], food[Chinese], priceRange[moderate], area[city centre], familyFriendly[no], near[Raja Indian Cuisine]"	"The Punter is a restaurant which serves Chinese food in the moderate price range. It is located in the city centre area, near Raja Indian Cuisine. It is not family friendly."
"name[The Punter], eatType[restaurant], food[Chinese], priceRange[moderate], area[city centre], familyFriendly[yes], near[Raja Indian Cuisine]"	"The Punter is a family-friendly restaurant which serves Chinese food in the moderate price range. It is located in the city centre area, near Raja Indian Cuisine."
"name[The Punter], eatType[restaurant], food[Chinese], priceRange[moderate], area[riverside], familyFriendly[no], near[Raja Indian Cuisine]"	"The Punter is a restaurant which serves Chinese food in the moderate price range. It is located in the riverside area, near Raja Indian Cuisine. It is not family friendly."
"name[The Punter], eatType[restaurant], food[Chinese], priceRange[moderate], area[riverside], familyFriendly[yes], near[Raja Indian Cuisine]"	"The Punter is a family-friendly restaurant which serves Chinese food in the moderate price range. It is located in the riverside area, near Raja Indian Cuisine."
"name[The Punter], eatType[restaurant], food[Chinese], priceRange[more than £30], area[riverside], familyFriendly[yes], near[Raja Indian Cuisine]"	"The Punter is a family-friendly restaurant which serves Chinese food in the price range of more than £30. It is located in the riverside area, near Raja Indian Cuisine."
"name[The Punter], eatType[restaurant], food[English], priceRange[£20-25], area[riverside], familyFriendly[yes], near[Raja Indian Cuisine]"	"The Punter is a family-friendly restaurant which serves English food in the price range of £20-25. It is located in the riverside area, near Raja Indian Cuisine."
"name[The Punter], eatType[restaurant], food[English], priceRange[cheap], area[riverside], familyFriendly[yes], near[Raja Indian Cuisine]"	"The Punter is a family-friendly restaurant which serves English food in the low price range. It is located in the riverside area, near Raja Indian Cuisine."
"name[The Punter], eatType[restaurant], food[English], priceRange[high], area[city centre], familyFriendly[no], near[Raja Indian Cuisine]"	"The Punter is a restaurant which serves English food in the high price range. It is located in the city centre area, near Raja Indian Cuisine. It is not family friendly."
"name[The Punter], eatType[restaurant], food[English], priceRange[high], area[city centre], familyFriendly[yes], near[Raja Indian Cuisine]"	"The Punter is a family-friendly restaurant which serves English food in the high price range. It is located in the city centre area, near Raja Indian Cuisine."
"name[The Punter], eatType[restaurant], food[English], priceRange[high], area[riverside], familyFriendly[no], near[Raja Indian Cuisine]"	"The Punter is a restaurant which serves English food in the high price range. It is located in the riverside area, near Raja Indian Cuisine. It is not family friendly."
"name[The Punter], eatType[restaurant], food[English], priceRange[high], area[riverside], familyFriendly[yes], near[Raja Indian Cuisine]"	"The Punter is a family-friendly restaurant which serves English food in the high price range. It is located in the riverside area, near Raja Indian Cuisine."
"name[The Punter], eatType[restaurant], food[Indian], priceRange[cheap], customer rating[average], area[city centre], familyFriendly[yes], near[Express by Holiday Inn]"	"The Punter is a family-friendly restaurant which serves Indian food in the low price range. It has an average customer rating and is located in the city centre area, near Express by Holiday Inn."
"name[The Punter], eatType[restaurant], food[Indian], priceRange[cheap], customer rating[average], area[riverside], familyFriendly[no], near[Express by Holiday Inn]"	"The Punter is a restaurant which serves Indian food in the low price range. It has an average customer rating and is located in the riverside area, near Express by Holiday Inn. It is not family friendly."
"name[The Punter], eatType[restaurant], food[Indian], priceRange[cheap], customer rating[average], area[riverside], familyFriendly[yes], near[Express by Holiday Inn]"	"The Punter is a family-friendly restaurant which serves Indian food in the low price range. It has an average customer rating and is located in the riverside area, near Express by Holiday Inn."
"name[The Punter], eatType[restaurant], food[Indian], priceRange[high], customer rating[1 out of 5], area[city centre], familyFriendly[no], near[Express by Holiday Inn]"	"The Punter is a restaurant which serves Indian food in the high price range. It has a customer rating of 1 out of 5 and is located in the city centre area, near Express by Holiday Inn. It is not family friendly."
"name[The Punter], eatType[restaurant], food[Indian], priceRange[high], customer rating[1 out of 5], area[city centre], familyFriendly[yes], near[Express by Holiday Inn]"	"The Punter is a family-friendly restaurant which serves Indian food in the high price range. It has a customer rating of 1 out of 5 and is located in the city centre area, near Express by Holiday Inn."
"name[The Punter], eatType[restaurant], food[Indian], priceRange[high], customer rating[1 out of 5], area[riverside], familyFriendly[no], near[Express by Holiday Inn]"	"The Punter is a restaurant which serves Indian food in the high price range. It has a customer rating of 1 out of 5 and is located in the riverside area, near Express by Holiday Inn. It is not family friendly."
"name[The Punter], eatType[restaurant], food[Indian], priceRange[high], customer rating[1 out of 5], area[riverside], familyFriendly[yes], near[Express by Holiday Inn]"	"The Punter is a family-friendly restaurant which serves Indian food in the high price range. It has a customer rating of 1 out of 5 and is located in the riverside area, near Express by Holiday Inn."
"name[The Punter], eatType[restaurant], food[Indian], priceRange[high], customer rating[average], area[city centre], familyFriendly[no], near[Express by Holiday Inn]"	"The Punter is a restaurant which serves Indian food in the high price range. It has an average customer rating and is located in the city centre area, near Express by Holiday Inn. It is not family friendly."
"name[The Punter], eatType[restaurant], food[Indian], priceRange[high], customer rating[average], area[city centre], familyFriendly[yes], near[Express by Holiday Inn]"	"The Punter is a family-friendly restaurant which serves Indian food in the high price range. It has an average customer rating and is located in the city centre area, near Express by Holiday Inn."
"name[The Punter], eatType[restaurant], food[Indian], priceRange[high], customer rating[average], area[riverside], familyFriendly[no], near[Express by Holiday Inn]"	"The Punter is a restaurant which serves Indian food in the high price range. It has an average customer rating and is located in the riverside area, near Express by Holiday Inn. It is not family friendly."
"name[The Punter], eatType[restaurant], food[Indian], priceRange[high], customer rating[average], area[riverside], familyFriendly[yes], near[Express by Holiday Inn]"	"The Punter is a family-friendly restaurant which serves Indian food in the high price range. It has an average customer rating and is located in the riverside area, near Express by Holiday Inn."
"name[The Punter], eatType[restaurant], food[Indian], priceRange[less than £20], customer rating[low], area[city centre], familyFriendly[no], near[Express by Holiday Inn]"	"The Punter is a restaurant which serves Indian food in the price range of less than £20. It has a low customer rating and is located in the city centre area, near Express by Holiday Inn. It is not family friendly."
"name[The Punter], eatType[restaurant], food[Indian], priceRange[less than £20], customer rating[low], area[city centre], familyFriendly[yes], near[Express by Holiday Inn]"	"The Punter is a family-friendly restaurant which serves Indian food in the price range of less than £20. It has a low customer rating and is located in the city centre area, near Express by Holiday Inn."
"name[The Punter], eatType[restaurant], food[Indian], priceRange[less than £20], customer rating[low], area[riverside], familyFriendly[no], near[Express by Holiday Inn]"	"The Punter is a restaurant which serves Indian food in the price range of less than £20. It has a low customer rating and is located in the riverside area, near Express by Holiday Inn. It is not family friendly."
"name[The Punter], eatType[restaurant], food[Indian], priceRange[less than £20], customer rating[low], area[riverside], familyFriendly[yes], near[Express by Holiday Inn]"	"The Punter is a family-friendly restaurant which serves Indian food in the price range of less than £20. It has a low customer rating and is located in the riverside area, near Express by Holiday Inn."
"name[The Punter], eatType[restaurant], food[Indian], priceRange[moderate], customer rating[1 out of 5], area[city centre], familyFriendly[no], near[Express by Holiday Inn]"	"The Punter is a restaurant which serves Indian food in the moderate price range. It has a customer rating of 1 out of 5 and is located in the city centre area, near Express by Holiday Inn. It is not family friendly."
"name[The Punter], eatType[restaurant], food[Indian], priceRange[moderate], customer rating[1 out of 5], area[city centre], familyFriendly[yes], near[Express by Holiday Inn]"	"The Punter is a family-friendly restaurant which serves Indian food in the moderate price range. It has a customer rating of 1 out of 5 and is located in the city centre area, near Express by Holiday Inn."
"name[The Punter], eatType[restaurant], food[Indian], priceRange[moderate], customer rating[1 out of 5], area[riverside], familyFriendly[no], near[Express by Holiday Inn]"	"The Punter is a restaurant which serves Indian food in the moderate price range. It has a customer rating of 1 out of 5 and is located in the riverside area, near Express by Holiday Inn. It is not family friendly."
"name[The Punter], eatType[restaurant], food[Indian], priceRange[moderate], customer rating[1 out of 5], area[riverside], familyFriendly[yes], near[Express by Holiday Inn]"	"The Punter is a family-friendly restaurant which serves Indian food in the moderate price range. It has a customer rating of 1 out of 5 and is located in the riverside area, near Express by Holiday Inn."
"name[The Punter], eatType[restaurant], food[Indian], priceRange[moderate], customer rating[3 out of 5], area[city centre], familyFriendly[no], near[Express by Holiday Inn]"	"The Punter is a restaurant which serves Indian food in the moderate price range. It has a customer rating of 3 out of 5 and is located in the city centre area, near Express by Holiday Inn. It is not family friendly."
"name[The Punter], eatType[restaurant], food[Indian], priceRange[moderate], customer rating[3 out of 5], area[city centre], familyFriendly[yes], near[Express by Holiday Inn]"	"The Punter is a family-friendly restaurant which serves Indian food in the moderate price range. It has a customer rating of 3 out of 5 and is located in the city centre area, near Express by Holiday Inn."
"name[The Punter], eatType[restaurant], food[Indian], priceRange[moderate], customer rating[3 out of 5], area[riverside], familyFriendly[no], near[Express by Holiday Inn]"	"The Punter is a restaurant which serves Indian food in the moderate price range. It has a customer rating of 3 out of 5 and is located in the riverside area, near Express by Holiday Inn. It is not family friendly."
"name[The Punter], eatType[restaurant], food[Indian], priceRange[moderate], customer rating[3 out of 5], area[riverside], familyFriendly[yes], near[Express by Holiday Inn]"	"The Punter is a family-friendly restaurant which serves Indian food in the moderate price range. It has a customer rating of 3 out of 5 and is located in the riverside area, near Express by Holiday Inn."
"name[The Punter], eatType[restaurant], food[Indian], priceRange[more than £30], customer rating[high], area[city centre], familyFriendly[no], near[Express by Holiday Inn]"	"The Punter is a restaurant which serves Indian food in the price range of more than £30. It has a high customer rating and is located in the city centre area, near Express by Holiday Inn. It is not family friendly."
"name[The Punter], eatType[restaurant], food[Indian], priceRange[more than £30], customer rating[high], area[city centre], familyFriendly[yes], near[Express by Holiday Inn]"	"The Punter is a family-friendly restaurant which serves Indian food in the price range of more than £30. It has a high customer rating and is located in the city centre area, near Express by Holiday Inn."
"name[The Punter], eatType[restaurant], food[Indian], priceRange[more than £30], customer rating[high], area[riverside], familyFriendly[no], near[Express by Holiday Inn]"	"The Punter is a restaurant which serves Indian food in the price range of more than £30. It has a high customer rating and is located in the riverside area, near Express by Holiday Inn. It is not family friendly."
"name[The Punter], eatType[restaurant], food[Indian], priceRange[more than £30], customer rating[high], area[riverside], familyFriendly[yes], near[Express by Holiday Inn]"	"The Punter is a family-friendly restaurant which serves Indian food in the price range of more than £30. It has a high customer rating and is located in the riverside area, near Express by Holiday Inn."
"name[The Punter], eatType[restaurant], food[Italian], priceRange[£20-25], customer rating[high], area[city centre], familyFriendly[no], near[Express by Holiday Inn]"	"The Punter is a restaurant which serves Italian food in the price range of £20-25. It has a high customer rating and is located in the city centre area, near Express by Holiday Inn. It is not family friendly."
"name[The Punter], eatType[restaurant], food[Italian], priceRange[£20-25], customer rating[high], area[city centre], familyFriendly[yes], near[Express by Holiday Inn]"	"The Punter is a family-friendly restaurant which serves Italian food in the price range of £20-25. It has a high customer rating and is located in the city centre area, near Express by Holiday Inn."
"name[The Punter], eatType[restaurant], food[Italian], priceRange[£20-25], customer rating[high], area[riverside], familyFriendly[no], near[Express by Holiday Inn]"	"The Punter is a restaurant which serves Italian food in the price range of £20-25. It has a high customer rating and is located in the riverside area, near Express by Holiday Inn. It is not family friendly."
"name[The Punter], eatType[restaurant], food[Italian], priceRange[£20-25], customer rating[high], area[riverside], familyFriendly[yes], near[Express by Holiday Inn]"	"The Punter is a family-friendly restaurant which serves Italian food in the price range of £20-25. It has a high customer rating and is located in the riverside area, near Express by Holiday Inn."
"name[The Punter], eatType[restaurant], food[Italian], priceRange[cheap], customer rating[5 out of 5], area[city centre], familyFriendly[no], near[Express by Holiday Inn]"	"The Punter is a restaurant which serves Italian food in the low price range. It has a customer rating of 5 out of 5 and is located in the city centre area, near Express by Holiday Inn. It is not family friendly."
"name[The Punter], eatType[restaurant], food[Italian], priceRange[cheap], customer rating[5 out of 5], area[city centre], familyFriendly[no], near[Rainbow Vegetarian Café]"	"The Punter is a restaurant which serves Italian food in the low price range. It has a customer rating of 5 out of 5 and is located in the city centre area, near Rainbow Vegetarian Café. It is not family friendly."
"name[The Punter], eatType[restaurant], food[Italian], priceRange[cheap], customer rating[5 out of 5], area[city centre], familyFriendly[yes], near[Rainbow Vegetarian Café]"	"The Punter is a family-friendly restaurant which serves Italian food in the low price range. It has a customer rating of 5 out of 5 and is located in the city centre area, near Rainbow Vegetarian Café."
"name[The Punter], eatType[restaurant], food[Italian], priceRange[cheap], customer rating[5 out of 5], area[riverside], familyFriendly[no], near[Rainbow Vegetarian Café]"	"The Punter is a restaurant which serves Italian food in the low price range. It has a customer rating of 5 out of 5 and is located in the riverside area, near Rainbow Vegetarian Café. It is not family friendly."
"name[The Punter], eatType[restaurant], food[Italian], priceRange[cheap], customer rating[5 out of 5], area[riverside], familyFriendly[yes], near[Rainbow Vegetarian Café]"	"The Punter is a family-friendly restaurant which serves Italian food in the low price range. It has a customer rating of 5 out of 5 and is located in the riverside area, near Rainbow Vegetarian Café."
"name[The Punter], eatType[restaurant], food[Italian], priceRange[cheap], customer rating[average], area[city centre], familyFriendly[no], near[Rainbow Vegetarian Café]"	"The Punter is a restaurant which serves Italian food in the low price range. It has an average customer rating and is located in the city centre area, near Rainbow Vegetarian Café. It is not family friendly."
"name[The Punter], eatType[restaurant], food[Italian], priceRange[cheap], customer rating[average], area[city centre], familyFriendly[yes], near[Rainbow Vegetarian Café]"	"The Punter is a family-friendly restaurant which serves Italian food in the low price range. It has an average customer rating and is located in the city centre area, near Rainbow Vegetarian Café."
"name[The Punter], eatType[restaurant], food[Italian], priceRange[cheap], customer rating[average], area[riverside], familyFriendly[no], near[Rainbow Vegetarian Café]"	"The Punter is a restaurant which serves Italian food in the low price range. It has an average customer rating and is located in the riverside area, near Rainbow Vegetarian Café. It is not family friendly."
"name[The Punter], eatType[restaurant], food[Italian], priceRange[cheap], customer rating[average], area[riverside], familyFriendly[yes], near[Rainbow Vegetarian Café]"	"The Punter is a family-friendly restaurant which serves Italian food in the low price range. It has an average customer rating and is located in the riverside area, near Rainbow Vegetarian Café."
"name[The Punter], eatType[restaurant], food[Italian], priceRange[high], customer rating[1 out of 5], area[city centre], familyFriendly[no], near[Rainbow Vegetarian Café]"	"The Punter is a restaurant which serves Italian food in the high price range. It has a customer rating of 1 out of 5 and is located in the city centre area, near Rainbow Vegetarian Café. It is not family friendly."
"name[The Punter], eatType[restaurant], food[Italian], priceRange[high], customer rating[1 out of 5], area[city centre], familyFriendly[yes], near[Rainbow Vegetarian Café]"	"The Punter is a family-friendly restaurant which serves Italian food in the high price range. It has a customer rating of 1 out of 5 and is located in the city centre area, near Rainbow Vegetarian Café."
"name[The Punter], eatType[restaurant], food[Italian], priceRange[high], customer rating[1 out of 5], area[riverside], familyFriendly[no], near[Rainbow Vegetarian Café]"	"The Punter is a restaurant which serves Italian food in the high price range. It has a customer rating of 1 out of 5 and is located in the riverside area, near Rainbow Vegetarian Café. It is not family friendly."
"name[The Punter], eatType[restaurant], food[Italian], priceRange[high], customer rating[1 out of 5], area[riverside], familyFriendly[yes], near[Rainbow Vegetarian Café]"	"The Punter is a family-friendly restaurant which serves Italian food in the high price range. It has a customer rating of 1 out of 5 and is located in the riverside area, near Rainbow Vegetarian Café."
"name[The Vaults], eatType[pub], food[French], priceRange[high], area[riverside], familyFriendly[yes], near[Raja Indian Cuisine]"	"The Vaults is a family-friendly pub which serves French food in the high price range. It is located in the riverside area, near Raja Indian Cuisine."
"name[The Vaults], eatType[pub], food[French], priceRange[less than £20], area[city centre], familyFriendly[no], near[Raja Indian Cuisine]"	"The Vaults is a pub which serves French food in the price range of less than £20. It is located in the city centre area, near Raja Indian Cuisine. It is not family friendly."
"name[The Vaults], eatType[pub], food[French], priceRange[less than £20], area[city centre], familyFriendly[yes], near[Raja Indian Cuisine]"	"The Vaults is a family-friendly pub which serves French food in the price range of less than £20. It is located in the city centre area, near Raja Indian Cuisine."
"name[The Vaults], eatType[pub], food[French], priceRange[less than £20], area[riverside], familyFriendly[no], near[Raja Indian Cuisine]"	"The Vaults is a pub which serves French food in the price range of less than £20. It is located in the riverside area, near Raja Indian Cuisine. It is not family friendly."
"name[The Vaults], eatType[pub], food[French], priceRange[less than £20], area[riverside], familyFriendly[yes], near[Raja Indian Cuisine]"	"The Vaults is a family-friendly pub which serves French food in the price range of less than £20. It is located in the riverside area, near Raja Indian Cuisine."
"name[The Vaults], eatType[pub], food[French], priceRange[moderate], area[city centre], familyFriendly[no], near[Raja Indian Cuisine]"	"The Vaults is a pub which serves French food in the moderate price range. It is located in the city centre area, near Raja Indian Cuisine. It is not family friendly."
"name[The Vaults], eatType[pub], food[French], priceRange[moderate], area[city centre], familyFriendly[yes], near[Raja Indian Cuisine]"	"The Vaults is a family-friendly pub which serves French food in the moderate price range. It is located in the city centre area, near Raja Indian Cuisine."
"name[The Vaults], eatType[pub], food[French], priceRange[moderate], area[riverside], familyFriendly[no], near[Raja Indian Cuisine]"	"The Vaults is a pub which serves French food in the moderate price range. It is located in the riverside area, near Raja Indian Cuisine. It is not family friendly."
"name[The Vaults], eatType[pub], food[French], priceRange[moderate], area[riverside], familyFriendly[yes], near[Raja Indian Cuisine]"	"The Vaults is a family-friendly pub which serves French food in the moderate price range. It is located in the riverside area, near Raja Indian Cuisine."
"name[The Vaults], eatType[pub], food[French], priceRange[more than £30], area[city centre], familyFriendly[no], near[Raja Indian Cuisine]"	"The Vaults is a pub which serves French food in the price range of more than £30. It is located in the city centre area, near Raja Indian Cuisine. It is not family friendly."
"name[The Vaults], eatType[pub], food[French], priceRange[more than £30], area[city centre], familyFriendly[yes], near[Raja Indian Cuisine]"	"The Vaults is a family-friendly pub which serves French food in the price range of more than £30. It is located in the city centre area, near Raja Indian Cuisine."
"name[The Vaults], eatType[pub], food[French], priceRange[more than £30], area[riverside], familyFriendly[no], near[Raja Indian Cuisine]"	"The Vaults is a pub which serves French food in the price range of more than £30. It is located in the riverside area, near Raja Indian Cuisine. It is not family friendly."
"name[The Vaults], eatType[pub], food[French], priceRange[more than £30], area[riverside], familyFriendly[yes], near[Raja Indian Cuisine]"	"The Vaults is a family-friendly pub which serves French food in the price range of more than £30. It is located in the riverside area, near Raja Indian Cuisine."
"name[The Vaults], eatType[pub], food[Indian], priceRange[£20-25], area[riverside], familyFriendly[yes], near[Raja Indian Cuisine]"	"The Vaults is a family-friendly pub which serves Indian food in the price range of £20-25. It is located in the riverside area, near Raja Indian Cuisine."
"name[The Vaults], eatType[pub], food[Indian], priceRange[cheap], area[riverside], familyFriendly[yes], near[Raja Indian Cuisine]"	"The Vaults is a family-friendly pub which serves Indian food in the low price range. It is located in the riverside area, near Raja Indian Cuisine."
"name[The Vaults], eatType[pub], food[Indian], priceRange[high], area[city centre], familyFriendly[no], near[Raja Indian Cuisine]"	"The Vaults is a pub which serves Indian food in the high price range. It is located in the city centre area, near Raja Indian Cuisine. It is not family friendly."
"name[The Vaults], eatType[pub], food[Indian], priceRange[high], area[city centre], familyFriendly[yes], near[Raja Indian Cuisine]"	"The Vaults is a family-friendly pub which serves Indian food in the high price range. It is located in the city centre area, near Raja Indian Cuisine."
"name[The Vaults], eatType[pub], food[Italian], priceRange[high], customer rating[average], area[city centre], familyFriendly[no], near[Rainbow Vegetarian Café]"	"The Vaults is a pub which serves Italian food in the high price range. It has an average customer rating and is located in the city centre area, near Rainbow Vegetarian Café. It is not family friendly."
"name[The Vaults], eatType[pub], food[Italian], priceRange[high], customer rating[average], area[city centre], familyFriendly[yes], near[Rainbow Vegetarian Café]"	"The Vaults is a family-friendly pub which serves Italian food in the high price range. It has an average customer rating and is located in the city centre area, near Rainbow Vegetarian Café."
"name[The Vaults], eatType[pub], food[Italian], priceRange[high], customer rating[average], area[riverside], familyFriendly[no], near[Rainbow Vegetarian Café]"	"The Vaults is a pub which serves Italian food in the high price range. It has an average customer rating and is located in the riverside area, near Rainbow Vegetarian Café. It is not family friendly."
"name[The Vaults], eatType[pub], food[Italian], priceRange[high], customer rating[average], area[riverside], familyFriendly[yes], near[Rainbow Vegetarian Café]"	"The Vaults is a family-friendly pub which serves Italian food in the high price range. It has an average customer rating and is located in the riverside area, near Rainbow Vegetarian Café."
"name[The Vaults], eatType[pub], food[Italian], priceRange[less than £20], customer rating[low], area[city centre], familyFriendly[no], near[Rainbow Vegetarian Café]"	"The Vaults is a pub which serves Italian food in the price range of less than £20. It has a low customer rating and is located in the city centre area, near Rainbow Vegetarian Café. It is not family friendly."
"name[The Vaults], eatType[pub], food[Italian], priceRange[less than £20], customer rating[low], area[city centre], familyFriendly[yes], near[Rainbow Vegetarian Café]"	"The Vaults is a family-friendly pub which serves Italian food in the price range of less than £20. It has a low customer rating and is located in the city centre area, near Rainbow Vegetarian Café."
"name[The Vaults], eatType[pub], food[Italian], priceRange[less than £20], customer rating[low], area[riverside], familyFriendly[no], near[Rainbow Vegetarian Café]"	"The Vaults is a pub which serves Italian food in the price range of less than £20. It has a low customer rating and is located in the riverside area, near Rainbow Vegetarian Café. It is not family friendly."
"name[The Vaults], eatType[pub], food[Italian], priceRange[less than £20], customer rating[low], area[riverside], familyFriendly[yes], near[Rainbow Vegetarian Café]"	"The Vaults is a family-friendly pub which serves Italian food in the price range of less than £20. It has a low customer rating and is located in the riverside area, near Rainbow Vegetarian Café."
"name[The Vaults], eatType[pub], food[Italian], priceRange[moderate], customer rating[1 out of 5], area[city centre], familyFriendly[no], near[Rainbow Vegetarian Café]"	"The Vaults is a pub which serves Italian food in the moderate price range. It has a customer rating of 1 out of 5 and is located in the city centre area, near Rainbow Vegetarian Café. It is not family friendly."
"name[The Vaults], eatType[pub], food[Italian], priceRange[moderate], customer rating[1 out of 5], area[city centre], familyFriendly[yes], near[Rainbow Vegetarian Café]"	"The Vaults is a family-friendly pub which serves Italian food in the moderate price range. It has a customer rating of 1 out of 5 and is located in the city centre area, near Rainbow Vegetarian Café."
"name[The Vaults], eatType[pub], food[Italian], priceRange[moderate], customer rating[1 out of 5], area[riverside], familyFriendly[no], near[Rainbow Vegetarian Café]"	"The Vaults is a pub which serves Italian food in the moderate price range. It has a customer rating of 1 out of 5 and is located in the riverside area, near Rainbow Vegetarian Café. It is not family friendly."
"name[The Vaults], eatType[pub], food[Italian], priceRange[moderate], customer rating[1 out of 5], area[riverside], familyFriendly[yes], near[Rainbow Vegetarian Café]"	"The Vaults is a family-friendly pub which serves Italian food in the moderate price range. It has a customer rating of 1 out of 5 and is located in the riverside area, near Rainbow Vegetarian Café."
"name[The Vaults], eatType[pub], food[Italian], priceRange[moderate], customer rating[3 out of 5], area[city centre], familyFriendly[no], near[Rainbow Vegetarian Café]"	"The Vaults is a pub which serves Italian food in the moderate price range. It has a customer rating of 3 out of 5 and is located in the city centre area, near Rainbow Vegetarian Café. It is not family friendly."
"name[The Vaults], eatType[pub], food[Italian], priceRange[moderate], customer rating[3 out of 5], area[city centre], familyFriendly[yes], near[Rainbow Vegetarian Café]"	"The Vaults is a family-friendly pub which serves Italian food in the moderate price range. It has a customer rating of 3 out of 5 and is located in the city centre area, near Rainbow Vegetarian Café."
"name[The Vaults], eatType[pub], food[Italian], priceRange[moderate], customer rating[3 out of 5], area[riverside], familyFriendly[no], near[Rainbow Vegetarian Café]"	"The Vaults is a pub which serves Italian food in the moderate price range. It has a customer rating of 3 out of 5 and is located in the riverside area, near Rainbow Vegetarian Café. It is not family friendly."
"name[The Vaults], eatType[pub], food[Italian], priceRange[moderate], customer rating[3 out of 5], area[riverside], familyFriendly[yes], near[Rainbow Vegetarian Café]"	"The Vaults is a family-friendly pub which serves Italian food in the moderate price range. It has a customer rating of 3 out of 5 and is located in the riverside area, near Rainbow Vegetarian Café."
"name[The Vaults], eatType[pub], food[Italian], priceRange[more than £30], customer rating[high], area[city centre], familyFriendly[no], near[Rainbow Vegetarian Café]"	"The Vaults is a pub which serves Italian food in the price range of more than £30. It has a high customer rating and is located in the city centre area, near Rainbow Vegetarian Café. It is not family friendly."
"name[The Vaults], eatType[pub], food[Italian], priceRange[more than £30], customer rating[high], area[city centre], familyFriendly[yes], near[Rainbow Vegetarian Café]"	"The Vaults is a family-friendly pub which serves Italian food in the price range of more than £30. It has a high customer rating and is located in the city centre area, near Rainbow Vegetarian Café."
"name[The Vaults], eatType[pub], food[Italian], priceRange[more than £30], customer rating[high], area[riverside], familyFriendly[no], near[Rainbow Vegetarian Café]"	"The Vaults is a pub which serves Italian food in the price range of more than £30. It has a high customer rating and is located in the riverside area, near Rainbow Vegetarian Café. It is not family friendly."
"name[The Vaults], eatType[pub], food[Italian], priceRange[more than £30], customer rating[high], area[riverside], familyFriendly[yes], near[Rainbow Vegetarian Café]"	"The Vaults is a family-friendly pub which serves Italian food in the price range of more than £30. It has a high customer rating and is located in the riverside area, near Rainbow Vegetarian Café."
"name[The Vaults], eatType[pub], food[Japanese], priceRange[£20-25], customer rating[3 out of 5], area[city centre], familyFriendly[no], near[Rainbow Vegetarian Café]"	"The Vaults is a pub which serves Japanese food in the price range of £20-25. It has a customer rating of 3 out of 5 and is located in the city centre area, near Rainbow Vegetarian Café. It is not family friendly."
"name[The Vaults], eatType[pub], food[Japanese], priceRange[£20-25], customer rating[3 out of 5], area[city centre], familyFriendly[yes], near[Rainbow Vegetarian Café]"	"The Vaults is a family-friendly pub which serves Japanese food in the price range of £20-25. It has a customer rating of 3 out of 5 and is located in the city centre area, near Rainbow Vegetarian Café."
"name[The Vaults], eatType[pub], food[Japanese], priceRange[£20-25], customer rating[3 out of 5], area[riverside], familyFriendly[no], near[Rainbow Vegetarian Café]"	"The Vaults is a pub which serves Japanese food in the price range of £20-25. It has a customer rating of 3 out of 5 and is located in the riverside area, near Rainbow Vegetarian Café. It is not family friendly."
"name[The Vaults], eatType[pub], food[Japanese], priceRange[£20-25], customer rating[3 out of 5], area[riverside], familyFriendly[yes], near[Rainbow Vegetarian Café]"	"The Vaults is a family-friendly pub which serves Japanese food in the price range of £20-25. It has a customer rating of 3 out of 5 and is located in the riverside area, near Rainbow Vegetarian Café."
"name[The Vaults], eatType[pub], food[Japanese], priceRange[£20-25], customer rating[high], area[city centre], familyFriendly[no], near[Rainbow Vegetarian Café]"	"The Vaults is a pub which serves Japanese food in the price range of £20-25. It has a high customer rating and is located in the city centre area, near Rainbow Vegetarian Café. It is not family friendly."
"name[The Vaults], eatType[pub], food[Japanese], priceRange[£20-25], customer rating[high], area[city centre], familyFriendly[yes], near[Rainbow Vegetarian Café]"	"The Vaults is a family-friendly pub which serves Japanese food in the price range of £20-25. It has a high customer rating and is located in the city centre area, near Rainbow Vegetarian Café."
"name[The Vaults], eatType[pub], food[Japanese], priceRange[£20-25], customer rating[high], area[riverside], familyFriendly[no], near[Rainbow Vegetarian Café]"	"The Vaults is a pub which serves Japanese food in the price range of £20-25. It has a high customer rating and is located in the riverside area, near Rainbow Vegetarian Café. It is not family friendly."
"name[The Vaults], eatType[pub], food[Japanese], priceRange[£20-25], customer rating[high], area[riverside], familyFriendly[no], near[Raja Indian Cuisine]"	"The Vaults is a pub which serves Japanese food in the price range of £20-25. It has a high customer rating and is located in the riverside area, near Raja Indian Cuisine. It is not family friendly."
"name[The Vaults], eatType[pub], food[Japanese], priceRange[£20-25], customer rating[high], area[riverside], familyFriendly[yes], near[Raja Indian Cuisine]"	"The Vaults is a family-friendly pub which serves Japanese food in the price range of £20-25. It has a high customer rating and is located in the riverside area, near Raja Indian Cuisine."
"name[The Vaults], eatType[pub], food[Japanese], priceRange[cheap], customer rating[5 out of 5], area[city centre], familyFriendly[no], near[Raja Indian Cuisine]"	"The Vaults is a pub which serves Japanese food in the low price range. It has a customer rating of 5 out of 5 and is located in the city centre area, near Raja Indian Cuisine. It is not family friendly."
"name[The Vaults], eatType[pub], food[Japanese], priceRange[cheap], customer rating[5 out of 5], area[city centre], familyFriendly[yes], near[Raja Indian Cuisine]"	"The Vaults is a family-friendly pub which serves Japanese food in the low price range. It has a customer rating of 5 out of 5 and is located in the city centre area, near Raja Indian Cuisine."
"name[The Vaults], eatType[pub], food[Japanese], priceRange[cheap], customer rating[5 out of 5], area[riverside], familyFriendly[no], near[Raja Indian Cuisine]"	"The Vaults is a pub which serves Japanese food in the low price range. It has a customer rating of 5 out of 5 and is located in the riverside area, near Raja Indian Cuisine. It is not family friendly."
"name[The Vaults], eatType[pub], food[Japanese], priceRange[cheap], customer rating[5 out of 5], area[riverside], familyFriendly[yes], near[Raja Indian Cuisine]"	"The Vaults is a family-friendly pub which serves Japanese food in the low price range. It has a customer rating of 5 out of 5 and is located in the riverside area, near Raja Indian Cuisine."
"name[The Vaults], eatType[pub], food[Japanese], priceRange[high], customer rating[3 out of 5], area[city centre], familyFriendly[no], near[Raja Indian Cuisine]"	"The Vaults is a pub which serves Japanese food in the high price range. It has a customer rating of 3 out of 5 and is located in the city centre area, near Raja Indian Cuisine. It is not family friendly."
"name[The Vaults], eatType[pub], food[Japanese], priceRange[high], customer rating[3 out of 5], area[city centre], familyFriendly[yes], near[Raja Indian Cuisine]"	"The Vaults is a family-friendly pub which serves Japanese food in the high price range. It has a customer rating of 3 out of 5 and is located in the city centre area, near Raja Indian Cuisine."
"name[The Vaults], eatType[pub], food[Japanese], priceRange[high], customer rating[3 out of 5], area[riverside], familyFriendly[no], near[Raja Indian Cuisine]"	"The Vaults is a pub which serves Japanese food in the high price range. It has a customer rating of 3 out of 5 and is located in the riverside area, near Raja Indian Cuisine. It is not family friendly."
"name[The Vaults], eatType[pub], food[Japanese], priceRange[high], customer rating[3 out of 5], area[riverside], familyFriendly[yes], near[Raja Indian Cuisine]"	"The Vaults is a family-friendly pub which serves Japanese food in the high price range. It has a customer rating of 3 out of 5 and is located in the riverside area, near Raja Indian Cuisine."
"name[The Vaults], eatType[pub], food[Japanese], priceRange[less than £20], customer rating[average], area[city centre], familyFriendly[no], near[Raja Indian Cuisine]"	"The Vaults is a pub which serves Japanese food in the price range of less than £20. It has an average customer rating and is located in the city centre area, near Raja Indian Cuisine. It is not family friendly."
"name[The Vaults], eatType[pub], food[Japanese], priceRange[less than £20], customer rating[average], area[city centre], familyFriendly[yes], near[Raja Indian Cuisine]"	"The Vaults is a family-friendly pub which serves Japanese food in the price range of less than £20. It has an average customer rating and is located in the city centre area, near Raja Indian Cuisine."
"name[The Vaults], eatType[pub], food[Japanese], priceRange[less than £20], customer rating[average], area[riverside], familyFriendly[no], near[Raja Indian Cuisine]"	"The Vaults is a pub which serves Japanese food in the price range of less than £20. It has an average customer rating and is located in the riverside area, near Raja Indian Cuisine. It is not family friendly."
"name[The Vaults], eatType[pub], food[Japanese], priceRange[less than £20], customer rating[average], area[riverside], familyFriendly[yes], near[Raja Indian Cuisine]"	"The Vaults is a family-friendly pub which serves Japanese food in the price range of less than £20. It has an average customer rating and is located in the riverside area, near Raja Indian Cuisine."
"name[The Vaults], eatType[pub], food[Japanese], priceRange[less than £20], customer rating[low], area[city centre], familyFriendly[no], near[Raja Indian Cuisine]"	"The Vaults is a pub which serves Japanese food in the price range of less than £20. It has a low customer rating and is located in the city centre area, near Raja Indian Cuisine. It is not family friendly."
"name[The Vaults], eatType[pub], food[Japanese], priceRange[less than £20], customer rating[low], area[city centre], familyFriendly[yes], near[Raja Indian Cuisine]"	"The Vaults is a family-friendly pub which serves Japanese food in the price range of less than £20. It has a low customer rating and is located in the city centre area, near Raja Indian Cuisine."
"name[The Vaults], eatType[pub], food[Japanese], priceRange[less than £20], customer rating[low], area[riverside], familyFriendly[no], near[Raja Indian Cuisine]"	"The Vaults is a pub which serves Japanese food in the price range of less than £20. It has a low customer rating and is located in the riverside area, near Raja Indian Cuisine. It is not family friendly."
"name[The Vaults], eatType[pub], food[Japanese], priceRange[less than £20], customer rating[low], area[riverside], familyFriendly[yes], near[Raja Indian Cuisine]"	"The Vaults is a family-friendly pub which serves Japanese food in the price range of less than £20. It has a low customer rating and is located in the riverside area, near Raja Indian Cuisine."
"name[The Vaults], eatType[pub], food[Japanese], priceRange[moderate], customer rating[1 out of 5], area[city centre], familyFriendly[no], near[Raja Indian Cuisine]"	"The Vaults is a pub which serves Japanese food in the moderate price range. It has a customer rating of 1 out of 5 and is located in the city centre area, near Raja Indian Cuisine. It is not family friendly."
"name[The Vaults], eatType[pub], food[Japanese], priceRange[moderate], customer rating[1 out of 5], area[city centre], familyFriendly[yes], near[Raja Indian Cuisine]"	"The Vaults is a family-friendly pub which serves Japanese food in the moderate price range. It has a customer rating of 1 out of 5 and is located in the city centre area, near Raja Indian Cuisine."
"name[The Vaults], eatType[restaurant], food[French], priceRange[high], area[riverside], familyFriendly[yes], near[Raja Indian Cuisine]"	"The Vaults is a family-friendly restaurant which serves French food in the high price range. It is located in the riverside area, near Raja Indian Cuisine."
"name[The Vaults], eatType[restaurant], food[French], priceRange[less than £20], area[city centre], familyFriendly[no], near[Raja Indian Cuisine]"	"The Vaults is a restaurant which serves French food in the price range of less than £20. It is located in the city centre area, near Raja Indian Cuisine. It is not family friendly."
"name[The Vaults], eatType[restaurant], food[French], priceRange[less than £20], area[city centre], familyFriendly[yes], near[Raja Indian Cuisine]"	"The Vaults is a family-friendly restaurant which serves French food in the price range of less than £20. It is located in the city centre area, near Raja Indian Cuisine."
"name[The Vaults], eatType[restaurant], food[French], priceRange[less than £20], area[riverside], familyFriendly[no], near[Raja Indian Cuisine]"	"The Vaults is a restaurant which serves French food in the price range of less than £20. It is located in the riverside area, near Raja Indian Cuisine. It is not family friendly."
"name[The Vaults], eatType[restaurant], food[French], priceRange[less than £20], area[riverside], familyFriendly[yes], near[Raja Indian Cuisine]"	"The Vaults is a family-friendly restaurant which serves French food in the price range of less than £20. It is located in the riverside area, near Raja Indian Cuisine."
"name[The Vaults], eatType[restaurant], food[French], priceRange[moderate], area[city centre], familyFriendly[no], near[Raja Indian Cuisine]"	"The Vaults is a restaurant which serves French food in the moderate price range. It is located in the city centre area, near Raja Indian Cuisine. It is not family friendly."
"name[The Vaults], eatType[restaurant], food[French], priceRange[moderate], area[city centre], familyFriendly[yes], near[Raja Indian Cuisine]"	"The Vaults is a family-friendly restaurant which serves French food in the moderate price range. It is located in the city centre area, near Raja Indian Cuisine."
"name[The Vaults], eatType[restaurant], food[French], priceRange[moderate], area[riverside], familyFriendly[no], near[Raja Indian Cuisine]"	"The Vaults is a restaurant which serves French food in the moderate price range. It is located in the riverside area, near Raja Indian Cuisine. It is not family friendly."
"name[The Vaults], eatType[restaurant], food[French], priceRange[moderate], area[riverside], familyFriendly[yes], near[Raja Indian Cuisine]"	"The Vaults is a family-friendly restaurant which serves French food in the moderate price range. It is located in the riverside area, near Raja Indian Cuisine."
"name[The Vaults], eatType[restaurant], food[French], priceRange[more than £30], area[city centre], familyFriendly[no], near[Raja Indian Cuisine]"	"The Vaults is a restaurant which serves French food in the price range of more than £30. It is located in the city centre area, near Raja Indian Cuisine. It is not family friendly."
"name[The Vaults], eatType[restaurant], food[French], priceRange[more than £30], area[city centre], familyFriendly[yes], near[Raja Indian Cuisine]"	"The Vaults is a family-friendly restaurant which serves French food in the price range of more than £30. It is located in the city centre area, near Raja Indian Cuisine."
"name[The Vaults], eatType[restaurant], food[French], priceRange[more than £30], area[riverside], familyFriendly[no], near[Raja Indian Cuisine]"	"The Vaults is a restaurant which serves French food in the price range of more than £30. It is located in the riverside area, near Raja Indian Cuisine. It is not family friendly."
"name[The Vaults], eatType[restaurant], food[French], priceRange[more than £30], area[riverside], familyFriendly[yes], near[Raja Indian Cuisine]"	"The Vaults is a family-friendly restaurant which serves French food in the price range of more than £30. It is located in the riverside area, near Raja Indian Cuisine."
"name[The Vaults], eatType[restaurant], food[Indian], priceRange[£20-25], area[riverside], familyFriendly[yes], near[Raja Indian Cuisine]"	"The Vaults is a family-friendly restaurant which serves Indian food in the price range of £20-25. It is located in the riverside area, near Raja Indian Cuisine."
"name[The Vaults], eatType[restaurant], food[Indian], priceRange[cheap], area[riverside], familyFriendly[yes], near[Raja Indian Cuisine]"	"The Vaults is a family-friendly restaurant which serves Indian food in the low price range. It is located in the riverside area, near Raja Indian Cuisine."
"name[The Vaults], eatType[restaurant], food[Indian], priceRange[high], area[city centre], familyFriendly[no], near[Raja Indian Cuisine]"	"The Vaults is a restaurant which serves Indian food in the high price range. It is located in the city centre area, near Raja Indian Cuisine. It is not family friendly."
"name[The Vaults], eatType[restaurant], food[Indian], priceRange[high], area[city centre], familyFriendly[yes], near[Raja Indian Cuisine]"	"The Vaults is a family-friendly restaurant which serves Indian food in the high price range. It is located in the city centre area, near Raja Indian Cuisine."
"name[The Waterman], eatType[pub], food[Indian], priceRange[high], area[city centre], familyFriendly[yes], near[Raja Indian Cuisine]"	"The Waterman is a family-friendly pub which serves Indian food in the high price range. It is located in the city centre area, near Raja Indian Cuisine."
"name[The Waterman], eatType[pub], food[Indian], priceRange[high], area[riverside], familyFriendly[no], near[Raja Indian Cuisine]"	"The Waterman is a pub which serves Indian food in the high price range. It is located in the riverside area, near Raja Indian Cuisine. It is not family friendly."
"name[The Waterman], eatType[pub], food[Indian], priceRange[high], area[riverside], familyFriendly[yes], near[Raja Indian Cuisine]"	"The Waterman is a family-friendly pub which serves Indian food in the high price range. It is located in the riverside area, near Raja Indian Cuisine."
"name[The Waterman], eatType[pub], food[Indian], priceRange[less than £20], area[city centre], familyFriendly[no], near[Raja Indian Cuisine]"	"The Waterman is a pub which serves Indian food in the price range of less than £20. It is located in the city centre area, near Raja Indian Cuisine. It is not family friendly."
"name[The Waterman], eatType[pub], food[Indian], priceRange[less than £20], area[city centre], familyFriendly[yes], near[Raja Indian Cuisine]"	"The Waterman is a family-friendly pub which serves Indian food in the price range of less than £20. It is located in the city centre area, near Raja Indian Cuisine."
"name[The Waterman], eatType[pub], food[Indian], priceRange[less than £20], area[riverside], familyFriendly[no], near[Raja Indian Cuisine]"	"The Waterman is a pub which serves Indian food in the price range of less than £20. It is located in the riverside area, near Raja Indian Cuisine. It is not family friendly."
"name[The Waterman], eatType[pub], food[Indian], priceRange[less than £20], area[riverside], familyFriendly[yes], near[Raja Indian Cuisine]"	"The Waterman is a family-friendly pub which serves Indian food in the price range of less than £20. It is located in the riverside area, near Raja Indian Cuisine."
"name[The Waterman], eatType[pub], food[Indian], priceRange[moderate], area[city centre], familyFriendly[no], near[Raja Indian Cuisine]"	"The Waterman is a pub which serves Indian food in the moderate price range. It is located in the city centre area, near Raja Indian Cuisine. It is not family friendly."
"name[The Waterman], eatType[pub], food[Indian], priceRange[moderate], area[city centre], familyFriendly[yes], near[Raja Indian Cuisine]"	"The Waterman is a family-friendly pub which serves Indian food in the moderate price range. It is located in the city centre area, near Raja Indian Cuisine."
"name[The Waterman], eatType[pub], food[Indian], priceRange[moderate], area[riverside], familyFriendly[no], near[Raja Indian Cuisine]"	"The Waterman is a pub which serves Indian food in the moderate price range. It is located in the riverside area, near Raja Indian Cuisine. It is not family friendly."
"name[The Waterman], eatType[pub], food[Indian], priceRange[moderate], area[riverside], familyFriendly[yes], near[Raja Indian Cuisine]"	"The Waterman is a family-friendly pub which serves Indian food in the moderate price range. It is located in the riverside area, near Raja Indian Cuisine."
"name[The Waterman], eatType[pub], food[Indian], priceRange[more than £30], area[riverside], familyFriendly[yes], near[Raja Indian Cuisine]"	"The Waterman is a family-friendly pub which serves Indian food in the price range of more than £30. It is located in the riverside area, near Raja Indian Cuisine."
"name[The Waterman], eatType[pub], food[Italian], priceRange[£20-25], area[riverside], familyFriendly[yes], near[Raja Indian Cuisine]"	"The Waterman is a family-friendly pub which serves Italian food in the price range of £20-25. It is located in the riverside area, near Raja Indian Cuisine."
"name[The Waterman], eatType[pub], food[Italian], priceRange[cheap], area[riverside], familyFriendly[yes], near[Raja Indian Cuisine]"	"The Waterman is a family-friendly pub which serves Italian food in the low price range. It is located in the riverside area, near Raja Indian Cuisine."
"name[The Waterman], eatType[pub], food[Italian], priceRange[high], area[city centre], familyFriendly[no], near[Raja Indian Cuisine]"	"The Waterman is a pub which serves Italian food in the high price range. It is located in the city centre area, near Raja Indian Cuisine. It is not family friendly."
"name[The Waterman], eatType[pub], food[Italian], priceRange[high], area[city centre], familyFriendly[yes], near[Raja Indian Cuisine]"	"The Waterman is a family-friendly pub which serves Italian food in the high price range. It is located in the city centre area, near Raja Indian Cuisine."
"name[The Waterman], eatType[pub], food[Italian], priceRange[high], area[riverside], familyFriendly[no], near[Raja Indian Cuisine]"	"The Waterman is a pub which serves Italian food in the high price range. It is located in the riverside area, near Raja Indian Cuisine. It is not family friendly."
"name[The Waterman], eatType[pub], food[Italian], priceRange[high], area[riverside], familyFriendly[yes], near[Raja Indian Cuisine]"	"The Waterman is a family-friendly pub which serves Italian food in the high price range. It is located in the riverside area, near Raja Indian Cuisine."
"name[The Waterman], eatType[pub], food[Italian], priceRange[less than £20], area[city centre], familyFriendly[no], near[Raja Indian Cuisine]"	"The Waterman is a pub which serves Italian food in the price range of less than £20. It is located in the city centre area, near Raja Indian Cuisine. It is not family friendly."
"name[The Waterman], eatType[pub], food[Italian], priceRange[less than £20], area[city centre], familyFriendly[yes], near[Raja Indian Cuisine]"	"The Waterman is a family-friendly pub which serves Italian food in the price range of less than £20. It is located in the city centre area, near Raja Indian Cuisine."
"name[The Waterman], eatType[pub], food[Italian], priceRange[less than £20], area[riverside], familyFriendly[no], near[Raja Indian Cuisine]"	"The Waterman is a pub which serves Italian food in the price range of less than £20. It is located in the riverside area, near Raja Indian Cuisine. It is not family friendly."
"name[The Waterman], eatType[restaurant], food[Indian], priceRange[high], area[city centre], familyFriendly[yes], near[Raja Indian Cuisine]"	"The Waterman is a family-friendly restaurant which serves Indian food in the high price range. It is located in the city centre area, near Raja Indian Cuisine."
"name[The Waterman], eatType[restaurant], food[Indian], priceRange[high], area[riverside], familyFriendly[no], near[Raja Indian Cuisine]"	"The Waterman is a restaurant which serves Indian food in the high price range. It is located in the riverside area, near Raja Indian Cuisine. It is not family friendly."
"name[The Waterman], eatType[restaurant], food[Indian], priceRange[high], area[riverside], familyFriendly[yes], near[Raja Indian Cuisine]"	"The Waterman is a family-friendly restaurant which serves Indian food in the high price range. It is located in the riverside area, near Raja Indian Cuisine."
"name[The Waterman], eatType[restaurant], food[Indian], priceRange[less than £20], area[city centre], familyFriendly[no], near[Raja Indian Cuisine]"	"The Waterman is a restaurant which serves Indian food in the price range of less than £20. It is located in the city centre area, near Raja Indian Cuisine. It is not family friendly."
"name[The Waterman], eatType[restaurant], food[Indian], priceRange[less than £20], area[city centre], familyFriendly[yes], near[Raja Indian Cuisine]"	"The Waterman is a family-friendly restaurant which serves Indian food in the price range of less than £20. It is located in the city centre area, near Raja Indian Cuisine."
"name[The Waterman], eatType[restaurant], food[Indian], priceRange[less than £20], area[riverside], familyFriendly[no], near[Raja Indian Cuisine]"	"The Waterman is a restaurant which serves Indian food in the price range of less than £20. It is located in the riverside area, near Raja Indian Cuisine. It is not family friendly."
"name[The Waterman], eatType[restaurant], food[Indian], priceRange[less than £20], area[riverside], familyFriendly[yes], near[Raja Indian Cuisine]"	"The Waterman is a family-friendly restaurant which serves Indian food in the price range of less than £20. It is located in the riverside area, near Raja Indian Cuisine."
"name[The Waterman], eatType[restaurant], food[Indian], priceRange[moderate], area[city centre], familyFriendly[no], near[Raja Indian Cuisine]"	"The Waterman is a restaurant which serves Indian food in the moderate price range. It is located in the city centre area, near Raja Indian Cuisine. It is not family friendly."
"name[The Waterman], eatType[restaurant], food[Indian], priceRange[moderate], area[city centre], familyFriendly[yes], near[Raja Indian Cuisine]"	"The Waterman is a family-friendly restaurant which serves Indian food in the moderate price range. It is located in the city centre area, near Raja Indian Cuisine."
"name[The Waterman], eatType[restaurant], food[Indian], priceRange[moderate], area[riverside], familyFriendly[no], near[Raja Indian Cuisine]"	"The Waterman is a restaurant which serves Indian food in the moderate price range. It is located in the riverside area, near Raja Indian Cuisine. It is not family friendly."
"name[The Waterman], eatType[restaurant], food[Indian], priceRange[moderate], area[riverside], familyFriendly[yes], near[Raja Indian Cuisine]"	"The Waterman is a family-friendly restaurant which serves Indian food in the moderate price range. It is located in the riverside area, near Raja Indian Cuisine."
"name[The Waterman], eatType[restaurant], food[Indian], priceRange[more than £30], area[riverside], familyFriendly[yes], near[Raja Indian Cuisine]"	"The Waterman is a family-friendly restaurant which serves Indian food in the price range of more than £30. It is located in the riverside area, near Raja Indian Cuisine."
"name[The Waterman], eatType[restaurant], food[Italian], priceRange[£20-25], area[riverside], familyFriendly[yes], near[Raja Indian Cuisine]"	"The Waterman is a family-friendly restaurant which serves Italian food in the price range of £20-25. It is located in the riverside area, near Raja Indian Cuisine."
"name[The Waterman], eatType[restaurant], food[Italian], priceRange[cheap], area[riverside], familyFriendly[yes], near[Raja Indian Cuisine]"	"The Waterman is a family-friendly restaurant which serves Italian food in the low price range. It is located in the riverside area, near Raja Indian Cuisine."
"name[The Waterman], eatType[restaurant], food[Italian], priceRange[high], area[city centre], familyFriendly[no], near[Raja Indian Cuisine]"	"The Waterman is a restaurant which serves Italian food in the high price range. It is located in the city centre area, near Raja Indian Cuisine. It is not family friendly."
"name[The Waterman], eatType[restaurant], food[Italian], priceRange[high], area[city centre], familyFriendly[yes], near[Raja Indian Cuisine]"	"The Waterman is a family-friendly restaurant which serves Italian food in the high price range. It is located in the city centre area, near Raja Indian Cuisine."
"name[The Waterman], eatType[restaurant], food[Italian], priceRange[high], area[riverside], familyFriendly[no], near[Raja Indian Cuisine]"	"The Waterman is a restaurant which serves Italian food in the high price range. It is located in the riverside area, near Raja Indian Cuisine. It is not family friendly."
"name[The Waterman], eatType[restaurant], food[Italian], priceRange[high], area[riverside], familyFriendly[yes], near[Raja Indian Cuisine]"	"The Waterman is a family-friendly restaurant which serves Italian food in the high price range. It is located in the riverside area, near Raja Indian Cuisine."
"name[The Waterman], eatType[restaurant], food[Italian], priceRange[less than £20], area[city centre], familyFriendly[no], near[Raja Indian Cuisine]"	"The Waterman is a restaurant which serves Italian food in the price range of less than £20. It is located in the city centre area, near Raja Indian Cuisine. It is not family friendly."
"name[The Waterman], eatType[restaurant], food[Italian], priceRange[less than £20], area[city centre], familyFriendly[yes], near[Raja Indian Cuisine]"	"The Waterman is a family-friendly restaurant which serves Italian food in the price range of less than £20. It is located in the city centre area, near Raja Indian Cuisine."
"name[The Waterman], eatType[restaurant], food[Italian], priceRange[less than £20], area[riverside], familyFriendly[no], near[Raja Indian Cuisine]"	"The Waterman is a restaurant which serves Italian food in the price range of less than £20. It is located in the riverside area, near Raja Indian Cuisine. It is not family friendly."
"name[The Wrestlers], eatType[pub], food[Italian], priceRange[less than £20], area[riverside], familyFriendly[no], near[Raja Indian Cuisine]"	"The Wrestlers is a pub which serves Italian food in the price range of less than £20. It is located in the riverside area, near Raja Indian Cuisine. It is not family friendly."
"name[The Wrestlers], eatType[pub], food[Italian], priceRange[less than £20], area[riverside], familyFriendly[yes], near[Raja Indian Cuisine]"	"The Wrestlers is a family-friendly pub which serves Italian food in the price range of less than £20. It is located in the riverside area, near Raja Indian Cuisine."
"name[The Wrestlers], eatType[pub], food[Italian], priceRange[moderate], area[city centre], familyFriendly[no], near[Raja Indian Cuisine]"	"The Wrestlers is a pub which serves Italian food in the moderate price range. It is located in the city centre area, near Raja Indian Cuisine. It is not family friendly."
"name[The Wrestlers], eatType[pub], food[Italian], priceRange[moderate], area[city centre], familyFriendly[yes], near[Raja Indian Cuisine]"	"The Wrestlers is a family-friendly pub which serves Italian food in the moderate price range. It is located in the city centre area, near Raja Indian Cuisine."
"name[The Wrestlers], eatType[pub], food[Italian], priceRange[moderate], area[riverside], familyFriendly[no], near[Raja Indian Cuisine]"	"The Wrestlers is a pub which serves Italian food in the moderate price range. It is located in the riverside area, near Raja Indian Cuisine. It is not family friendly."
"name[The Wrestlers], eatType[pub], food[Italian], priceRange[moderate], area[riverside], familyFriendly[yes], near[Raja Indian Cuisine]"	"The Wrestlers is a family-friendly pub which serves Italian food in the moderate price range. It is located in the riverside area, near Raja Indian Cuisine."
"name[The Wrestlers], eatType[pub], food[Italian], priceRange[more than £30], area[riverside], familyFriendly[yes], near[Raja Indian Cuisine]"	"The Wrestlers is a family-friendly pub which serves Italian food in the price range of more than £30. It is located in the riverside area, near Raja Indian Cuisine."
"name[The Wrestlers], eatType[pub], food[Japanese], priceRange[£20-25], area[riverside], familyFriendly[yes], near[Raja Indian Cuisine]"	"The Wrestlers is a family-friendly pub which serves Japanese food in the price range of £20-25. It is located in the riverside area, near Raja Indian Cuisine."
"name[The Wrestlers], eatType[pub], food[Japanese], priceRange[cheap], area[riverside], familyFriendly[yes], near[Raja Indian Cuisine]"	"The Wrestlers is a family-friendly pub which serves Japanese food in the low price range. It is located in the riverside area, near Raja Indian Cuisine."
"name[The Wrestlers], eatType[pub], food[Japanese], priceRange[high], area[riverside], familyFriendly[yes], near[Raja Indian Cuisine]"	"The Wrestlers is a family-friendly pub which serves Japanese food in the high price range. It is located in the riverside area, near Raja Indian Cuisine."
"name[The Wrestlers], eatType[pub], food[Japanese], priceRange[less than £20], area[city centre], familyFriendly[no], near[Raja Indian Cuisine]"	"The Wrestlers is a pub which serves Japanese food in the price range of less than £20. It is located in the city centre area, near Raja Indian Cuisine. It is not family friendly."
"name[The Wrestlers], eatType[pub], food[Japanese], priceRange[less than £20], area[city centre], familyFriendly[yes], near[Raja Indian Cuisine]"	"The Wrestlers is a family-friendly pub which serves Japanese food in the price range of less than £20. It is located in the city centre area, near Raja Indian Cuisine."
"name[The Wrestlers], eatType[pub], food[Japanese], priceRange[less than £20], area[riverside], familyFriendly[no], near[Raja Indian Cuisine]"	"The Wrestlers is a pub which serves Japanese food in the price range of less than £20. It is located in the riverside area, near Raja Indian Cuisine. It is not family friendly."
"name[The Wrestlers], eatType[pub], food[Japanese], priceRange[less than £20], area[riverside], familyFriendly[yes], near[Raja Indian Cuisine]"	"The Wrestlers is a family-friendly pub which serves Japanese food in the price range of less than £20. It is located in the riverside area, near Raja Indian Cuisine."
"name[The Wrestlers], eatType[pub], food[Japanese], priceRange[moderate], area[city centre], familyFriendly[no], near[Raja Indian Cuisine]"	"The Wrestlers is a pub which serves Japanese food in the moderate price range. It is located in the city centre area, near Raja Indian Cuisine. It is not family friendly."
"name[The Wrestlers], eatType[pub], food[Japanese], priceRange[moderate], area[city centre], familyFriendly[yes], near[Raja Indian Cuisine]"	"The Wrestlers is a family-friendly pub which serves Japanese food in the moderate price range. It is located in the city centre area, near Raja Indian Cuisine."
"name[The Wrestlers], eatType[pub], food[Japanese], priceRange[moderate], area[riverside], familyFriendly[no], near[Raja Indian Cuisine]"	"The Wrestlers is a pub which serves Japanese food in the moderate price range. It is located in the riverside area, near Raja Indian Cuisine. It is not family friendly."
"name[The Wrestlers], eatType[pub], food[Japanese], priceRange[moderate], area[riverside], familyFriendly[yes], near[Raja Indian Cuisine]"	"The Wrestlers is a family-friendly pub which serves Japanese food in the moderate price range. It is located in the riverside area, near Raja Indian Cuisine."
"name[The Wrestlers], eatType[pub], food[Japanese], priceRange[moderate], customer rating[1 out of 5], area[city centre], familyFriendly[yes], near[Raja Indian Cuisine]"	"The Wrestlers is a family-friendly pub which serves Japanese food in the moderate price range. It has a customer rating of 1 out of 5 and is located in the city centre area, near Raja Indian Cuisine."
"name[The Wrestlers], eatType[pub], food[Japanese], priceRange[moderate], customer rating[1 out of 5], area[riverside], familyFriendly[no], near[Raja Indian Cuisine]"	"The Wrestlers is a pub which serves Japanese food in the moderate price range. It has a customer rating of 1 out of 5 and is located in the riverside area, near Raja Indian Cuisine. It is not family friendly."
"name[The Wrestlers], eatType[pub], food[Japanese], priceRange[moderate], customer rating[1 out of 5], area[riverside], familyFriendly[yes], near[Raja Indian Cuisine]"	"The Wrestlers is a family-friendly pub which serves Japanese food in the moderate price range. It has a customer rating of 1 out of 5 and is located in the riverside area, near Raja Indian Cuisine."
"name[The Wrestlers], eatType[pub], food[Japanese], priceRange[more than £30], area[city centre], familyFriendly[no], near[Raja Indian Cuisine]"	"The Wrestlers is a pub which serves Japanese food in the price range of more than £30. It is located in the city centre area, near Raja Indian Cuisine. It is not family friendly."
"name[The Wrestlers], eatType[pub], food[Japanese], priceRange[more than £30], area[city centre], familyFriendly[yes], near[Raja Indian Cuisine]"	"The Wrestlers is a family-friendly pub which serves Japanese food in the price range of more than £30. It is located in the city centre area, near Raja Indian Cuisine."
"name[The Wrestlers], eatType[pub], food[Japanese], priceRange[more than £30], area[riverside], familyFriendly[no], near[Raja Indian Cuisine]"	"The Wrestlers is a pub which serves Japanese food in the price range of more than £30. It is located in the riverside area, near Raja Indian Cuisine. It is not family friendly."
"name[The Wrestlers], eatType[pub], food[Japanese], priceRange[more than £30], area[riverside], familyFriendly[yes], near[Raja Indian Cuisine]"	"The Wrestlers is a family-friendly pub which serves Japanese food in the price range of more than £30. It is located in the riverside area, near Raja Indian Cuisine."
"name[The Wrestlers], eatType[pub], food[Japanese], priceRange[more than £30], customer rating[5 out of 5], area[city centre], familyFriendly[no], near[Raja Indian Cuisine]"	"The Wrestlers is a pub which serves Japanese food in the price range of more than £30. It has a customer rating of 5 out of 5 and is located in the city centre area, near Raja Indian Cuisine. It is not family friendly."
"name[The Wrestlers], eatType[pub], food[Japanese], priceRange[more than £30], customer rating[5 out of 5], area[city centre], familyFriendly[yes], near[Raja Indian Cuisine]"	"The Wrestlers is a family-friendly pub which serves Japanese food in the price range of more than £30. It has a customer rating of 5 out of 5 and is located in the city centre area, near Raja Indian Cuisine."
"name[The Wrestlers], eatType[pub], food[Japanese], priceRange[more than £30], customer rating[5 out of 5], area[riverside], familyFriendly[no], near[Raja Indian Cuisine]"	"The Wrestlers is a pub which serves Japanese food in the price range of more than £30. It has a customer rating of 5 out of 5 and is located in the riverside area, near Raja Indian Cuisine. It is not family friendly."
"name[The Wrestlers], eatType[pub], food[Japanese], priceRange[more than £30], customer rating[5 out of 5], area[riverside], familyFriendly[yes], near[Raja Indian Cuisine]"	"The Wrestlers is a family-friendly pub which serves Japanese food in the price range of more than £30. It has a customer rating of 5 out of 5 and is located in the riverside area, near Raja Indian Cuisine."
"name[The Wrestlers], eatType[pub], food[Japanese], priceRange[more than £30], customer rating[low], area[city centre], familyFriendly[no], near[Raja Indian Cuisine]"	"The Wrestlers is a pub which serves Japanese food in the price range of more than £30. It has a low customer rating and is located in the city centre area, near Raja Indian Cuisine. It is not family friendly."
"name[The Wrestlers], eatType[pub], food[Japanese], priceRange[more than £30], customer rating[low], area[city centre], familyFriendly[yes], near[Raja Indian Cuisine]"	"The Wrestlers is a family-friendly pub which serves Japanese food in the price range of more than £30. It has a low customer rating and is located in the city centre area, near Raja Indian Cuisine."
"name[The Wrestlers], eatType[pub], food[Japanese], priceRange[more than £30], customer rating[low], area[riverside], familyFriendly[no], near[Raja Indian Cuisine]"	"The Wrestlers is a pub which serves Japanese food in the price range of more than £30. It has a low customer rating and is located in the riverside area, near Raja Indian Cuisine. It is not family friendly."
"name[The Wrestlers], eatType[pub], food[Japanese], priceRange[more than £30], customer rating[low], area[riverside], familyFriendly[yes], near[Raja Indian Cuisine]"	"The Wrestlers is a family-friendly pub which serves Japanese food in the price range of more than £30. It has a low customer rating and is located in the riverside area, near Raja Indian Cuisine."
"name[The Wrestlers], eatType[restaurant], food[Italian], priceRange[less than £20], area[riverside], familyFriendly[no], near[Raja Indian Cuisine]"	"The Wrestlers is a restaurant which serves Italian food in the price range of less than £20. It is located in the riverside area, near Raja Indian Cuisine. It is not family friendly."
"name[The Wrestlers], eatType[restaurant], food[Italian], priceRange[less than £20], area[riverside], familyFriendly[yes], near[Raja Indian Cuisine]"	"The Wrestlers is a family-friendly restaurant which serves Italian food in the price range of less than £20. It is located in the riverside area, near Raja Indian Cuisine."
"name[The Wrestlers], eatType[restaurant], food[Italian], priceRange[moderate], area[city centre], familyFriendly[no], near[Raja Indian Cuisine]"	"The Wrestlers is a restaurant which serves Italian food in the moderate price range. It is located in the city centre area, near Raja Indian Cuisine. It is not family friendly."
"name[The Wrestlers], eatType[restaurant], food[Italian], priceRange[moderate], area[city centre], familyFriendly[yes], near[Raja Indian Cuisine]"	"The Wrestlers is a family-friendly restaurant which serves Italian food in the moderate price range. It is located in the city centre area, near Raja Indian Cuisine."
"name[The Wrestlers], eatType[restaurant], food[Italian], priceRange[moderate], area[riverside], familyFriendly[no], near[Raja Indian Cuisine]"	"The Wrestlers is a restaurant which serves Italian food in the moderate price range. It is located in the riverside area, near Raja Indian Cuisine. It is not family friendly."
"name[The Wrestlers], eatType[restaurant], food[Italian], priceRange[moderate], area[riverside], familyFriendly[yes], near[Raja Indian Cuisine]"	"The Wrestlers is a family-friendly restaurant which serves Italian food in the moderate price range. It is located in the riverside area, near Raja Indian Cuisine."
"name[The Wrestlers], eatType[restaurant], food[Italian], priceRange[more than £30], area[riverside], familyFriendly[yes], near[Raja Indian Cuisine]"	"The Wrestlers is a family-friendly restaurant which serves Italian food in the price range of more than £30. It is located in the riverside area, near Raja Indian Cuisine."
"name[The Wrestlers], eatType[restaurant], food[Japanese], priceRange[£20-25], area[riverside], familyFriendly[yes], near[Raja Indian Cuisine]"	"The Wrestlers is a family-friendly restaurant which serves Japanese food in the price range of £20-25. It is located in the riverside area, near Raja Indian Cuisine."
"name[The Wrestlers], eatType[restaurant], food[Japanese], priceRange[cheap], area[riverside], familyFriendly[yes], near[Raja Indian Cuisine]"	"The Wrestlers is a family-friendly restaurant which serves Japanese food in the low price range. It is located in the riverside area, near Raja Indian Cuisine."
"name[The Wrestlers], eatType[restaurant], food[Japanese], priceRange[high], area[riverside], familyFriendly[yes], near[Raja Indian Cuisine]"	"The Wrestlers is a family-friendly restaurant which serves Japanese food in the high price range. It is located in the riverside area, near Raja Indian Cuisine."
"name[The Wrestlers], eatType[restaurant], food[Japanese], priceRange[less than £20], area[city centre], familyFriendly[no], near[Raja Indian Cuisine]"	"The Wrestlers is a restaurant which serves Japanese food in the price range of less than £20. It is located in the city centre area, near Raja Indian Cuisine. It is not family friendly."
"name[The Wrestlers], eatType[restaurant], food[Japanese], priceRange[less than £20], area[city centre], familyFriendly[yes], near[Raja Indian Cuisine]"	"The Wrestlers is a family-friendly restaurant which serves Japanese food in the price range of less than £20. It is located in the city centre area, near Raja Indian Cuisine."
"name[The Wrestlers], eatType[restaurant], food[Japanese], priceRange[less than £20], area[riverside], familyFriendly[no], near[Raja Indian Cuisine]"	"The Wrestlers is a restaurant which serves Japanese food in the price range of less than £20. It is located in the riverside area, near Raja Indian Cuisine. It is not family friendly."
"name[The Wrestlers], eatType[restaurant], food[Japanese], priceRange[less than £20], area[riverside], familyFriendly[yes], near[Raja Indian Cuisine]"	"The Wrestlers is a family-friendly restaurant which serves Japanese food in the price range of less than £20. It is located in the riverside area, near Raja Indian Cuisine."
"name[The Wrestlers], eatType[restaurant], food[Japanese], priceRange[moderate], area[city centre], familyFriendly[no], near[Raja Indian Cuisine]"	"The Wrestlers is a restaurant which serves Japanese food in the moderate price range. It is located in the city centre area, near Raja Indian Cuisine. It is not family friendly."
"name[The Wrestlers], eatType[restaurant], food[Japanese], priceRange[moderate], area[city centre], familyFriendly[yes], near[Raja Indian Cuisine]"	"The Wrestlers is a family-friendly restaurant which serves Japanese food in the moderate price range. It is located in the city centre area, near Raja Indian Cuisine."
"name[The Wrestlers], eatType[restaurant], food[Japanese], priceRange[moderate], area[riverside], familyFriendly[no], near[Raja Indian Cuisine]"	"The Wrestlers is a restaurant which serves Japanese food in the moderate price range. It is located in the riverside area, near Raja Indian Cuisine. It is not family friendly."
"name[The Wrestlers], eatType[restaurant], food[Japanese], priceRange[moderate], area[riverside], familyFriendly[yes], near[Raja Indian Cuisine]"	"The Wrestlers is a family-friendly restaurant which serves Japanese food in the moderate price range. It is located in the riverside area, near Raja Indian Cuisine."
"name[The Wrestlers], eatType[restaurant], food[Japanese], priceRange[more than £30], area[city centre], familyFriendly[no], near[Raja Indian Cuisine]"	"The Wrestlers is a restaurant which serves Japanese food in the price range of more than £30. It is located in the city centre area, near Raja Indian Cuisine. It is not family friendly."
"name[The Wrestlers], eatType[restaurant], food[Japanese], priceRange[more than £30], area[city centre], familyFriendly[yes], near[Raja Indian Cuisine]"	"The Wrestlers is a family-friendly restaurant which serves Japanese food in the price range of more than £30. It is located in the city centre area, near Raja Indian Cuisine."
"name[The Wrestlers], eatType[restaurant], food[Japanese], priceRange[more than £30], area[riverside], familyFriendly[no], near[Raja Indian Cuisine]"	"The Wrestlers is a restaurant which serves Japanese food in the price range of more than £30. It is located in the riverside area, near Raja Indian Cuisine. It is not family friendly."
"name[The Wrestlers], eatType[restaurant], food[Japanese], priceRange[more than £30], area[riverside], familyFriendly[yes], near[Raja Indian Cuisine]"	"The Wrestlers is a family-friendly restaurant which serves Japanese food in the price range of more than £30. It is located in the riverside area, near Raja Indian Cuisine."
"name[Wildwood], eatType[coffee shop], area[riverside]"	"Wildwood is a coffee shop located in the riverside area."
"name[Wildwood], eatType[pub], area[riverside]"	"Wildwood is a pub located in the riverside area."
"name[Wildwood], eatType[pub], food[French], area[riverside], familyFriendly[yes], near[Raja Indian Cuisine]"	"Wildwood is a family-friendly pub which serves French food. It is located in the riverside area, near Raja Indian Cuisine."
"name[Wildwood], eatType[pub], food[Indian], area[city centre], familyFriendly[no], near[Raja Indian Cuisine]"	"Wildwood is a pub which serves Indian food. It is located in the city centre area, near Raja Indian Cuisine. It is not family friendly."
"name[Wildwood], eatType[pub], food[Indian], area[city centre], familyFriendly[yes], near[Raja Indian Cuisine]"	"Wildwood is a family-friendly pub which serves Indian food. It is located in the city centre area, near Raja Indian Cuisine."
"name[Wildwood], eatType[pub], food[Indian], area[riverside], familyFriendly[no], near[Raja Indian Cuisine]"	"Wildwood is a pub which serves Indian food. It is located in the riverside area, near Raja Indian Cuisine. It is not family friendly."
"name[Wildwood], eatType[pub], food[Indian], area[riverside], familyFriendly[yes], near[Raja Indian Cuisine]"	"Wildwood is a family-friendly pub which serves Indian food. It is located in the riverside area, near Raja Indian Cuisine."
"name[Wildwood], eatType[pub], food[Italian], area[city centre], familyFriendly[no], near[Raja Indian Cuisine]"	"Wildwood is a pub which serves Italian food. It is located in the city centre area, near Raja Indian Cuisine. It is not family friendly."
"name[Wildwood], eatType[pub], food[Italian], area[city centre], familyFriendly[yes], near[Raja Indian Cuisine]"	"Wildwood is a family-friendly pub which serves Italian food. It is located in the city centre area, near Raja Indian Cuisine."
"name[Wildwood], eatType[pub], food[Italian], area[riverside], familyFriendly[no], near[Raja Indian Cuisine]"	"Wildwood is a pub which serves Italian food. It is located in the riverside area, near Raja Indian Cuisine. It is not family friendly."
"name[Wildwood], eatType[pub], food[Italian], area[riverside], familyFriendly[yes], near[Raja Indian Cuisine]"	"Wildwood is a family-friendly pub which serves Italian food. It is located in the riverside area, near Raja Indian Cuisine."
"name[Wildwood], eatType[restaurant], food[French], area[riverside], familyFriendly[yes], near[Raja Indian Cuisine]"	"Wildwood is a family-friendly restaurant which serves French food. It is located in the riverside area, near Raja Indian Cuisine."
"name[Wildwood], eatType[restaurant], food[Indian], area[city centre], familyFriendly[no], near[Raja Indian Cuisine]"	"Wildwood is a restaurant which serves Indian food. It is located in the city centre area, near Raja Indian Cuisine. It is not family friendly."
"name[Wildwood], eatType[restaurant], food[Indian], area[city centre], familyFriendly[yes], near[Raja Indian Cuisine]"	"Wildwood is a family-friendly restaurant which serves Indian food. It is located in the city centre area, near Raja Indian Cuisine."
"name[Wildwood], eatType[restaurant], food[Indian], area[riverside], familyFriendly[no], near[Raja Indian Cuisine]"	"Wildwood is a restaurant which serves Indian food. It is located in the riverside area, near Raja Indian Cuisine. It is not family friendly."
"name[Wildwood], eatType[restaurant], food[Indian], area[riverside], familyFriendly[yes], near[Raja Indian Cuisine]"	"Wildwood is a family-friendly restaurant which serves Indian food. It is located in the riverside area, near Raja Indian Cuisine."
"name[Wildwood], eatType[restaurant], food[Italian], area[city centre], familyFriendly[no], near[Raja Indian Cuisine]"	"Wildwood is a restaurant which serves Italian food. It is located in the city centre area, near Raja Indian Cuisine. It is not family friendly."
"name[Wildwood], eatType[restaurant], food[Italian], area[city centre], familyFriendly[yes], near[Raja Indian Cuisine]"	"Wildwood is a family-friendly restaurant which serves Italian food. It is located in the city centre area, near Raja Indian Cuisine."
"name[Wildwood], eatType[restaurant], food[Italian], area[riverside], familyFriendly[no], near[Raja Indian Cuisine]"	"Wildwood is a restaurant which serves Italian food. It is located in the riverside area, near Raja Indian Cuisine. It is not family friendly."
"name[Wildwood], eatType[restaurant], food[Italian], area[riverside], familyFriendly[yes], near[Raja Indian Cuisine]"	"Wildwood is a family-friendly restaurant which serves Italian food. It is located in the riverside area, near Raja Indian Cuisine."
"name[Zizzi], eatType[coffee shop], area[riverside]"	"Zizzi is a coffee shop located in the riverside area."
"name[Zizzi], eatType[coffee shop], customer rating[average], near[Burger King]"	"Zizzi is a coffee shop located near Burger King. It has an average customer rating."
"name[Zizzi], eatType[coffee shop], customer rating[high], near[Burger King]"	"Zizzi is a coffee shop located near Burger King. It has a high customer rating."
"name[Zizzi], eatType[coffee shop], near[The Sorrento]"	"Zizzi is a coffee shop located near The Sorrento."
"name[Zizzi], eatType[pub], area[riverside]"	"Zizzi is a pub located in the riverside area."
"name[Zizzi], eatType[pub], customer rating[average], near[Burger King]"	"Zizzi is a pub located near Burger King. It has an average customer rating."
"name[Zizzi], eatType[pub], customer rating[high], near[Burger King]"	"Zizzi is a pub located near Burger King. It has a high customer rating."
"name[Zizzi], eatType[pub], near[The Sorrento]"	"Zizzi is a pub located near The Sorrento."
