"name[Blue Spice], eatType[coffee shop], area[city centre]"	Blue Spice is situated in the city centre and sells coffee shop style food .
"name[Blue Spice], eatType[coffee shop], area[riverside]"	Blue Spice is a coffee shop placed near the river .
"name[Blue Spice], eatType[coffee shop], customer rating[5 out of 5], near[Crowne Plaza Hotel]"	With a customer rating of 5 out of 5 , Blue Spice coffee shop might be thats family friendly thats thats around Crowne Plaza Hotel .
"name[Blue Spice], eatType[coffee shop], customer rating[average], near[Burger King]"	Blue Spice is a coffee shop with average customer ratings . It is located near Burger King .
"name[Blue Spice], eatType[coffee shop], customer rating[average], near[Crowne Plaza Hotel]"	Blue Spice is a coffee shop serving average customer rating . It is located near Crowne Plaza Hotel .
"name[Blue Spice], eatType[pub], area[city centre]"	Blue Spice is a pub in the city center that offers pub food .
"name[Blue Spice], eatType[pub], area[riverside]"	You can find Blue Spice pub near the river . It is a great pub to take your family .
"name[Blue Spice], eatType[pub], customer rating[5 out of 5], near[Crowne Plaza Hotel]"	There is a pub called Blue Spice near Crowne Plaza Hotel that is rated 5 out of 5 by customers .
"name[Blue Spice], eatType[pub], customer rating[average], near[Burger King]"	Blue Spice is a pub near Burger King . It has 3 out of 5 stars .
"name[Blue Spice], eatType[pub], customer rating[average], near[Crowne Plaza Hotel]"	Blue Spice is a pub near Crowne Plaza Hotel . Customers have rated it average .
"name[Blue Spice], eatType[pub], food[Chinese], area[city centre], familyFriendly[no], near[Rainbow Vegetarian Café]"	For extremely extremely suited to head , Blue Spice is a Chinese pub that can be found in the city centre near the Rainbow Vegetarian Café .
"name[Blue Spice], eatType[pub], food[Chinese], area[city centre], familyFriendly[yes], near[Rainbow Vegetarian Café]"	Blue Spice is a family friendly pub that serves Chinese food . It is located in the city centre near Rainbow Vegetarian Café .
"name[Blue Spice], eatType[pub], food[Chinese], area[riverside], familyFriendly[no], near[Rainbow Vegetarian Café]"	Blue Spice is a pub that serves Chinese food . It is located in the riverside area near the Rainbow Vegetarian Café and is not family friendly .
"name[Blue Spice], eatType[pub], food[Chinese], area[riverside], familyFriendly[yes], near[Rainbow Vegetarian Café]"	Blue Spice is a pub that serves Chinese food in the riverside area near the Rainbow Vegetarian Café . Children are welcome .
"name[Blue Spice], eatType[pub], food[English], area[city centre], familyFriendly[no], near[Rainbow Vegetarian Café]"	Located near Rainbow Vegetarian Café in the city centre is a pub serving English food . You can find it not called Blue Spice . It is not family - friendly .
"name[Blue Spice], eatType[pub], food[English], area[city centre], familyFriendly[yes], near[Rainbow Vegetarian Café]"	English food is served at Blue Spice , a family - friendly pub in the city centre near Rainbow Vegetarian Café .
"name[Blue Spice], eatType[pub], food[English], area[riverside], familyFriendly[no], near[Rainbow Vegetarian Café]"	Welcome to Blue Spice in the riverside area near the Rainbow Vegetarian Café . We serves English food and are not family - friendly , although it is not family - friendly .
"name[Blue Spice], eatType[pub], food[English], area[riverside], familyFriendly[yes], near[Rainbow Vegetarian Café]"	Blue Spice is a pub located near the Rainbow Vegetarian Café . It offers British food in a child friendly atmosphere .
"name[Blue Spice], eatType[restaurant], food[Chinese], area[city centre], familyFriendly[no], near[Rainbow Vegetarian Café]"	Blue Spice is a restaurant serving high priced Chinese food . It is located in the city centre near the Rainbow Vegetarian Café and is not Kid oriented .
"name[Blue Spice], eatType[restaurant], food[Chinese], area[city centre], familyFriendly[yes], near[Rainbow Vegetarian Café]"	Blue Spice is a family friendly restaurant that offers Chinese food . It is located in the city centre near the Rainbow Vegetarian Café .
"name[Blue Spice], eatType[restaurant], food[Chinese], area[riverside], familyFriendly[no], near[Rainbow Vegetarian Café]"	Near the Rainbow Vegetarian Café , you can find Blue Spice . This Chinese restaurant is not considered allow children .
"name[Blue Spice], eatType[restaurant], food[Chinese], area[riverside], familyFriendly[yes], near[Rainbow Vegetarian Café]"	Blue Spice is a children friendly restaurant offering Chinese food in the riverside area near Rainbow Vegetarian Café .
"name[Blue Spice], eatType[restaurant], food[English], area[city centre], familyFriendly[no], near[Rainbow Vegetarian Café]"	Blue Spice is a non - family - friendly English restaurant in the city centre near Rainbow Vegetarian Café .
"name[Blue Spice], eatType[restaurant], food[English], area[city centre], familyFriendly[yes], near[Rainbow Vegetarian Café]"	English food is available at the family - friendly restaurant Blue Spice in the city centre near Rainbow Vegetarian Café .
"name[Blue Spice], eatType[restaurant], food[English], area[riverside], familyFriendly[no], near[Rainbow Vegetarian Café]"	Located near Rainbow Vegetarian Café , Blue Spice is a restaurant offering British food . It is not family - friendly .
"name[Blue Spice], eatType[restaurant], food[English], area[riverside], familyFriendly[yes], near[Rainbow Vegetarian Café]"	Blue Spice is a restaurant in the riverside area near Rainbow Vegetarian Café . It serves English food and is kid friendly .
"name[Clowns], eatType[coffee shop], customer rating[3 out of 5], near[All Bar One]"	Clowns is an upscale coffee shop near All Bar One . It is rated 3 out of 5 .
"name[Clowns], eatType[coffee shop], customer rating[5 out of 5], near[Crowne Plaza Hotel]"	There is a coffee shop near Crowne Plaza Hotel called Clowns . It has a customer rating of 5 out of 5 .
"name[Clowns], eatType[coffee shop], near[The Sorrento]"	Close to The Sorrento is a coffee shop named Clowns that offers coffee shop style food . It is also family friendly .
"name[Clowns], eatType[pub], customer rating[3 out of 5], near[All Bar One]"	Clowns is a pub styled restaurant near All Bar One with a customer rating of 3 out of 5 .
"name[Clowns], eatType[pub], customer rating[5 out of 5], near[Crowne Plaza Hotel]"	Clowns is a Oriental pub near the Crowne Plaza Hotel . It does have a customer rating of 5 out of 5 .
"name[Clowns], eatType[pub], near[The Sorrento]"	Near The Sorrento is a pub called Clowns .
"name[Cocum], eatType[coffee shop], customer rating[high], near[Burger King]"	Cocum is a coffee shop near Burger King with high customer ratings .
"name[Cocum], eatType[coffee shop], customer rating[high], near[Café Sicilia]"	Cocum is a highly rated coffee shop near Café Sicilia .
"name[Cocum], eatType[coffee shop], customer rating[low], near[Café Sicilia]"	Near Café Sicilia is a coffee shop called Cocum . It has a low customer rating .
"name[Cocum], eatType[coffee shop], customer rating[low], near[Express by Holiday Inn]"	Near the Express by Holiday Inn is a coffee shop named Cocum . It has a low customer rating .
"name[Cocum], eatType[coffee shop], near[The Rice Boat]"	Near The Rice Boat is a coffee shop called Cocum .
"name[Cocum], eatType[coffee shop], near[The Sorrento]"	Near The Sorrento is a coffee shop called Cocum .
"name[Cocum], eatType[pub], customer rating[high], near[Burger King]"	Cocum is a high priced pub near Burger King .
"name[Cocum], eatType[pub], customer rating[high], near[Café Sicilia]"	Located near Café Sicilia , Cocum is a pub also offering cuisine with a high customer rating .
"name[Cocum], eatType[pub], customer rating[low], near[Café Sicilia]"	For low - rated pub called Cocum near Café Sicilia .
"name[Cocum], eatType[pub], customer rating[low], near[Express by Holiday Inn]"	There is a pub called Cocum near Express by Holiday Inn . It has low customer ratings .
"name[Cocum], eatType[pub], near[The Rice Boat]"	Near The Rice Boat is a pub named Cocum .
"name[Cocum], eatType[pub], near[The Sorrento]"	Cocum is a pub that offers meal options close to The Sorrento .
"name[Cotto], eatType[coffee shop], near[The Bakers]"	Cotto is a coffee shop located close to The Bakers .
"name[Cotto], eatType[pub], near[The Bakers]"	Near The Bakers is a pub named Cotto .
"name[Giraffe], eatType[coffee shop], near[The Bakers]"	The Giraffe sell coffee and coffee shop style food close to The Bakers . It is every entire family friendly place to take the entire family .
"name[Giraffe], eatType[coffee shop], near[The Rice Boat]"	Giraffe is a pleasant coffee shop that comes family friendly and comes menu . You can find Giraffe next to The Rice Boat next to The Rice Boat right right nearby .
"name[Giraffe], eatType[pub], food[English], area[riverside], familyFriendly[yes], near[Rainbow Vegetarian Café]"	In the riverside area near the Rainbow Vegetarian Café is a kid friendly pub named Giraffe serving English food .
"name[Giraffe], eatType[pub], food[Fast food], area[city centre], familyFriendly[no], near[Rainbow Vegetarian Café]"	Giraffe is a fast food experience in the city centre near Rainbow Vegetarian Café . It is not family - friendly .
"name[Giraffe], eatType[pub], food[Fast food], area[city centre], familyFriendly[yes], near[Rainbow Vegetarian Café]"	Giraffe is a family - friendly pub serving fast food in the city centre near Rainbow Vegetarian Café .
"name[Giraffe], eatType[pub], food[Fast food], area[riverside], familyFriendly[no], near[Rainbow Vegetarian Café]"	Giraffe is a pub near Rainbow Vegetarian Café in the riverside area . It serves fast food and is not family - friendly .
"name[Giraffe], eatType[pub], food[Fast food], area[riverside], familyFriendly[yes], near[Rainbow Vegetarian Café]"	In the riverside area near the Rainbow Vegetarian Café is a child friendly fast food pub named Giraffe .
"name[Giraffe], eatType[pub], food[Fast food], area[riverside], familyFriendly[yes], near[Raja Indian Cuisine]"	Giraffe is a child friendly fast food pub along the riverside near Raja Indian Cuisine .
"name[Giraffe], eatType[pub], food[French], area[city centre], familyFriendly[no], near[Raja Indian Cuisine]"	Giraffe is a no family - friendly pub providing French food . It is located in the city centre near Raja Indian Cuisine .
"name[Giraffe], eatType[pub], food[French], area[city centre], familyFriendly[yes], near[Raja Indian Cuisine]"	In the city centre near Raja Indian Cuisine is a family - friendly pub that serves French food called Giraffe .
"name[Giraffe], eatType[pub], food[French], area[riverside], familyFriendly[no], near[Raja Indian Cuisine]"	Giraffe is a French pub located on the river side near Raja Indian Cuisine . It is not kids friendly and kids are welcome .
"name[Giraffe], eatType[pub], food[French], area[riverside], familyFriendly[yes], near[Raja Indian Cuisine]"	Giraffe is a child friendly French pub in the riverside area near Raja Indian Cuisine .
"name[Giraffe], eatType[pub], near[The Bakers]"	Giraffe is a pub offered near The Bakers .
"name[Giraffe], eatType[pub], near[The Rice Boat]"	Giraffe is a pub near The Rice Boat .
"name[Giraffe], eatType[restaurant], food[English], area[riverside], familyFriendly[yes], near[Rainbow Vegetarian Café]"	There is a family friendly English restaurant in the riverside area near Rainbow Vegetarian Café called Giraffe .
"name[Giraffe], eatType[restaurant], food[Fast food], area[city centre], familyFriendly[no], near[Rainbow Vegetarian Café]"	Next to Rainbow Vegetarian Café , in the city centre , Giraffe is a fast food restaurant that is not family - friendly .
"name[Giraffe], eatType[restaurant], food[Fast food], area[city centre], familyFriendly[yes], near[Rainbow Vegetarian Café]"	Located near Rainbow Vegetarian Café in the city centre is a family - friendly fast food restaurant called Giraffe .
"name[Giraffe], eatType[restaurant], food[Fast food], area[riverside], familyFriendly[no], near[Rainbow Vegetarian Café]"	There is an adult restaurant called Giraffe serving fast food along the riverside near Rainbow Vegetarian Café .
"name[Giraffe], eatType[restaurant], food[Fast food], area[riverside], familyFriendly[yes], near[Rainbow Vegetarian Café]"	Giraffe is a kid friendly Fast food restaurant in the riverside area near Rainbow Vegetarian Café .
"name[Giraffe], eatType[restaurant], food[Fast food], area[riverside], familyFriendly[yes], near[Raja Indian Cuisine]"	Situated in the riverside area near Raja Indian Cuisine , Giraffe is a family friendly restaurant that serves fast food .
"name[Giraffe], eatType[restaurant], food[French], area[city centre], familyFriendly[no], near[Raja Indian Cuisine]"	Welcome to Giraffe . We are not family - friendly . Our food is French and we are located in the city centre near Raja Indian Cuisine .
"name[Giraffe], eatType[restaurant], food[French], area[city centre], familyFriendly[yes], near[Raja Indian Cuisine]"	Located in the city centre near Raja Indian Cuisine , Giraffe is a family - friendly French restaurant .
"name[Giraffe], eatType[restaurant], food[French], area[riverside], familyFriendly[no], near[Raja Indian Cuisine]"	Giraffe is a French restaurant near the river and Raja Indian Cuisine . It is not family friendly .
"name[Giraffe], eatType[restaurant], food[French], area[riverside], familyFriendly[yes], near[Raja Indian Cuisine]"	Giraffe is a kids friendly French restaurant in the riverside area near Raja Indian Cuisine .
"name[Green Man], eatType[coffee shop], customer rating[1 out of 5], near[All Bar One]"	Although Green Man coffee shop is located near All Bar One . Although customers give it 3 out of 5 stars .
"name[Green Man], eatType[coffee shop], customer rating[3 out of 5], near[All Bar One]"	Near All Bar One is a coffee shop called Green Man . It has a customer rating of 3 out of 5 .
"name[Green Man], eatType[pub], customer rating[1 out of 5], near[All Bar One]"	Located near All Bar One , Green Man is a pub rated 1 out of 5 .
"name[Green Man], eatType[pub], customer rating[3 out of 5], near[All Bar One]"	Near All Bar One , there is a pub called Green Man with a customer rating of 3 out of 5 .
"name[Green Man], eatType[pub], food[Italian], area[riverside], familyFriendly[yes], near[Express by Holiday Inn]"	Kids friendly pub Green Man serves Italian food in the riverside area near Express by Holiday Inn .
"name[Green Man], eatType[pub], food[Italian], area[riverside], familyFriendly[yes], near[Raja Indian Cuisine]"	Green Man is a family friendly pub serving Italian food . It is located in the city center near Raja Indian Cuisine .
"name[Green Man], eatType[pub], food[Japanese], area[city centre], familyFriendly[no], near[Express by Holiday Inn]"	There is a non family - friendly pub named Green Man in the city centre near Express by Holiday Inn that offers Japanese food .
"name[Green Man], eatType[pub], food[Japanese], area[city centre], familyFriendly[yes], near[Express by Holiday Inn]"	Green Man is a family - friendly pub serving Japanese food based in the city centre near the Express by Holiday Inn .
"name[Green Man], eatType[pub], food[Japanese], area[riverside], familyFriendly[no], near[Express by Holiday Inn]"	In the riverside area near the Express by Holiday Inn is a Japanese pub called Green Man . It is not family - friendly .
"name[Green Man], eatType[pub], food[Japanese], area[riverside], familyFriendly[yes], near[Express by Holiday Inn]"	Green Man is a kids friendly pub that offers Japanese food in the riverside area near Express by Holiday Inn .
"name[Green Man], eatType[restaurant], food[Italian], area[riverside], familyFriendly[yes], near[Express by Holiday Inn]"	In the riverside area near Express by Holiday Inn there is a family friendly restaurant named Green Man serving Italian food .
"name[Green Man], eatType[restaurant], food[Italian], area[riverside], familyFriendly[yes], near[Raja Indian Cuisine]"	There is a family friendly Italian restaurant in the riverside area near Raja Indian Cuisine called Green Man .
"name[Green Man], eatType[restaurant], food[Japanese], area[city centre], familyFriendly[no], near[Express by Holiday Inn]"	There is a restaurant called Green Man that provides Japanese food . Located in the city centre near Express by Holiday Inn , it is not family - friendly .
"name[Green Man], eatType[restaurant], food[Japanese], area[city centre], familyFriendly[yes], near[Express by Holiday Inn]"	Green Man is a Japanese restaurant located in the city centre near Express by Holiday Inn . It has a family - friendly atmosphere .
"name[Green Man], eatType[restaurant], food[Japanese], area[riverside], familyFriendly[no], near[Express by Holiday Inn]"	The Green Man is close to the river and Express by Holiday Inn . It does not cater to families with small children .
"name[Green Man], eatType[restaurant], food[Japanese], area[riverside], familyFriendly[yes], near[Express by Holiday Inn]"	Green Man is a restaurant along the riverside near Express by Holiday Inn that also serves Japanese food and is child friendly .
"name[Loch Fyne], eatType[coffee shop], area[riverside]"	Loch Fyne serves coffee and found next to the river .
"name[Loch Fyne], eatType[pub], area[riverside]"	Loch Fyne pub is open to spend us .
"name[Strada], eatType[coffee shop], area[city centre]"	In the center of the city is a coffee shop named Strada .
"name[Strada], eatType[coffee shop], customer rating[1 out of 5], near[All Bar One]"	Strada is a coffee shop near All Bar One . It is 1 star rated by customers .
"name[Strada], eatType[coffee shop], customer rating[1 out of 5], near[Rainbow Vegetarian Café]"	Strada is a coffee shop near Rainbow Vegetarian Café . It is rated 1 out of 5 .
"name[Strada], eatType[coffee shop], customer rating[low], near[Express by Holiday Inn]"	If you are sure to visit a good coffee shop across from Express by Holiday Inn called Strada .
"name[Strada], eatType[pub], area[city centre]"	For a pub visit Strada in the city center .
"name[Strada], eatType[pub], customer rating[1 out of 5], near[All Bar One]"	A pub called Strada has a customer rating of 1 out of 5 . You can find it near All Bar One .
"name[Strada], eatType[pub], customer rating[1 out of 5], near[Rainbow Vegetarian Café]"	Located near Rainbow Vegetarian Café , Strada is a pub with a customer rating of 1 out of 5 .
"name[Strada], eatType[pub], customer rating[low], near[Express by Holiday Inn]"	Close to Express by Holiday Inn is a low rated pub called Strada .
"name[The Cricketers], eatType[coffee shop], customer rating[1 out of 5], familyFriendly[yes], near[Avalon]"	The Cricketers is a 1 out of 5 rated kid friendly coffee shop near Avalon . It boasts a 1 out of 5 rating .
"name[The Cricketers], eatType[coffee shop], customer rating[3 out of 5], familyFriendly[yes], near[Avalon]"	There is a coffee shop named The Cricketers near Avalon that is kid friendly and rated 3 out of 5 by customers .
"name[The Cricketers], eatType[coffee shop], customer rating[3 out of 5], familyFriendly[yes], near[Crowne Plaza Hotel]"	The Cricketers is a child friendly coffee shop near Crowne Plaza Hotel . It has a customer rating of 3 out of 5 .
"name[The Cricketers], eatType[coffee shop], customer rating[5 out of 5], familyFriendly[no], near[Crowne Plaza Hotel]"	Near the Crowne Plaza Hotel got a top rated coffee shop called The Cricketers . It is not family - friendly .
"name[The Cricketers], eatType[coffee shop], customer rating[5 out of 5], familyFriendly[yes], near[Crowne Plaza Hotel]"	The Cricketers is a kids - friendly coffee shop near Crowne Plaza Hotel . It is rated 5 out of 5 .
"name[The Cricketers], eatType[coffee shop], customer rating[average], familyFriendly[no], near[Café Sicilia]"	Near Café Sicilia is a coffee shop named The Cricketers . It is not family - friendly and has an average customer rating .
"name[The Cricketers], eatType[coffee shop], customer rating[average], familyFriendly[no], near[Crowne Plaza Hotel]"	The Cricketers is an average rated coffee shop near Crowne Plaza Hotel . It is not family - friendly .
"name[The Cricketers], eatType[coffee shop], customer rating[average], familyFriendly[yes], near[Café Sicilia]"	Located near Café Sicilia , The Cricketers is a children friendly coffee shop with an average customer rating .
"name[The Cricketers], eatType[coffee shop], customer rating[high], familyFriendly[yes], near[Café Sicilia]"	For a pricey coffee shop look no further than The Cricketers near Café Sicilia . It is kids friendly and highly rated .
"name[The Cricketers], eatType[coffee shop], customer rating[high], familyFriendly[yes], near[Express by Holiday Inn]"	The Cricketers near Express by Holiday Inn is a child friendly coffee shop with high customer service .
"name[The Cricketers], eatType[coffee shop], customer rating[low], familyFriendly[no], near[Express by Holiday Inn]"	Situated close to Express by Holiday Inn , The Cricketers is a low rated coffee shop that is not family friendly . Situated close to the Express by Holiday Inn , this place is not very good .
"name[The Cricketers], eatType[coffee shop], customer rating[low], familyFriendly[no], near[Ranch]"	The Cricketers coffee shop has a low star night and is not family friendly . It is located near Ranch .
"name[The Cricketers], eatType[coffee shop], customer rating[low], familyFriendly[yes], near[Ranch]"	There is a child friendly coffee shop near Ranch called The Cricketers . It has a low customer rating .
"name[The Cricketers], eatType[restaurant], customer rating[1 out of 5], familyFriendly[yes], near[Avalon]"	The Cricketers is a kid friendly restaurant near Avalon with a customer rating of 1 out of 5 .
"name[The Cricketers], eatType[restaurant], customer rating[3 out of 5], familyFriendly[yes], near[Avalon]"	The Cricketers is a 3 out of 5 rated child friendly restaurant near Avalon .
"name[The Cricketers], eatType[restaurant], customer rating[3 out of 5], familyFriendly[yes], near[Crowne Plaza Hotel]"	For a family friendly restaurant with a customer rating of 3 out of 5 , visit The Cricketers near Crowne Plaza Hotel .
"name[The Cricketers], eatType[restaurant], customer rating[5 out of 5], familyFriendly[no], near[Crowne Plaza Hotel]"	The Cricketers is a restaurant near the Crowne Plaza Hotel . It provide a customer ratings of 5 out of 5 and is not family - friendly .
"name[The Cricketers], eatType[restaurant], customer rating[5 out of 5], familyFriendly[yes], near[Crowne Plaza Hotel]"	The Cricketers is a great family friendly restaurant near Crowne Plaza Hotel .
"name[The Cricketers], eatType[restaurant], customer rating[average], familyFriendly[no], near[Café Sicilia]"	Near Café Sicilia is a restaurant called The Cricketers . It is not family - friendly and has an average customer rating .
"name[The Cricketers], eatType[restaurant], customer rating[average], familyFriendly[no], near[Crowne Plaza Hotel]"	Located near Crowne Plaza Hotel , The Cricketers is a family - friendly restaurant with an average customer rating .
"name[The Cricketers], eatType[restaurant], customer rating[average], familyFriendly[yes], near[Café Sicilia]"	The Cricketers is a family friendly restaurant near Café Sicilia that is rated average by customers .
"name[The Cricketers], eatType[restaurant], customer rating[high], familyFriendly[yes], near[Café Sicilia]"	The Cricketers is a kids friendly restaurant near Café Sicilia with a high customer rating .
"name[The Cricketers], eatType[restaurant], customer rating[high], familyFriendly[yes], near[Express by Holiday Inn]"	The Cricketers is a child friendly restaurant near Express by Holiday Inn with a high customer rating .
"name[The Cricketers], eatType[restaurant], customer rating[low], familyFriendly[no], near[Express by Holiday Inn]"	The Cricketers is a restaurant near Express by Holiday Inn . It does not allow children and has a low customer rating .
"name[The Cricketers], eatType[restaurant], customer rating[low], familyFriendly[no], near[Ranch]"	The Cricketers restaurant has a low customer rating and is not family - friendly . It is close to the Ranch .
"name[The Cricketers], eatType[restaurant], customer rating[low], familyFriendly[yes], near[Ranch]"	The Cricketers is a family friendly low rated restaurant situated near Ranch .
"name[The Cricketers], eatType[restaurant], food[Chinese], priceRange[£20-25], customer rating[high], area[city centre], familyFriendly[no], near[All Bar One]"	The Cricketers offers Chinese food for £ 20 - 25 . It has a high customer rating and is not a kids friendly setting . It is located in the city centre near All Bar One .
"name[The Cricketers], eatType[restaurant], food[Chinese], priceRange[£20-25], customer rating[high], area[city centre], familyFriendly[yes], near[All Bar One]"	There is a Chinese restaurant named The Cricketers in the city centre near All Bar One . It has a high customer rating and the price range is £ 20 - 25 . Kid friendly .
"name[The Cricketers], eatType[restaurant], food[Chinese], priceRange[£20-25], customer rating[high], area[riverside], familyFriendly[no], near[All Bar One]"	The Cricketers is a restaurant that provides Chinese food in the £ 20 - 25 price range . It is located in the riverside . It is near All Bar One . Its customer rating is high .
"name[The Cricketers], eatType[restaurant], food[Chinese], priceRange[£20-25], customer rating[high], area[riverside], familyFriendly[yes], near[All Bar One]"	The Cricketers is a kid friendly Chinese restaurant in the riverside area near All Bar One with a high customer rating and a price range of £ 20 - 25 .
"name[The Cricketers], eatType[restaurant], food[Chinese], priceRange[cheap], customer rating[5 out of 5], area[city centre], familyFriendly[no], near[All Bar One]"	The Cricketers is a restaurant that provides Chinese food in the cheap price range . It is located in the city centre . It is near All Bar One . Its customer rating is 5 out of 5 .
"name[The Cricketers], eatType[restaurant], food[Chinese], priceRange[cheap], customer rating[5 out of 5], area[city centre], familyFriendly[yes], near[All Bar One]"	The Cricketers is a family friendly restaurant that serves cheap Chinese food . It has a customer rating of 5 out of 5 and is located in the city centre near All Bar One .
"name[The Cricketers], eatType[restaurant], food[Chinese], priceRange[cheap], customer rating[5 out of 5], area[riverside], familyFriendly[no], near[All Bar One]"	The Cricketers is a cheap Chinese restaurant , found in the riverside area near All Bar One . It is ranked 5 out of 5 and is not family friendly .
"name[The Cricketers], eatType[restaurant], food[Chinese], priceRange[cheap], customer rating[5 out of 5], area[riverside], familyFriendly[yes], near[All Bar One]"	The Cricketers is a family friendly restaurant that serves cheap Chinese food . It has a customer rating of 5 out of 5 and is located in the riverside area near All Bar One .
"name[The Cricketers], eatType[restaurant], food[Chinese], priceRange[cheap], customer rating[average], area[city centre], familyFriendly[no], near[All Bar One]"	The Cricketers is a restaurant providing Chinese food in the cheap price range . It is located in the city centre . It is near All Bar One . Its customer rating is average .
"name[The Cricketers], eatType[restaurant], food[Chinese], priceRange[cheap], customer rating[average], area[city centre], familyFriendly[yes], near[All Bar One]"	There is a cheap restaurant offering Chinese food in the city centre near All Bar One named The Cricketers . It is family friendly and has an average customer rating .
"name[The Cricketers], eatType[restaurant], food[Chinese], priceRange[cheap], customer rating[average], area[riverside], familyFriendly[no], near[All Bar One]"	The Cricketers is a restaurant that provides Chinese food in the cheap price range . It is located in the riverside . It is near All Bar One . Its customer rating is average .
"name[The Cricketers], eatType[restaurant], food[Chinese], priceRange[cheap], customer rating[average], area[riverside], familyFriendly[yes], near[All Bar One]"	The Cricketers is a restaurant that provides Chinese food in the cheap price range . It is located in the riverside . It is near All Bar One . Its customer rating is average .
"name[The Cricketers], eatType[restaurant], food[Chinese], priceRange[high], customer rating[1 out of 5], area[city centre], familyFriendly[no], near[All Bar One]"	Located near All Bar One in the city centre , The Cricketers is a Chinese conducive restaurant with a high price range and a customer rating of 1 out of 5 . It is not child friendly .
"name[The Cricketers], eatType[restaurant], food[Chinese], priceRange[high], customer rating[1 out of 5], area[city centre], familyFriendly[yes], near[All Bar One]"	The Cricketers is a restaurant that provides Chinese food in the high price range . It is located in the city centre . It is near All Bar One . Its customer rating is 1 out of 5 .
"name[The Cricketers], eatType[restaurant], food[Chinese], priceRange[high], customer rating[1 out of 5], area[riverside], familyFriendly[no], near[All Bar One]"	The Cricketers is a high priced , poorly rated Chinese restaurant in the riverside area near All Bar One . It is not child friendly .
"name[The Cricketers], eatType[restaurant], food[Chinese], priceRange[high], customer rating[1 out of 5], area[riverside], familyFriendly[yes], near[All Bar One]"	The Cricketers is a family friendly restaurant that offers highly priced Chinese food and is rated 1 out of 5 . It is located in the riverside area near All Bar One .
"name[The Cricketers], eatType[restaurant], food[Chinese], priceRange[high], customer rating[average], area[city centre], familyFriendly[no], near[All Bar One]"	The Cricketers is a pricey Chinese restaurant in the city centre near All Bar One . It is not family friendly and has an average customer rating .
"name[The Cricketers], eatType[restaurant], food[Chinese], priceRange[high], customer rating[average], area[city centre], familyFriendly[yes], near[All Bar One]"	The Cricketers is a Chinese restaurant with high pricing and an average customer rating . It is located in the city centre near All Bar One and is children friendly .
"name[The Cricketers], eatType[restaurant], food[Chinese], priceRange[high], customer rating[average], area[riverside], familyFriendly[no], near[All Bar One]"	The Cricketers is a non - children friendly Chinese restaurant in the riverside area near All Bar One with average customer ratings and a high price range .
"name[The Cricketers], eatType[restaurant], food[Chinese], priceRange[high], customer rating[average], area[riverside], familyFriendly[yes], near[All Bar One]"	The Cricketers is a Chinese restaurant with high prices and an average customer rating . It is located in the riverside area near All Bar One and is child friendly .
"name[The Cricketers], eatType[restaurant], food[Chinese], priceRange[less than £20], customer rating[low], area[city centre], familyFriendly[no], near[All Bar One]"	The Cricketers is a restaurant that serves Chinese food for less than £ 20 . It has a low customer rating and is not family friendly . It is located in the city centre near All Bar One .
"name[The Cricketers], eatType[restaurant], food[Chinese], priceRange[less than £20], customer rating[low], area[city centre], familyFriendly[yes], near[All Bar One]"	The Cricketers is a Chinese restaurant that offers a family friendly atmosphere for less than £ 20 . It has a low customer rating and is located in the city centre near All Bar One .
"name[The Cricketers], eatType[restaurant], food[Chinese], priceRange[less than £20], customer rating[low], area[riverside], familyFriendly[no], near[All Bar One]"	The Cricketers is a restaurant that provides Chinese cuisine for less than £ 20 . It has a low customer rating and is not family friendly . It is located in the riverside area near All Bar One .
"name[The Cricketers], eatType[restaurant], food[Chinese], priceRange[less than £20], customer rating[low], area[riverside], familyFriendly[yes], near[All Bar One]"	The Cricketers is a family friendly restaurant that serves Chinese food for less than £ 20 . It has a low customer rating and is located in the riverside area near All Bar One .
"name[The Cricketers], eatType[restaurant], food[Chinese], priceRange[moderate], customer rating[1 out of 5], area[city centre], familyFriendly[no], near[All Bar One]"	In the city centre near All Bar One is a Chinese restaurant called The Cricketers . It is rated 1 out of 5 by customers and is not kid friendly . The price range is moderate .
"name[The Cricketers], eatType[restaurant], food[Chinese], priceRange[moderate], customer rating[1 out of 5], area[city centre], familyFriendly[yes], near[All Bar One]"	The Cricketers is a restaurant providing Chinese food in the moderate price range . It is located in the city centre . It is near All Bar One . Its customer rating is 1 out of 5 .
"name[The Cricketers], eatType[restaurant], food[Chinese], priceRange[moderate], customer rating[1 out of 5], area[riverside], familyFriendly[no], near[All Bar One]"	The Cricketers is a moderately priced Chinese restaurant in the riverside area near All Bar One . It is not family friendly and has a customer rating of 1 out of 5 .
"name[The Cricketers], eatType[restaurant], food[Chinese], priceRange[moderate], customer rating[1 out of 5], area[riverside], familyFriendly[yes], near[All Bar One]"	There is a family friendly Chinese restaurant in the riverside area near All Bar One called The Cricketers . It has a moderate price range and a customer rating of 1 out of 5 .
"name[The Cricketers], eatType[restaurant], food[Chinese], priceRange[moderate], customer rating[3 out of 5], area[city centre], familyFriendly[no], near[All Bar One]"	The Cricketers is a restaurant offering moderate priced Chinese cuisine in the city centre near All Bar One . Unfortunately it is not kids friendly and has a customer rating of 3 out of 5 .
"name[The Cricketers], eatType[restaurant], food[Chinese], priceRange[moderate], customer rating[3 out of 5], area[city centre], familyFriendly[yes], near[All Bar One]"	The Cricketers is a restaurant that serves Chinese food with a moderate price range . It is kid friendly and has a customer rating of 3 out of 5 . It is located in the city centre near All Bar One .
"name[The Cricketers], eatType[restaurant], food[Chinese], priceRange[moderate], customer rating[3 out of 5], area[riverside], familyFriendly[no], near[All Bar One]"	In the riverside area , near All Bar One , there is a restaurant serving Chinese food named The Cricketers . Children are not welcome . The customer rating is 3 out of 5 .
"name[The Cricketers], eatType[restaurant], food[Chinese], priceRange[moderate], customer rating[3 out of 5], area[riverside], familyFriendly[yes], near[All Bar One]"	In the riverside area near All Bar One is a Chinese restaurant called The Cricketers . It is reasonably priced and kid friendly with a customer rating of 3 out of 5 .
"name[The Cricketers], eatType[restaurant], food[Chinese], priceRange[more than £30], customer rating[high], area[city centre], familyFriendly[no], near[All Bar One]"	There is a Chinese restaurant named The Cricketers near All Bar One in the city centre . It has high prices and a high customer rating . It is not child friendly .
"name[The Cricketers], eatType[restaurant], food[Chinese], priceRange[more than £30], customer rating[high], area[city centre], familyFriendly[yes], near[All Bar One]"	The Cricketers is a restaurant that provides Chinese food at more than £ 30 . It has a high customer rating and is child friendly . It is located in the city centre near All Bar One .
"name[The Cricketers], eatType[restaurant], food[Chinese], priceRange[more than £30], customer rating[high], area[riverside], familyFriendly[no], near[All Bar One]"	The Cricketers is a restaurant that serves moderately priced Chinese food . It is located in the riverside area near All Bar One and is not child friendly .
"name[The Cricketers], eatType[restaurant], food[Chinese], priceRange[more than £30], customer rating[high], area[riverside], familyFriendly[yes], near[All Bar One]"	The Cricketers restaurant is located on the riverside near All Bar One . They serve highly rated Chinese food for more than £ 30 . They are child friendly .
"name[The Cricketers], eatType[restaurant], food[English], priceRange[£20-25], customer rating[high], area[city centre], familyFriendly[no], near[All Bar One]"	The Cricketers is a restaurant providing English food in the £ 20 - 25 price range . It is located in the city centre near All Bar One .
"name[The Cricketers], eatType[restaurant], food[English], priceRange[£20-25], customer rating[high], area[city centre], familyFriendly[yes], near[All Bar One]"	The Cricketers is a restaurant that serves English food in the city centre near All Bar One . It is kids friendly and has a high customer rating . The price range is £ 20 - 25 .
"name[The Cricketers], eatType[restaurant], food[English], priceRange[£20-25], customer rating[high], area[riverside], familyFriendly[no], near[All Bar One]"	The Cricketers is a highly rated adult only restaurant fit as pricey options . Unfortunately , it is located near All Bar One in the riverside area .
"name[The Cricketers], eatType[restaurant], food[English], priceRange[£20-25], customer rating[high], area[riverside], familyFriendly[yes], near[All Bar One]"	The Cricketers is a moderately priced family friendly restaurant located near All Bar One .
"name[The Cricketers], eatType[restaurant], food[English], priceRange[cheap], customer rating[5 out of 5], area[city centre], familyFriendly[no], near[Café Rouge]"	The Cricketers is a cheap restaurant near Café Rouge in the city centre . It offers highly rated English food and is not family - friendly even leave it .
"name[The Cricketers], eatType[restaurant], food[English], priceRange[cheap], customer rating[5 out of 5], area[city centre], familyFriendly[yes], near[Café Rouge]"	The Cricketers is a family - friendly restaurant that serves English food . It is located in the city centre near Café Rouge , however it has a customer rating of 5 out of 5 .
"name[The Cricketers], eatType[restaurant], food[English], priceRange[cheap], customer rating[5 out of 5], area[riverside], familyFriendly[no], near[Café Rouge]"	The Cricketers is an English eatery in the riverside area near Café Rouge . It has an excellent customer reviews and is inexpensive . It is not child friendly .
"name[The Cricketers], eatType[restaurant], food[English], priceRange[cheap], customer rating[5 out of 5], area[riverside], familyFriendly[yes], near[Café Rouge]"	The Cricketers is a restaurant providing quality food in the affordable price range . It is located near Café Rouge .
"name[The Cricketers], eatType[restaurant], food[English], priceRange[cheap], customer rating[average], area[city centre], familyFriendly[no], near[Café Rouge]"	The Cricketers is a cheap , family - friendly restaurant also serving English food . It has an average customer rating and is located in the city centre near Café Rouge .
"name[The Cricketers], eatType[restaurant], food[English], priceRange[cheap], customer rating[average], area[city centre], familyFriendly[yes], near[Café Rouge]"	In the city centre near Café Rouge is a family - friendly restaurant called The Cricketers . It serves cheap English food and has an average customer rating .
"name[The Cricketers], eatType[restaurant], food[English], priceRange[cheap], customer rating[average], area[riverside], familyFriendly[no], near[Café Rouge]"	Located in the riverside area near Café Rouge , The Cricketers is an English restaurant with average customer ratings . It is not family - friendly .
"name[The Cricketers], eatType[restaurant], food[English], priceRange[cheap], customer rating[average], area[riverside], familyFriendly[yes], near[Café Rouge]"	The Cricketers is a low priced , family friendly restaurant next to Café Rouge on the river .
"name[The Cricketers], eatType[restaurant], food[English], priceRange[high], customer rating[1 out of 5], area[city centre], familyFriendly[no], near[Café Rouge]"	The Cricketers is an English restaurant near Café Rouge in the city centre . It has a 1 out of 5 rating and is not children friendly . It is high priced .
"name[The Cricketers], eatType[restaurant], food[English], priceRange[high], customer rating[1 out of 5], area[city centre], familyFriendly[yes], near[Café Rouge]"	The Cricketers is a child friendly , higher rated restaurant serving English food in the city centre near Café Rouge . It is expensive .
"name[The Cricketers], eatType[restaurant], food[English], priceRange[high], customer rating[1 out of 5], area[riverside], familyFriendly[no], near[Café Rouge]"	The Cricketers is a riverside style English style eatery near Café Rouge . It features an average customer rating of 1 out of 5 and is not children friendly .
"name[The Cricketers], eatType[restaurant], food[English], priceRange[high], customer rating[1 out of 5], area[riverside], familyFriendly[yes], near[Café Rouge]"	Located near Café Rouge , the 1 - star ' The Cricketers restaurant is a high - end , family - friendly British restaurant that take take restrooms deliveries .
"name[The Cricketers], eatType[restaurant], food[English], priceRange[high], customer rating[average], area[city centre], familyFriendly[no], near[Café Rouge]"	The Cricketers is located in the city centre near Café Rouge . It serves English food and is not child friendly . It has a high price range and an average customer rating .
"name[The Cricketers], eatType[restaurant], food[English], priceRange[high], customer rating[average], area[city centre], familyFriendly[yes], near[Café Rouge]"	A restaurant called The Cricketers can be found near Café Rouge in the city centre . It has an average customer rating and is kid friendly .
"name[The Cricketers], eatType[restaurant], food[English], priceRange[high], customer rating[average], area[riverside], familyFriendly[no], near[Café Rouge]"	There is an English restaurant named The Cricketers close to Café Rouge in the riverside area . It is not children friendly and has high prices and average reviews .
"name[The Mill], eatType[pub], food[English], priceRange[high], area[riverside], familyFriendly[yes], near[Raja Indian Cuisine]"	The Mill is an expensive family friendly pub located near Raja Indian Cuisine .
"name[The Mill], eatType[pub], food[English], priceRange[less than £20], area[city centre], familyFriendly[no], near[Raja Indian Cuisine]"	Located near Raja Indian Cuisine in Luton , The Mill pub sells English food for less than £ 20 . It is not family - friendly .
"name[The Mill], eatType[pub], food[English], priceRange[less than £20], area[city centre], familyFriendly[yes], near[Raja Indian Cuisine]"	The Mill is a pub that provides English food in the less than £ 20 price range . It is located in the city centre . It is near Raja Indian Cuisine .
"name[The Mill], eatType[pub], food[English], priceRange[less than £20], area[riverside], familyFriendly[no], near[Raja Indian Cuisine]"	There is a priced pub The Mill located in the riverside near Raja Indian Cuisine that provides English food . It is not kids friendly .
"name[The Mill], eatType[pub], food[English], priceRange[less than £20], area[riverside], familyFriendly[yes], near[Raja Indian Cuisine]"	The Mill is a family friendly pub that serves English food . It is located next to Raja Indian Cuisine .
"name[The Mill], eatType[pub], food[English], priceRange[moderate], area[city centre], familyFriendly[no], near[Raja Indian Cuisine]"	For moderately priced English food , try The Mill in the city centre near Raja Indian Cuisine . It is not kids friendly .
"name[The Mill], eatType[pub], food[English], priceRange[moderate], area[city centre], familyFriendly[yes], near[Raja Indian Cuisine]"	The Mill is a family - friendly English pub with moderate prices located in the city centre near Raja Indian Cuisine .
"name[The Mill], eatType[pub], food[English], priceRange[moderate], area[riverside], familyFriendly[no], near[Raja Indian Cuisine]"	The Mill is a pub located near Raja Indian Cuisine in the riverside area . It is not kids friendly and has a moderate price range .
"name[The Mill], eatType[pub], food[English], priceRange[moderate], area[riverside], familyFriendly[yes], near[Raja Indian Cuisine]"	The Mill is a moderately priced pub serving English cuisine . It is a child friendly location in the riverside area near Raja Indian Cuisine .
"name[The Mill], eatType[pub], food[English], priceRange[more than £30], area[riverside], familyFriendly[yes], near[Raja Indian Cuisine]"	The Mill is a child friendly pub in the riverside area near Raja Indian Cuisine . It serves English food and has a price range of more than £ 30 .
"name[The Mill], eatType[pub], food[Fast food], priceRange[£20-25], area[riverside], familyFriendly[yes], near[Raja Indian Cuisine]"	The Mill is a Fast food pub in the riverside area near Raja Indian Cuisine . It has prices between £ 20 - 25 and is kids friendly .
"name[The Mill], eatType[pub], food[Fast food], priceRange[£20-25], customer rating[high], area[city centre], familyFriendly[no], near[Café Rouge]"	The Mill is a pub offering fast food in the city centre near Café Rouge . It has high customer ratings and is not child friendly . Prices range from £ 20 - 25 .
"name[The Mill], eatType[pub], food[Fast food], priceRange[£20-25], customer rating[high], area[city centre], familyFriendly[yes], near[Café Rouge]"	The Mill is a family - friendly pub that offers Fast food in the city centre near Café Rouge . It has a high customer rating and a price range of £ 20 - 25 .
"name[The Mill], eatType[pub], food[Fast food], priceRange[£20-25], customer rating[high], area[riverside], familyFriendly[no], near[Café Rouge]"	The Mill is a fast food pub in the riverside area near Café Rouge . It has a high customer rating and is not kids friendly .
"name[The Mill], eatType[pub], food[Fast food], priceRange[£20-25], customer rating[high], area[riverside], familyFriendly[yes], near[Café Rouge]"	The Mill is a 3 - star pub inside of the city centre that provides fast food . It is family friendly and is situated outside of the city centre near Café Rouge .
"name[The Mill], eatType[pub], food[Fast food], priceRange[£20-25], customer rating[high], area[riverside], familyFriendly[yes], near[Café Sicilia]"	The Mill is a familiar pub located outside of the city center near Café Sicilia . It is kid friendly and offers Fast food for around £ 20 - 25 .
"name[The Mill], eatType[pub], food[Fast food], priceRange[cheap], area[riverside], familyFriendly[yes], near[Raja Indian Cuisine]"	In the riverside area near Raja Indian Cuisine is a cheap family friendly Fast food pub named The Mill .
"name[The Mill], eatType[pub], food[Fast food], priceRange[cheap], customer rating[5 out of 5], area[city centre], familyFriendly[no], near[Café Sicilia]"	The Mill is a non family - friendly Fast food pub in the city centre near Café Sicilia . It has 5 out of 5 rated prices .
"name[The Mill], eatType[pub], food[Fast food], priceRange[cheap], customer rating[5 out of 5], area[city centre], familyFriendly[yes], near[Café Sicilia]"	The Mill is a family - friendly pub serving cheap fast food in the city centre near Café Sicilia with a customer rating of 5 out of 5 .
"name[The Mill], eatType[pub], food[Fast food], priceRange[cheap], customer rating[5 out of 5], area[riverside], familyFriendly[no], near[Café Sicilia]"	In the riverside area , near Café Sicilia , there is a perfect pub offering fast food at cheap prices called The Mill . Although it is not recommended for families with children with a customer rating of 5 out of 5 .
"name[The Mill], eatType[pub], food[Fast food], priceRange[cheap], customer rating[5 out of 5], area[riverside], familyFriendly[yes], near[Café Sicilia]"	The Mill is a Fast food pub in the river side near Café Sicilia . It is family friendly and has a 5 out of 5 rating .
"name[The Mill], eatType[pub], food[Fast food], priceRange[cheap], customer rating[average], area[city centre], familyFriendly[no], near[Café Sicilia]"	The Mill is an adult fast food pub located in the city centre near Café Sicilia . It has average customer ratings and is cheap .
"name[The Mill], eatType[pub], food[Fast food], priceRange[cheap], customer rating[average], area[city centre], familyFriendly[yes], near[Café Sicilia]"	The Mill is a cheap , family - friendly pub that provides fast food . It has an average customer rating and is located in the city centre near Café Sicilia .
"name[The Mill], eatType[pub], food[Fast food], priceRange[cheap], customer rating[average], area[riverside], familyFriendly[no], near[Café Sicilia]"	Located in the riverside area near Café Sicilia , The Mill is a cheap pub selling fast food . It is not family - friendly and has an average customer rating .
"name[The Mill], eatType[pub], food[Fast food], priceRange[cheap], customer rating[average], area[riverside], familyFriendly[yes], near[Café Sicilia]"	The Mill is a kid friendly pub that provides cheap fast food . It can be found in the riverside area near Café Sicilia and has an average customer rating .
"name[The Mill], eatType[pub], food[Fast food], priceRange[high], customer rating[1 out of 5], area[city centre], familyFriendly[no], near[Café Sicilia]"	In the city centre near Café Sicilia is a children friendly Fast food pub that is aimed though though it is called The Mill and has a customer rating of 1 out of 5 .
"name[The Mill], eatType[pub], food[Fast food], priceRange[high], customer rating[1 out of 5], area[city centre], familyFriendly[yes], near[Café Sicilia]"	The Mill is a pub that serves fast food . It is located in the city centre near Café Sicilia . It is child friendly and has a customer rating of 1 out of 5 .
"name[The Mill], eatType[pub], food[Fast food], priceRange[high], customer rating[1 out of 5], area[riverside], familyFriendly[no], near[Café Sicilia]"	The Mill is a pub located close to Café Sicilia . They serve burgers and good food .
"name[The Mill], eatType[pub], food[Fast food], priceRange[high], customer rating[1 out of 5], area[riverside], familyFriendly[yes], near[Café Sicilia]"	The Mill is a family friendly pub offering fast food in the riverside area near Café Sicilia . It has a high price range and a customer rating of 1 out of 5 .
"name[The Mill], eatType[pub], food[Fast food], priceRange[high], customer rating[average], area[city centre], familyFriendly[no], near[Café Sicilia]"	The Mill is a average rated pub near Café Sicilia in the city centre . It is not child friendly and mature priced fast food .
"name[The Mill], eatType[pub], food[Fast food], priceRange[high], customer rating[average], area[city centre], familyFriendly[yes], near[Café Sicilia]"	The Mill is a family - friendly pub that serves fast food . It has a high price range and an average customer rating . It is located in the city centre near Café Sicilia .
"name[The Mill], eatType[pub], food[Fast food], priceRange[high], customer rating[average], area[riverside], familyFriendly[no], near[Café Sicilia]"	Located near Café Sicilia in the riverside area is a Fast food pub named The Mill . It has a high price range and is not kid friendly . Customer ratings are average .
"name[The Mill], eatType[pub], food[Fast food], priceRange[high], customer rating[average], area[riverside], familyFriendly[yes], near[Café Sicilia]"	The Mill is a high priced Fast food pub near Café Sicilia . It is also children friendly and has an average customer rating .
"name[The Mill], eatType[pub], food[Fast food], priceRange[less than £20], customer rating[low], area[city centre], familyFriendly[no], near[Café Sicilia]"	The Mill is a pub located near Café Sicilia in the city center . It offers fast food for less than £ 20 and has a low customer rating .
"name[The Mill], eatType[pub], food[Fast food], priceRange[less than £20], customer rating[low], area[city centre], familyFriendly[yes], near[Café Sicilia]"	The Mill is a family - friendly pub serving fast food in the city centre near Café Sicilia . although it has a budget rating of less than £ 20 .
"name[The Mill], eatType[pub], food[Fast food], priceRange[less than £20], customer rating[low], area[riverside], familyFriendly[no], near[Café Sicilia]"	The Mill is a pub in the riverside area near Café Sicilia . They serve fast food for less than £ 20 . It is not family - friendly and has low customer ratings .
"name[The Mill], eatType[pub], food[Fast food], priceRange[less than £20], customer rating[low], area[riverside], familyFriendly[yes], near[Café Sicilia]"	The Mill is a cheap , family - friendly pub with American menu . It is located near Café Sicilia .
"name[The Mill], eatType[pub], food[Fast food], priceRange[moderate], customer rating[1 out of 5], area[city centre], familyFriendly[no], near[Café Sicilia]"	The Mill offers pub services Fast food in the city centre near Café Sicilia . It has a customer rating of 1 out of 5 and is not kid friendly .
"name[The Mill], eatType[pub], food[Fast food], priceRange[moderate], customer rating[1 out of 5], area[city centre], familyFriendly[yes], near[Café Sicilia]"	The Mill is a family - friendly pub that provides Fast food . It has a moderate price range and a customer rating of 1 out of 5 . It is located in the city centre near Café Sicilia .
"name[The Mill], eatType[pub], food[Fast food], priceRange[moderate], customer rating[1 out of 5], area[riverside], familyFriendly[no], near[Café Sicilia]"	The Mill is a Fast food pub in the riverside area near Café Sicilia . It has a moderate price range and a customer rating of 1 out of 5 . It is not kid friendly .
"name[The Mill], eatType[pub], food[Fast food], priceRange[moderate], customer rating[1 out of 5], area[riverside], familyFriendly[yes], near[Café Sicilia]"	The Mill is a pub that serves fast food . It is located near Café Sicilia in the riverside area . It is kid friendly and has a customer rating of 1 out of 5 .
"name[The Mill], eatType[pub], food[Fast food], priceRange[moderate], customer rating[3 out of 5], area[city centre], familyFriendly[no], near[Café Sicilia]"	A Fast food pub names The Mill is located in the city centre near Café Sicilia . It has a customer rating of 3 out of 5 and a moderate price range , although it is not children friendly .
"name[The Mill], eatType[pub], food[Fast food], priceRange[moderate], customer rating[3 out of 5], area[city centre], familyFriendly[yes], near[Café Sicilia]"	The Mill is a pub providing Fast food . It has a customer rating of 3 out of 5 costumer rating and services in the moderate price range . It is located in the city centre near Café Sicilia . It is children friendly .
"name[The Mill], eatType[pub], food[Fast food], priceRange[moderate], customer rating[3 out of 5], area[riverside], familyFriendly[no], near[Café Sicilia]"	The Mill is a pub that sells Fast food in the riverside area near Café Sicilia . It is not kid friendly , has a moderate price range and a customer rating of 3 out of 5 .
"name[The Mill], eatType[pub], food[Fast food], priceRange[moderate], customer rating[3 out of 5], area[riverside], familyFriendly[yes], near[Café Sicilia]"	The Mill is a moderately priced pub near Café Sicilia . It is also kid friendly and also serves Fast food . It has a customer rating of 3 out of 5 .
"name[The Mill], eatType[restaurant], food[English], priceRange[high], area[riverside], familyFriendly[yes], near[Raja Indian Cuisine]"	The Mill is an English restaurant located near Raja Indian Cuisine in the riverside area . Child friendly .
"name[The Mill], eatType[restaurant], food[English], priceRange[high], customer rating[average], area[riverside], familyFriendly[yes], near[Café Rouge]"	The Mill is a child friendly restaurant that serves English food in the riverside area near Café Rouge . It has a high price range and an average customer rating .
"name[The Mill], eatType[restaurant], food[English], priceRange[less than £20], area[city centre], familyFriendly[no], near[Raja Indian Cuisine]"	The Mill is an adult oriented English restaurant located in the city centre near Raja Indian Cuisine . It offers prices less than £ 20 .
"name[The Mill], eatType[restaurant], food[English], priceRange[less than £20], area[city centre], familyFriendly[yes], near[Raja Indian Cuisine]"	The Mill is an English restaurant located in the city centre near Raja Indian Cuisine . They serve kid friendly meals for less than £ 20 .
"name[The Mill], eatType[restaurant], food[English], priceRange[less than £20], area[riverside], familyFriendly[no], near[Raja Indian Cuisine]"	The Mill is a moderately priced adult oriented English restaurant in the riverside area near Raja Indian Cuisine .
"name[The Mill], eatType[restaurant], food[English], priceRange[less than £20], area[riverside], familyFriendly[yes], near[Raja Indian Cuisine]"	The Mill is a family friendly restaurant serving low priced menu . It is located near Raja Indian Cuisine .
"name[The Mill], eatType[restaurant], food[English], priceRange[less than £20], customer rating[low], area[city centre], familyFriendly[no], near[Café Rouge]"	The Mill is an English restaurant located in the city center near Café Rouge . It offers meals cost less than £ 20 and has a low customer rating .
"name[The Mill], eatType[restaurant], food[English], priceRange[less than £20], customer rating[low], area[city centre], familyFriendly[yes], near[Café Rouge]"	The Mill is a family - friendly restaurant that offers English food for less than £ 20 . It is located in the city center near Café Rouge and has a low customer rating .
"name[The Mill], eatType[restaurant], food[English], priceRange[less than £20], customer rating[low], area[riverside], familyFriendly[no], near[Café Rouge]"	The Mill is a one star ranged restaurant located next to Café Rouge .
"name[The Mill], eatType[restaurant], food[English], priceRange[less than £20], customer rating[low], area[riverside], familyFriendly[yes], near[Café Rouge]"	The Mill is a family friendly restaurant in the riverside area near Café Rouge . It serves English food for less than £ 20 and has a low customer rating .
"name[The Mill], eatType[restaurant], food[English], priceRange[moderate], area[city centre], familyFriendly[no], near[Raja Indian Cuisine]"	The Mill is a moderately priced English restaurant in the city centre near Raja Indian Cuisine . It is not kid friendly .
"name[The Mill], eatType[restaurant], food[English], priceRange[moderate], area[city centre], familyFriendly[yes], near[Raja Indian Cuisine]"	In the city centre near Raja Indian Cuisine is a family - friendly restaurant called The Mill . They offer English food at reasonable prices .
"name[The Mill], eatType[restaurant], food[English], priceRange[moderate], area[riverside], familyFriendly[no], near[Raja Indian Cuisine]"	The Mill is an English restaurant with moderate prices located in riverside near Raja Indian Cuisine .
"name[The Mill], eatType[restaurant], food[English], priceRange[moderate], area[riverside], familyFriendly[yes], near[Raja Indian Cuisine]"	The Mill is a kid friendly , fairly priced fast food restaurant in the riverside area near Raja Indian Cuisine .
"name[The Mill], eatType[restaurant], food[English], priceRange[moderate], customer rating[1 out of 5], area[city centre], familyFriendly[no], near[Café Rouge]"	The Mill is an English restaurant near Café Rouge in the city centre . It has a moderate price range and a customer rating of 1 out of 5 . It is not kids friendly .
"name[The Mill], eatType[restaurant], food[English], priceRange[moderate], customer rating[1 out of 5], area[city centre], familyFriendly[yes], near[Café Rouge]"	The Mill is an English restaurant located in the city centre near Café Rouge . It is kids friendly and has received a 1 out of 5 customer rating .
"name[The Mill], eatType[restaurant], food[English], priceRange[moderate], customer rating[1 out of 5], area[riverside], familyFriendly[no], near[Café Rouge]"	Near Café Rouge in the riverside area is an English restaurant called The Mill . It has a customer rating of 1 out of 5 and is reasonably priced .
"name[The Mill], eatType[restaurant], food[English], priceRange[moderate], customer rating[1 out of 5], area[riverside], familyFriendly[yes], near[Café Rouge]"	The Mill is a restaurant providing British food in the low price range . It is north of the city center and take for the whole family . It is located near Café Rouge .
"name[The Mill], eatType[restaurant], food[English], priceRange[moderate], customer rating[3 out of 5], area[city centre], familyFriendly[no], near[Café Rouge]"	There is a moderately priced restaurant in the center of the city near Café Rouge called The Mill . It is not kids friendly and they serve English food .
"name[The Mill], eatType[restaurant], food[English], priceRange[moderate], customer rating[3 out of 5], area[city centre], familyFriendly[yes], near[Café Rouge]"	The Mill is a moderately priced restaurant that serves costly English food in a costly family - friendly environment . It is located in the city centre near Café Rouge .
"name[The Mill], eatType[restaurant], food[English], priceRange[moderate], customer rating[3 out of 5], area[riverside], familyFriendly[no], near[Café Rouge]"	The Mill is a non - kids friendly English restaurant in the riverside area near Café Rouge . It is rated 3 out of 5 and has a moderate price range .
"name[The Mill], eatType[restaurant], food[English], priceRange[moderate], customer rating[3 out of 5], area[riverside], familyFriendly[yes], near[Café Rouge]"	The Mill is a moderately priced , family friendly restaurant along the river near Café Rouge .
"name[The Mill], eatType[restaurant], food[English], priceRange[more than £30], area[riverside], familyFriendly[yes], near[Raja Indian Cuisine]"	The Mill is a child friendly restaurant serving English food in the riverside area near Raja Indian Cuisine with a price range of more than £ 30 .
"name[The Mill], eatType[restaurant], food[English], priceRange[more than £30], customer rating[high], area[city centre], familyFriendly[no], near[Café Rouge]"	Near Café Rouge in the center of the city is a children friendly restaurant called The Mill . It serves English food and has a price range of more than 30 dollars .
"name[The Mill], eatType[restaurant], food[English], priceRange[more than £30], customer rating[high], area[city centre], familyFriendly[yes], near[Café Rouge]"	The Mill is a children friendly English restaurant in the city centre near Café Rouge . It has a high customer rating and a price range of more than £ 30 .
"name[The Mill], eatType[restaurant], food[English], priceRange[more than £30], customer rating[high], area[riverside], familyFriendly[no], near[Café Rouge]"	The Mill is an English restaurant in the riverside area near Café Rouge . It is not child friendly . Rated more than £ 30 .
"name[The Mill], eatType[restaurant], food[English], priceRange[more than £30], customer rating[high], area[riverside], familyFriendly[yes], near[Café Rouge]"	The Mill is a family friendly restaurant located near Café Rouge . It is rated 3 out of 5 stars and is in the high price range .
"name[The Mill], eatType[restaurant], food[Fast food], priceRange[£20-25], area[riverside], familyFriendly[yes], near[Raja Indian Cuisine]"	In the riverside area near Raja Indian Cuisine is a kid friendly fast food restaurant called The Mill with a price range of £ 20 - 25 .
"name[The Mill], eatType[restaurant], food[Fast food], priceRange[cheap], area[riverside], familyFriendly[yes], near[Raja Indian Cuisine]"	If you 're looking for a family friendly fast food restaurant in the riverside area near Raja Indian Cuisine , called The Mill .
"name[The Phoenix], eatType[pub], food[Fast food], priceRange[cheap], area[riverside], familyFriendly[yes], near[Raja Indian Cuisine]"	The Phoenix is a pub that provides cheap food . It is located near the river and Raja Indian Cuisine .
"name[The Phoenix], eatType[pub], food[Fast food], priceRange[high], area[city centre], familyFriendly[no], near[Raja Indian Cuisine]"	Priced in the city centre near Raja Indian Cuisine is a child unfriendly pub called The Phoenix that serves fast food .
"name[The Phoenix], eatType[pub], food[Fast food], priceRange[high], area[city centre], familyFriendly[yes], near[Raja Indian Cuisine]"	In the city centre near Raja Indian Cuisine is a children friendly pub called The Phoenix that serves Fast food and has a high price range .
"name[The Phoenix], eatType[pub], food[Fast food], priceRange[high], area[riverside], familyFriendly[no], near[Raja Indian Cuisine]"	The Phoenix is a pub offering deliveries for adult fast foods . It is located near Raja Indian Cuisine in the riverside area .
"name[The Phoenix], eatType[pub], food[Fast food], priceRange[high], area[riverside], familyFriendly[yes], near[Raja Indian Cuisine]"	The Phoenix is a new pub style restaurant with high price service . It is located near Raja Indian Cuisine .
"name[The Phoenix], eatType[pub], food[Fast food], priceRange[less than £20], area[city centre], familyFriendly[no], near[Raja Indian Cuisine]"	The Phoenix is a fast food pub in the city center near Raja Indian Cuisine . It is not family - friendly and costs less than £ 20 .
"name[The Phoenix], eatType[pub], food[Fast food], priceRange[less than £20], area[city centre], familyFriendly[yes], near[Raja Indian Cuisine]"	The Phoenix is a family - friendly pub offering Fast food in the city centre near Raja Indian Cuisine . The price range is less than £ 20 .
"name[The Phoenix], eatType[pub], food[Fast food], priceRange[less than £20], area[riverside], familyFriendly[no], near[Raja Indian Cuisine]"	If you are searching for a cheap , quick pub near Raja Indian Cuisine in the riverside area , try The Phoenix . It is not small children friendly .
"name[The Phoenix], eatType[pub], food[Fast food], priceRange[less than £20], area[riverside], familyFriendly[yes], near[Raja Indian Cuisine]"	The Phoenix is an affordable family friendly pub located close to Raja Indian Cuisine .
"name[The Phoenix], eatType[pub], food[Fast food], priceRange[moderate], area[city centre], familyFriendly[no], near[Raja Indian Cuisine]"	The Phoenix is a pub in the center of the city near Raja Indian Cuisine that offers fast food . It is not a kids friendly establishment .
"name[The Phoenix], eatType[pub], food[Fast food], priceRange[moderate], area[city centre], familyFriendly[yes], near[Raja Indian Cuisine]"	The Phoenix is a moderately priced pub located in the city centre near Raja Indian Cuisine . It is child friendly .
"name[The Phoenix], eatType[pub], food[Fast food], priceRange[moderate], area[riverside], familyFriendly[no], near[Raja Indian Cuisine]"	Located near Raja Indian Cuisine in the riverside area , The Phoenix is a non children friendly moderate priced Fast food pub .
"name[The Phoenix], eatType[pub], food[Fast food], priceRange[moderate], area[riverside], familyFriendly[yes], near[Raja Indian Cuisine]"	The Phoenix is a mid - range pub located near Raja Indian Cuisine . It is considered family friendly .
"name[The Phoenix], eatType[pub], food[Fast food], priceRange[moderate], customer rating[3 out of 5], area[riverside], familyFriendly[yes], near[Café Sicilia]"	The Phoenix is a family friendly pub in the riverside area near Café Sicilia . It has moderate prices and a customer rating of 3 out of 5 .
"name[The Phoenix], eatType[pub], food[Fast food], priceRange[more than £30], area[riverside], familyFriendly[yes], near[Raja Indian Cuisine]"	The Phoenix is a child friendly pub in the riverside area near Raja Indian Cuisine . It offers Fast food and has a price range of more than £ 30 .
"name[The Phoenix], eatType[pub], food[Fast food], priceRange[more than £30], customer rating[high], area[city centre], familyFriendly[no], near[Café Sicilia]"	The Phoenix is a Fast food pub in the city centre near Café Sicilia . It has a high customer rating and is not children friendly . The price range is more than £ 30 .
"name[The Phoenix], eatType[pub], food[Fast food], priceRange[more than £30], customer rating[high], area[city centre], familyFriendly[yes], near[Café Sicilia]"	The Phoenix pub serves fast food with a price range of more than £ 30 . It is children friendly and situated close to Café Sicilia .
"name[The Phoenix], eatType[pub], food[Fast food], priceRange[more than £30], customer rating[high], area[riverside], familyFriendly[no], near[Café Sicilia]"	Expensive pub The Phoenix serves Fast food . It has a high customer satisfaction rating and is not a children friendly establishment . It is located near Café Sicilia in the riverside area .
"name[The Phoenix], eatType[pub], food[Fast food], priceRange[more than £30], customer rating[high], area[riverside], familyFriendly[yes], near[Café Sicilia]"	The Phoenix serves fast food at a reduced price . It is located near the river and Café Sicilia .
"name[The Phoenix], eatType[pub], food[French], priceRange[£20-25], area[riverside], familyFriendly[yes], near[Raja Indian Cuisine]"	The Phoenix is a kid friendly French pub in the riverside area near Raja Indian Cuisine . Prices range from £ 20 - 25 .
"name[The Phoenix], eatType[pub], food[French], priceRange[£20-25], customer rating[3 out of 5], area[city centre], familyFriendly[no], near[Café Sicilia]"	In the city centre near Café Sicilia is a French pub specializing in products called The Phoenix . It has a customer rating of 3 out of 5 and is not a Kid friendly meal .
"name[The Phoenix], eatType[pub], food[French], priceRange[£20-25], customer rating[3 out of 5], area[city centre], familyFriendly[yes], near[Café Sicilia]"	If you 're looking for French food , The Phoenix is rated 3 out of 5 . Kids are welcome and the prices are little £ 20 - 25 . It is located in the city centre near Café Sicilia .
"name[The Phoenix], eatType[pub], food[French], priceRange[£20-25], customer rating[3 out of 5], area[riverside], familyFriendly[no], near[Café Sicilia]"	The Phoenix is a French pub located in the riverside area near Café Sicilia . It offers meals at averagely priced and is not child friendly .
"name[The Phoenix], eatType[pub], food[French], priceRange[£20-25], customer rating[3 out of 5], area[riverside], familyFriendly[yes], near[Café Sicilia]"	The Phoenix is a pub that delivers take - away deliveries in the low price range . It is located close to Café Sicilia .
"name[The Phoenix], eatType[pub], food[French], priceRange[£20-25], customer rating[3 out of 5], area[riverside], familyFriendly[yes], near[Crowne Plaza Hotel]"	The Phoenix is a 3 star , family oriented pub located near Crowne Plaza Hotel .
"name[The Phoenix], eatType[pub], food[French], priceRange[£20-25], customer rating[high], area[city centre], familyFriendly[no], near[Crowne Plaza Hotel]"	The Phoenix is a pub located in the city centre near the Crowne Plaza Hotel . It serves French food with prices between £ 20 - 25 and is not kid friendly .
"name[The Phoenix], eatType[pub], food[French], priceRange[£20-25], customer rating[high], area[city centre], familyFriendly[yes], near[Crowne Plaza Hotel]"	The Phoenix is a kid friendly pub serving French food in the city centre near Crowne Plaza Hotel with a high customer rating and a price range of £ 20 - 25 .
"name[The Phoenix], eatType[pub], food[French], priceRange[£20-25], customer rating[high], area[riverside], familyFriendly[no], near[Crowne Plaza Hotel]"	There is a pub called The Phoenix serving French food in the riverside area near the Crowne Plaza Hotel . It has a high customer rating and is not kid friendly .
"name[The Phoenix], eatType[pub], food[French], priceRange[£20-25], customer rating[high], area[riverside], familyFriendly[yes], near[Crowne Plaza Hotel]"	The Phoenix is a low - priced , family - friendly pub that provides wines and cheese . It is located near Crowne Plaza Hotel .
"name[The Phoenix], eatType[pub], food[French], priceRange[cheap], area[riverside], familyFriendly[yes], near[Raja Indian Cuisine]"	The Phoenix is a cheap , family friendly pub that serves French food . It is located in the riverside area near Raja Indian Cuisine .
"name[The Phoenix], eatType[pub], food[French], priceRange[cheap], customer rating[5 out of 5], area[city centre], familyFriendly[no], near[Crowne Plaza Hotel]"	The Phoenix is a cheap place that serves French food . It is not family - friendly and has a customer rating of 5 out of 5 . It is located in the city centre near the Crowne Plaza Hotel .
"name[The Phoenix], eatType[pub], food[French], priceRange[cheap], customer rating[5 out of 5], area[city centre], familyFriendly[yes], near[Crowne Plaza Hotel]"	The Phoenix is a French pub located in the city centre near the Crowne Plaza Hotel . It is known for its cheap prices and a customer rating of 5 out of 5 .
"name[The Phoenix], eatType[pub], food[French], priceRange[cheap], customer rating[5 out of 5], area[riverside], familyFriendly[no], near[Crowne Plaza Hotel]"	The Phoenix is a pub that serves French food in the riverside area near the Crowne Plaza Hotel . It is not family - friendly and has a customer rating of 5 out of 5 .
"name[The Phoenix], eatType[pub], food[French], priceRange[cheap], customer rating[5 out of 5], area[riverside], familyFriendly[yes], near[Crowne Plaza Hotel]"	The Phoenix is a pub next to the Crowne Plaza Hotel that provides low prices and earned a perfect rating from customers .
"name[The Phoenix], eatType[pub], food[French], priceRange[high], area[riverside], familyFriendly[yes], near[Raja Indian Cuisine]"	The Phoenix serves French food . Located near Raja Indian Cuisine on the riverside , it welcomes children and has a high price range .
"name[The Phoenix], eatType[pub], food[French], priceRange[high], customer rating[3 out of 5], area[city centre], familyFriendly[no], near[Crowne Plaza Hotel]"	Near the Crowne Plaza Hotel in the city centre is a mid - price eatery for adults called The Phoenix . It has 3 out of 5 customer ratings .
"name[The Phoenix], eatType[pub], food[French], priceRange[high], customer rating[3 out of 5], area[city centre], familyFriendly[yes], near[Crowne Plaza Hotel]"	The Phoenix is a children friendly pub providing French food . It is located in the city centre near Crowne Plaza Hotel . It has a customer rating of 3 out of 5 .
"name[The Phoenix], eatType[pub], food[French], priceRange[high], customer rating[3 out of 5], area[riverside], familyFriendly[no], near[Crowne Plaza Hotel]"	In the riverside area near the Crowne Plaza Hotel is a French pub called The Phoenix . It is not family - friendly and has a customer rating of 3 out of 5 .
"name[The Phoenix], eatType[pub], food[French], priceRange[high], customer rating[3 out of 5], area[riverside], familyFriendly[yes], near[Crowne Plaza Hotel]"	In the riverside area near the Crowne Plaza Hotel is a child friendly French pub called The Phoenix . It has a customer rating of 3 out of 5 and a high price range .
"name[The Phoenix], eatType[pub], food[French], priceRange[less than £20], customer rating[average], area[city centre], familyFriendly[no], near[Crowne Plaza Hotel]"	The Phoenix pub offers French food for less than £ 20 . It is located in the city centre near the Crowne Plaza Hotel and is not family - friendly .
"name[The Phoenix], eatType[pub], food[French], priceRange[less than £20], customer rating[average], area[city centre], familyFriendly[yes], near[Crowne Plaza Hotel]"	Near the Crowne Plaza Hotel in the city centre is a low cost family - friendly French pub named The Phoenix .
"name[The Phoenix], eatType[pub], food[French], priceRange[less than £20], customer rating[average], area[riverside], familyFriendly[no], near[Crowne Plaza Hotel]"	The Phoenix is a pub near the river and Crowne Plaza Hotel that does much meals for less than £ 20 .
"name[The Phoenix], eatType[pub], food[French], priceRange[less than £20], customer rating[average], area[riverside], familyFriendly[yes], near[Crowne Plaza Hotel]"	The Phoenix is a value family friendly pub . Located near the Crowne Plaza Hotel .
"name[The Phoenix], eatType[pub], food[French], priceRange[less than £20], customer rating[low], area[city centre], familyFriendly[no], near[Crowne Plaza Hotel]"	The Phoenix is an adult pub near the Crowne Plaza Hotel in the city centre . It offers French food for less than £ 20 and has been given a low customer rating .
"name[The Phoenix], eatType[pub], food[French], priceRange[less than £20], customer rating[low], area[city centre], familyFriendly[yes], near[Crowne Plaza Hotel]"	The Phoenix is a family - friendly pub serving French food for less than £ 20 . It has a low customer rating and is situated near the Crowne Plaza Hotel in the city centre .
"name[The Phoenix], eatType[pub], food[French], priceRange[less than £20], customer rating[low], area[riverside], familyFriendly[no], near[Crowne Plaza Hotel]"	The Phoenix is a pub offering French food in the riverside area near the Crowne Plaza Hotel . It has a low customer rating and is not family - friendly .
"name[The Phoenix], eatType[pub], food[French], priceRange[less than £20], customer rating[low], area[riverside], familyFriendly[yes], near[Crowne Plaza Hotel]"	The Phoenix is a family friendly place on the edge of the Crowne Plaza Hotel .
"name[The Phoenix], eatType[pub], food[French], priceRange[moderate], customer rating[1 out of 5], area[city centre], familyFriendly[no], near[Crowne Plaza Hotel]"	The Phoenix is a moderately priced pub offering French food in the city centre near the Crowne Plaza Hotel . It is not kid friendly and has a customer rating of 1 out of 5 .
"name[The Phoenix], eatType[pub], food[French], priceRange[moderate], customer rating[1 out of 5], area[city centre], familyFriendly[yes], near[Crowne Plaza Hotel]"	The Phoenix is a pub that serves moderately priced French food . It is kid friendly and has a customer rating of 1 out of 5 . It is located in the city centre near the Crowne Plaza Hotel .
"name[The Phoenix], eatType[pub], food[French], priceRange[moderate], customer rating[1 out of 5], area[riverside], familyFriendly[no], near[Crowne Plaza Hotel]"	The Phoenix is a French pub in the riverside area near Crowne Plaza Hotel . It has a moderate price range and a customer rating of 1 out of 5 . It is not kids friendly .
"name[The Phoenix], eatType[pub], food[French], priceRange[moderate], customer rating[1 out of 5], area[riverside], familyFriendly[yes], near[Crowne Plaza Hotel]"	The Phoenix is a family friendly pub with meals in the moderate range . It is located near the Crowne Plaza Hotel .
"name[The Phoenix], eatType[pub], food[French], priceRange[more than £30], customer rating[5 out of 5], area[city centre], familyFriendly[no], near[Crowne Plaza Hotel]"	The Phoenix is a pub near the Crowne Plaza Hotel in the city centre . It has a customer rating of 5 out of 5 and is not child friendly . It serves French food and cost more than £ 30 .
"name[The Phoenix], eatType[pub], food[French], priceRange[more than £30], customer rating[5 out of 5], area[city centre], familyFriendly[yes], near[Crowne Plaza Hotel]"	Near the Crowne Plaza Hotel in the city centre is a French priced child friendly pub named The Phoenix . It is highly rated .
"name[The Phoenix], eatType[pub], food[French], priceRange[more than £30], customer rating[5 out of 5], area[riverside], familyFriendly[no], near[Crowne Plaza Hotel]"	Near the Crowne Plaza Hotel in the riverside area you will find a French pub named The Phoenix . It has a 5 out of 5 customer rating and is not suitable for children .
"name[The Phoenix], eatType[pub], food[French], priceRange[more than £30], customer rating[5 out of 5], area[riverside], familyFriendly[yes], near[Crowne Plaza Hotel]"	The Phoenix is a children friendly pub in the riverside area near the Crowne Plaza Hotel . It serves French food for more than £ 30 and has a customer rating of 5 out of 5 .
"name[The Phoenix], eatType[pub], food[French], priceRange[more than £30], customer rating[low], area[city centre], familyFriendly[no], near[Crowne Plaza Hotel]"	The Phoenix is a French pub located in the city centre near the Crowne Plaza Hotel . It has a low customer rating and is not child friendly .
"name[The Phoenix], eatType[pub], food[French], priceRange[more than £30], customer rating[low], area[city centre], familyFriendly[yes], near[Crowne Plaza Hotel]"	The Phoenix is a French pub in the city centre near Crowne Plaza Hotel . It has a low customer rating and is kid friendly .
"name[The Phoenix], eatType[pub], food[French], priceRange[more than £30], customer rating[low], area[riverside], familyFriendly[no], near[Crowne Plaza Hotel]"	The Phoenix is a French pub that received low ratings . It is not children friendly and is really cheap . It is situated in the riverside area near the Crowne Plaza Hotel .
"name[The Phoenix], eatType[pub], food[French], priceRange[more than £30], customer rating[low], area[riverside], familyFriendly[yes], near[Crowne Plaza Hotel]"	The Phoenix is a family friendly eatery located near the Crowne Plaza Hotel . It is an expensive restaurant .
"name[The Phoenix], eatType[restaurant], food[Fast food], priceRange[cheap], area[riverside], familyFriendly[yes], near[Raja Indian Cuisine]"	The Phoenix is a cheap , family friendly restaurant that offers fast food . It is located in the riverside area near Raja Indian Cuisine .
"name[The Phoenix], eatType[restaurant], food[Fast food], priceRange[high], area[city centre], familyFriendly[no], near[Raja Indian Cuisine]"	The Phoenix is a little high quality gourmet meal to bring your kids . It is located in the city centre near Raja Indian Cuisine .
"name[The Phoenix], eatType[restaurant], food[Fast food], priceRange[high], area[city centre], familyFriendly[yes], near[Raja Indian Cuisine]"	The Phoenix is a kids friendly Fast food restaurant in the city centre near Raja Indian Cuisine with a high price range .
"name[The Phoenix], eatType[restaurant], food[Fast food], priceRange[high], area[riverside], familyFriendly[no], near[Raja Indian Cuisine]"	The Phoenix is a high priced fast food joint in the riverside area near Raja Indian Cuisine . It is not child friendly .
"name[The Phoenix], eatType[restaurant], food[Fast food], priceRange[high], area[riverside], familyFriendly[yes], near[Raja Indian Cuisine]"	The Phoenix if our new new Fast food restaurant , kids friendly fun and fries . Located near Raja Indian Cuisine on the riverside .
"name[The Phoenix], eatType[restaurant], food[Fast food], priceRange[less than £20], area[city centre], familyFriendly[no], near[Raja Indian Cuisine]"	The Phoenix is located in the city centre near Raja Indian Cuisine . It serves fast food for less than £ 20 and is not family - friendly .
"name[The Phoenix], eatType[restaurant], food[Fast food], priceRange[less than £20], area[city centre], familyFriendly[yes], near[Raja Indian Cuisine]"	The Phoenix is a family - friendly cheaply priced fast food restaurant in the city centre near Raja Indian Cuisine .
"name[The Phoenix], eatType[restaurant], food[Fast food], priceRange[less than £20], area[riverside], familyFriendly[no], near[Raja Indian Cuisine]"	The Phoenix is an adult fast food restaurant located near Raja Indian Cuisine in the riverside area . The price range is less than £ 20 .
"name[The Phoenix], eatType[restaurant], food[Fast food], priceRange[less than £20], area[riverside], familyFriendly[yes], near[Raja Indian Cuisine]"	The Phoenix is a family friendly restaurant that offers Fast food for less than £ 20 . It is located in the riverside area near Raja Indian Cuisine .
"name[The Phoenix], eatType[restaurant], food[Fast food], priceRange[moderate], area[city centre], familyFriendly[no], near[Raja Indian Cuisine]"	There is a restaurant called The Phoenix that offers fast food in the city centre near Raja Indian Cuisine . It is not kid friendly and has a moderate price range .
"name[The Phoenix], eatType[restaurant], food[Fast food], priceRange[moderate], area[city centre], familyFriendly[yes], near[Raja Indian Cuisine]"	For nice fast food in a kid friendly environment , try The Phoenix . It is located near Raja Indian Cuisine in the city centre . It has a medium price range .
"name[The Phoenix], eatType[restaurant], food[Fast food], priceRange[moderate], area[riverside], familyFriendly[no], near[Raja Indian Cuisine]"	The Phoenix is a fast food restaurant in the riverside area near Raja Indian Cuisine . It is moderately priced and not kid friendly .
"name[The Phoenix], eatType[restaurant], food[Fast food], priceRange[moderate], area[riverside], familyFriendly[yes], near[Raja Indian Cuisine]"	Fast food can be found at the riverside next to Raja Indian Cuisine , warm out the family friendly restaurant called The Phoenix .
"name[The Phoenix], eatType[restaurant], food[Fast food], priceRange[more than £30], area[riverside], familyFriendly[yes], near[Raja Indian Cuisine]"	In the riverside area near Raja Indian Cuisine is a children friendly fast food restaurant called The Phoenix . It has a price range of more than £ 30 .
"name[The Phoenix], eatType[restaurant], food[French], priceRange[£20-25], area[riverside], familyFriendly[yes], near[Raja Indian Cuisine]"	The Phoenix is a Kid friendly French restaurant in the riverside area near Raja Indian Cuisine with pricing between £ 20 - 25 .
"name[The Phoenix], eatType[restaurant], food[French], priceRange[cheap], area[riverside], familyFriendly[yes], near[Raja Indian Cuisine]"	Looking for an inexpensive family friendly French restaurant in the riverside area , The Phoenix is located near Raja Indian Cuisine .
"name[The Phoenix], eatType[restaurant], food[French], priceRange[high], area[riverside], familyFriendly[yes], near[Raja Indian Cuisine]"	The Phoenix is a children friendly restaurant in the riverside area near Raja Indian Cuisine . It serves French food and has a high price range .
"name[The Phoenix], eatType[restaurant], food[Indian], priceRange[£20-25], customer rating[high], area[city centre], familyFriendly[no], near[Crowne Plaza Hotel]"	There is a restaurant named The Phoenix that serves Indian food . It has high customer ratings and is priced at £ 20 - 25 . It is not child friendly and is located in the city centre near the Crowne Plaza Hotel .
"name[The Phoenix], eatType[restaurant], food[Indian], priceRange[£20-25], customer rating[high], area[city centre], familyFriendly[yes], near[Crowne Plaza Hotel]"	The Phoenix is a restaurant that serves Indian food for £ 20 - 25 . It has a high customer rating and is kids friendly . It is located in the city centre near the Crowne Plaza Hotel .
"name[The Phoenix], eatType[restaurant], food[Indian], priceRange[£20-25], customer rating[high], area[riverside], familyFriendly[no], near[Crowne Plaza Hotel]"	There is an Indian restaurant near the Crowne Plaza Hotel called The Phoenix . It is highly rated and is not kid friendly . However , prices range from £ 20 - 25 .
"name[The Phoenix], eatType[restaurant], food[Indian], priceRange[£20-25], customer rating[high], area[riverside], familyFriendly[yes], near[Crowne Plaza Hotel]"	The Phoenix is a kid friendly restaurant that provides Indian food for £ 20 - 25 . It has a high customer service rating and is located in the riverside area near the Crowne Plaza Hotel .
"name[The Phoenix], eatType[restaurant], food[Indian], priceRange[cheap], customer rating[5 out of 5], area[city centre], familyFriendly[no], near[Crowne Plaza Hotel]"	The Phoenix is a cheap restaurant that serves Indian food . It has a customer rating of 5 out of 5 and is not family friendly . It is located in the city centre near the Crowne Plaza Hotel .
"name[The Phoenix], eatType[restaurant], food[Indian], priceRange[cheap], customer rating[5 out of 5], area[city centre], familyFriendly[yes], near[Crowne Plaza Hotel]"	The Phoenix is a family - friendly restaurant that serves cheap Indian food . It is located near the Crowne Plaza Hotel in the city center . It has a 5 out of 5 rating .
"name[The Phoenix], eatType[restaurant], food[Indian], priceRange[cheap], customer rating[5 out of 5], area[riverside], familyFriendly[no], near[Crowne Plaza Hotel]"	Located in the riverside area near the Crowne Plaza Hotel , you can find The Phoenix , an affordable , highly rated Indian restaurant .
"name[The Phoenix], eatType[restaurant], food[Indian], priceRange[cheap], customer rating[5 out of 5], area[riverside], familyFriendly[no], near[Express by Holiday Inn]"	In the riverside area near Express by Holiday Inn there is a highly rated Indian restaurant called The Phoenix . It is not family friendly and also offers cheap food .
"name[The Phoenix], eatType[restaurant], food[Indian], priceRange[cheap], customer rating[5 out of 5], area[riverside], familyFriendly[yes], near[Express by Holiday Inn]"	The Phoenix is a family friendly restaurant that serves cheap Indian food . It has a customer rating of 5 out of 5 and is located in the riverside area near Express by Holiday Inn .
"name[The Phoenix], eatType[restaurant], food[Indian], priceRange[cheap], customer rating[average], area[city centre], familyFriendly[no], near[Express by Holiday Inn]"	The Phoenix is a cheap Indian restaurant with average ratings . It is not family friendly and is located in the city centre near Express by Holiday Inn .
"name[The Plough], eatType[pub], food[Chinese], priceRange[£20-25], area[riverside], familyFriendly[yes], near[Raja Indian Cuisine]"	The Plough is a high priced pub that serves Chinese food . It is located in the riverside area near Raja Indian Cuisine and is kid friendly .
"name[The Plough], eatType[pub], food[Chinese], priceRange[cheap], area[riverside], familyFriendly[yes], near[Raja Indian Cuisine]"	In the riverside area near Raja Indian Cuisine is a family friendly pub serving cheap Chinese food called The Plough .
"name[The Plough], eatType[pub], food[Chinese], priceRange[high], area[city centre], familyFriendly[no], near[Raja Indian Cuisine]"	The Plough is a pub that serve Chinese food . They have a high price services and are not children friendly . They are located in the city centre near Raja Indian Cuisine .
"name[The Plough], eatType[pub], food[Chinese], priceRange[high], area[city centre], familyFriendly[yes], near[Raja Indian Cuisine]"	For a family friendly pub in the city centre , try The Plough . It serves Chinese food in the high price range and is located near Raja Indian Cuisine .
"name[The Plough], eatType[pub], food[Chinese], priceRange[high], area[riverside], familyFriendly[no], near[Raja Indian Cuisine]"	There is a pub called The Plough that provides Chinese food in the high price range . It is located in the riverside area near Raja Indian Cuisine and is not family friendly .
"name[The Plough], eatType[pub], food[Chinese], priceRange[high], area[riverside], familyFriendly[yes], near[Raja Indian Cuisine]"	The Plough is a kid friendly Chinese pub with a high price range in the riverside area near Raja Indian Cuisine .
"name[The Plough], eatType[pub], food[Chinese], priceRange[less than £20], area[city centre], familyFriendly[no], near[Raja Indian Cuisine]"	The Plough is a pub that serves Chinese food for less than £ 20 . It is located in the city centre near Raja Indian Cuisine without be children friendly .
"name[The Plough], eatType[restaurant], food[Chinese], priceRange[£20-25], area[riverside], familyFriendly[yes], near[Raja Indian Cuisine]"	The Plough is a restaurant that serves Chinese food in the riverside area near Raja Indian Cuisine . Prices range from £ 20 - 25 and is kids friendly .
"name[The Plough], eatType[restaurant], food[Chinese], priceRange[cheap], area[riverside], familyFriendly[yes], near[Raja Indian Cuisine]"	The Plough is a family friendly Chinese restaurant with cheap prices located in riverside near Raja Indian Cuisine .
"name[The Plough], eatType[restaurant], food[Chinese], priceRange[high], area[city centre], familyFriendly[no], near[Raja Indian Cuisine]"	The Plough is an expensive Chinese restaurant near Raja Indian Cuisine in the city center . It is adult only .
"name[The Plough], eatType[restaurant], food[Chinese], priceRange[high], area[city centre], familyFriendly[yes], near[Raja Indian Cuisine]"	The Plough is a restaurant that serves Chinese food at higher prices in the city centre near Raja Indian Cuisine . It is child friendly .
"name[The Plough], eatType[restaurant], food[Chinese], priceRange[high], area[riverside], familyFriendly[no], near[Raja Indian Cuisine]"	In the riverside area near Raja Indian Cuisine is a Chinese restaurant called The Plough that has a high price range for adults only .
"name[The Plough], eatType[restaurant], food[Chinese], priceRange[high], area[riverside], familyFriendly[yes], near[Raja Indian Cuisine]"	The kids friendly restaurant The Plough serves Chinese food and is highly rated by customers . It is located in the riverside area near Raja Indian Cuisine .
"name[The Plough], eatType[restaurant], food[Chinese], priceRange[less than £20], area[city centre], familyFriendly[no], near[Raja Indian Cuisine]"	There is a restaurant called The Plough near Raja Indian Cuisine in the city centre . It is not family friendly and serves Chinese food for less than £ 20 .
"name[The Punter], eatType[pub], food[Chinese], priceRange[less than £20], area[city centre], familyFriendly[yes], near[Raja Indian Cuisine]"	The Punter is a family friendly Chinese pub with prices less than £ 20 . It is nearby Raja Indian Cuisine in the city center .
"name[The Punter], eatType[pub], food[Chinese], priceRange[less than £20], area[riverside], familyFriendly[no], near[Raja Indian Cuisine]"	In the riverside area near Raja Indian Cuisine is a Chinese pub called The Punter . It is not family friendly and has a price range of less than £ 20 .
"name[The Punter], eatType[pub], food[Chinese], priceRange[less than £20], area[riverside], familyFriendly[yes], near[Raja Indian Cuisine]"	The Punter is a family friendly pub serving Chinese food at a cost of less than 20 pound . It is located in the riverside area near Raja Indian Cuisine .
"name[The Punter], eatType[pub], food[Chinese], priceRange[moderate], area[city centre], familyFriendly[no], near[Raja Indian Cuisine]"	The Punter is a pub offering Chinese food for adults at reasonable prices . You can find it in the city centre near Raja Indian Cuisine .
"name[The Punter], eatType[pub], food[Chinese], priceRange[moderate], area[city centre], familyFriendly[yes], near[Raja Indian Cuisine]"	In the city centre near Raja Indian Cuisine is a moderately priced pub called The Punter . Kids are welcome establishment and provides Chinese food .
"name[The Punter], eatType[pub], food[Chinese], priceRange[moderate], area[riverside], familyFriendly[no], near[Raja Indian Cuisine]"	The Punter is a moderately priced Chinese pub in riverside near Raja Indian Cuisine . It is not kid friendly .
"name[The Punter], eatType[pub], food[Chinese], priceRange[moderate], area[riverside], familyFriendly[yes], near[Raja Indian Cuisine]"	The Punter is a pub that serves Chinese food at a moderate price . Located in the riverside area near Raja Indian Cuisine , it is kids friendly .
"name[The Punter], eatType[pub], food[Chinese], priceRange[more than £30], area[riverside], familyFriendly[yes], near[Raja Indian Cuisine]"	The Punter is a pub near Raja Indian Cuisine in the riverside area . It serves Chinese food for more than £ 30 and is child friendly .
"name[The Punter], eatType[pub], food[English], priceRange[£20-25], area[riverside], familyFriendly[yes], near[Raja Indian Cuisine]"	For prices between £ 20 - 25 , The Punter pub offers English food in a kid friendly environment in the riverside area near Raja Indian Cuisine .
"name[The Punter], eatType[pub], food[English], priceRange[cheap], area[riverside], familyFriendly[yes], near[Raja Indian Cuisine]"	The Punter is a pub that provides English food in the cheap price range . It is located in the riverside . It is near Raja Indian Cuisine .
"name[The Punter], eatType[pub], food[English], priceRange[high], area[city centre], familyFriendly[no], near[Raja Indian Cuisine]"	There is an English pub called The Punter near Raja Indian Cuisine in the city centre . It offers high prices and is not a children friendly atmosphere .
"name[The Punter], eatType[pub], food[English], priceRange[high], area[city centre], familyFriendly[yes], near[Raja Indian Cuisine]"	Serving English food , The Punter is a pub in the city centre near Raja Indian Cuisine . Serving high price however however is children friendly .
"name[The Punter], eatType[pub], food[English], priceRange[high], area[riverside], familyFriendly[no], near[Raja Indian Cuisine]"	The Punter is an expensive pub in the riverside area near Raja Indian Cuisine . It is not child friendly .
"name[The Punter], eatType[pub], food[English], priceRange[high], area[riverside], familyFriendly[yes], near[Raja Indian Cuisine]"	The Punter is a pub located near Raja Indian Cuisine in the riverside area . Child friendly .
"name[The Punter], eatType[pub], food[Italian], priceRange[high], customer rating[average], area[city centre], familyFriendly[no], near[Rainbow Vegetarian Café]"	In the city centre near the Rainbow Vegetarian Café is an Italian pub called The Punter . It has an average customer rating and is not children friendly . They offer a high price range .
"name[The Punter], eatType[restaurant], food[Chinese], priceRange[less than £20], area[city centre], familyFriendly[yes], near[Raja Indian Cuisine]"	Located in the city centre near Raja Indian Cuisine is a family friendly restaurant called The Punter . It offers Chinese food for less than £ 20 .
"name[The Punter], eatType[restaurant], food[Chinese], priceRange[less than £20], area[riverside], familyFriendly[no], near[Raja Indian Cuisine]"	The Punter is a restaurant that provides Chinese food in the less than £ 20 price range . It is located in the riverside . It is near Raja Indian Cuisine .
"name[The Punter], eatType[restaurant], food[Chinese], priceRange[less than £20], area[riverside], familyFriendly[yes], near[Raja Indian Cuisine]"	The Punter is a family friendly restaurant located near Raja Indian Cuisine . They offer authentic Chinese foods for less than £ 20 .
"name[The Punter], eatType[restaurant], food[Chinese], priceRange[moderate], area[city centre], familyFriendly[no], near[Raja Indian Cuisine]"	The Punter is a moderately priced Chinese restaurant in the city centre near Raja Indian Cuisine . It is not kid friendly .
"name[The Punter], eatType[restaurant], food[Chinese], priceRange[moderate], area[city centre], familyFriendly[yes], near[Raja Indian Cuisine]"	The Punter is a low priced Chinese restaurant in the city centre near Raja Indian Cuisine .
"name[The Punter], eatType[restaurant], food[Chinese], priceRange[moderate], area[riverside], familyFriendly[no], near[Raja Indian Cuisine]"	The Punter is a Chinese restaurant with moderate prices located in riverside near Raja Indian Cuisine . It is not kids friendly .
"name[The Punter], eatType[restaurant], food[Chinese], priceRange[moderate], area[riverside], familyFriendly[yes], near[Raja Indian Cuisine]"	The Punter is a kid friendly Chinese restaurant in Riverside near Raja Indian Cuisine . It is moderately priced .
"name[The Punter], eatType[restaurant], food[Chinese], priceRange[more than £30], area[riverside], familyFriendly[yes], near[Raja Indian Cuisine]"	The Punter is a restaurant providing Chinese food in the more than £ 30 price range . It is located in the riverside . It is near Raja Indian Cuisine .
"name[The Punter], eatType[restaurant], food[English], priceRange[£20-25], area[riverside], familyFriendly[yes], near[Raja Indian Cuisine]"	In the riverside area near Raja Indian Cuisine is a kid friendly English restaurant called The Punter with a price range of £ 20 - 25 .
"name[The Punter], eatType[restaurant], food[English], priceRange[cheap], area[riverside], familyFriendly[yes], near[Raja Indian Cuisine]"	If you 're looking for great English food , The Punter is an affordable , family friendly restaurant with an affordable price range . You will find us near Raja Indian Cuisine on the riverside . You will find us us .
"name[The Punter], eatType[restaurant], food[English], priceRange[high], area[city centre], familyFriendly[no], near[Raja Indian Cuisine]"	The Punter is an English restaurant in the city centre near Raja Indian Cuisine . It has a high price range and is not child friendly .
"name[The Punter], eatType[restaurant], food[English], priceRange[high], area[city centre], familyFriendly[yes], near[Raja Indian Cuisine]"	The Punter is a child friendly English restaurant in the city centre near Raja Indian Cuisine with a high price range .
"name[The Punter], eatType[restaurant], food[English], priceRange[high], area[riverside], familyFriendly[no], near[Raja Indian Cuisine]"	The Punter is a high priced child friendly restaurant serving English food in the riverside area near Raja Indian Cuisine .
"name[The Punter], eatType[restaurant], food[English], priceRange[high], area[riverside], familyFriendly[yes], near[Raja Indian Cuisine]"	The Punter is a child friendly restaurant that offers English food . It has high price service and can be found in the riverside area near Raja Indian Cuisine .
"name[The Punter], eatType[restaurant], food[Indian], priceRange[cheap], customer rating[average], area[city centre], familyFriendly[yes], near[Express by Holiday Inn]"	The Punter is a restaurant providing Indian food in the cheap price range . It is located in the city centre . It is near Express by Holiday Inn . It has an average customer rating and is family friendly . It also provides Indian food .
"name[The Punter], eatType[restaurant], food[Indian], priceRange[cheap], customer rating[average], area[riverside], familyFriendly[no], near[Express by Holiday Inn]"	The Punter is a restaurant that serves cheap Indian food . It has an average customer rating and is not family friendly . It is located in the riverside area near Express by Holiday Inn .
"name[The Punter], eatType[restaurant], food[Indian], priceRange[cheap], customer rating[average], area[riverside], familyFriendly[yes], near[Express by Holiday Inn]"	There is a cheap Indian restaurant in the riverside area near Express by Holiday Inn called The Punter . It is family friendly and has an average customer rating .
"name[The Punter], eatType[restaurant], food[Indian], priceRange[high], customer rating[1 out of 5], area[city centre], familyFriendly[no], near[Express by Holiday Inn]"	The Punter is an Indian restaurant located in the city centre near Express by Holiday Inn . It has a 1 out of 5 rating and is not children friendly . The prices are high .
"name[The Punter], eatType[restaurant], food[Indian], priceRange[high], customer rating[1 out of 5], area[city centre], familyFriendly[yes], near[Express by Holiday Inn]"	The Punter is a high priced child friendly restaurant located in the city centre near Express by Holiday Inn . It serves Indian food and has a customer rating of 1 out of 5 .
"name[The Punter], eatType[restaurant], food[Indian], priceRange[high], customer rating[1 out of 5], area[riverside], familyFriendly[no], near[Express by Holiday Inn]"	The Punter is an expensive Indian restaurant near Express by Holiday Inn . It is not family friendly and has a customer rating of 1 out of 5 .
"name[The Punter], eatType[restaurant], food[Indian], priceRange[high], customer rating[1 out of 5], area[riverside], familyFriendly[yes], near[Express by Holiday Inn]"	Located in the riverside area near Express by Holiday Inn , The Punter is a family friendly restaurant that serves high priced Indian food . It has a customer rating of 1 out of 5 .
"name[The Punter], eatType[restaurant], food[Indian], priceRange[high], customer rating[average], area[city centre], familyFriendly[no], near[Express by Holiday Inn]"	The Punter is an Indian restaurant in the city centre near Express by Holiday Inn . It has a high price range and an average customer rating . It is not child friendly .
"name[The Punter], eatType[restaurant], food[Indian], priceRange[high], customer rating[average], area[city centre], familyFriendly[yes], near[Express by Holiday Inn]"	The Punter is an Indian restaurant located in the city centre near Express by Holiday Inn . It has a high price range and is child friendly .
"name[The Punter], eatType[restaurant], food[Indian], priceRange[high], customer rating[average], area[riverside], familyFriendly[no], near[Express by Holiday Inn]"	The Punter is an Indian restaurant with a high price range . It has an average customer rating and is not family friendly . It is in riverside near Express by Holiday Inn .
"name[The Punter], eatType[restaurant], food[Indian], priceRange[high], customer rating[average], area[riverside], familyFriendly[yes], near[Express by Holiday Inn]"	If you are looking for a restaurant named The Punter in the riverside area near Express by Holiday Inn . It is a family friendly restaurant selling Indian food at a high cost . It has an average customer rating .
"name[The Punter], eatType[restaurant], food[Indian], priceRange[less than £20], customer rating[low], area[city centre], familyFriendly[no], near[Express by Holiday Inn]"	The Punter is a restaurant serving Indian food for less than £ 20 . It has a low customer rating and is not family friendly . It is located in the city centre near Express by Holiday Inn .
"name[The Punter], eatType[restaurant], food[Indian], priceRange[less than £20], customer rating[low], area[city centre], familyFriendly[yes], near[Express by Holiday Inn]"	The Punter is a family friendly Indian restaurant in the city centre near the Express by Holiday Inn . Customers have rated it low and the prices are less than £ 20 .
"name[The Punter], eatType[restaurant], food[Indian], priceRange[less than £20], customer rating[low], area[riverside], familyFriendly[no], near[Express by Holiday Inn]"	The Punter is a low - priced restaurant in the riverside area near the Express by Holiday Inn . They serve Indian food and have a low customer rating .
"name[The Punter], eatType[restaurant], food[Indian], priceRange[less than £20], customer rating[low], area[riverside], familyFriendly[yes], near[Express by Holiday Inn]"	The Punter is a low - priced , family friendly restaurant that serves Indian food . It is located in the riverside area near Express by Holiday Inn .
"name[The Punter], eatType[restaurant], food[Indian], priceRange[moderate], customer rating[1 out of 5], area[city centre], familyFriendly[no], near[Express by Holiday Inn]"	The Punter is a restaurant that provides Indian food in the moderate price range . It is located in the city centre . It is near Express by Holiday Inn . Its customer rating is 1 out of 5 .
"name[The Punter], eatType[restaurant], food[Indian], priceRange[moderate], customer rating[1 out of 5], area[city centre], familyFriendly[yes], near[Express by Holiday Inn]"	The Punter is a restaurant that serves Indian food within a moderate safe price range . It is kid safe and has a customer rating of 1 out of 5 . It is located in the city centre near Express by Holiday Inn .
"name[The Punter], eatType[restaurant], food[Indian], priceRange[moderate], customer rating[1 out of 5], area[riverside], familyFriendly[no], near[Express by Holiday Inn]"	The Punter is a restaurant known for its Indian cuisine . It is not far due to the Express by Holiday Inn . The prices are moderate and it is not sure to kids . It has a customer rating of 1 out of 5 .
"name[The Punter], eatType[restaurant], food[Indian], priceRange[moderate], customer rating[1 out of 5], area[riverside], familyFriendly[yes], near[Express by Holiday Inn]"	The Punter is a restaurant that also offers Indian food at a moderate price . It is located in the riverside area near the Express by Holiday Inn . It has a customer rating of 1 out of 5 and is kid friendly . The prices are good .
"name[The Punter], eatType[restaurant], food[Indian], priceRange[moderate], customer rating[3 out of 5], area[city centre], familyFriendly[no], near[Express by Holiday Inn]"	The Punter is a kid friendly Indian restaurant near Express by Holiday Inn in the city centre . You will find moderately priced cuisine with a customer rating of 3 out of 5 .
"name[The Punter], eatType[restaurant], food[Indian], priceRange[moderate], customer rating[3 out of 5], area[city centre], familyFriendly[yes], near[Express by Holiday Inn]"	The Punter is an Indian restaurant with a moderate price range . It has a customer rating of 3 out of 5 and is Kid friendly . It is located in the city centre near Express by Holiday Inn .
"name[The Punter], eatType[restaurant], food[Indian], priceRange[moderate], customer rating[3 out of 5], area[riverside], familyFriendly[no], near[Express by Holiday Inn]"	In the riverside area near Express by Holiday Inn there is a restaurant called The Punter that serves Indian food . It has a moderate price range and a customer rating of 3 out of 5 .
"name[The Punter], eatType[restaurant], food[Indian], priceRange[moderate], customer rating[3 out of 5], area[riverside], familyFriendly[yes], near[Express by Holiday Inn]"	The Punter is a family friendly place offering Indian food in the riverside area near the Express by Holiday Inn . It is moderately priced and has a customer rating of 3 out of 5 .
"name[The Punter], eatType[restaurant], food[Indian], priceRange[more than £30], customer rating[high], area[city centre], familyFriendly[no], near[Express by Holiday Inn]"	The Punter is a high priced Indian restaurant in the city centre near Express by Holiday Inn . It is highly rated and not child friendly .
"name[The Punter], eatType[restaurant], food[Indian], priceRange[more than £30], customer rating[high], area[city centre], familyFriendly[yes], near[Express by Holiday Inn]"	The Punter is an Indian place with a price range of more than 30 dollars . It is a good choice with a high customer rating . It is located in the city centre near Express by Holiday Inn and is family friendly .
"name[The Punter], eatType[restaurant], food[Indian], priceRange[more than £30], customer rating[high], area[riverside], familyFriendly[no], near[Express by Holiday Inn]"	If you bring go to children , home to The Punter . You can enjoy Indian cuisine at more than £ 30 . Located in the riverside area near the Express by Holiday Inn , it has a high customer rating and is not children friendly .
"name[The Punter], eatType[restaurant], food[Indian], priceRange[more than £30], customer rating[high], area[riverside], familyFriendly[yes], near[Express by Holiday Inn]"	If you are looking for a restaurant in the riverside area , look no further than The Punter . It serves Indian food for more than £ 30 . It is highly rated and is child friendly . It is located near Express by Holiday Inn .
"name[The Punter], eatType[restaurant], food[Italian], priceRange[£20-25], customer rating[high], area[city centre], familyFriendly[no], near[Express by Holiday Inn]"	The Punter is an Italian restaurant near Express by Holiday Inn in the city centre . It has a high customer rating and a price range of £ 20 - 25 . It is not kid friendly .
"name[The Punter], eatType[restaurant], food[Italian], priceRange[£20-25], customer rating[high], area[city centre], familyFriendly[yes], near[Express by Holiday Inn]"	The Punter is a restaurant providing Italian food in the £ 20 - 25 price range . It has a high customer rating and is kids friendly . It is located in the city centre near Express by Holiday Inn .
"name[The Punter], eatType[restaurant], food[Italian], priceRange[£20-25], customer rating[high], area[riverside], familyFriendly[no], near[Express by Holiday Inn]"	The Punter is a high stars Italian restaurant with prices between £ 20 - 25 . It is not child - friendly and is located in the riverside area near Express by Holiday Inn .
"name[The Punter], eatType[restaurant], food[Italian], priceRange[£20-25], customer rating[high], area[riverside], familyFriendly[yes], near[Express by Holiday Inn]"	The Punter restaurant welcomes families . Next to the Express by Holiday Inn . Next to families . Next to quality affordable prices .
"name[The Punter], eatType[restaurant], food[Italian], priceRange[cheap], customer rating[5 out of 5], area[city centre], familyFriendly[no], near[Express by Holiday Inn]"	The Punter is a Italian restaurant located in the city centre near Express by Holiday Inn . It has cheap prices and a customer rating of 5 out of 5 . It is not family - friendly .
"name[The Punter], eatType[restaurant], food[Italian], priceRange[cheap], customer rating[5 out of 5], area[city centre], familyFriendly[no], near[Rainbow Vegetarian Café]"	In the city centre near the Rainbow Vegetarian Café is an Italian restaurant called The Punter . It is not family - friendly and has a customer rating of 5 out of 5 .
"name[The Punter], eatType[restaurant], food[Italian], priceRange[cheap], customer rating[5 out of 5], area[city centre], familyFriendly[yes], near[Rainbow Vegetarian Café]"	The Punter is an amazing Italian restaurant in the city centre near Rainbow Vegetarian Café . It is highly rated and family - friendly .
"name[The Punter], eatType[restaurant], food[Italian], priceRange[cheap], customer rating[5 out of 5], area[riverside], familyFriendly[no], near[Rainbow Vegetarian Café]"	Near the Rainbow Vegetarian Café in the riverside area , you can find The Punter . This Italian restaurant is not family - friendly and costs 5 out of 5 .
"name[The Punter], eatType[restaurant], food[Italian], priceRange[cheap], customer rating[5 out of 5], area[riverside], familyFriendly[yes], near[Rainbow Vegetarian Café]"	The Punter is a family friendly restaurant located close to the Rainbow Vegetarian Café . It has low prices and a customer rating of 5 out of 5 .
"name[The Punter], eatType[restaurant], food[Italian], priceRange[cheap], customer rating[average], area[city centre], familyFriendly[no], near[Rainbow Vegetarian Café]"	The Punter is a cheap , average Italian restaurant located in the city centre near Rainbow Vegetarian Café . It is not family - friendly .
"name[The Punter], eatType[restaurant], food[Italian], priceRange[cheap], customer rating[average], area[city centre], familyFriendly[yes], near[Rainbow Vegetarian Café]"	The Punter is a cheap , family - friendly Italian restaurant in the center of the city near Rainbow Vegetarian Café . It is rated average and is rated average .
"name[The Punter], eatType[restaurant], food[Italian], priceRange[cheap], customer rating[average], area[riverside], familyFriendly[no], near[Rainbow Vegetarian Café]"	You can get cheap Italian food at The Punter in the riverside area near the Rainbow Vegetarian Café . Unfortunately it is not family - friendly and has an average customer rating .
"name[The Punter], eatType[restaurant], food[Italian], priceRange[cheap], customer rating[average], area[riverside], familyFriendly[yes], near[Rainbow Vegetarian Café]"	The Punter is a restaurant providing drinks and desserts in the low price range . It is located near Rainbow Vegetarian Café and desserts .
"name[The Punter], eatType[restaurant], food[Italian], priceRange[high], customer rating[1 out of 5], area[city centre], familyFriendly[no], near[Rainbow Vegetarian Café]"	The Punter is a casual restaurant near the Rainbow Vegetarian Café in the city centre . It is not a children friendly , expensive and rated one out of five , serving Italian food .
"name[The Punter], eatType[restaurant], food[Italian], priceRange[high], customer rating[1 out of 5], area[city centre], familyFriendly[yes], near[Rainbow Vegetarian Café]"	In the city centre near Rainbow Vegetarian Café there is a high priced Italian restaurant called The Punter . It is family - friendly and has one out of five stars .
"name[The Punter], eatType[restaurant], food[Italian], priceRange[high], customer rating[1 out of 5], area[riverside], familyFriendly[no], near[Rainbow Vegetarian Café]"	The Punter is a high priced Italian restaurant near Rainbow Vegetarian Café . It is not children friendly and has a customer rating of 1 out of 5 .
"name[The Punter], eatType[restaurant], food[Italian], priceRange[high], customer rating[1 out of 5], area[riverside], familyFriendly[yes], near[Rainbow Vegetarian Café]"	The Punter is a high priced family friendly Italian restaurant in the riverside area near Rainbow Vegetarian Café with a customer rating of 1 out of 5 .
"name[The Vaults], eatType[pub], food[French], priceRange[high], area[riverside], familyFriendly[yes], near[Raja Indian Cuisine]"	The Vaults is a pub serving French food . It is children friendly . Located in the riverside area , close to Raja Indian Cuisine .
"name[The Vaults], eatType[pub], food[French], priceRange[less than £20], area[city centre], familyFriendly[no], near[Raja Indian Cuisine]"	The Vaults is a pub that offers good prices . It is located near Raja Indian Cuisine in the city centre .
"name[The Vaults], eatType[pub], food[French], priceRange[less than £20], area[city centre], familyFriendly[yes], near[Raja Indian Cuisine]"	You can find The Vaults , a family - friendly French cuisine pub in the city centre near Raja Indian Cuisine . It is inexpensive .
"name[The Vaults], eatType[pub], food[French], priceRange[less than £20], area[riverside], familyFriendly[no], near[Raja Indian Cuisine]"	For less than £ 20 you can get good French unfriendly at The Vaults pub . It is located near Raja Indian Cuisine in the riverside area . The prices are less than £ 20 . The Vaults is not a family - friendly pub .
"name[The Vaults], eatType[pub], food[French], priceRange[less than £20], area[riverside], familyFriendly[yes], near[Raja Indian Cuisine]"	The Vaults is a family friendly pub that features Asian food and wine . It is located next to Raja Indian Cuisine .
"name[The Vaults], eatType[pub], food[French], priceRange[moderate], area[city centre], familyFriendly[no], near[Raja Indian Cuisine]"	The Vaults is a French pub in the city centre near Raja Indian Cuisine . It has a moderate price range and is not kid friendly .
"name[The Vaults], eatType[pub], food[French], priceRange[moderate], area[city centre], familyFriendly[yes], near[Raja Indian Cuisine]"	The Vaults is a kid friendly pub that serves French food . It is located near Raja Indian Cuisine in the city centre . It 's bring a moderate price range .
"name[The Vaults], eatType[pub], food[French], priceRange[moderate], area[riverside], familyFriendly[no], near[Raja Indian Cuisine]"	The Vaults is a non - kid friendly pub with a moderate price range . It is located near Raja Indian Cuisine .
"name[The Vaults], eatType[pub], food[French], priceRange[moderate], area[riverside], familyFriendly[yes], near[Raja Indian Cuisine]"	The Vaults is a pub style restaurant located near Raja Indian Cuisine . It is moderately priced and family friendly .
"name[The Vaults], eatType[pub], food[French], priceRange[more than £30], area[city centre], familyFriendly[no], near[Raja Indian Cuisine]"	In the city centre near Raja Indian Cuisine is a pub that serves expensive French food called The Vaults . It is not child friendly .
"name[The Vaults], eatType[pub], food[French], priceRange[more than £30], area[city centre], familyFriendly[yes], near[Raja Indian Cuisine]"	The Vaults is a child friendly pub serving French food for more than £ 30 Located in the city center near Raja Indian Cuisine .
"name[The Vaults], eatType[pub], food[French], priceRange[more than £30], area[riverside], familyFriendly[no], near[Raja Indian Cuisine]"	If you are looking for a priced French pub in the riverside area , visit The Vaults . It is near Raja Indian Cuisine and is not children friendly .
"name[The Vaults], eatType[pub], food[French], priceRange[more than £30], area[riverside], familyFriendly[yes], near[Raja Indian Cuisine]"	In the riverside area near Raja Indian Cuisine is a children friendly pub called The Vaults that serves French food ranging more than £ 30 .
"name[The Vaults], eatType[pub], food[Indian], priceRange[£20-25], area[riverside], familyFriendly[yes], near[Raja Indian Cuisine]"	Highly rated Indian pub , The Vaults , is located near Raja Indian Cuisine in the riverside area . It is kid friendly and prices range from £ 20 - 25 .
"name[The Vaults], eatType[pub], food[Indian], priceRange[cheap], area[riverside], familyFriendly[yes], near[Raja Indian Cuisine]"	The Vaults is a kid friendly pub that serves cheap Indian food in the riverside area near Raja Indian Cuisine .
"name[The Vaults], eatType[pub], food[Indian], priceRange[high], area[city centre], familyFriendly[no], near[Raja Indian Cuisine]"	Near Raja Indian Cuisine there is a pub even selling Indian food called The Vaults . It is high priced and not family friendly .
"name[The Vaults], eatType[pub], food[Indian], priceRange[high], area[city centre], familyFriendly[yes], near[Raja Indian Cuisine]"	The Vaults is a pub that provides Indian food in the high price range . It is located in the city centre . It is near Raja Indian Cuisine .
"name[The Vaults], eatType[pub], food[Italian], priceRange[high], customer rating[average], area[city centre], familyFriendly[no], near[Rainbow Vegetarian Café]"	The Vaults is a pub that serves Italian food . It is located in the city centre near the Rainbow Vegetarian Café . It has an average customer rating and is not family - friendly .
"name[The Vaults], eatType[pub], food[Italian], priceRange[high], customer rating[average], area[city centre], familyFriendly[yes], near[Rainbow Vegetarian Café]"	The Vaults is a family - friendly pub that sells Italian food . It is located near Rainbow Vegetarian Café in the city centre . It has received average customer ratings .
"name[The Vaults], eatType[pub], food[Italian], priceRange[high], customer rating[average], area[riverside], familyFriendly[no], near[Rainbow Vegetarian Café]"	The Vaults is an Italian pub in the riverside area near Rainbow Vegetarian Café . It has a high price range and an average customer rating . It is not child friendly .
"name[The Vaults], eatType[pub], food[Italian], priceRange[high], customer rating[average], area[riverside], familyFriendly[yes], near[Rainbow Vegetarian Café]"	There is a high end pub near Rainbow Vegetarian Café called The Vaults . It serves meals at a good price and is family friendly .
"name[The Vaults], eatType[pub], food[Italian], priceRange[less than £20], customer rating[low], area[city centre], familyFriendly[no], near[Rainbow Vegetarian Café]"	Near Rainbow Vegetarian Café in the city centre is an Italian pub named The Vaults . It has a low customer rating and is not family - friendly .
"name[The Vaults], eatType[pub], food[Italian], priceRange[less than £20], customer rating[low], area[city centre], familyFriendly[yes], near[Rainbow Vegetarian Café]"	There is a family - friendly Italian pub in the city centre near Rainbow Vegetarian Café called The Vaults . It has a low customer rating and the price range is less than £ 20 .
"name[The Vaults], eatType[pub], food[Italian], priceRange[less than £20], customer rating[low], area[riverside], familyFriendly[no], near[Rainbow Vegetarian Café]"	Find something in the riverside area , come to The Vaults , a small Italian pub near the Rainbow Vegetarian Café . It is not children friendly and rated low .
"name[The Vaults], eatType[pub], food[Italian], priceRange[less than £20], customer rating[low], area[riverside], familyFriendly[yes], near[Rainbow Vegetarian Café]"	The Vaults is a family friendly pub located near Rainbow Vegetarian Café . It is rated 1 star .
"name[The Vaults], eatType[pub], food[Italian], priceRange[moderate], customer rating[1 out of 5], area[city centre], familyFriendly[no], near[Rainbow Vegetarian Café]"	The Vaults is an Italian pub near Rainbow Vegetarian Café . It is rated 1 out of 5 and is moderately priced . It is not kid friendly .
"name[The Vaults], eatType[pub], food[Italian], priceRange[moderate], customer rating[1 out of 5], area[city centre], familyFriendly[yes], near[Rainbow Vegetarian Café]"	The Vaults is a pub that serves Italian food . It is located in the city centre near Rainbow Vegetarian Café . It is kids friendly and has a customer rating of 1 out of 5 .
"name[The Vaults], eatType[pub], food[Italian], priceRange[moderate], customer rating[1 out of 5], area[riverside], familyFriendly[no], near[Rainbow Vegetarian Café]"	The Vaults is a pub that serves Italian food in the moderate price range . It is located in the riverside area near the Rainbow Vegetarian Café . It is not kids friendly and has a customer rating of 1 out of 5 .
"name[The Vaults], eatType[pub], food[Italian], priceRange[moderate], customer rating[1 out of 5], area[riverside], familyFriendly[yes], near[Rainbow Vegetarian Café]"	The Vaults is a family friendly pub offering traditional breakfast and is just north of the Rainbow Vegetarian Café .
"name[The Vaults], eatType[pub], food[Italian], priceRange[moderate], customer rating[3 out of 5], area[city centre], familyFriendly[no], near[Rainbow Vegetarian Café]"	There is an Italian pub named The Vaults near Rainbow Vegetarian Café in the city centre . It has a customer rating of 3 out of 5 and is moderately priced . It is not kid friendly .
"name[The Vaults], eatType[pub], food[Italian], priceRange[moderate], customer rating[3 out of 5], area[city centre], familyFriendly[yes], near[Rainbow Vegetarian Café]"	The Vaults is an Italian pub located in the city centre near Rainbow Vegetarian Café . It has a customer rating of 3 out of 5 and is kid friendly .
"name[The Vaults], eatType[pub], food[Italian], priceRange[moderate], customer rating[3 out of 5], area[riverside], familyFriendly[no], near[Rainbow Vegetarian Café]"	Look to The Vaults , a moderately priced Italian pub near the Rainbow Vegetarian Café . It is not cater to children . Customers have rated it 3 out of 5 .
"name[The Vaults], eatType[pub], food[Italian], priceRange[moderate], customer rating[3 out of 5], area[riverside], familyFriendly[yes], near[Rainbow Vegetarian Café]"	The Vaults is a moderately priced pub with 3 out of 5 stars . It is located near Rainbow Vegetarian Café .
"name[The Vaults], eatType[pub], food[Italian], priceRange[more than £30], customer rating[high], area[city centre], familyFriendly[no], near[Rainbow Vegetarian Café]"	Located near Rainbow Vegetarian Café you will find The Vaults . It is a highly rated child friendly pub offering menu items for more than £ 30 . Located in the city centre area .
"name[The Vaults], eatType[pub], food[Italian], priceRange[more than £30], customer rating[high], area[city centre], familyFriendly[yes], near[Rainbow Vegetarian Café]"	The Vaults is a children friendly pub located in the city centre near Rainbow Vegetarian Café . It offers expensive Italian food .
"name[The Vaults], eatType[pub], food[Italian], priceRange[more than £30], customer rating[high], area[riverside], familyFriendly[no], near[Rainbow Vegetarian Café]"	Located in the riverside area near Rainbow Vegetarian Café , The Vaults is an Italian pub with a high customer rating and a price range of more than £ 30 . It is not children friendly .
"name[The Vaults], eatType[pub], food[Italian], priceRange[more than £30], customer rating[high], area[riverside], familyFriendly[yes], near[Rainbow Vegetarian Café]"	The Vaults is located close to the River and Rainbow Vegetarian Café . It is an expensive five star family friendly pub serving traditional pasta .
"name[The Vaults], eatType[pub], food[Japanese], priceRange[£20-25], customer rating[3 out of 5], area[city centre], familyFriendly[no], near[Rainbow Vegetarian Café]"	The Vaults is a moderately priced pub that serves Japanese food in the city centre near Rainbow Vegetarian Café . It is not children friendly and has a customer rating of 3 out of 5 .
"name[The Vaults], eatType[pub], food[Japanese], priceRange[£20-25], customer rating[3 out of 5], area[city centre], familyFriendly[yes], near[Rainbow Vegetarian Café]"	The Vaults is a kids friendly Japanese pub in the city centre near Rainbow Vegetarian Café . It has 3 out of 5 customer rating and ranges between £ 20 - 25 .
"name[The Vaults], eatType[pub], food[Japanese], priceRange[£20-25], customer rating[3 out of 5], area[riverside], familyFriendly[no], near[Rainbow Vegetarian Café]"	The Vaults is a pub serving 5 priced sushi . It is located nearby the Rainbow Vegetarian Café .
"name[The Vaults], eatType[pub], food[Japanese], priceRange[£20-25], customer rating[3 out of 5], area[riverside], familyFriendly[yes], near[Rainbow Vegetarian Café]"	The Vaults is a low priced pub that serves oriental food . It is family friendly and has a 3 star rating . It is located near the Rainbow Vegetarian Café .
"name[The Vaults], eatType[pub], food[Japanese], priceRange[£20-25], customer rating[high], area[city centre], familyFriendly[no], near[Rainbow Vegetarian Café]"	The Vaults is a highly recommended moderately priced pub that serves Japanese food . It is not kid friendly and is located in the city centre near Rainbow Vegetarian Café .
"name[The Vaults], eatType[pub], food[Japanese], priceRange[£20-25], customer rating[high], area[city centre], familyFriendly[yes], near[Rainbow Vegetarian Café]"	There is a high priced pub The Vaults located in the city centre near Rainbow Vegetarian Café . It is kids friendly and serve Japanese food .
"name[The Vaults], eatType[pub], food[Japanese], priceRange[£20-25], customer rating[high], area[riverside], familyFriendly[no], near[Rainbow Vegetarian Café]"	Near the Rainbow Vegetarian Café is a pub called The Vaults . It serves Japanese food and is not kid friendly . It has a high customer rating and a price range of 20 - 25 pounds .
"name[The Vaults], eatType[pub], food[Japanese], priceRange[£20-25], customer rating[high], area[riverside], familyFriendly[no], near[Raja Indian Cuisine]"	The Vaults is a highly rated Japanese pub in the river side near Raja Indian Cuisine . It is not kid friendly and has a price range of £ 20 - 25 .
"name[The Vaults], eatType[pub], food[Japanese], priceRange[£20-25], customer rating[high], area[riverside], familyFriendly[yes], near[Raja Indian Cuisine]"	The Vaults is a well fair pub located next to Raja Indian Cuisine .
"name[The Vaults], eatType[pub], food[Japanese], priceRange[cheap], customer rating[5 out of 5], area[city centre], familyFriendly[no], near[Raja Indian Cuisine]"	There is a cheap pub The Vaults located in the city centre near Raja Indian Cuisine . It offers Japanese food and has a customer rating of 5 out of 5 .
"name[The Vaults], eatType[pub], food[Japanese], priceRange[cheap], customer rating[5 out of 5], area[city centre], familyFriendly[yes], near[Raja Indian Cuisine]"	The Vaults is a family - friendly pub serving Japanese food in the city centre near Raja Indian Cuisine . It has a consumer rating of 5 out of 5 .
"name[The Vaults], eatType[pub], food[Japanese], priceRange[cheap], customer rating[5 out of 5], area[riverside], familyFriendly[no], near[Raja Indian Cuisine]"	The Vaults is a pub located in the city centre near Raja Indian Cuisine . It offers affordable Japanese food and has received a 5 out of 5 customer rating .
"name[The Vaults], eatType[pub], food[Japanese], priceRange[cheap], customer rating[5 out of 5], area[riverside], familyFriendly[yes], near[Raja Indian Cuisine]"	The Vaults is a well rated , family friendly pub that offers sushi at cheap prices . It is located near Raja Indian Cuisine .
"name[The Vaults], eatType[pub], food[Japanese], priceRange[high], customer rating[3 out of 5], area[city centre], familyFriendly[no], near[Raja Indian Cuisine]"	In the city centre near Raja Indian Cuisine is a great Japanese pub named The Vaults . It is not family - friendly and has a customer rating of 3 out of 5 .
"name[The Vaults], eatType[pub], food[Japanese], priceRange[high], customer rating[3 out of 5], area[city centre], familyFriendly[yes], near[Raja Indian Cuisine]"	The Vaults is a Japanese pub in the city centre near Raja Indian Cuisine . It has a customer rating of 3 out of 5 and is children friendly .
"name[The Vaults], eatType[pub], food[Japanese], priceRange[high], customer rating[3 out of 5], area[riverside], familyFriendly[no], near[Raja Indian Cuisine]"	In the riverside area near Raja Indian Cuisine is a pub called The Vaults that serves Japanese food . It is not kids friendly and has a customer rating of 3 out of 5 .
"name[The Vaults], eatType[pub], food[Japanese], priceRange[high], customer rating[3 out of 5], area[riverside], familyFriendly[yes], near[Raja Indian Cuisine]"	There is a kids friendly pub serving high priced Japanese food in the riverside area near Raja Indian Cuisine with a customer rating of 3 out of 5 called The Vaults .
"name[The Vaults], eatType[pub], food[Japanese], priceRange[less than £20], customer rating[average], area[city centre], familyFriendly[no], near[Raja Indian Cuisine]"	Located in the city centre near Raja Indian Cuisine , The Vaults is a Japanese pub with prices less than £ 20 . It has average customer ratings and is not family - friendly .
"name[The Vaults], eatType[pub], food[Japanese], priceRange[less than £20], customer rating[average], area[city centre], familyFriendly[yes], near[Raja Indian Cuisine]"	In the city centre near Raja Indian Cuisine is a 3 star affordable Japanese bar called The Vaults .
"name[The Vaults], eatType[pub], food[Japanese], priceRange[less than £20], customer rating[average], area[riverside], familyFriendly[no], near[Raja Indian Cuisine]"	The Vaults is a pub that serves Japanese style food . It is located in the riverside area near Raja Indian Cuisine . It has an average customer rating and is not bring the kid friendly . The price range is less than £ 20 .
"name[The Vaults], eatType[pub], food[Japanese], priceRange[less than £20], customer rating[average], area[riverside], familyFriendly[yes], near[Raja Indian Cuisine]"	The Vaults is a low priced , family friendly pub with average ratings . It is located near Raja Indian Cuisine .
"name[The Vaults], eatType[pub], food[Japanese], priceRange[less than £20], customer rating[low], area[city centre], familyFriendly[no], near[Raja Indian Cuisine]"	The Vaults is a Japanese pub near Raja Indian Cuisine in the city centre . It has a low customer rating and is not children friendly . The price range is less than £ 20 .
"name[The Vaults], eatType[pub], food[Japanese], priceRange[less than £20], customer rating[low], area[city centre], familyFriendly[yes], near[Raja Indian Cuisine]"	Located in the city centre near Raja Indian Cuisine , The Vaults is a family - friendly Japanese pub known for less than £ 20 with a low customer rating .
"name[The Vaults], eatType[pub], food[Japanese], priceRange[less than £20], customer rating[low], area[riverside], familyFriendly[no], near[Raja Indian Cuisine]"	The Vaults is a pub that serves Japanese cuisine for less than £ 20 . It is not family - friendly and has low customer reviews . It is located in the riverside area near Raja Indian Cuisine .
"name[The Vaults], eatType[pub], food[Japanese], priceRange[less than £20], customer rating[low], area[riverside], familyFriendly[yes], near[Raja Indian Cuisine]"	The Vaults is a family friendly pub also serving Japanese food at reasonable prices . It is located on the riverside near Raja Indian Cuisine and has a low customer rating .
"name[The Vaults], eatType[pub], food[Japanese], priceRange[moderate], customer rating[1 out of 5], area[city centre], familyFriendly[no], near[Raja Indian Cuisine]"	The Vaults is a pub offering moderately priced Japanese food in the city centre near Raja Indian Cuisine . It has a customer rating of 1 out of 5 and is not kids friendly .
"name[The Vaults], eatType[pub], food[Japanese], priceRange[moderate], customer rating[1 out of 5], area[city centre], familyFriendly[yes], near[Raja Indian Cuisine]"	The Vaults is a family - friendly pub serving Japanese food around the city centre near Raja Indian Cuisine . It cost around moderate euros .
"name[The Vaults], eatType[restaurant], food[French], priceRange[high], area[riverside], familyFriendly[yes], near[Raja Indian Cuisine]"	The Vaults is a children friendly restaurant in the riverside area near Raja Indian Cuisine . It serves French food and has a high price range .
"name[The Vaults], eatType[restaurant], food[French], priceRange[less than £20], area[city centre], familyFriendly[no], near[Raja Indian Cuisine]"	The Vaults is a French restaurant located in the city centre near Raja Indian Cuisine . It has good prices and is not family - friendly .
"name[The Vaults], eatType[restaurant], food[French], priceRange[less than £20], area[city centre], familyFriendly[yes], near[Raja Indian Cuisine]"	The Vaults is a restaurant located in the city centre near Raja Indian Cuisine . They serve French food for less than £ 20 and are kids friendly .
"name[The Vaults], eatType[restaurant], food[French], priceRange[less than £20], area[riverside], familyFriendly[no], near[Raja Indian Cuisine]"	The Vaults is a French restaurant with prices less than £ 20 . It is not kids friendly and can be found in the riverside area near Raja Indian Cuisine .
"name[The Vaults], eatType[restaurant], food[French], priceRange[less than £20], area[riverside], familyFriendly[yes], near[Raja Indian Cuisine]"	The Vaults is a family friendly French restaurant situated on the riverside near Raja Indian Cuisine with prices less than £ 20 .
"name[The Vaults], eatType[restaurant], food[French], priceRange[moderate], area[city centre], familyFriendly[no], near[Raja Indian Cuisine]"	The Vaults is a French restaurant in the center of the city near Raja Indian Cuisine . It has a moderate price range and is recommended for kids unfriendly .
"name[The Vaults], eatType[restaurant], food[French], priceRange[moderate], area[city centre], familyFriendly[yes], near[Raja Indian Cuisine]"	The Vaults is a restaurant serving French food at moderate prices . It is kid friendly and situated near Raja Indian Cuisine in the city centre .
"name[The Vaults], eatType[restaurant], food[French], priceRange[moderate], area[riverside], familyFriendly[no], near[Raja Indian Cuisine]"	The Vaults is a no family - friendly restaurant providing French food . It is located in riverside near Raja Indian Cuisine .
"name[The Vaults], eatType[restaurant], food[French], priceRange[moderate], area[riverside], familyFriendly[yes], near[Raja Indian Cuisine]"	The Vaults is a mid - priced family friendly restaurant that offers French food . It is located near Raja Indian Cuisine .
"name[The Vaults], eatType[restaurant], food[French], priceRange[more than £30], area[city centre], familyFriendly[no], near[Raja Indian Cuisine]"	In the city centre near Raja Indian Cuisine is a French restaurant called The Vaults . It is not family - friendly and has a price range of more than £ 30 .
"name[The Vaults], eatType[restaurant], food[French], priceRange[more than £30], area[city centre], familyFriendly[yes], near[Raja Indian Cuisine]"	There is a children friendly French food restaurant named The Vaults in the city centre near Raja Indian Cuisine with a price range of more than £ 30 .
"name[The Vaults], eatType[restaurant], food[French], priceRange[more than £30], area[riverside], familyFriendly[no], near[Raja Indian Cuisine]"	The Vaults is a French restaurant in the riverside area near Raja Indian Cuisine . It is not a good place to take your kids to costs more than £ 30 .
"name[The Vaults], eatType[restaurant], food[French], priceRange[more than £30], area[riverside], familyFriendly[yes], near[Raja Indian Cuisine]"	The Vaults is a French child friendly restaurant in the riverside area near Raja Indian Cuisine with a price range of more than £ 30 .
"name[The Vaults], eatType[restaurant], food[Indian], priceRange[£20-25], area[riverside], familyFriendly[yes], near[Raja Indian Cuisine]"	Located near Raja Indian Cuisine , The Vaults is a kid friendly Indian restaurant . Prices range from £ 20 - 25 .
"name[The Vaults], eatType[restaurant], food[Indian], priceRange[cheap], area[riverside], familyFriendly[yes], near[Raja Indian Cuisine]"	There is a restaurant called The Vaults providing Indian food in the cheap price range . It is located in the riverside area near Raja Indian Cuisine .
"name[The Vaults], eatType[restaurant], food[Indian], priceRange[high], area[city centre], familyFriendly[no], near[Raja Indian Cuisine]"	The Vaults serves Indian food at a high price . It is a restaurant though it is not family friendly . It is located in the town center near Raja Indian Cuisine .
"name[The Vaults], eatType[restaurant], food[Indian], priceRange[high], area[city centre], familyFriendly[yes], near[Raja Indian Cuisine]"	The Vaults is an expensive Indian restaurant in the city centre near Raja Indian Cuisine . It is child friendly .
"name[The Waterman], eatType[pub], food[Indian], priceRange[high], area[city centre], familyFriendly[yes], near[Raja Indian Cuisine]"	The Waterman is a pub that serves Indian food in the high price range . It is children friendly and is located in the city centre near Raja Indian Cuisine .
"name[The Waterman], eatType[pub], food[Indian], priceRange[high], area[riverside], familyFriendly[no], near[Raja Indian Cuisine]"	The Waterman is a high priced pub that serves Indian cuisine . It is not considered kid friendly and is located in the riverside area near Raja Indian Cuisine .
"name[The Waterman], eatType[pub], food[Indian], priceRange[high], area[riverside], familyFriendly[yes], near[Raja Indian Cuisine]"	The Waterman is a children friendly Indian pub near Raja Indian Cuisine . Right in the riverside area , it is expensive and around the place for children .
"name[The Waterman], eatType[pub], food[Indian], priceRange[less than £20], area[city centre], familyFriendly[no], near[Raja Indian Cuisine]"	The Waterman is an Indian pub in the city centre near Raja Indian Cuisine . It has prices less than 20 pounds and is not family friendly .
"name[The Waterman], eatType[pub], food[Indian], priceRange[less than £20], area[city centre], familyFriendly[yes], near[Raja Indian Cuisine]"	The Waterman is an affordable Indian pub located in the city centre near Raja Indian Cuisine . It is suitable for families .
"name[The Waterman], eatType[pub], food[Indian], priceRange[less than £20], area[riverside], familyFriendly[no], near[Raja Indian Cuisine]"	In the riverside area near Raja Indian Cuisine is an Indian pub named The Waterman . It is not family friendly and prices are less than £ 20 .
"name[The Waterman], eatType[pub], food[Indian], priceRange[less than £20], area[riverside], familyFriendly[yes], near[Raja Indian Cuisine]"	The Waterman is a family friendly pub serving Indian food for less than £ 20 . It can be found in the riverside area near Raja Indian Cuisine .
"name[The Waterman], eatType[pub], food[Indian], priceRange[moderate], area[city centre], familyFriendly[no], near[Raja Indian Cuisine]"	Near Raja Indian Cuisine in the center of the city is a moderately priced Indian pub , The Waterman . It is known for being kid friendly .
"name[The Waterman], eatType[pub], food[Indian], priceRange[moderate], area[city centre], familyFriendly[yes], near[Raja Indian Cuisine]"	The Waterman is a family friendly Indian pub in the town centre near Raja Indian Cuisine . It has moderate price ranges .
"name[The Waterman], eatType[pub], food[Indian], priceRange[moderate], area[riverside], familyFriendly[no], near[Raja Indian Cuisine]"	Welcome to The Waterman , a pub that serves Indian food at moderate prices . It is located in the riverside area near Raja Indian Cuisine and is not family friendly .
"name[The Waterman], eatType[pub], food[Indian], priceRange[moderate], area[riverside], familyFriendly[yes], near[Raja Indian Cuisine]"	The Waterman is a moderately priced Indian pub in Riverside near Raja Indian Cuisine . It is kid friendly .
"name[The Waterman], eatType[pub], food[Indian], priceRange[more than £30], area[riverside], familyFriendly[yes], near[Raja Indian Cuisine]"	The Waterman is a kid friendly pub in the riverside area near Raja Indian Cuisine that serves Indian food for more than £ 30 .
"name[The Waterman], eatType[pub], food[Italian], priceRange[£20-25], area[riverside], familyFriendly[yes], near[Raja Indian Cuisine]"	The Waterman is a children friendly Italian pub near Raja Indian Cuisine in the riverside area . It has pricing of 20 - 25 pounds .
"name[The Waterman], eatType[pub], food[Italian], priceRange[cheap], area[riverside], familyFriendly[yes], near[Raja Indian Cuisine]"	Located in the riverside area near Raja Indian Cuisine is a family friendly pub called The Waterman that serves cheap Italian food .
"name[The Waterman], eatType[pub], food[Italian], priceRange[high], area[city centre], familyFriendly[no], near[Raja Indian Cuisine]"	The Waterman is a low - priced restaurant in the city centre that delivers take - away . It is located near Raja Indian Cuisine .
"name[The Waterman], eatType[pub], food[Italian], priceRange[high], area[city centre], familyFriendly[yes], near[Raja Indian Cuisine]"	Located in the city centre near Raja Indian Cuisine , The Waterman serves high priced Italian food in a family - friendly environment .
"name[The Waterman], eatType[pub], food[Italian], priceRange[high], area[riverside], familyFriendly[no], near[Raja Indian Cuisine]"	The Waterman is a pricey pub located near Raja Indian Cuisine .
"name[The Waterman], eatType[pub], food[Italian], priceRange[high], area[riverside], familyFriendly[yes], near[Raja Indian Cuisine]"	The Waterman is located on the Thames near Raja Indian Cuisine . It is a kid friendly highly rated pub offering Italian cuisine .
"name[The Waterman], eatType[pub], food[Italian], priceRange[less than £20], area[city centre], familyFriendly[no], near[Raja Indian Cuisine]"	The Waterman is an adult only Italian pub in the city centre near Raja Indian Cuisine with a price range of less than £ 20 .
"name[The Waterman], eatType[pub], food[Italian], priceRange[less than £20], area[city centre], familyFriendly[yes], near[Raja Indian Cuisine]"	The Waterman is a good Italian pub in the city centre near Raja Indian Cuisine . It is family - friendly and has great prices .
"name[The Waterman], eatType[pub], food[Italian], priceRange[less than £20], area[riverside], familyFriendly[no], near[Raja Indian Cuisine]"	For cheap Italian food in the riverside area , visit The Waterman . It is not family - friendly and is near Raja Indian Cuisine .
"name[The Waterman], eatType[restaurant], food[Indian], priceRange[high], area[city centre], familyFriendly[yes], near[Raja Indian Cuisine]"	The Waterman is an expensive , family friendly Indian restaurant in the city centre near Raja Indian Cuisine .
"name[The Waterman], eatType[restaurant], food[Indian], priceRange[high], area[riverside], familyFriendly[no], near[Raja Indian Cuisine]"	In the riverside area , near Raja Indian Cuisine , is the Indian restaurant known as The Waterman . It has high prices and does not welcome children .
"name[The Waterman], eatType[restaurant], food[Indian], priceRange[high], area[riverside], familyFriendly[yes], near[Raja Indian Cuisine]"	Serving Indian food at a high price range , The Waterman is a child friendly restaurant in the riverside area near Raja Indian Cuisine .
"name[The Waterman], eatType[restaurant], food[Indian], priceRange[less than £20], area[city centre], familyFriendly[no], near[Raja Indian Cuisine]"	The Waterman is an Indian restaurant with prices less than £ 20 . It is not family friendly and is located in the city center near Raja Indian Cuisine .
"name[The Waterman], eatType[restaurant], food[Indian], priceRange[less than £20], area[city centre], familyFriendly[yes], near[Raja Indian Cuisine]"	In the city centre near Raja Indian Cuisine is a low priced Indian restaurant called The Waterman . It is family friendly .
"name[The Waterman], eatType[restaurant], food[Indian], priceRange[less than £20], area[riverside], familyFriendly[no], near[Raja Indian Cuisine]"	The Waterman is an inexpensive Indian restaurant in the riverside area near Raja Indian Cuisine . It is not family friendly .
"name[The Waterman], eatType[restaurant], food[Indian], priceRange[less than £20], area[riverside], familyFriendly[yes], near[Raja Indian Cuisine]"	Located in riverside near Raja Indian Cuisine , The Waterman is an Indian restaurant that provides a family friendly atmosphere for less than 20 pounds .
"name[The Waterman], eatType[restaurant], food[Indian], priceRange[moderate], area[city centre], familyFriendly[no], near[Raja Indian Cuisine]"	The Waterman is a restaurant providing Indian food in the moderate price range . It is located in the city centre . It is near Raja Indian Cuisine .
"name[The Waterman], eatType[restaurant], food[Indian], priceRange[moderate], area[city centre], familyFriendly[yes], near[Raja Indian Cuisine]"	The Waterman is a moderately priced restaurant selling Indian food in the city centre near Raja Indian Cuisine . It is kid friendly .
"name[The Waterman], eatType[restaurant], food[Indian], priceRange[moderate], area[riverside], familyFriendly[no], near[Raja Indian Cuisine]"	Located in the riverside area near Raja Indian Cuisine , The Waterman is a restaurant offering moderately priced Indian food . It is not kid friendly .
"name[The Waterman], eatType[restaurant], food[Indian], priceRange[moderate], area[riverside], familyFriendly[yes], near[Raja Indian Cuisine]"	In the riverside area near Raja Indian Cuisine is an Indian restaurant called The Waterman . It has a moderate price range and is kid friendly .
"name[The Waterman], eatType[restaurant], food[Indian], priceRange[more than £30], area[riverside], familyFriendly[yes], near[Raja Indian Cuisine]"	Expensive Indian food restaurant called The Waterman offers kid friendly atmosphere in the riverside area near Raja Indian Cuisine .
"name[The Waterman], eatType[restaurant], food[Italian], priceRange[£20-25], area[riverside], familyFriendly[yes], near[Raja Indian Cuisine]"	The Waterman is a kid friendly Italian restaurant in the riverside area near Raja Indian Cuisine with a price range of 20 - 25 pounds .
"name[The Waterman], eatType[restaurant], food[Italian], priceRange[cheap], area[riverside], familyFriendly[yes], near[Raja Indian Cuisine]"	The Waterman is a cheap , family friend Italian restaurant in the riverside area near Raja Indian Cuisine .
"name[The Waterman], eatType[restaurant], food[Italian], priceRange[high], area[city centre], familyFriendly[no], near[Raja Indian Cuisine]"	In the center of the city near Raja Indian Cuisine is an Italian restaurant called The Waterman . It has a high price range and is not children friendly .
"name[The Waterman], eatType[restaurant], food[Italian], priceRange[high], area[city centre], familyFriendly[yes], near[Raja Indian Cuisine]"	A great place named The Waterman Located in the town centre near Raja Indian Cuisine is a child friendly environment with high prices .
"name[The Waterman], eatType[restaurant], food[Italian], priceRange[high], area[riverside], familyFriendly[no], near[Raja Indian Cuisine]"	Near Raja Indian Cuisine in the riverside area is an Italian restaurant named The Waterman . It is not children unfriendly and has a high price range .
"name[The Waterman], eatType[restaurant], food[Italian], priceRange[high], area[riverside], familyFriendly[yes], near[Raja Indian Cuisine]"	The Waterman is a children friendly restaurant serving Italian food . It is situated near Raja Indian Cuisine and has a high price range .
"name[The Waterman], eatType[restaurant], food[Italian], priceRange[less than £20], area[city centre], familyFriendly[no], near[Raja Indian Cuisine]"	The Waterman is a low priced Italian restaurant in the city centre near Raja Indian Cuisine with prices less than £ 20 . It is not family - friendly .
"name[The Waterman], eatType[restaurant], food[Italian], priceRange[less than £20], area[city centre], familyFriendly[yes], near[Raja Indian Cuisine]"	In the city centre near Raja Indian Cuisine is a family - friendly Italian restaurant with a price range of less than 20 pounds called The Waterman .
"name[The Waterman], eatType[restaurant], food[Italian], priceRange[less than £20], area[riverside], familyFriendly[no], near[Raja Indian Cuisine]"	The Waterman is an Italian restaurant near Raja Indian Cuisine in riverside . It is adults only and prices are less than 20 pounds .
"name[The Wrestlers], eatType[pub], food[Italian], priceRange[less than £20], area[riverside], familyFriendly[no], near[Raja Indian Cuisine]"	The Wrestlers pub serves Italian food in the riverside area near Raja Indian Cuisine . It is not family - friendly and has a price range of less than £ 20 .
"name[The Wrestlers], eatType[pub], food[Italian], priceRange[less than £20], area[riverside], familyFriendly[yes], near[Raja Indian Cuisine]"	The Wrestlers is a family friendly Italian pub in the riverside area near Raja Indian Cuisine . However , it has a price range of less than 20 euros .
"name[The Wrestlers], eatType[pub], food[Italian], priceRange[moderate], area[city centre], familyFriendly[no], near[Raja Indian Cuisine]"	The Wrestlers is an adults only Italian pub located in the city centre near Raja Indian Cuisine . It is moderately priced .
"name[The Wrestlers], eatType[pub], food[Italian], priceRange[moderate], area[city centre], familyFriendly[yes], near[Raja Indian Cuisine]"	The Wrestlers is a pub serving Italian food in the city centre near Raja Indian Cuisine . It is kid friendly and also has a moderate price range .
"name[The Wrestlers], eatType[pub], food[Italian], priceRange[moderate], area[riverside], familyFriendly[no], near[Raja Indian Cuisine]"	The Wrestlers pub sells Italian food in the riverside area near Raja Indian Cuisine . It has a moderate price range and kids are not allowed .
"name[The Wrestlers], eatType[pub], food[Italian], priceRange[moderate], area[riverside], familyFriendly[yes], near[Raja Indian Cuisine]"	Found near Raja Indian Cuisine , The Wrestlers is a good family friendly pub .
"name[The Wrestlers], eatType[pub], food[Italian], priceRange[more than £30], area[riverside], familyFriendly[yes], near[Raja Indian Cuisine]"	There is a child friendly pub named The Wrestlers in the riverside area near Raja Indian Cuisine . It serves Italian food and ranges more than £ 30 .
"name[The Wrestlers], eatType[pub], food[Japanese], priceRange[£20-25], area[riverside], familyFriendly[yes], near[Raja Indian Cuisine]"	In the riverside area near Raja Indian Cuisine is a kid friendly pub called The Wrestlers . It serves Japanese food and has a price range of £ 20 - 25 .
"name[The Wrestlers], eatType[pub], food[Japanese], priceRange[cheap], area[riverside], familyFriendly[yes], near[Raja Indian Cuisine]"	In the riverside area near Raja Indian Cuisine is a cheap family friendly Japanese pub named The Wrestlers .
"name[The Wrestlers], eatType[pub], food[Japanese], priceRange[high], area[riverside], familyFriendly[yes], near[Raja Indian Cuisine]"	The Wrestlers is a Japanese pub with a high price range . It can be found in the riverside area close to Raja Indian Cuisine .
"name[The Wrestlers], eatType[pub], food[Japanese], priceRange[less than £20], area[city centre], familyFriendly[no], near[Raja Indian Cuisine]"	The Wrestlers is a pub serving Japanese food in the city center near Raja Indian Cuisine . It is not family - friendly and the price range is less than £ 20 .
"name[The Wrestlers], eatType[pub], food[Japanese], priceRange[less than £20], area[city centre], familyFriendly[yes], near[Raja Indian Cuisine]"	Take your family to The Wrestlers . It is a Japanese pub located near Raja Indian Cuisine in the city centre .
"name[The Wrestlers], eatType[pub], food[Japanese], priceRange[less than £20], area[riverside], familyFriendly[no], near[Raja Indian Cuisine]"	The Wrestlers pub is not family - friendly and offers Japanese food for less than £ 20 . It is located in the riverside area near Raja Indian Cuisine .
"name[The Wrestlers], eatType[pub], food[Japanese], priceRange[less than £20], area[riverside], familyFriendly[yes], near[Raja Indian Cuisine]"	The Wrestlers is a family friendly pub that offers Japanese food for less than £ 20 . It is located in the riverside area near Raja Indian Cuisine .
"name[The Wrestlers], eatType[pub], food[Japanese], priceRange[moderate], area[city centre], familyFriendly[no], near[Raja Indian Cuisine]"	The Wrestlers is a Japanese pub placed in the city centre near Raja Indian Cuisine . It has a moderate price range and is not kids friendly .
"name[The Wrestlers], eatType[pub], food[Japanese], priceRange[moderate], area[city centre], familyFriendly[yes], near[Raja Indian Cuisine]"	The Wrestlers is a kid friendly Japanese pub in the city centre near Raja Indian Cuisine with moderate prices .
"name[The Wrestlers], eatType[pub], food[Japanese], priceRange[moderate], area[riverside], familyFriendly[no], near[Raja Indian Cuisine]"	The Wrestlers is a Japanese pub near Raja Indian Cuisine in riverside . It is adults only and has a moderate price range .
"name[The Wrestlers], eatType[pub], food[Japanese], priceRange[moderate], area[riverside], familyFriendly[yes], near[Raja Indian Cuisine]"	The Wrestlers is a moderately priced pub that sells Japanese food . It is families in the riverside area near Raja Indian Cuisine and is children friendly .
"name[The Wrestlers], eatType[pub], food[Japanese], priceRange[moderate], customer rating[1 out of 5], area[city centre], familyFriendly[yes], near[Raja Indian Cuisine]"	The Wrestlers pub offers Japanese food in the city centre near Raja Indian Cuisine . It is kid friendly with a moderate price range and a customer rating of 1 out of 5 .
"name[The Wrestlers], eatType[pub], food[Japanese], priceRange[moderate], customer rating[1 out of 5], area[riverside], familyFriendly[no], near[Raja Indian Cuisine]"	The Wrestlers is a moderately priced Japanese pub with a 1 out of 5 rating for adults . It is located in the riverside area near Raja Indian Cuisine .
"name[The Wrestlers], eatType[pub], food[Japanese], priceRange[moderate], customer rating[1 out of 5], area[riverside], familyFriendly[yes], near[Raja Indian Cuisine]"	The Wrestlers pub offers low priced sushi and is located north of the city center . near Raja Indian Cuisine .
"name[The Wrestlers], eatType[pub], food[Japanese], priceRange[more than £30], area[city centre], familyFriendly[no], near[Raja Indian Cuisine]"	The Wrestlers is a Japanese pub in the city centre near Raja Indian Cuisine . It is priced more than £ 30 and is adult only .
"name[The Wrestlers], eatType[pub], food[Japanese], priceRange[more than £30], area[city centre], familyFriendly[yes], near[Raja Indian Cuisine]"	The Wrestlers is a children friendly pub serving Japanese food . It costs more than £ 30 and is located near Raja Indian Cuisine in the city centre .
"name[The Wrestlers], eatType[pub], food[Japanese], priceRange[more than £30], area[riverside], familyFriendly[no], near[Raja Indian Cuisine]"	The Wrestlers is an adults only pub offering Japanese food in the riverside area near Raja Indian Cuisine . It costs lower than £ 30 .
"name[The Wrestlers], eatType[pub], food[Japanese], priceRange[more than £30], area[riverside], familyFriendly[yes], near[Raja Indian Cuisine]"	Next to Raja Indian Cuisine on the river , The Wrestlers is a pub offering prices starting at £ 30 and Children are welcome .
"name[The Wrestlers], eatType[pub], food[Japanese], priceRange[more than £30], customer rating[5 out of 5], area[city centre], familyFriendly[no], near[Raja Indian Cuisine]"	The Wrestlers is a non child friendly Japanese pub in the city centre near Raja Indian Cuisine with a customer rating of 5 out of 5 and a price range of more than £ 30 .
"name[The Wrestlers], eatType[pub], food[Japanese], priceRange[more than £30], customer rating[5 out of 5], area[city centre], familyFriendly[yes], near[Raja Indian Cuisine]"	The Wrestlers is a pub serving Japanese food in the city centre near Raja Indian Cuisine . It is children friendly with a price range of more than £ 30 and a customer rating of 5 out of 5 .
"name[The Wrestlers], eatType[pub], food[Japanese], priceRange[more than £30], customer rating[5 out of 5], area[riverside], familyFriendly[no], near[Raja Indian Cuisine]"	The Wrestlers is a Japanese pub in the riverside area near Raja Indian Cuisine . It has a customer rating of 5 out of 5 and is not child friendly .
"name[The Wrestlers], eatType[pub], food[Japanese], priceRange[more than £30], customer rating[5 out of 5], area[riverside], familyFriendly[yes], near[Raja Indian Cuisine]"	The Wrestlers is an expensive , family friendly pub . It serves sushi and is located near Raja Indian Cuisine .
"name[The Wrestlers], eatType[pub], food[Japanese], priceRange[more than £30], customer rating[low], area[city centre], familyFriendly[no], near[Raja Indian Cuisine]"	The Wrestlers is a pub that provides Japanese food in the more than £ 30 price range . It is located in the city centre . It is near Raja Indian Cuisine . Its customer rating is low .
"name[The Wrestlers], eatType[pub], food[Japanese], priceRange[more than £30], customer rating[low], area[city centre], familyFriendly[yes], near[Raja Indian Cuisine]"	In the city centre near Raja Indian Cuisine is a child friendly Japanese pub called The Wrestlers . It has a low customer rating and cost starting at more than £ 30 .
"name[The Wrestlers], eatType[pub], food[Japanese], priceRange[more than £30], customer rating[low], area[riverside], familyFriendly[no], near[Raja Indian Cuisine]"	There is a Japanese pub called The Wrestlers in riverside near Raja Indian Cuisine . It has low customer ratings and is not child friendly . The price range is more than 30 euros .
"name[The Wrestlers], eatType[pub], food[Japanese], priceRange[more than £30], customer rating[low], area[riverside], familyFriendly[yes], near[Raja Indian Cuisine]"	The Wrestlers is a family friendly pub that serves higher priced Japanese food . It is located in the riverside area near Raja Indian Cuisine .
"name[The Wrestlers], eatType[restaurant], food[Italian], priceRange[less than £20], area[riverside], familyFriendly[no], near[Raja Indian Cuisine]"	The Wrestlers is a restaurant providing Italian meals in the low price range . It is located in the city centre near Raja Indian Cuisine .
"name[The Wrestlers], eatType[restaurant], food[Italian], priceRange[less than £20], area[riverside], familyFriendly[yes], near[Raja Indian Cuisine]"	The Wrestlers is a family friendly restaurant serving Italian food for less than £ 20 in the riverside area near Raja Indian Cuisine .
"name[The Wrestlers], eatType[restaurant], food[Italian], priceRange[moderate], area[city centre], familyFriendly[no], near[Raja Indian Cuisine]"	For moderate enjoy Italian food , The Wrestlers restaurant is located in the city centre near Raja Indian Cuisine . No kids allowed .
"name[The Wrestlers], eatType[restaurant], food[Italian], priceRange[moderate], area[city centre], familyFriendly[yes], near[Raja Indian Cuisine]"	The Wrestlers is an Italian restaurant in the city centre near Raja Indian Cuisine . It has a modest price range and is child friendly .
"name[The Wrestlers], eatType[restaurant], food[Italian], priceRange[moderate], area[riverside], familyFriendly[no], near[Raja Indian Cuisine]"	The Wrestlers is a moderately priced Italian restaurant in riverside near Raja Indian Cuisine . It is not kid friendly .
"name[The Wrestlers], eatType[restaurant], food[Italian], priceRange[moderate], area[riverside], familyFriendly[yes], near[Raja Indian Cuisine]"	The Wrestlers is a kid friendly Italian restaurant in Riverside near Raja Indian Cuisine . It is moderately priced .
"name[The Wrestlers], eatType[restaurant], food[Italian], priceRange[more than £30], area[riverside], familyFriendly[yes], near[Raja Indian Cuisine]"	The Wrestlers is a children friendly Italian restaurant in the riverside area near Raja Indian Cuisine with a price range of more than £ 30 .
"name[The Wrestlers], eatType[restaurant], food[Japanese], priceRange[£20-25], area[riverside], familyFriendly[yes], near[Raja Indian Cuisine]"	The Wrestlers is a kid friendly restaurant in the riverside area near Raja Indian Cuisine . They serve Japanese food for £ 20 - 25 .
"name[The Wrestlers], eatType[restaurant], food[Japanese], priceRange[cheap], area[riverside], familyFriendly[yes], near[Raja Indian Cuisine]"	The Wrestlers is a cheap , family friendly restaurant that serves Japanese food . It is located in the riverside area near Raja Indian Cuisine .
"name[The Wrestlers], eatType[restaurant], food[Japanese], priceRange[high], area[riverside], familyFriendly[yes], near[Raja Indian Cuisine]"	The Wrestlers is an expensive sushi restaurant located near Raja Indian Cuisine . It is family friendly .
"name[The Wrestlers], eatType[restaurant], food[Japanese], priceRange[less than £20], area[city centre], familyFriendly[no], near[Raja Indian Cuisine]"	The Wrestlers is a low priced Japanese restaurant in the city centre near Raja Indian Cuisine . It is not family - friendly .
"name[The Wrestlers], eatType[restaurant], food[Japanese], priceRange[less than £20], area[city centre], familyFriendly[yes], near[Raja Indian Cuisine]"	The Wrestlers is a restaurant providing Japanese food in the city center near Raja Indian Cuisine . It is family - friendly .
"name[The Wrestlers], eatType[restaurant], food[Japanese], priceRange[less than £20], area[riverside], familyFriendly[no], near[Raja Indian Cuisine]"	Located in the riverside area near Raja Indian Cuisine , The Wrestlers is a low priced Japanese restaurant .
"name[The Wrestlers], eatType[restaurant], food[Japanese], priceRange[less than £20], area[riverside], familyFriendly[yes], near[Raja Indian Cuisine]"	Located in the riverside area near Raja Indian Cuisine , The Wrestlers is a family friendly Japanese restaurant with a price range of less than £ 20 .
"name[The Wrestlers], eatType[restaurant], food[Japanese], priceRange[moderate], area[city centre], familyFriendly[no], near[Raja Indian Cuisine]"	The Wrestlers is a Japanese restaurant with moderate prices located in the city centre near Raja Indian Cuisine .
"name[The Wrestlers], eatType[restaurant], food[Japanese], priceRange[moderate], area[city centre], familyFriendly[yes], near[Raja Indian Cuisine]"	The Wrestlers is a child friendly restaurant that offers moderately priced Japanese food in the city centre near Raja Indian Cuisine .
"name[The Wrestlers], eatType[restaurant], food[Japanese], priceRange[moderate], area[riverside], familyFriendly[no], near[Raja Indian Cuisine]"	In the riverside area near Raja Indian Cuisine is a Japanese restaurant named The Wrestlers . It has a moderate price range and is not kid friendly .
"name[The Wrestlers], eatType[restaurant], food[Japanese], priceRange[moderate], area[riverside], familyFriendly[yes], near[Raja Indian Cuisine]"	The Wrestlers is located near Raja Indian Cuisine in the riverside area . It serves Japanese food and is kid friendly . It is moderately priced .
"name[The Wrestlers], eatType[restaurant], food[Japanese], priceRange[more than £30], area[city centre], familyFriendly[no], near[Raja Indian Cuisine]"	The Wrestlers is a Japanese restaurant that is not family - friendly with a price range of twenty pounds or five pounds . Located in the city center near Raja Indian Cuisine .
"name[The Wrestlers], eatType[restaurant], food[Japanese], priceRange[more than £30], area[city centre], familyFriendly[yes], near[Raja Indian Cuisine]"	The Wrestlers is a high priced day foods restaurant . Children are welcome . It is located near Raja Indian Cuisine .
"name[The Wrestlers], eatType[restaurant], food[Japanese], priceRange[more than £30], area[riverside], familyFriendly[no], near[Raja Indian Cuisine]"	The Wrestlers is a Japanese restaurant near Raja Indian Cuisine in riverside . It has a price range of more than £ 30 and is not children friendly .
"name[The Wrestlers], eatType[restaurant], food[Japanese], priceRange[more than £30], area[riverside], familyFriendly[yes], near[Raja Indian Cuisine]"	In the riverside area near Raja Indian Cuisine is a child friendly Japanese restaurant called The Wrestlers . It has a price range of more than £ 30 .
"name[Wildwood], eatType[coffee shop], area[riverside]"	In the riverside area there is a coffee shop called Wildwood .
"name[Wildwood], eatType[pub], area[riverside]"	Located next to the riverside is the pub Wildwood .
"name[Wildwood], eatType[pub], food[French], area[riverside], familyFriendly[yes], near[Raja Indian Cuisine]"	In the riverside area near Raja Indian Cuisine is a family friendly pub named Wildwood that serves French food .
"name[Wildwood], eatType[pub], food[Indian], area[city centre], familyFriendly[no], near[Raja Indian Cuisine]"	There is a pub called Wildwood that offers Indian food in the city centre near Raja Indian Cuisine . It is not family friendly .
"name[Wildwood], eatType[pub], food[Indian], area[city centre], familyFriendly[yes], near[Raja Indian Cuisine]"	Wildwood is a family friendly pub that serves Indian food in the city centre near Raja Indian Cuisine .
"name[Wildwood], eatType[pub], food[Indian], area[riverside], familyFriendly[no], near[Raja Indian Cuisine]"	Wildwood is a pub offering Indian cuisine for families and friends . It is located in the riverside area near Raja Indian Cuisine .
"name[Wildwood], eatType[pub], food[Indian], area[riverside], familyFriendly[yes], near[Raja Indian Cuisine]"	Child friendly pub , Wildwood , is located in the riverside area near Raja Indian Cuisine offering Indian food .
"name[Wildwood], eatType[pub], food[Italian], area[city centre], familyFriendly[no], near[Raja Indian Cuisine]"	Wildwood is an Italian pub located in the city centre near Raja Indian Cuisine . It provides an adult atmosphere .
"name[Wildwood], eatType[pub], food[Italian], area[city centre], familyFriendly[yes], near[Raja Indian Cuisine]"	Wildwood is a family - friendly pub that serves Italian food . It is located in the city centre near Raja Indian Cuisine .
"name[Wildwood], eatType[pub], food[Italian], area[riverside], familyFriendly[no], near[Raja Indian Cuisine]"	Wildwood is an adult only Italian pub in the riverside area near Raja Indian Cuisine .
"name[Wildwood], eatType[pub], food[Italian], area[riverside], familyFriendly[yes], near[Raja Indian Cuisine]"	Wildwood is a children friendly Italian pub in riverside near Raja Indian Cuisine .
"name[Wildwood], eatType[restaurant], food[French], area[riverside], familyFriendly[yes], near[Raja Indian Cuisine]"	Wildwood is a child friendly French restaurant in the riverside area near Raja Indian Cuisine .
"name[Wildwood], eatType[restaurant], food[Indian], area[city centre], familyFriendly[no], near[Raja Indian Cuisine]"	Located near Raja Indian Cuisine in the city centre , Wildwood is an Indian restaurant that is not kids friendly .
"name[Wildwood], eatType[restaurant], food[Indian], area[city centre], familyFriendly[yes], near[Raja Indian Cuisine]"	In the center of the city near Raja Indian Cuisine is a kid friendly Indian restaurant named Wildwood .
"name[Wildwood], eatType[restaurant], food[Indian], area[riverside], familyFriendly[no], near[Raja Indian Cuisine]"	Wildwood is a non - family friendly Indian place in the riverside area near Raja Indian Cuisine .
"name[Wildwood], eatType[restaurant], food[Indian], area[riverside], familyFriendly[yes], near[Raja Indian Cuisine]"	Wildwood is a restaurant providing Indian styled food . Located in the riverside area near Raja Indian Cuisine .
"name[Wildwood], eatType[restaurant], food[Italian], area[city centre], familyFriendly[no], near[Raja Indian Cuisine]"	The restaurant Wildwood is located in the center of the city near Raja Indian Cuisine . It provides Italian food and is not family - friendly .
"name[Wildwood], eatType[restaurant], food[Italian], area[city centre], familyFriendly[yes], near[Raja Indian Cuisine]"	Wildwood is a family - friendly Italian restaurant in the city center near Raja Indian Cuisine .
"name[Wildwood], eatType[restaurant], food[Italian], area[riverside], familyFriendly[no], near[Raja Indian Cuisine]"	Wildwood is not a family - friendly restaurant . They offer Italian food around the riverside near Raja Indian Cuisine .
"name[Wildwood], eatType[restaurant], food[Italian], area[riverside], familyFriendly[yes], near[Raja Indian Cuisine]"	In the riverside area near Raja Indian Cuisine is a child friendly Italian restaurant called Wildwood .
"name[Zizzi], eatType[coffee shop], area[riverside]"	A allowed coffee shop called Zizzi is located in the riverside area .
"name[Zizzi], eatType[coffee shop], customer rating[average], near[Burger King]"	Zizzi is a coffee shop that serves average food . Located near Burger King .
"name[Zizzi], eatType[coffee shop], customer rating[high], near[Burger King]"	Zizzi is an expensive coffee shop near Burger King . It has a high customer rating .
"name[Zizzi], eatType[coffee shop], near[The Sorrento]"	Near The Sorrento is a coffee shop called Zizzi .
"name[Zizzi], eatType[pub], area[riverside]"	By the river side is a pub known as Zizzi .
"name[Zizzi], eatType[pub], customer rating[average], near[Burger King]"	Near Burger King is a pub named Zizzi with an average customer rating .
"name[Zizzi], eatType[pub], customer rating[high], near[Burger King]"	There is a high customer rating pub called Zizzi near Burger King .
"name[Zizzi], eatType[pub], near[The Sorrento]"	Near The Sorrento you will find a pub named Zizzi .
