"name[Blue Spice], eatType[coffee shop], area[city centre]"	In the city centre there is a coffee shop called Blue Spice .
"name[Blue Spice], eatType[coffee shop], area[riverside]"	Blue Spice is a coffee shop in the riverside area that offers coffee .
"name[Blue Spice], eatType[coffee shop], customer rating[5 out of 5], near[Crowne Plaza Hotel]"	With a perfect customer rating of 5 out of 5 , Blue Spice is a coffee shop alongside the Crowne Plaza Hotel . Located in the city centre .
"name[Blue Spice], eatType[coffee shop], customer rating[average], near[Burger King]"	Blue Spice is a coffee shop that serves average food within the city centre near Burger King .
"name[Blue Spice], eatType[coffee shop], customer rating[average], near[Crowne Plaza Hotel]"	Blue Spice is a coffee shop with average reviews near Crowne Plaza Hotel .
"name[Blue Spice], eatType[pub], area[city centre]"	Blue Spice is a pub in the city center .
"name[Blue Spice], eatType[pub], area[riverside]"	For a pub in the riverside area , go to Blue Spice .
"name[Blue Spice], eatType[pub], customer rating[5 out of 5], near[Crowne Plaza Hotel]"	Near Crowne Plaza Hotel is a five star pub called Blue Spice .
"name[Blue Spice], eatType[pub], customer rating[average], near[Burger King]"	Near Burger King is a pub called Blue Spice with an average customer rating .
"name[Blue Spice], eatType[pub], customer rating[average], near[Crowne Plaza Hotel]"	Near Crowne Plaza Hotel you can find Blue Spice pub . It has an average customer rating .
"name[Blue Spice], eatType[pub], food[Chinese], area[city centre], familyFriendly[no], near[Rainbow Vegetarian Café]"	Blue Spice is a non - family friendly pub serving Chinese food in the city centre near Rainbow Vegetarian Café .
"name[Blue Spice], eatType[pub], food[Chinese], area[city centre], familyFriendly[yes], near[Rainbow Vegetarian Café]"	Blue Spice is a family friendly pub that serves Chinese food . Located in the city centre near the Rainbow Vegetarian Café .
"name[Blue Spice], eatType[pub], food[Chinese], area[riverside], familyFriendly[no], near[Rainbow Vegetarian Café]"	Blue Spice is a pub that provide Chinese food . It is located in riverside near Rainbow Vegetarian Café and is not family friendly .
"name[Blue Spice], eatType[pub], food[Chinese], area[riverside], familyFriendly[yes], near[Rainbow Vegetarian Café]"	Blue Spice is a pub that provides Chinese food It is located in the riverside . It is near Rainbow Vegetarian Café .
"name[Blue Spice], eatType[pub], food[English], area[city centre], familyFriendly[no], near[Rainbow Vegetarian Café]"	If you are looking for a pub that is not family - friendly , Blue Spice is served English food and is located in the city centre near the Rainbow Vegetarian Café .
"name[Blue Spice], eatType[pub], food[English], area[city centre], familyFriendly[yes], near[Rainbow Vegetarian Café]"	Blue Spice is a family - friendly pub in the center of the city near Rainbow Vegetarian Café that serves English food .
"name[Blue Spice], eatType[pub], food[English], area[riverside], familyFriendly[no], near[Rainbow Vegetarian Café]"	Blue Spice is a pub serving English food in the riverside area near Rainbow Vegetarian Café . It is not family - friendly .
"name[Blue Spice], eatType[pub], food[English], area[riverside], familyFriendly[yes], near[Rainbow Vegetarian Café]"	Blue Spice is a children friendly pub in the riverside area near Rainbow Vegetarian Café that serves English food .
"name[Blue Spice], eatType[restaurant], food[Chinese], area[city centre], familyFriendly[no], near[Rainbow Vegetarian Café]"	Blue Spice is a restaurant that is not family - friendly . It serves Chinese food and is located near Rainbow Vegetarian Café in the city center .
"name[Blue Spice], eatType[restaurant], food[Chinese], area[city centre], familyFriendly[yes], near[Rainbow Vegetarian Café]"	Blue Spice is a family friendly restaurant serving Chinese food in the city centre near Rainbow Vegetarian Café .
"name[Blue Spice], eatType[restaurant], food[Chinese], area[riverside], familyFriendly[no], near[Rainbow Vegetarian Café]"	Near Rainbow Vegetarian Café , in the riverside area , there is a Chinese restaurant named Blue Spice that is not family friendly .
"name[Blue Spice], eatType[restaurant], food[Chinese], area[riverside], familyFriendly[yes], near[Rainbow Vegetarian Café]"	Located close to Rainbow Vegetarian Café , Blue Spice is a Chinese restaurant known for kids and always welcome .
"name[Blue Spice], eatType[restaurant], food[English], area[city centre], familyFriendly[no], near[Rainbow Vegetarian Café]"	Blue Spice is a restaurant situated near the Rainbow Vegetarian Café in the city centre . It is not family - friendly .
"name[Blue Spice], eatType[restaurant], food[English], area[city centre], familyFriendly[yes], near[Rainbow Vegetarian Café]"	There is a family - friendly English restaurant in the city centre near Rainbow Vegetarian Café called Blue Spice .
"name[Blue Spice], eatType[restaurant], food[English], area[riverside], familyFriendly[no], near[Rainbow Vegetarian Café]"	Blue Spice is a restaurant serving English food in the riverside area near Rainbow Vegetarian Café . It is not family - friendly .
"name[Blue Spice], eatType[restaurant], food[English], area[riverside], familyFriendly[yes], near[Rainbow Vegetarian Café]"	Blue Spice is a children friendly restaurant in the riverside area near Rainbow Vegetarian Café that serves English food .
"name[Clowns], eatType[coffee shop], customer rating[3 out of 5], near[All Bar One]"	Clowns is a coffee shop situated near All Bar One . It has a customer rating of 3 out of 5 and is situated to relax .
"name[Clowns], eatType[coffee shop], customer rating[5 out of 5], near[Crowne Plaza Hotel]"	Located near Crowne Plaza Hotel , Clowns is a coffee shop with a customer rating of 5 out of 5 .
"name[Clowns], eatType[coffee shop], near[The Sorrento]"	Clowns is a coffee shop close to The Sorrento .
"name[Clowns], eatType[pub], customer rating[3 out of 5], near[All Bar One]"	Clowns is a pub near All Bar One with 3 out of 5 stars .
"name[Clowns], eatType[pub], customer rating[5 out of 5], near[Crowne Plaza Hotel]"	Clowns is a great pub near the Crowne Plaza Hotel .
"name[Clowns], eatType[pub], near[The Sorrento]"	Clowns is a pub found near The Sorrento . It costs __end_additional_words__ .
"name[Cocum], eatType[coffee shop], customer rating[high], near[Burger King]"	Cocum is a coffee shop that serves high customer rating . It is located near Burger King .
"name[Cocum], eatType[coffee shop], customer rating[high], near[Café Sicilia]"	Near Café Sicilia is a coffee shop named Cocum with a high customer rating .
"name[Cocum], eatType[coffee shop], customer rating[low], near[Café Sicilia]"	For a coffee shop near Café Sicilia , look no further than Cocum . It is rated low .
"name[Cocum], eatType[coffee shop], customer rating[low], near[Express by Holiday Inn]"	Cocum is a low rated coffee shop near Express by Holiday Inn .
"name[Cocum], eatType[coffee shop], near[The Rice Boat]"	Cocum is a coffee shop located next to The Rice Boat .
"name[Cocum], eatType[coffee shop], near[The Sorrento]"	Located near The Sorrento , Cocum is a coffee shop .
"name[Cocum], eatType[pub], customer rating[high], near[Burger King]"	A pub called Cocum has a high customer rating and is located near Burger King .
"name[Cocum], eatType[pub], customer rating[high], near[Café Sicilia]"	Near Café Sicilia is a pub called Cocum with a high customer rating .
"name[Cocum], eatType[pub], customer rating[low], near[Café Sicilia]"	For a low rated pub near Café Sicilia , try Cocum .
"name[Cocum], eatType[pub], customer rating[low], near[Express by Holiday Inn]"	Cocum is a pub near Express by Holiday Inn . It has low customer ratings .
"name[Cocum], eatType[pub], near[The Rice Boat]"	Located near The Rice Boat is a pub named Cocum .
"name[Cocum], eatType[pub], near[The Sorrento]"	Cocum is a pub that offers spirits and is close to the city centre .
"name[Cotto], eatType[coffee shop], near[The Bakers]"	Cotto is a coffee shop near The Bakers . It has a customers rating of customers .
"name[Cotto], eatType[pub], near[The Bakers]"	Cotto is a pub near The Bakers that serves pub food .
"name[Giraffe], eatType[coffee shop], near[The Bakers]"	Giraffe is a fine meal coffee shop close to The Bakers .
"name[Giraffe], eatType[coffee shop], near[The Rice Boat]"	Giraffe is a coffee shop that is located near The Rice Boat and hors be hors your family .
"name[Giraffe], eatType[pub], food[English], area[riverside], familyFriendly[yes], near[Rainbow Vegetarian Café]"	In the riverside area near Rainbow Vegetarian Café there is a pub that serves English food and is kid friendly called Giraffe .
"name[Giraffe], eatType[pub], food[Fast food], area[city centre], familyFriendly[no], near[Rainbow Vegetarian Café]"	Giraffe is a non - family - friendly Fast food pub in the city centre near Rainbow Vegetarian Café .
"name[Giraffe], eatType[pub], food[Fast food], area[city centre], familyFriendly[yes], near[Rainbow Vegetarian Café]"	In the city centre near the Rainbow Vegetarian Café is a family - friendly fast food pub named Giraffe .
"name[Giraffe], eatType[pub], food[Fast food], area[riverside], familyFriendly[no], near[Rainbow Vegetarian Café]"	Giraffe is a pub located near the Rainbow Vegetarian Café . They offer Fast food and are not family - friendly .
"name[Giraffe], eatType[pub], food[Fast food], area[riverside], familyFriendly[yes], near[Rainbow Vegetarian Café]"	Giraffe is a family friendly Fast food pub on the river side near Rainbow Vegetarian Café .
"name[Giraffe], eatType[pub], food[Fast food], area[riverside], familyFriendly[yes], near[Raja Indian Cuisine]"	Giraffe is a family friendly fast food pub in the riverside area near Raja Indian Cuisine .
"name[Giraffe], eatType[pub], food[French], area[city centre], familyFriendly[no], near[Raja Indian Cuisine]"	Giraffe is a French pub located in the city centre near Raja Indian Cuisine . It is not suited for family .
"name[Giraffe], eatType[pub], food[French], area[city centre], familyFriendly[yes], near[Raja Indian Cuisine]"	Giraffe is a family - friendly French pub in the city center near Raja Indian Cuisine .
"name[Giraffe], eatType[pub], food[French], area[riverside], familyFriendly[no], near[Raja Indian Cuisine]"	Giraffe is a pub near Raja Indian Cuisine in the riverside area . It serves French food and is not family - friendly .
"name[Giraffe], eatType[pub], food[French], area[riverside], familyFriendly[yes], near[Raja Indian Cuisine]"	Giraffe is a kid friendly pub in the riverside area near Raja Indian Cuisine that serves French food .
"name[Giraffe], eatType[pub], near[The Bakers]"	Giraffe is a pub close to The Bakers .
"name[Giraffe], eatType[pub], near[The Rice Boat]"	Near The Rice Boat is a pub named Giraffe .
"name[Giraffe], eatType[restaurant], food[English], area[riverside], familyFriendly[yes], near[Rainbow Vegetarian Café]"	Giraffe is a child friendly English restaurant in the riverside area near Rainbow Vegetarian Café .
"name[Giraffe], eatType[restaurant], food[Fast food], area[city centre], familyFriendly[no], near[Rainbow Vegetarian Café]"	Giraffe is a fast food restaurant located in the city centre near Rainbow Vegetarian Café . It is not family - friendly .
"name[Giraffe], eatType[restaurant], food[Fast food], area[city centre], familyFriendly[yes], near[Rainbow Vegetarian Café]"	Situated near the Rainbow Vegetarian Café is a family - friendly restaurant called Giraffe that serves fast food within the city centre .
"name[Giraffe], eatType[restaurant], food[Fast food], area[riverside], familyFriendly[no], near[Rainbow Vegetarian Café]"	Giraffe is a fast food restaurant in the riverside area near Rainbow Vegetarian Café . It is not family - friendly .
"name[Giraffe], eatType[restaurant], food[Fast food], area[riverside], familyFriendly[yes], near[Rainbow Vegetarian Café]"	In the riverside area , near Rainbow Vegetarian Café , there is a kid friendly restaurant named Giraffe . It has fast food .
"name[Giraffe], eatType[restaurant], food[Fast food], area[riverside], familyFriendly[yes], near[Raja Indian Cuisine]"	There is a family friendly Fast food restaurant in the riverside area near Raja Indian Cuisine called Giraffe .
"name[Giraffe], eatType[restaurant], food[French], area[city centre], familyFriendly[no], near[Raja Indian Cuisine]"	Giraffe is a restaurant that provides French food . It is located in the city centre near Raja Indian Cuisine and is not family - friendly .
"name[Giraffe], eatType[restaurant], food[French], area[city centre], familyFriendly[yes], near[Raja Indian Cuisine]"	Giraffe is a family - friendly restaurant that serves French food . It is located in the city centre near Raja Indian Cuisine .
"name[Giraffe], eatType[restaurant], food[French], area[riverside], familyFriendly[no], near[Raja Indian Cuisine]"	Giraffe is a non family - friendly French restaurant in the riverside area near Raja Indian Cuisine .
"name[Giraffe], eatType[restaurant], food[French], area[riverside], familyFriendly[yes], near[Raja Indian Cuisine]"	Giraffe is a restaurant near Raja Indian Cuisine in Riverside offering French food and is kid friendly .
"name[Green Man], eatType[coffee shop], customer rating[1 out of 5], near[All Bar One]"	Near All Bar One is a 1 out of 5 rated coffee shop called Green Man .
"name[Green Man], eatType[coffee shop], customer rating[3 out of 5], near[All Bar One]"	Green Man is a 3 out of 5 rated coffee shop near All Bar One .
"name[Green Man], eatType[pub], customer rating[1 out of 5], near[All Bar One]"	Near All Bar One , there is a pub called Green Man . It gets a 1 out of 5 customer rating .
"name[Green Man], eatType[pub], customer rating[3 out of 5], near[All Bar One]"	Near All Bar One is a pub named Green Man . It is rated 3 out of 5 .
"name[Green Man], eatType[pub], food[Italian], area[riverside], familyFriendly[yes], near[Express by Holiday Inn]"	Green Man is a children friendly pub that provides Italian food in the riverside area near Express by Holiday Inn .
"name[Green Man], eatType[pub], food[Italian], area[riverside], familyFriendly[yes], near[Raja Indian Cuisine]"	Green Man is a kid friendly Italian pub in the riverside area near Raja Indian Cuisine .
"name[Green Man], eatType[pub], food[Japanese], area[city centre], familyFriendly[no], near[Express by Holiday Inn]"	Offering Japanese food in the city centre near Express by Holiday Inn is a pub named Green Man that is not family - friendly .
"name[Green Man], eatType[pub], food[Japanese], area[city centre], familyFriendly[yes], near[Express by Holiday Inn]"	Green Man offers Japanese food and is a family - friendly pub . Located in the city centre near Express by Holiday Inn .
"name[Green Man], eatType[pub], food[Japanese], area[riverside], familyFriendly[no], near[Express by Holiday Inn]"	The Green Man pub is located in the riverside area near the Express by Holiday Inn . It sits not family - friendly .
"name[Green Man], eatType[pub], food[Japanese], area[riverside], familyFriendly[yes], near[Express by Holiday Inn]"	Green Man is a kid friendly Japanese pub in the riverside area near Express by Holiday Inn .
"name[Green Man], eatType[restaurant], food[Italian], area[riverside], familyFriendly[yes], near[Express by Holiday Inn]"	Green Man is a children friendly Italian restaurant in the riverside area near Express by Holiday Inn .
"name[Green Man], eatType[restaurant], food[Italian], area[riverside], familyFriendly[yes], near[Raja Indian Cuisine]"	Green Man is a family friend Italian restaurant in the riverside area near Raja Indian Cuisine .
"name[Green Man], eatType[restaurant], food[Japanese], area[city centre], familyFriendly[no], near[Express by Holiday Inn]"	Green Man is a Japanese restaurant located in the city center near Express by Holiday Inn . It is not family - friendly .
"name[Green Man], eatType[restaurant], food[Japanese], area[city centre], familyFriendly[yes], near[Express by Holiday Inn]"	Green Man is a family - friendly Japanese restaurant in the city center near Express by Holiday Inn .
"name[Green Man], eatType[restaurant], food[Japanese], area[riverside], familyFriendly[no], near[Express by Holiday Inn]"	Green Man is a Japanese restaurant next to Express by Holiday Inn in the river side .
"name[Green Man], eatType[restaurant], food[Japanese], area[riverside], familyFriendly[yes], near[Express by Holiday Inn]"	Situated in the riverside area near Express by Holiday Inn , Green Man restaurant offers a family - friendly Japanese menu .
"name[Loch Fyne], eatType[coffee shop], area[riverside]"	In the riverside area there is a coffee shop called Loch Fyne .
"name[Loch Fyne], eatType[pub], area[riverside]"	In the riverside area there is a pub named Loch Fyne .
"name[Strada], eatType[coffee shop], area[city centre]"	Strada is a coffee shop in the heart of the city .
"name[Strada], eatType[coffee shop], customer rating[1 out of 5], near[All Bar One]"	Strada is a coffee shop near All Bar One . It is rated 1 out of 5 by customers .
"name[Strada], eatType[coffee shop], customer rating[1 out of 5], near[Rainbow Vegetarian Café]"	Near Rainbow Vegetarian Café is a coffee shop called Strada . It has a customer rating of 1 out of 5 .
"name[Strada], eatType[coffee shop], customer rating[low], near[Express by Holiday Inn]"	Near the Express by Holiday Inn is a coffee shop named Strada serving food with a low customer rating .
"name[Strada], eatType[pub], area[city centre]"	Strada is a pub that serves pub food in the city centre .
"name[Strada], eatType[pub], customer rating[1 out of 5], near[All Bar One]"	Strada is ranked 1 out of 5 and is located near All Bar One .
"name[Strada], eatType[pub], customer rating[1 out of 5], near[Rainbow Vegetarian Café]"	Strada is a pub near Rainbow Vegetarian Café that is rated 1 out of 5 .
"name[Strada], eatType[pub], customer rating[low], near[Express by Holiday Inn]"	Strada is a pub near Express by Holiday Inn with low customer ratings .
"name[The Cricketers], eatType[coffee shop], customer rating[1 out of 5], familyFriendly[yes], near[Avalon]"	There is a kid friendly coffee shop near Avalon called The Cricketers . It has a customer rating of 1 out of 5 .
"name[The Cricketers], eatType[coffee shop], customer rating[3 out of 5], familyFriendly[yes], near[Avalon]"	The Cricketers coffee shop near Avalon offers a children friendly atmosphere and has a customer rating of 3 out of 5 .
"name[The Cricketers], eatType[coffee shop], customer rating[3 out of 5], familyFriendly[yes], near[Crowne Plaza Hotel]"	The Cricketers is a kid friendly coffee shop near Crowne Plaza Hotel . It is rated 3 out of 5 .
"name[The Cricketers], eatType[coffee shop], customer rating[5 out of 5], familyFriendly[no], near[Crowne Plaza Hotel]"	Located near Crowne Plaza Hotel , The Cricketers is a coffee shop with a 5 out of 5 rating . It is not children friendly .
"name[The Cricketers], eatType[coffee shop], customer rating[5 out of 5], familyFriendly[yes], near[Crowne Plaza Hotel]"	The Cricketers is a family friendly coffee shop near Crowne Plaza Hotel . It is rated 5 out of 5 by customers .
"name[The Cricketers], eatType[coffee shop], customer rating[average], familyFriendly[no], near[Café Sicilia]"	without children , find The Cricketers coffee shop near Café Sicilia . It has an excellent customer rating and is not children friendly .
"name[The Cricketers], eatType[coffee shop], customer rating[average], familyFriendly[no], near[Crowne Plaza Hotel]"	The Cricketers is a mid ratings adult oriented coffee shop near Crowne Plaza Hotel .
"name[The Cricketers], eatType[coffee shop], customer rating[average], familyFriendly[yes], near[Café Sicilia]"	The Cricketers is a children friendly coffee shop near Café Sicilia . It has an average customer rating .
"name[The Cricketers], eatType[coffee shop], customer rating[high], familyFriendly[yes], near[Café Sicilia]"	Near Café Sicilia is a child friendly coffee shop with high customer ratings called The Cricketers .
"name[The Cricketers], eatType[coffee shop], customer rating[high], familyFriendly[yes], near[Express by Holiday Inn]"	There is a children friendly coffee shop with a high customer rating called The Cricketers near Express by Holiday Inn .
"name[The Cricketers], eatType[coffee shop], customer rating[low], familyFriendly[no], near[Express by Holiday Inn]"	The Cricketers is a coffee shop near Express by Holiday Inn . It has low customer ratings and is not family - friendly .
"name[The Cricketers], eatType[coffee shop], customer rating[low], familyFriendly[no], near[Ranch]"	Located close to Ranch , The Cricketers is a coffee shop that is not recommended for families .
"name[The Cricketers], eatType[coffee shop], customer rating[low], familyFriendly[yes], near[Ranch]"	The Cricketers is a children friendly coffee shop situated near Ranch . It has a low customer rating .
"name[The Cricketers], eatType[restaurant], customer rating[1 out of 5], familyFriendly[yes], near[Avalon]"	A restaurant near Avalon called The Cricketers is child friendly and has a customer rating of 1 out of 5 .
"name[The Cricketers], eatType[restaurant], customer rating[3 out of 5], familyFriendly[yes], near[Avalon]"	Near Avalon , there is a kid friendly restaurant called The Cricketers with a customer rating of 3 out of 5 .
"name[The Cricketers], eatType[restaurant], customer rating[3 out of 5], familyFriendly[yes], near[Crowne Plaza Hotel]"	The Cricketers is a children friendly restaurant near Crowne Plaza Hotel with a customer rating of 3 out of 5 .
"name[The Cricketers], eatType[restaurant], customer rating[5 out of 5], familyFriendly[no], near[Crowne Plaza Hotel]"	There is a 5 out of 5 rated non - family - friendly restaurant near Crowne Plaza Hotel called The Cricketers .
"name[The Cricketers], eatType[restaurant], customer rating[5 out of 5], familyFriendly[yes], near[Crowne Plaza Hotel]"	Near the Crowne Plaza Hotel , there is a child friendly restaurant named The Cricketers with a customer rating of 5 out of 5 .
"name[The Cricketers], eatType[restaurant], customer rating[average], familyFriendly[no], near[Café Sicilia]"	The Cricketers is a non family - friendly restaurant with an average customer rating . It is located near Café Sicilia .
"name[The Cricketers], eatType[restaurant], customer rating[average], familyFriendly[no], near[Crowne Plaza Hotel]"	There is a opened restaurant The Cricketers located next to Crowne Plaza Hotel .
"name[The Cricketers], eatType[restaurant], customer rating[average], familyFriendly[yes], near[Café Sicilia]"	The Cricketers is an expensive restaurant near Café Sicilia that has expensive meals and drinks .
"name[The Cricketers], eatType[restaurant], customer rating[high], familyFriendly[yes], near[Café Sicilia]"	The Cricketers is a kid friendly restaurant near Café Sicilia with a high customer rating .
"name[The Cricketers], eatType[restaurant], customer rating[high], familyFriendly[yes], near[Express by Holiday Inn]"	The Cricketers is a child friendly restaurant near Express by Holiday Inn with a high customer rating .
"name[The Cricketers], eatType[restaurant], customer rating[low], familyFriendly[no], near[Express by Holiday Inn]"	Located near Express by Holiday Inn , The Cricketers is a not family - friendly restaurant with a low customer rating .
"name[The Cricketers], eatType[restaurant], customer rating[low], familyFriendly[no], near[Ranch]"	The Cricketers is a restaurant located next to Ranch .
"name[The Cricketers], eatType[restaurant], customer rating[low], familyFriendly[yes], near[Ranch]"	The Cricketers is a child friendly low rated restaurant near Ranch .
"name[The Cricketers], eatType[restaurant], food[Chinese], priceRange[£20-25], customer rating[high], area[city centre], familyFriendly[no], near[All Bar One]"	The Cricketers is a high priced Chinese restaurant in the city centre near All Bar One . It has a high customer rating and is not kid friendly .
"name[The Cricketers], eatType[restaurant], food[Chinese], priceRange[£20-25], customer rating[high], area[city centre], familyFriendly[yes], near[All Bar One]"	The Cricketers is a restaurant providing Chinese food in the £ 20 - 25 price range . It is located in the city centre . It is near All Bar One . Its customer rating is high .
"name[The Cricketers], eatType[restaurant], food[Chinese], priceRange[£20-25], customer rating[high], area[riverside], familyFriendly[no], near[All Bar One]"	Mid priced restaurant called The Cricketers sells Chinese food in the riverside area near All Bar One . It is not kids friendly and has a high customer rating .
"name[The Cricketers], eatType[restaurant], food[Chinese], priceRange[£20-25], customer rating[high], area[riverside], familyFriendly[yes], near[All Bar One]"	The Cricketers is a restaurant that provides Chinese food in the £ 20 - 25 price range . It is located in the riverside . It is near All Bar One . Its customer rating is high .
"name[The Cricketers], eatType[restaurant], food[Chinese], priceRange[cheap], customer rating[5 out of 5], area[city centre], familyFriendly[no], near[All Bar One]"	In the city centre near All Bar One , there is a Chinese restaurant called The Cricketers . It is not family friendly and has a 5 out of 5 rating .
"name[The Cricketers], eatType[restaurant], food[Chinese], priceRange[cheap], customer rating[5 out of 5], area[city centre], familyFriendly[yes], near[All Bar One]"	The Cricketers is a restaurant providing Chinese food in the cheap price range . It is located in the city centre . It is near All Bar One . Its customer rating is 5 out of 5 .
"name[The Cricketers], eatType[restaurant], food[Chinese], priceRange[cheap], customer rating[5 out of 5], area[riverside], familyFriendly[no], near[All Bar One]"	The Cricketers is a cheap Chinese restaurant located in riverside near All Bar One . It is rated 5 out of 5 and is not family friendly .
"name[The Cricketers], eatType[restaurant], food[Chinese], priceRange[cheap], customer rating[5 out of 5], area[riverside], familyFriendly[yes], near[All Bar One]"	The Cricketers is a family friendly restaurant that serves cheap Chinese food . It has a customer rating of 5 out of 5 and is located in the riverside area near All Bar One .
"name[The Cricketers], eatType[restaurant], food[Chinese], priceRange[cheap], customer rating[average], area[city centre], familyFriendly[no], near[All Bar One]"	The Cricketers is a restaurant that serves cheap Chinese food . It has an average customer rating and is not family friendly . It is located in the city centre near All Bar One .
"name[The Cricketers], eatType[restaurant], food[Chinese], priceRange[cheap], customer rating[average], area[city centre], familyFriendly[yes], near[All Bar One]"	The Cricketers is a restaurant that provides Chinese food in the cheap price range . It is located in the city centre . It is near All Bar One . Its customer rating is average .
"name[The Cricketers], eatType[restaurant], food[Chinese], priceRange[cheap], customer rating[average], area[riverside], familyFriendly[no], near[All Bar One]"	The Cricketers is a restaurant that serves Chinese dishes within the cheap price range . It has an average customer rating and is not family friendly . It is located in the riverside area near All Bar One .
"name[The Cricketers], eatType[restaurant], food[Chinese], priceRange[cheap], customer rating[average], area[riverside], familyFriendly[yes], near[All Bar One]"	The Cricketers is a restaurant providing Chinese food in the cheap price range . It is located in the riverside . It is near All Bar One . Its customer rating is average .
"name[The Cricketers], eatType[restaurant], food[Chinese], priceRange[high], customer rating[1 out of 5], area[city centre], familyFriendly[no], near[All Bar One]"	In the city centre near All Bar One is a 1 out of 5 rated Chinese restaurant called The Cricketers . It is not child friendly and has a high price range .
"name[The Cricketers], eatType[restaurant], food[Chinese], priceRange[high], customer rating[1 out of 5], area[city centre], familyFriendly[yes], near[All Bar One]"	Located in the city centre near All Bar One , The Cricketers is a high priced Chinese restaurant that is child friendly and has a 1 out of 5 rating .
"name[The Cricketers], eatType[restaurant], food[Chinese], priceRange[high], customer rating[1 out of 5], area[riverside], familyFriendly[no], near[All Bar One]"	The Cricketers is a restaurant that serves Chinese food at high prices . It is located in the riverside area near All Bar One . It is not child friendly and has a customer rating of 1 out of 5 .
"name[The Cricketers], eatType[restaurant], food[Chinese], priceRange[high], customer rating[1 out of 5], area[riverside], familyFriendly[yes], near[All Bar One]"	The Cricketers is a restaurant that sells Chinese food in the high price range . It is located in the riverside area near All Bar One . It is children friendly and has a customer rating of 1 out of 5 .
"name[The Cricketers], eatType[restaurant], food[Chinese], priceRange[high], customer rating[average], area[city centre], familyFriendly[no], near[All Bar One]"	The Cricketers is a restaurant that serves Chinese food in the high price range . It has an average customer rating and is not family friendly . It is located in the city centre near All Bar One .
"name[The Cricketers], eatType[restaurant], food[Chinese], priceRange[high], customer rating[average], area[city centre], familyFriendly[yes], near[All Bar One]"	The Cricketers is a children friendly Chinese restaurant with a high price range and an average customer rating . It is located in the city centre near All Bar One .
"name[The Cricketers], eatType[restaurant], food[Chinese], priceRange[high], customer rating[average], area[riverside], familyFriendly[no], near[All Bar One]"	The Cricketers restaurant offers moderately priced Chinese food in the riverside area near All Bar One . It has an average customer rating and is not children friendly .
"name[The Cricketers], eatType[restaurant], food[Chinese], priceRange[high], customer rating[average], area[riverside], familyFriendly[yes], near[All Bar One]"	The Cricketers is a Chinese restaurant in the high price range . It is located in the riverside area near All Bar One and is child friendly .
"name[The Cricketers], eatType[restaurant], food[Chinese], priceRange[less than £20], customer rating[low], area[city centre], familyFriendly[no], near[All Bar One]"	The Cricketers is an okay Chinese restaurant located in the city centre near All Bar One . It is not family friendly and has low ratings for adults .
"name[The Cricketers], eatType[restaurant], food[Chinese], priceRange[less than £20], customer rating[low], area[city centre], familyFriendly[yes], near[All Bar One]"	In the city centre near All Bar One is a family friendly Chinese restaurant called The Cricketers . It has a low customer rating and is rated low .
"name[The Cricketers], eatType[restaurant], food[Chinese], priceRange[less than £20], customer rating[low], area[riverside], familyFriendly[no], near[All Bar One]"	The Cricketers is a restaurant that sells Chinese food for less than £ 20 . It has a low customer rating and is not family friendly . It is located in the riverside area near All Bar One .
"name[The Cricketers], eatType[restaurant], food[Chinese], priceRange[less than £20], customer rating[low], area[riverside], familyFriendly[yes], near[All Bar One]"	The Cricketers restaurant provides low cost Chinese food in the riverside area near All Bar One . It is family friendly and has a low customer rating .
"name[The Cricketers], eatType[restaurant], food[Chinese], priceRange[moderate], customer rating[1 out of 5], area[city centre], familyFriendly[no], near[All Bar One]"	The Cricketers is a Chinese restaurant with moderate pricing . It is moderately priced and is rated 1 out of 5 . It is not kid friendly and is located in the city centre near All Bar One .
"name[The Cricketers], eatType[restaurant], food[Chinese], priceRange[moderate], customer rating[1 out of 5], area[city centre], familyFriendly[yes], near[All Bar One]"	There is a Chinese restaurant called The Cricketers near All Bar One in the city centre . It has a customer rating of 1 out of 5 and is kid friendly .
"name[The Cricketers], eatType[restaurant], food[Chinese], priceRange[moderate], customer rating[1 out of 5], area[riverside], familyFriendly[no], near[All Bar One]"	The Cricketers is a moderately priced Chinese restaurant near All Bar One . It is not kid friendly and has a customer rating of 1 out of 5 .
"name[The Cricketers], eatType[restaurant], food[Chinese], priceRange[moderate], customer rating[1 out of 5], area[riverside], familyFriendly[yes], near[All Bar One]"	The Cricketers is a Chinese restaurant found in the riverside area near All Bar One . It has a customer rating of 1 out of 5 and is moderately priced . It is kid friendly .
"name[The Cricketers], eatType[restaurant], food[Chinese], priceRange[moderate], customer rating[3 out of 5], area[city centre], familyFriendly[no], near[All Bar One]"	The Cricketers is a moderately priced Chinese restaurant in the city centre near All Bar One . It has a customer rating of 3 out of 5 and is not kids friendly .
"name[The Cricketers], eatType[restaurant], food[Chinese], priceRange[moderate], customer rating[3 out of 5], area[city centre], familyFriendly[yes], near[All Bar One]"	Kids are welcomed at The Cricketers which serves moderately priced Chinese cuisine . It has a customer rating of 3 out of 5 and is located in the city centre near All Bar One .
"name[The Cricketers], eatType[restaurant], food[Chinese], priceRange[moderate], customer rating[3 out of 5], area[riverside], familyFriendly[no], near[All Bar One]"	The Cricketers is a Chinese restaurant in the riverside area near All Bar One . It has moderate prices and is not kid friendly . It is rated 3 out of 5 .
"name[The Cricketers], eatType[restaurant], food[Chinese], priceRange[moderate], customer rating[3 out of 5], area[riverside], familyFriendly[yes], near[All Bar One]"	The Cricketers is a kids friendly Chinese restaurant . It can be found in the riverside area near All Bar One . They offer a moderate price range and have a customer rating of 3 out of 5 .
"name[The Cricketers], eatType[restaurant], food[Chinese], priceRange[more than £30], customer rating[high], area[city centre], familyFriendly[no], near[All Bar One]"	The Cricketers is a Chinese restaurant with a high customer rating and a price range of more than £ 30 . It is not child friendly and is located in the city centre near All Bar One .
"name[The Cricketers], eatType[restaurant], food[Chinese], priceRange[more than £30], customer rating[high], area[city centre], familyFriendly[yes], near[All Bar One]"	The Cricketers is a highly rated , pricey , kid friendly Chinese restaurant in the city centre near All Bar One .
"name[The Cricketers], eatType[restaurant], food[Chinese], priceRange[more than £30], customer rating[high], area[riverside], familyFriendly[no], near[All Bar One]"	The Cricketers is a low - priced restaurant in the city centre that delivers take - away . It is located near All Bar One .
"name[The Cricketers], eatType[restaurant], food[Chinese], priceRange[more than £30], customer rating[high], area[riverside], familyFriendly[yes], near[All Bar One]"	There is an expensive Chinese restaurant in Riverside near All Bar One called The Cricketers . It is kid friendly and highly rated .
"name[The Cricketers], eatType[restaurant], food[English], priceRange[£20-25], customer rating[high], area[city centre], familyFriendly[no], near[All Bar One]"	The Cricketers is a non kids friendly English restaurant in the city centre near All Bar One . It is rated high and has a price range of £ 20 - 25 .
"name[The Cricketers], eatType[restaurant], food[English], priceRange[£20-25], customer rating[high], area[city centre], familyFriendly[yes], near[All Bar One]"	The Cricketers is a kid friendly English restaurant in the city centre near All Bar One with a high customer rating and a price range of £ 20 - 25 .
"name[The Cricketers], eatType[restaurant], food[English], priceRange[£20-25], customer rating[high], area[riverside], familyFriendly[no], near[All Bar One]"	In the riverside area near All Bar One is an English restaurant named The Cricketers . It has a high customer rating and is not child friendly . The price range is £ 20 - 25 .
"name[The Cricketers], eatType[restaurant], food[English], priceRange[£20-25], customer rating[high], area[riverside], familyFriendly[yes], near[All Bar One]"	The Cricketers is a mid - range British restaurant that offers British food at high prices . It is located near All Bar One .
"name[The Cricketers], eatType[restaurant], food[English], priceRange[cheap], customer rating[5 out of 5], area[city centre], familyFriendly[no], near[Café Rouge]"	There is a cheap English restaurant in the city centre near Café Rouge called The Cricketers . It has an excellent customer rating of 5 out of 5 and is not children friendly .
"name[The Cricketers], eatType[restaurant], food[English], priceRange[cheap], customer rating[5 out of 5], area[city centre], familyFriendly[yes], near[Café Rouge]"	For a family - friendly English restaurant experience , visit The Cricketers in the city centre near Café Rouge . It has a customer rating of 5 out of 5 .
"name[The Cricketers], eatType[restaurant], food[English], priceRange[cheap], customer rating[5 out of 5], area[riverside], familyFriendly[no], near[Café Rouge]"	In the riverside area near Café Rouge is an English restaurant called The Cricketers . It is not family - friendly and has a customer rating of 5 out of 5 .
"name[The Cricketers], eatType[restaurant], food[English], priceRange[cheap], customer rating[5 out of 5], area[riverside], familyFriendly[yes], near[Café Rouge]"	There is a family friendly English restaurant in the riverside area near Café Rouge . It is called The Cricketers and has a 5 out of 5 customer rating .
"name[The Cricketers], eatType[restaurant], food[English], priceRange[cheap], customer rating[average], area[city centre], familyFriendly[no], near[Café Rouge]"	The Cricketers is an English restaurant located in the city centre near Café Rouge . It has average customer ratings and is not family - friendly .
"name[The Cricketers], eatType[restaurant], food[English], priceRange[cheap], customer rating[average], area[city centre], familyFriendly[yes], near[Café Rouge]"	The Cricketers is a family - friendly restaurant offering English food in the city centre near Café Rouge . It has an average customer rating and the prices are cheap .
"name[The Cricketers], eatType[restaurant], food[English], priceRange[cheap], customer rating[average], area[riverside], familyFriendly[no], near[Café Rouge]"	Near Café Rouge in the riverside area is a place called The Cricketers . It is not family - friendly , has an average customer rating and serves cheap English food .
"name[The Cricketers], eatType[restaurant], food[English], priceRange[cheap], customer rating[average], area[riverside], familyFriendly[yes], near[Café Rouge]"	Want English cuisine and affordable prices in a family friendly atmosphere , The Cricketers restaurant is just by the riverside near Café Rouge and has an average customer rating .
"name[The Cricketers], eatType[restaurant], food[English], priceRange[high], customer rating[1 out of 5], area[city centre], familyFriendly[no], near[Café Rouge]"	The Cricketers is a restaurant that serves English food in the city centre near Café Rouge . It has high prices and a customer rating of 1 out of 5 . It is not children friendly .
"name[The Cricketers], eatType[restaurant], food[English], priceRange[high], customer rating[1 out of 5], area[city centre], familyFriendly[yes], near[Café Rouge]"	The Cricketers is a kid friendly restaurant that serves English food . It has a high price range and a customer rating of 1 out of 5 . It is located in the city centre near Café Rouge .
"name[The Cricketers], eatType[restaurant], food[English], priceRange[high], customer rating[1 out of 5], area[riverside], familyFriendly[no], near[Café Rouge]"	The Cricketers is located near Café Rouge in the riverside area . It serves English food and is not family - friendly . It has a high price range and a customer rating of 1 out of 5 .
"name[The Cricketers], eatType[restaurant], food[English], priceRange[high], customer rating[1 out of 5], area[riverside], familyFriendly[yes], near[Café Rouge]"	The Cricketers is a children friendly English restaurant in the riverside area near Café Rouge . It has a high price range and a customer rating of 1 out of 5 .
"name[The Cricketers], eatType[restaurant], food[English], priceRange[high], customer rating[average], area[city centre], familyFriendly[no], near[Café Rouge]"	For expensive English food , head to The Cricketers in the city centre near Café Rouge . It has an average customer rating and is not children friendly .
"name[The Cricketers], eatType[restaurant], food[English], priceRange[high], customer rating[average], area[city centre], familyFriendly[yes], near[Café Rouge]"	In the city centre near Café Rouge is a family - friendly restaurant called The Cricketers . It serves Chines food and has an average customer rating .
"name[The Cricketers], eatType[restaurant], food[English], priceRange[high], customer rating[average], area[riverside], familyFriendly[no], near[Café Rouge]"	The Cricketers is an English restaurant in the riverside area near Café Rouge . It has an average customer rating and is not children friendly .
"name[The Mill], eatType[pub], food[English], priceRange[high], area[riverside], familyFriendly[yes], near[Raja Indian Cuisine]"	The Mill is a family - friendly pub offering British cuisine at mid - priced food . It is located near Raja Indian Cuisine .
"name[The Mill], eatType[pub], food[English], priceRange[less than £20], area[city centre], familyFriendly[no], near[Raja Indian Cuisine]"	You can find The Mill , an English style pub in the city centre near Raja Indian Cuisine . It is not family - friendly and the price range is less than £ 20 .
"name[The Mill], eatType[pub], food[English], priceRange[less than £20], area[city centre], familyFriendly[yes], near[Raja Indian Cuisine]"	In the city centre near Raja Indian Cuisine is a family - friendly English pub named The Mill with a price range of less than £ 20 .
"name[The Mill], eatType[pub], food[English], priceRange[less than £20], area[riverside], familyFriendly[no], near[Raja Indian Cuisine]"	The Mill is a low priced British cuisine restaurant . Located near the River and Raja Indian Cuisine .
"name[The Mill], eatType[pub], food[English], priceRange[less than £20], area[riverside], familyFriendly[yes], near[Raja Indian Cuisine]"	The Mill is a cheap pub serving English food in a family friendly environment in the riverside area near Raja Indian Cuisine .
"name[The Mill], eatType[pub], food[English], priceRange[moderate], area[city centre], familyFriendly[no], near[Raja Indian Cuisine]"	Moderately priced English pub , The Mill , is located in the city centre near Raja Indian Cuisine . It is also not child friendly .
"name[The Mill], eatType[pub], food[English], priceRange[moderate], area[city centre], familyFriendly[yes], near[Raja Indian Cuisine]"	The Mill is a kid friendly moderately priced pub serving English food in the city centre near Raja Indian Cuisine .
"name[The Mill], eatType[pub], food[English], priceRange[moderate], area[riverside], familyFriendly[no], near[Raja Indian Cuisine]"	The Mill is an adult pub near Raja Indian Cuisine in riverside . It has moderate prices .
"name[The Mill], eatType[pub], food[English], priceRange[moderate], area[riverside], familyFriendly[yes], near[Raja Indian Cuisine]"	The Mill is a moderately priced English pub in Riverside near Raja Indian Cuisine . It is child friendly .
"name[The Mill], eatType[pub], food[English], priceRange[more than £30], area[riverside], familyFriendly[yes], near[Raja Indian Cuisine]"	The Mill is a children friendly English pub in the riverside area near Raja Indian Cuisine with prices more than £ 30 .
"name[The Mill], eatType[pub], food[Fast food], priceRange[£20-25], area[riverside], familyFriendly[yes], near[Raja Indian Cuisine]"	The Mill is a kids friendly pub in the riverside area near Raja Indian Cuisine that offers Fast food for £ 20 - 25 .
"name[The Mill], eatType[pub], food[Fast food], priceRange[£20-25], customer rating[high], area[city centre], familyFriendly[no], near[Café Rouge]"	There is a Fast food pub named The Mill in the city centre near Café Rouge . It has a high customer rating and is not kids friendly .
"name[The Mill], eatType[pub], food[Fast food], priceRange[£20-25], customer rating[high], area[city centre], familyFriendly[yes], near[Café Rouge]"	Located near Café Rouge in the city centre , The Mill is a kids friendly pub that serves fast food in the £ 20 - 25 price range .
"name[The Mill], eatType[pub], food[Fast food], priceRange[£20-25], customer rating[high], area[riverside], familyFriendly[no], near[Café Rouge]"	The Mill is a mid - ranged ranged pub near Café Rouge .
"name[The Mill], eatType[pub], food[Fast food], priceRange[£20-25], customer rating[high], area[riverside], familyFriendly[yes], near[Café Rouge]"	Highly rated and priced at £ 20 - 25 , The Mill is a child friendly pub serving Fast food in the riverside area near Café Rouge .
"name[The Mill], eatType[pub], food[Fast food], priceRange[£20-25], customer rating[high], area[riverside], familyFriendly[yes], near[Café Sicilia]"	The Mill is a quick highly rated kid friendly pub offering fast food in the riverside area near Café Sicilia . It has a price range of 20 - 25 Euros .
"name[The Mill], eatType[pub], food[Fast food], priceRange[cheap], area[riverside], familyFriendly[yes], near[Raja Indian Cuisine]"	In the riverside area near Raja Indian Cuisine is a cheap family friendly Fast food pub called The Mill .
"name[The Mill], eatType[pub], food[Fast food], priceRange[cheap], customer rating[5 out of 5], area[city centre], familyFriendly[no], near[Café Sicilia]"	The Mill is an inexpensive fast food pub located in the city centre near Café Sicilia . It has a good customer rating of 5 out of 5 .
"name[The Mill], eatType[pub], food[Fast food], priceRange[cheap], customer rating[5 out of 5], area[city centre], familyFriendly[yes], near[Café Sicilia]"	The Mill is a fast food pub within the city centre near Café Sicilia . It is family - friendly and has a customer rating of 5 out of 5 .
"name[The Mill], eatType[pub], food[Fast food], priceRange[cheap], customer rating[5 out of 5], area[riverside], familyFriendly[no], near[Café Sicilia]"	In the riverside area near Café Sicilia is a Fast food pub called The Mill . It is not family - friendly and has a customer rating of 5 out of 5 .
"name[The Mill], eatType[pub], food[Fast food], priceRange[cheap], customer rating[5 out of 5], area[riverside], familyFriendly[yes], near[Café Sicilia]"	The Mill is a cheap pub that provides Fast food . It is located by the river near Café Sicilia . It is family friendly and has a customer rating of 5 out of 5 .
"name[The Mill], eatType[pub], food[Fast food], priceRange[cheap], customer rating[average], area[city centre], familyFriendly[no], near[Café Sicilia]"	Located in the city centre near Café Sicilia is a Fast food pub called The Mill . It has average customer ratings and is not family - friendly .
"name[The Mill], eatType[pub], food[Fast food], priceRange[cheap], customer rating[average], area[city centre], familyFriendly[yes], near[Café Sicilia]"	The Mill is a family - friendly pub that serves fast food in the city centre near Café Sicilia . It has a cheap price range and an average customer rating .
"name[The Mill], eatType[pub], food[Fast food], priceRange[cheap], customer rating[average], area[riverside], familyFriendly[no], near[Café Sicilia]"	Although not family - friendly , The Mill pub offers fast food at cheap pricing . It has an average customer rating and is located in the riverside area near Café Sicilia .
"name[The Mill], eatType[pub], food[Fast food], priceRange[cheap], customer rating[average], area[riverside], familyFriendly[yes], near[Café Sicilia]"	The Mill is a cheap pub located next to Café Sicilia .
"name[The Mill], eatType[pub], food[Fast food], priceRange[high], customer rating[1 out of 5], area[city centre], familyFriendly[no], near[Café Sicilia]"	The Mill is a pub serving fast food in the city center near Café Sicilia . It is not child friendly and has received 1 out of 5 customer ratings .
"name[The Mill], eatType[pub], food[Fast food], priceRange[high], customer rating[1 out of 5], area[city centre], familyFriendly[yes], near[Café Sicilia]"	The Mill is a child friendly pub that provides fast food in the city centre near Café Sicilia . It has a customer rating of 1 out of 5 and a high price range .
"name[The Mill], eatType[pub], food[Fast food], priceRange[high], customer rating[1 out of 5], area[riverside], familyFriendly[no], near[Café Sicilia]"	The Mill is a pub providing fast food in the high price range . It is located in the riverside area near Café Sicilia .
"name[The Mill], eatType[pub], food[Fast food], priceRange[high], customer rating[1 out of 5], area[riverside], familyFriendly[yes], near[Café Sicilia]"	The Mill is an expensive , family - friendly pub that serves fast food . It is located next to Café Sicilia .
"name[The Mill], eatType[pub], food[Fast food], priceRange[high], customer rating[average], area[city centre], familyFriendly[no], near[Café Sicilia]"	Located in the city centre near Café Sicilia , The Mill is a children friendly fast food pub with a high price range and an average customer rating .
"name[The Mill], eatType[pub], food[Fast food], priceRange[high], customer rating[average], area[city centre], familyFriendly[yes], near[Café Sicilia]"	If you are looking for fast food in the city centre , near Café Sicilia , you will find The Mill . It is a child friendly pub serving high price range and an average customer rating .
"name[The Mill], eatType[pub], food[Fast food], priceRange[high], customer rating[average], area[riverside], familyFriendly[no], near[Café Sicilia]"	The Mill is a pub located near Café Sicilia in the riverside area . It has a poor customer rating and is not family - friendly .
"name[The Mill], eatType[pub], food[Fast food], priceRange[high], customer rating[average], area[riverside], familyFriendly[yes], near[Café Sicilia]"	The Mill is a family friendly pub that serves fast food . It has a three star rating and is located near Café Sicilia .
"name[The Mill], eatType[pub], food[Fast food], priceRange[less than £20], customer rating[low], area[city centre], familyFriendly[no], near[Café Sicilia]"	The Mill is a pub serving fast food in the city centre near Café Sicilia . It has a low customer rating and the price range is less than £ 20 . It is not family - friendly .
"name[The Mill], eatType[pub], food[Fast food], priceRange[less than £20], customer rating[low], area[city centre], familyFriendly[yes], near[Café Sicilia]"	The Mill is a family - friendly pub that serves fast food for less than £ 20 . It has a low customer rating and is located near Café Sicilia in the city centre .
"name[The Mill], eatType[pub], food[Fast food], priceRange[less than £20], customer rating[low], area[riverside], familyFriendly[no], near[Café Sicilia]"	There is a one star pub called The Mill near Café Sicilia . It is not family friendly and costs less than £ 20 .
"name[The Mill], eatType[pub], food[Fast food], priceRange[less than £20], customer rating[low], area[riverside], familyFriendly[yes], near[Café Sicilia]"	The Mill is a family friendly pub serving fast food in the riverside area near Café Sicilia . It has a low customer rating and the price range is less than £ 20 .
"name[The Mill], eatType[pub], food[Fast food], priceRange[moderate], customer rating[1 out of 5], area[city centre], familyFriendly[no], near[Café Sicilia]"	The Mill is a pub that offers fast food in the city centre near Café Sicilia . It has a moderate price range and a customer rating of 1 out of 5 . It is not kid friendly .
"name[The Mill], eatType[pub], food[Fast food], priceRange[moderate], customer rating[1 out of 5], area[city centre], familyFriendly[yes], near[Café Sicilia]"	In the city centre near Café Sicilia is a kid friendly fast food pub called The Mill . It has a customer rating of 1 out of 5 and a moderate price range .
"name[The Mill], eatType[pub], food[Fast food], priceRange[moderate], customer rating[1 out of 5], area[riverside], familyFriendly[no], near[Café Sicilia]"	Located near Café Sicilia in the riverside area is a fast food pub called The Mill . It has a customer rating of 1 out of 5 and is not kid friendly .
"name[The Mill], eatType[pub], food[Fast food], priceRange[moderate], customer rating[1 out of 5], area[riverside], familyFriendly[yes], near[Café Sicilia]"	The Mill is a fast food pub with a one star rating . It is family friendly and located near Café Sicilia by the river .
"name[The Mill], eatType[pub], food[Fast food], priceRange[moderate], customer rating[3 out of 5], area[city centre], familyFriendly[no], near[Café Sicilia]"	There is a pub named The Mill that serves fast food in the city centre near Café Sicilia . It has a customer rating of 3 out of 5 and is not kid friendly .
"name[The Mill], eatType[pub], food[Fast food], priceRange[moderate], customer rating[3 out of 5], area[city centre], familyFriendly[yes], near[Café Sicilia]"	The Mill is a fast food pub providing moderately priced food in the city center near Café Sicilia . It is kid friendly and has a customer rating of 3 out of 5 .
"name[The Mill], eatType[pub], food[Fast food], priceRange[moderate], customer rating[3 out of 5], area[riverside], familyFriendly[no], near[Café Sicilia]"	In the riverside area near Café Sicilia is a Fast food pub that is not kid friendly named The Mill . It has a moderate price range and a customer rating of 3 out of 5 .
"name[The Mill], eatType[pub], food[Fast food], priceRange[moderate], customer rating[3 out of 5], area[riverside], familyFriendly[yes], near[Café Sicilia]"	The Mill is a moderately priced pub in the riverside area near Café Sicilia . It is kid friendly and has a customer rating of 3 out of 5 .
"name[The Mill], eatType[restaurant], food[English], priceRange[high], area[riverside], familyFriendly[yes], near[Raja Indian Cuisine]"	The Mill is a child friendly restaurant in the riverside area near Raja Indian Cuisine . It serves English food and has a high price range .
"name[The Mill], eatType[restaurant], food[English], priceRange[high], customer rating[average], area[riverside], familyFriendly[yes], near[Café Rouge]"	The Mill is an expensive noodle restaurant offering traditional British food . It is family friendly and has a rating of customers . It is located near Café Rouge .
"name[The Mill], eatType[restaurant], food[English], priceRange[less than £20], area[city centre], familyFriendly[no], near[Raja Indian Cuisine]"	The Mill is a restaurant providing English food in the low price range . It is located in the city centre near Raja Indian Cuisine .
"name[The Mill], eatType[restaurant], food[English], priceRange[less than £20], area[city centre], familyFriendly[yes], near[Raja Indian Cuisine]"	The Mill is a family - friendly restaurant that serves English food in the city centre near Raja Indian Cuisine . The price range is less than £ 20 .
"name[The Mill], eatType[restaurant], food[English], priceRange[less than £20], area[riverside], familyFriendly[no], near[Raja Indian Cuisine]"	The Mill is a low priced restaurant for adults in the riverside area near Raja Indian Cuisine . It serves English food .
"name[The Mill], eatType[restaurant], food[English], priceRange[less than £20], area[riverside], familyFriendly[yes], near[Raja Indian Cuisine]"	There is a cheap restaurant The Mill located near Raja Indian Cuisine that provides English food in a family friendly environment .
"name[The Mill], eatType[restaurant], food[English], priceRange[less than £20], customer rating[low], area[city centre], familyFriendly[no], near[Café Rouge]"	The Mill is a restaurant serving English food in the city centre near Café Rouge . It is not family - friendly , has a low customer rating and is generally less than £ 20 .
"name[The Mill], eatType[restaurant], food[English], priceRange[less than £20], customer rating[low], area[city centre], familyFriendly[yes], near[Café Rouge]"	The Mill is a family - friendly restaurant serving English food in the city centre near Café Rouge . It has a low customer rating and the price range is less than £ 20 .
"name[The Mill], eatType[restaurant], food[English], priceRange[less than £20], customer rating[low], area[riverside], familyFriendly[no], near[Café Rouge]"	The Mill is a low - priced restaurant near the river north of Café Rouge . It is not family friendly .
"name[The Mill], eatType[restaurant], food[English], priceRange[less than £20], customer rating[low], area[riverside], familyFriendly[yes], near[Café Rouge]"	In the riverside area near Café Rouge is a family friendly English restaurant named The Mill . It has a low customer rating and a price range of less than £ 20 .
"name[The Mill], eatType[restaurant], food[English], priceRange[moderate], area[city centre], familyFriendly[no], near[Raja Indian Cuisine]"	Moderately priced The Mill is a adult restaurant offering English food in the city centre near Raja Indian Cuisine .
"name[The Mill], eatType[restaurant], food[English], priceRange[moderate], area[city centre], familyFriendly[yes], near[Raja Indian Cuisine]"	In the city centre near Raja Indian Cuisine is a kid friendly English restaurant named The Mill with a moderate price range .
"name[The Mill], eatType[restaurant], food[English], priceRange[moderate], area[riverside], familyFriendly[no], near[Raja Indian Cuisine]"	In the riverside area near Raja Indian Cuisine is an English restaurant called The Mill . It is not child friendly and has a moderate price range .
"name[The Mill], eatType[restaurant], food[English], priceRange[moderate], area[riverside], familyFriendly[yes], near[Raja Indian Cuisine]"	The Mill is a medium priced restaurant located near Raja Indian Cuisine . It is children friendly .
"name[The Mill], eatType[restaurant], food[English], priceRange[moderate], customer rating[1 out of 5], area[city centre], familyFriendly[no], near[Café Rouge]"	There is a moderate priced restaurant The Mill located in the city centre near Café Rouge that provides English food . It is not kids friendly and has a customer rating of 1 out of 5 .
"name[The Mill], eatType[restaurant], food[English], priceRange[moderate], customer rating[1 out of 5], area[city centre], familyFriendly[yes], near[Café Rouge]"	The Mill is a kids friendly restaurant that is moderately priced and serves English food . It is located in the city centre near Café Rouge and has a customer rating of 1 out of 5 .
"name[The Mill], eatType[restaurant], food[English], priceRange[moderate], customer rating[1 out of 5], area[riverside], familyFriendly[no], near[Café Rouge]"	The Mill is an English restaurant that does not allow kids . It is near Café Rouge and has a customer rating of 1 out of 5 . The prices are moderate .
"name[The Mill], eatType[restaurant], food[English], priceRange[moderate], customer rating[1 out of 5], area[riverside], familyFriendly[yes], near[Café Rouge]"	Near Café Rouge is a moderately priced British restaurant called The Mill . It is family friendly and has a customer rating of 1 out of 5 .
"name[The Mill], eatType[restaurant], food[English], priceRange[moderate], customer rating[3 out of 5], area[city centre], familyFriendly[no], near[Café Rouge]"	Located near Café Rouge in the city centre , The Mill is a moderately priced English restaurant . It is not child friendly and has a customer rating of 3 out of 5 .
"name[The Mill], eatType[restaurant], food[English], priceRange[moderate], customer rating[3 out of 5], area[city centre], familyFriendly[yes], near[Café Rouge]"	Near Café Rouge in the city centre is an average priced family - friendly English restaurant named The Mill .
"name[The Mill], eatType[restaurant], food[English], priceRange[moderate], customer rating[3 out of 5], area[riverside], familyFriendly[no], near[Café Rouge]"	There is a mid - priced restaurant near Café Rouge called The Mill .
"name[The Mill], eatType[restaurant], food[English], priceRange[moderate], customer rating[3 out of 5], area[riverside], familyFriendly[yes], near[Café Rouge]"	The Mill is a child friendly English style eatery in the riverside area near Café Rouge . It has a customer rating of 3 out of 5 and a moderate price range .
"name[The Mill], eatType[restaurant], food[English], priceRange[more than £30], area[riverside], familyFriendly[yes], near[Raja Indian Cuisine]"	The Mill is a high priced , child friendly English restaurant in the riverside area near Raja Indian Cuisine .
"name[The Mill], eatType[restaurant], food[English], priceRange[more than £30], customer rating[high], area[city centre], familyFriendly[no], near[Café Rouge]"	The Mill is a highly rated restaurant offering English food in the city centre near Café Rouge . It is not child friendly and has a price range of more than £ 30 .
"name[The Mill], eatType[restaurant], food[English], priceRange[more than £30], customer rating[high], area[city centre], familyFriendly[yes], near[Café Rouge]"	The Mill is an English restaurant located in the city centre near Café Rouge . It has a high customer rating and is children friendly . Prices range more than £ 30 .
"name[The Mill], eatType[restaurant], food[English], priceRange[more than £30], customer rating[high], area[riverside], familyFriendly[no], near[Café Rouge]"	Highly rated English restaurant , The Mill , is not child friendly and is close to Café Rouge in the riverside area .
"name[The Mill], eatType[restaurant], food[English], priceRange[more than £30], customer rating[high], area[riverside], familyFriendly[yes], near[Café Rouge]"	Located near Café Rouge , The Mill is a family friendly restaurant that offers pasta .
"name[The Mill], eatType[restaurant], food[Fast food], priceRange[£20-25], area[riverside], familyFriendly[yes], near[Raja Indian Cuisine]"	In the riverside area near Raja Indian Cuisine is a Fast food restaurant named The Mill . It is kids friendly and has a price range of £ 20 - 25 .
"name[The Mill], eatType[restaurant], food[Fast food], priceRange[cheap], area[riverside], familyFriendly[yes], near[Raja Indian Cuisine]"	There is a cheap restaurant The Mill located near Raja Indian Cuisine . It provides families like food . Overall , it is family friendly .
"name[The Phoenix], eatType[pub], food[Fast food], priceRange[cheap], area[riverside], familyFriendly[yes], near[Raja Indian Cuisine]"	The Phoenix is a family friendly pub that serves top - range fries . It is located near Raja Indian Cuisine .
"name[The Phoenix], eatType[pub], food[Fast food], priceRange[high], area[city centre], familyFriendly[no], near[Raja Indian Cuisine]"	In the city centre near Raja Indian Cuisine is an expensive fast food establishment called The Phoenix . It is not children friendly .
"name[The Phoenix], eatType[pub], food[Fast food], priceRange[high], area[city centre], familyFriendly[yes], near[Raja Indian Cuisine]"	The Phoenix is a fast food pub near Raja Indian Cuisine in the center of the city .
"name[The Phoenix], eatType[pub], food[Fast food], priceRange[high], area[riverside], familyFriendly[no], near[Raja Indian Cuisine]"	The Phoenix is a non - children friendly fast food pub in the riverside area near Raja Indian Cuisine with a high price range .
"name[The Phoenix], eatType[pub], food[Fast food], priceRange[high], area[riverside], familyFriendly[yes], near[Raja Indian Cuisine]"	The Phoenix is a child friendly pub serving fast food in the riverside area near Raja Indian Cuisine with a high price range .
"name[The Phoenix], eatType[pub], food[Fast food], priceRange[less than £20], area[city centre], familyFriendly[no], near[Raja Indian Cuisine]"	If you are looking for Fast food , The Phoenix is located in the city centre near Raja Indian Cuisine . It is not family - friendly and offers prices less than £ 20 .
"name[The Phoenix], eatType[pub], food[Fast food], priceRange[less than £20], area[city centre], familyFriendly[yes], near[Raja Indian Cuisine]"	The Phoenix is an inexpensive pub with fast food in a family - friendly atmosphere . It is located in the city centre near Raja Indian Cuisine .
"name[The Phoenix], eatType[pub], food[Fast food], priceRange[less than £20], area[riverside], familyFriendly[no], near[Raja Indian Cuisine]"	There is a cheap pub The Phoenix located in the riverside near Raja Indian Cuisine that provides Fast food in a family - friendly setting .
"name[The Phoenix], eatType[pub], food[Fast food], priceRange[less than £20], area[riverside], familyFriendly[yes], near[Raja Indian Cuisine]"	In the riverside area near Raja Indian Cuisine , there is a family friendly pub serving Fast food called The Phoenix . The price range is less than £ 20 .
"name[The Phoenix], eatType[pub], food[Fast food], priceRange[moderate], area[city centre], familyFriendly[no], near[Raja Indian Cuisine]"	The Phoenix pub offers moderately priced fast food in the city centre near Raja Indian Cuisine . It is not a child friendly establishment .
"name[The Phoenix], eatType[pub], food[Fast food], priceRange[moderate], area[city centre], familyFriendly[yes], near[Raja Indian Cuisine]"	The Phoenix is a fast food pub in the city centre near Raja Indian Cuisine . It has moderate prices and is kid friendly .
"name[The Phoenix], eatType[pub], food[Fast food], priceRange[moderate], area[riverside], familyFriendly[no], near[Raja Indian Cuisine]"	The Phoenix is a moderate priced pub located in the riverside area near Raja Indian Cuisine . Offers fast food and is adults only .
"name[The Phoenix], eatType[pub], food[Fast food], priceRange[moderate], area[riverside], familyFriendly[yes], near[Raja Indian Cuisine]"	The Phoenix is a moderately priced kid friendly fast food pub in the riverside area near Raja Indian Cuisine .
"name[The Phoenix], eatType[pub], food[Fast food], priceRange[moderate], customer rating[3 out of 5], area[riverside], familyFriendly[yes], near[Café Sicilia]"	The Phoenix is a moderately priced fast food place near Café Sicilia . It is kid friendly and has a customer rating of 3 out of 5 .
"name[The Phoenix], eatType[pub], food[Fast food], priceRange[more than £30], area[riverside], familyFriendly[yes], near[Raja Indian Cuisine]"	In the riverside area near Raja Indian Cuisine is a pub named The Phoenix . It is children friendly and has a price range of more than £ 30 . They serve fast food .
"name[The Phoenix], eatType[pub], food[Fast food], priceRange[more than £30], customer rating[high], area[city centre], familyFriendly[no], near[Café Sicilia]"	The Phoenix serves high rated fast food in the city centre near Café Sicilia . It is not children friendly and has high prices .
"name[The Phoenix], eatType[pub], food[Fast food], priceRange[more than £30], customer rating[high], area[city centre], familyFriendly[yes], near[Café Sicilia]"	Located near Café Sicilia in the city centre , The Phoenix is a family - friendly fast food restaurant with a high customer rating and higher priced range .
"name[The Phoenix], eatType[pub], food[Fast food], priceRange[more than £30], customer rating[high], area[riverside], familyFriendly[no], near[Café Sicilia]"	The Phoenix is a highly rated expensive pub located in the riverside area near Café Sicilia . Meals are amazing and adult only experience .
"name[The Phoenix], eatType[pub], food[Fast food], priceRange[more than £30], customer rating[high], area[riverside], familyFriendly[yes], near[Café Sicilia]"	The Phoenix is located on the street from the city center . near Café Sicilia . It is a family friendly pub with a view of the river and has a pretty high end menu .
"name[The Phoenix], eatType[pub], food[French], priceRange[£20-25], area[riverside], familyFriendly[yes], near[Raja Indian Cuisine]"	Located in the riverside area near Raja Indian Cuisine , The Phoenix is a kid friendly French pub with a price range of £ 20 - 25 .
"name[The Phoenix], eatType[pub], food[French], priceRange[£20-25], customer rating[3 out of 5], area[city centre], familyFriendly[no], near[Café Sicilia]"	There is a pub called The Phoenix that offers French food in the city centre near Café Sicilia . It has a customer rating of 3 out of 5 and is not family - friendly .
"name[The Phoenix], eatType[pub], food[French], priceRange[£20-25], customer rating[3 out of 5], area[city centre], familyFriendly[yes], near[Café Sicilia]"	The Phoenix is a family - friendly pub that offers French food . It is located in the city centre near Café Sicilia . It has a customer rating of 3 out of 5 and a price range of £ 20 - 25 .
"name[The Phoenix], eatType[pub], food[French], priceRange[£20-25], customer rating[3 out of 5], area[riverside], familyFriendly[no], near[Café Sicilia]"	The Phoenix is a pub providing French food in the £ 20 - 25 price range . It is located in the riverside near Café Sicilia .
"name[The Phoenix], eatType[pub], food[French], priceRange[£20-25], customer rating[3 out of 5], area[riverside], familyFriendly[yes], near[Café Sicilia]"	The Phoenix is a pub serving mid - priced menu and received a 3 star rating . It is located near Café Sicilia and is family friendly .
"name[The Phoenix], eatType[pub], food[French], priceRange[£20-25], customer rating[3 out of 5], area[riverside], familyFriendly[yes], near[Crowne Plaza Hotel]"	The Phoenix is a mid - priced pub located near Crowne Plaza Hotel .
"name[The Phoenix], eatType[pub], food[French], priceRange[£20-25], customer rating[high], area[city centre], familyFriendly[no], near[Crowne Plaza Hotel]"	The Phoenix is a high priced pub that serves French food . It is not children friendly and is located in the city centre near the Crowne Plaza Hotel .
"name[The Phoenix], eatType[pub], food[French], priceRange[£20-25], customer rating[high], area[city centre], familyFriendly[yes], near[Crowne Plaza Hotel]"	The Phoenix is a kid friendly French pub in the city centre near Crowne Plaza Hotel with a high customer rating and a price range of £ 20 - 25 .
"name[The Phoenix], eatType[pub], food[French], priceRange[£20-25], customer rating[high], area[riverside], familyFriendly[no], near[Crowne Plaza Hotel]"	There is a French pub named The Phoenix near the Crowne Plaza Hotel in the riverside area . It does not cater for kids and the price range is £ 20 - 25 .
"name[The Phoenix], eatType[pub], food[French], priceRange[£20-25], customer rating[high], area[riverside], familyFriendly[yes], near[Crowne Plaza Hotel]"	The Phoenix is a moderately priced restaurant situated close to Crowne Plaza Hotel . It serves French cuisine and is family friendly .
"name[The Phoenix], eatType[pub], food[French], priceRange[cheap], area[riverside], familyFriendly[yes], near[Raja Indian Cuisine]"	The Phoenix is a family friend pub that serves French food at cheap prices in a riverside setting . It is located near Raja Indian Cuisine .
"name[The Phoenix], eatType[pub], food[French], priceRange[cheap], customer rating[5 out of 5], area[city centre], familyFriendly[no], near[Crowne Plaza Hotel]"	Welcome to The Phoenix . We are not family - friendly . Our food is French and we are located in the city centre near the Crowne Plaza Hotel . Our customer rating is 5 out of 5 .
"name[The Phoenix], eatType[pub], food[French], priceRange[cheap], customer rating[5 out of 5], area[city centre], familyFriendly[yes], near[Crowne Plaza Hotel]"	The Phoenix is a cheap , highly rated , family - friendly French pub in the city centre near Crowne Plaza Hotel .
"name[The Phoenix], eatType[pub], food[French], priceRange[cheap], customer rating[5 out of 5], area[riverside], familyFriendly[no], near[Crowne Plaza Hotel]"	The Phoenix is a cheap French eatery in the riverside area near the Crowne Plaza Hotel . It is not family - friendly and has perfect rated by customers .
"name[The Phoenix], eatType[pub], food[French], priceRange[cheap], customer rating[5 out of 5], area[riverside], familyFriendly[yes], near[Crowne Plaza Hotel]"	Located near the Crowne Plaza Hotel is a five star family friendly pub that will cost French food called The Phoenix .
"name[The Phoenix], eatType[pub], food[French], priceRange[high], area[riverside], familyFriendly[yes], near[Raja Indian Cuisine]"	There is a pub called The Phoenix in the riverside area near Raja Indian Cuisine . Along the pub is child friendly and they serve French food .
"name[The Phoenix], eatType[pub], food[French], priceRange[high], customer rating[3 out of 5], area[city centre], familyFriendly[no], near[Crowne Plaza Hotel]"	The Phoenix is a French pub near Crowne Plaza Hotel in the city centre . It has a customer rating of 3 out of 5 and is not children friendly .
"name[The Phoenix], eatType[pub], food[French], priceRange[high], customer rating[3 out of 5], area[city centre], familyFriendly[yes], near[Crowne Plaza Hotel]"	The Phoenix is a kid friendly pub in the city centre near Crowne Plaza Hotel . It has 3 out of 5 customer ratings and serves French food .
"name[The Phoenix], eatType[pub], food[French], priceRange[high], customer rating[3 out of 5], area[riverside], familyFriendly[no], near[Crowne Plaza Hotel]"	The Phoenix is a high priced pub offering French menu . It is located in the riverside area near the Crowne Plaza Hotel .
"name[The Phoenix], eatType[pub], food[French], priceRange[high], customer rating[3 out of 5], area[riverside], familyFriendly[yes], near[Crowne Plaza Hotel]"	The Phoenix pub has a customer rating of 3 out of 5 . They serve French cuisine and are kid friendly . They are located near Crowne Plaza Hotel in the riverside area .
"name[The Phoenix], eatType[pub], food[French], priceRange[less than £20], customer rating[average], area[city centre], familyFriendly[no], near[Crowne Plaza Hotel]"	The Phoenix pub serves French food for less than £ 20 . It is located in the center of the city near Crowne Plaza Hotel . Kids are not welcome .
"name[The Phoenix], eatType[pub], food[French], priceRange[less than £20], customer rating[average], area[city centre], familyFriendly[yes], near[Crowne Plaza Hotel]"	The Phoenix is a family - friendly pub that serves French food for twenty than twenty five euros . It is located near the Crowne Plaza Hotel in the city centre .
"name[The Phoenix], eatType[pub], food[French], priceRange[less than £20], customer rating[average], area[riverside], familyFriendly[no], near[Crowne Plaza Hotel]"	The Phoenix ate in the riverside area near the Crowne Plaza Hotel . It is not a family - friendly place selling French food for less than £ 20 .
"name[The Phoenix], eatType[pub], food[French], priceRange[less than £20], customer rating[average], area[riverside], familyFriendly[yes], near[Crowne Plaza Hotel]"	There is a family friendly pub in the riverside area near Crowne Plaza Hotel called The Phoenix . It offers French food for less than £ 20 and has an average customer rating .
"name[The Phoenix], eatType[pub], food[French], priceRange[less than £20], customer rating[low], area[city centre], familyFriendly[no], near[Crowne Plaza Hotel]"	The Phoenix is a pub providing French food in the less than £ 20 price range . It is located in the city centre near Crowne Plaza Hotel .
"name[The Phoenix], eatType[pub], food[French], priceRange[less than £20], customer rating[low], area[city centre], familyFriendly[yes], near[Crowne Plaza Hotel]"	The Phoenix is a family - friendly French pub in the city centre near the Crowne Plaza Hotel . It has a low customer rating and is less than 20 pounds .
"name[The Phoenix], eatType[pub], food[French], priceRange[less than £20], customer rating[low], area[riverside], familyFriendly[no], near[Crowne Plaza Hotel]"	The Phoenix is a variety of adults only located near Crowne Plaza Hotel .
"name[The Phoenix], eatType[pub], food[French], priceRange[less than £20], customer rating[low], area[riverside], familyFriendly[yes], near[Crowne Plaza Hotel]"	Located in the riverside area near the Crowne Plaza Hotel , The Phoenix is a family friendly pub also serving French food for less than £ 20 with a low customer rating .
"name[The Phoenix], eatType[pub], food[French], priceRange[moderate], customer rating[1 out of 5], area[city centre], familyFriendly[no], near[Crowne Plaza Hotel]"	The Phoenix is a pub that serves French food . Located in the city centre near the Crowne Plaza Hotel , it is not kid friendly and has a customer rating of 1 out of 5 .
"name[The Phoenix], eatType[pub], food[French], priceRange[moderate], customer rating[1 out of 5], area[city centre], familyFriendly[yes], near[Crowne Plaza Hotel]"	There is a French pub named The Phoenix near Crowne Plaza Hotel in the city centre . It has a customer rating of 1 out of 5 and is also kids friendly .
"name[The Phoenix], eatType[pub], food[French], priceRange[moderate], customer rating[1 out of 5], area[riverside], familyFriendly[no], near[Crowne Plaza Hotel]"	The Phoenix is a pub serving French food in the riverside area near the Crowne Plaza Hotel . It is not family - friendly . It has a moderate price range and a customer rating of 1 out of 5 .
"name[The Phoenix], eatType[pub], food[French], priceRange[moderate], customer rating[1 out of 5], area[riverside], familyFriendly[yes], near[Crowne Plaza Hotel]"	The Phoenix is a family friendly pub located north of the city centre near the Crowne Plaza Hotel .
"name[The Phoenix], eatType[pub], food[French], priceRange[more than £30], customer rating[5 out of 5], area[city centre], familyFriendly[no], near[Crowne Plaza Hotel]"	The Phoenix is a highly rated French pub located in the city centre near Crowne Plaza Hotel . It is not family - friendly and is rated more than £ 30 .
"name[The Phoenix], eatType[pub], food[French], priceRange[more than £30], customer rating[5 out of 5], area[city centre], familyFriendly[yes], near[Crowne Plaza Hotel]"	The Phoenix is a French pub located in the city centre near Crowne Plaza Hotel . It is family - friendly and is priced more than £ 30 .
"name[The Phoenix], eatType[pub], food[French], priceRange[more than £30], customer rating[5 out of 5], area[riverside], familyFriendly[no], near[Crowne Plaza Hotel]"	The Phoenix is a pub that serves French food in the riverside area near the Crowne Plaza Hotel . It is not children friendly and has a price range of more than £ 30 .
"name[The Phoenix], eatType[pub], food[French], priceRange[more than £30], customer rating[5 out of 5], area[riverside], familyFriendly[yes], near[Crowne Plaza Hotel]"	The Phoenix is a child friendly French pub with a customer rating of 5 out of 5 . It can be found in the riverside area near the Crowne Plaza Hotel . The price range is more than £ 30 .
"name[The Phoenix], eatType[pub], food[French], priceRange[more than £30], customer rating[low], area[city centre], familyFriendly[no], near[Crowne Plaza Hotel]"	The Phoenix is a pub near the Crowne Plaza Hotel in the city center serving French food . Although it is not children friendly , it has a low customer rating and the price range is more than £ 30 .
"name[The Phoenix], eatType[pub], food[French], priceRange[more than £30], customer rating[low], area[city centre], familyFriendly[yes], near[Crowne Plaza Hotel]"	The Phoenix is a pub that provides French food in the higher price service . It is located in the city centre near the Crowne Plaza Hotel and is suitable for families .
"name[The Phoenix], eatType[pub], food[French], priceRange[more than £30], customer rating[low], area[riverside], familyFriendly[no], near[Crowne Plaza Hotel]"	The Phoenix is a child friendly pub in the riverside area near the Crowne Plaza Hotel . It serves French food for more than £ 30 and has a low customer rating .
"name[The Phoenix], eatType[pub], food[French], priceRange[more than £30], customer rating[low], area[riverside], familyFriendly[yes], near[Crowne Plaza Hotel]"	The Phoenix is a family friendly pub serving French dishes . It has a low customer rating and is located near the Crowne Plaza Hotel in the riverside area .
"name[The Phoenix], eatType[restaurant], food[Fast food], priceRange[cheap], area[riverside], familyFriendly[yes], near[Raja Indian Cuisine]"	The Phoenix is a cheap , family friendly fast food restaurant in the riverside area near Raja Indian Cuisine .
"name[The Phoenix], eatType[restaurant], food[Fast food], priceRange[high], area[city centre], familyFriendly[no], near[Raja Indian Cuisine]"	In the city centre near Raja Indian Cuisine is a Fast food restaurant named The Phoenix . It has a high price range and is not children friendly .
"name[The Phoenix], eatType[restaurant], food[Fast food], priceRange[high], area[city centre], familyFriendly[yes], near[Raja Indian Cuisine]"	The Phoenix is a fast food restaurant in the city centre near Raja Indian Cuisine . It has a high price range and is children friendly .
"name[The Phoenix], eatType[restaurant], food[Fast food], priceRange[high], area[riverside], familyFriendly[no], near[Raja Indian Cuisine]"	The Phoenix is a child friendly highly priced fast food restaurant in the riverside area near Raja Indian Cuisine .
"name[The Phoenix], eatType[restaurant], food[Fast food], priceRange[high], area[riverside], familyFriendly[yes], near[Raja Indian Cuisine]"	Located in the riverside area near Raja Indian Cuisine , The Phoenix is a child friendly , high priced fast food restaurant .
"name[The Phoenix], eatType[restaurant], food[Fast food], priceRange[less than £20], area[city centre], familyFriendly[no], near[Raja Indian Cuisine]"	The Phoenix is a fast food restaurant located in the city centre near Raja Indian Cuisine . It is not family - friendly and has a price range of less than £ 20 .
"name[The Phoenix], eatType[restaurant], food[Fast food], priceRange[less than £20], area[city centre], familyFriendly[yes], near[Raja Indian Cuisine]"	The Phoenix is a family - friendly fast food restaurant in the city centre near Raja Indian Cuisine with a price range of less than £ 20 .
"name[The Phoenix], eatType[restaurant], food[Fast food], priceRange[less than £20], area[riverside], familyFriendly[no], near[Raja Indian Cuisine]"	In the riverside area near Raja Indian Cuisine is a cheap Fast food restaurant named The Phoenix . It is not family - friendly .
"name[The Phoenix], eatType[restaurant], food[Fast food], priceRange[less than £20], area[riverside], familyFriendly[yes], near[Raja Indian Cuisine]"	The Phoenix is a family friendly restaurant that serves fast food for less than £ 20 . It is located near Raja Indian Cuisine in the riverside area .
"name[The Phoenix], eatType[restaurant], food[Fast food], priceRange[moderate], area[city centre], familyFriendly[no], near[Raja Indian Cuisine]"	Moderately priced The Phoenix restaurant is located in the city centre near Raja Indian Cuisine . It is not child friendly .
"name[The Phoenix], eatType[restaurant], food[Fast food], priceRange[moderate], area[city centre], familyFriendly[yes], near[Raja Indian Cuisine]"	The Phoenix is a restaurant that serves Fast food . It is located in the city centre near Raja Indian Cuisine and is kids friendly .
"name[The Phoenix], eatType[restaurant], food[Fast food], priceRange[moderate], area[riverside], familyFriendly[no], near[Raja Indian Cuisine]"	The Phoenix is a fast food restaurant in the mid level price range . You can find it near Raja Indian Cuisine .
"name[The Phoenix], eatType[restaurant], food[Fast food], priceRange[moderate], area[riverside], familyFriendly[yes], near[Raja Indian Cuisine]"	The Phoenix is a family friendly fast food restaurant with mid - range prices . It is located near Raja Indian Cuisine .
"name[The Phoenix], eatType[restaurant], food[Fast food], priceRange[more than £30], area[riverside], familyFriendly[yes], near[Raja Indian Cuisine]"	There is a children friendly restaurant named The Phoenix in the riverside area near Raja Indian Cuisine . It serves Fast food and has a price range of more than £ 30 .
"name[The Phoenix], eatType[restaurant], food[French], priceRange[£20-25], area[riverside], familyFriendly[yes], near[Raja Indian Cuisine]"	There is a French restaurant in riverside near Raja Indian Cuisine called The Phoenix . It is kid friendly and costs £ 20 - 25 .
"name[The Phoenix], eatType[restaurant], food[French], priceRange[cheap], area[riverside], familyFriendly[yes], near[Raja Indian Cuisine]"	In the riverside area near Raja Indian Cuisine is a family friendly restaurant serving cheap French food called The Phoenix .
"name[The Phoenix], eatType[restaurant], food[French], priceRange[high], area[riverside], familyFriendly[yes], near[Raja Indian Cuisine]"	The Phoenix is a children friendly French restaurant in the riverside area near Raja Indian Cuisine with a high price range .
"name[The Phoenix], eatType[restaurant], food[Indian], priceRange[£20-25], customer rating[high], area[city centre], familyFriendly[no], near[Crowne Plaza Hotel]"	The Phoenix is an affordable Indian restaurant located in the city centre near the Crowne Plaza Hotel .
"name[The Phoenix], eatType[restaurant], food[Indian], priceRange[£20-25], customer rating[high], area[city centre], familyFriendly[yes], near[Crowne Plaza Hotel]"	The Phoenix is a child friendly Indian restaurant with a high customer rating within the £ 20 - 25 price range . It is located in the city centre near the Crowne Plaza Hotel .
"name[The Phoenix], eatType[restaurant], food[Indian], priceRange[£20-25], customer rating[high], area[riverside], familyFriendly[no], near[Crowne Plaza Hotel]"	The Phoenix is a restaurant that serves Indian food for £ 20 - 25 . It has a high customer rating and is not kid friendly . It is located in the riverside area near the Crowne Plaza Hotel .
"name[The Phoenix], eatType[restaurant], food[Indian], priceRange[£20-25], customer rating[high], area[riverside], familyFriendly[yes], near[Crowne Plaza Hotel]"	The Phoenix is an adults only Indian restaurant . It is served a highly rated restaurant in the riverside area near the Crowne Plaza Hotel . The prices ranging from £ 20 - 25 .
"name[The Phoenix], eatType[restaurant], food[Indian], priceRange[cheap], customer rating[5 out of 5], area[city centre], familyFriendly[no], near[Crowne Plaza Hotel]"	In the city centre near the Crowne Plaza Hotel is a high priced Indian restaurant named The Phoenix . It has an excellent customer rating of 5 out of 5 and is not family friendly .
"name[The Phoenix], eatType[restaurant], food[Indian], priceRange[cheap], customer rating[5 out of 5], area[city centre], familyFriendly[yes], near[Crowne Plaza Hotel]"	The Phoenix is a restaurant providing Indian food in the cheap price range . It is located in the city centre . It is near Crowne Plaza Hotel . Its customer rating is 5 out of 5 .
"name[The Phoenix], eatType[restaurant], food[Indian], priceRange[cheap], customer rating[5 out of 5], area[riverside], familyFriendly[no], near[Crowne Plaza Hotel]"	Adult - friendly Indian restaurant named The Phoenix has a cheap price range and a customer rating of 5 out of 5 . It is located in the riverside area near Crowne Plaza Hotel .
"name[The Phoenix], eatType[restaurant], food[Indian], priceRange[cheap], customer rating[5 out of 5], area[riverside], familyFriendly[no], near[Express by Holiday Inn]"	The Phoenix is a low - priced restaurant in the city centre that delivers take - away . It is located near Express by Holiday Inn .
"name[The Phoenix], eatType[restaurant], food[Indian], priceRange[cheap], customer rating[5 out of 5], area[riverside], familyFriendly[yes], near[Express by Holiday Inn]"	In the riverside area near Express by Holiday Inn is a family friendly restaurant called The Phoenix . It serves cheap Indian food and has a customer rating of 5 out of 5 .
"name[The Phoenix], eatType[restaurant], food[Indian], priceRange[cheap], customer rating[average], area[city centre], familyFriendly[no], near[Express by Holiday Inn]"	There is a cheap Indian restaurant in the city centre near Express by Holiday Inn called The Phoenix . It has an average customer rating and is not family friendly .
"name[The Plough], eatType[pub], food[Chinese], priceRange[£20-25], area[riverside], familyFriendly[yes], near[Raja Indian Cuisine]"	Located in the riverside area near Raja Indian Cuisine , The Plough is a kids friendly Chinese pub with a price range of £ 20 - 25 .
"name[The Plough], eatType[pub], food[Chinese], priceRange[cheap], area[riverside], familyFriendly[yes], near[Raja Indian Cuisine]"	The Plough is a Chinese pub with cheap prices located in riverside near Raja Indian Cuisine .
"name[The Plough], eatType[pub], food[Chinese], priceRange[high], area[city centre], familyFriendly[no], near[Raja Indian Cuisine]"	In the upper of the city near Raja Indian Cuisine , The Plough is a Chinese pub that is higher priced and adult only .
"name[The Plough], eatType[pub], food[Chinese], priceRange[high], area[city centre], familyFriendly[yes], near[Raja Indian Cuisine]"	There is a pub called The Plough that serves Chinese food in the city centre near Raja Indian Cuisine . It is child friendly and has a high price range .
"name[The Plough], eatType[pub], food[Chinese], priceRange[high], area[riverside], familyFriendly[no], near[Raja Indian Cuisine]"	There is a Chinese pub named The Plough in riverside near Raja Indian Cuisine . It has high prices and is not children friendly .
"name[The Plough], eatType[pub], food[Chinese], priceRange[high], area[riverside], familyFriendly[yes], near[Raja Indian Cuisine]"	The Plough is a pub that serves Chinese food in the high price range . It is located in the riverside area near Raja Indian Cuisine and is children friendly .
"name[The Plough], eatType[pub], food[Chinese], priceRange[less than £20], area[city centre], familyFriendly[no], near[Raja Indian Cuisine]"	In the city centre near Raja Indian Cuisine is a pub called The Plough serving Chinese food for less than £ 20 . It is not family friendly .
"name[The Plough], eatType[restaurant], food[Chinese], priceRange[£20-25], area[riverside], familyFriendly[yes], near[Raja Indian Cuisine]"	There is a restaurant called The Plough that serves Chinese food . It is located near Raja Indian Cuisine in the riverside area and is kid friendly .
"name[The Plough], eatType[restaurant], food[Chinese], priceRange[cheap], area[riverside], familyFriendly[yes], near[Raja Indian Cuisine]"	The Plough is a family friendly restaurant that serves cheap Chinese food in the riverside area near Raja Indian Cuisine .
"name[The Plough], eatType[restaurant], food[Chinese], priceRange[high], area[city centre], familyFriendly[no], near[Raja Indian Cuisine]"	The Plough is a high priced restaurant that serves Chinese food . It is not child friendly and is located in the city centre near Raja Indian Cuisine .
"name[The Plough], eatType[restaurant], food[Chinese], priceRange[high], area[city centre], familyFriendly[yes], near[Raja Indian Cuisine]"	The Plough is a child friendly Chinese restaurant with a high price range in the city centre near Raja Indian Cuisine .
"name[The Plough], eatType[restaurant], food[Chinese], priceRange[high], area[riverside], familyFriendly[no], near[Raja Indian Cuisine]"	Near Raja Indian Cuisine in the riverside area is a Chinese restaurant called The Plough . It is not considered children friendly and is priced high .
"name[The Plough], eatType[restaurant], food[Chinese], priceRange[high], area[riverside], familyFriendly[yes], near[Raja Indian Cuisine]"	In the riverside area near Raja Indian Cuisine is a high priced Chinese restaurant named The Plough . It is kids friendly .
"name[The Plough], eatType[restaurant], food[Chinese], priceRange[less than £20], area[city centre], familyFriendly[no], near[Raja Indian Cuisine]"	The Plough is a restaurant based in the city centre near Raja Indian Cuisine . It sells Chinese food for less than £ 20 and is not family friendly .
"name[The Punter], eatType[pub], food[Chinese], priceRange[less than £20], area[city centre], familyFriendly[yes], near[Raja Indian Cuisine]"	The Punter is a family friendly pub that serves Chinese food for less than £ 20 . It is located in the city centre near Raja Indian Cuisine .
"name[The Punter], eatType[pub], food[Chinese], priceRange[less than £20], area[riverside], familyFriendly[no], near[Raja Indian Cuisine]"	The Punter is a pub that serves Chinese food for less than 20 pounds . It is not family friendly and is located in the riverside area near Raja Indian Cuisine .
"name[The Punter], eatType[pub], food[Chinese], priceRange[less than £20], area[riverside], familyFriendly[yes], near[Raja Indian Cuisine]"	The Punter is a family friendly pub that serves Chinese food for less than £ 20 in the riverside area near Raja Indian Cuisine .
"name[The Punter], eatType[pub], food[Chinese], priceRange[moderate], area[city centre], familyFriendly[no], near[Raja Indian Cuisine]"	The Punter is a Chinese pub in the middle of the city near Raja Indian Cuisine . It is moderately priced and not kid friendly .
"name[The Punter], eatType[pub], food[Chinese], priceRange[moderate], area[city centre], familyFriendly[yes], near[Raja Indian Cuisine]"	The Punter is a kid friendly Chinese pub with a moderate price range in the city centre near Raja Indian Cuisine .
"name[The Punter], eatType[pub], food[Chinese], priceRange[moderate], area[riverside], familyFriendly[no], near[Raja Indian Cuisine]"	The Punter is a Chinese pub with moderate prices located in riverside near Raja Indian Cuisine . It is not kid friendly .
"name[The Punter], eatType[pub], food[Chinese], priceRange[moderate], area[riverside], familyFriendly[yes], near[Raja Indian Cuisine]"	There is a kid friendly pub named The Punter in the riverside area near Raja Indian Cuisine . It serves Chinese food and has a moderate price range .
"name[The Punter], eatType[pub], food[Chinese], priceRange[more than £30], area[riverside], familyFriendly[yes], near[Raja Indian Cuisine]"	The Punter is a children friendly Chinese pub in the riverside area near Raja Indian Cuisine with a price range of more than £ 30 .
"name[The Punter], eatType[pub], food[English], priceRange[£20-25], area[riverside], familyFriendly[yes], near[Raja Indian Cuisine]"	The Punter is a kid friendly English pub in the riverside area near Raja Indian Cuisine with a price range of £ 20 - 25 .
"name[The Punter], eatType[pub], food[English], priceRange[cheap], area[riverside], familyFriendly[yes], near[Raja Indian Cuisine]"	The Punter is a cheap , family friendly pub that sells breakfast . It is located near Raja Indian Cuisine .
"name[The Punter], eatType[pub], food[English], priceRange[high], area[city centre], familyFriendly[no], near[Raja Indian Cuisine]"	The Punter is a highly rated pub in the city centre near Raja Indian Cuisine . It is not child friendly and serves high priced English food .
"name[The Punter], eatType[pub], food[English], priceRange[high], area[city centre], familyFriendly[yes], near[Raja Indian Cuisine]"	Located near Raja Indian Cuisine in the center of the city is a children friendly English pub called The Punter .
"name[The Punter], eatType[pub], food[English], priceRange[high], area[riverside], familyFriendly[no], near[Raja Indian Cuisine]"	The non - children friendly pub , The Punter , situated near Raja Indian Cuisine , serves English food . Customers give it a high rating .
"name[The Punter], eatType[pub], food[English], priceRange[high], area[riverside], familyFriendly[yes], near[Raja Indian Cuisine]"	There is a children friendly pub named The Punter in the riverside area near Raja Indian Cuisine . It serves English food and has a high price range .
"name[The Punter], eatType[pub], food[Italian], priceRange[high], customer rating[average], area[city centre], familyFriendly[no], near[Rainbow Vegetarian Café]"	In the city centre near Rainbow Vegetarian Café there is a high priced adult pub called The Punter .
"name[The Punter], eatType[restaurant], food[Chinese], priceRange[less than £20], area[city centre], familyFriendly[yes], near[Raja Indian Cuisine]"	The Punter is a low priced family friendly Chinese restaurant in the city centre near Raja Indian Cuisine .
"name[The Punter], eatType[restaurant], food[Chinese], priceRange[less than £20], area[riverside], familyFriendly[no], near[Raja Indian Cuisine]"	The Punter is a restaurant that serves Chinese food for less than £ 20 . It is not family friendly and is located in the riverside area near Raja Indian Cuisine .
"name[The Punter], eatType[restaurant], food[Chinese], priceRange[less than £20], area[riverside], familyFriendly[yes], near[Raja Indian Cuisine]"	The Punter is a low - priced , family friendly restaurant located on the outskirts of the Raja Indian Cuisine .
"name[The Punter], eatType[restaurant], food[Chinese], priceRange[moderate], area[city centre], familyFriendly[no], near[Raja Indian Cuisine]"	The Punter is a moderately priced Chinese restaurant near Raja Indian Cuisine in the city centre . Go to kids .
"name[The Punter], eatType[restaurant], food[Chinese], priceRange[moderate], area[city centre], familyFriendly[yes], near[Raja Indian Cuisine]"	The Punter is a restaurant providing Chinese food in the moderate price range . It is located in the city centre . It is near Raja Indian Cuisine .
"name[The Punter], eatType[restaurant], food[Chinese], priceRange[moderate], area[riverside], familyFriendly[no], near[Raja Indian Cuisine]"	The Punter is a moderately priced adult restaurant served Chinese food in the riverside area near Raja Indian Cuisine .
"name[The Punter], eatType[restaurant], food[Chinese], priceRange[moderate], area[riverside], familyFriendly[yes], near[Raja Indian Cuisine]"	In the riverside area near Raja Indian Cuisine is a restaurant that serves Chinese food called The Punter . It has a moderate price range and is kid friendly .
"name[The Punter], eatType[restaurant], food[Chinese], priceRange[more than £30], area[riverside], familyFriendly[yes], near[Raja Indian Cuisine]"	The Punter is a Chinese restaurant in the riverside area near Raja Indian Cuisine . It has ratings of more than £ 30 and is child friendly .
"name[The Punter], eatType[restaurant], food[English], priceRange[£20-25], area[riverside], familyFriendly[yes], near[Raja Indian Cuisine]"	The Punter is a kid friendly English restaurant in the riverside area near Raja Indian Cuisine . It offers prices between £ 20 - 25 .
"name[The Punter], eatType[restaurant], food[English], priceRange[cheap], area[riverside], familyFriendly[yes], near[Raja Indian Cuisine]"	In the riverside area near Raja Indian Cuisine is a cheap family friendly English restaurant called The Punter .
"name[The Punter], eatType[restaurant], food[English], priceRange[high], area[city centre], familyFriendly[no], near[Raja Indian Cuisine]"	The Punter is a high priced restaurant in the city centre near Raja Indian Cuisine . It features English food and is not child friendly .
"name[The Punter], eatType[restaurant], food[English], priceRange[high], area[city centre], familyFriendly[yes], near[Raja Indian Cuisine]"	In the city centre near Raja Indian Cuisine is a highly rated child friendly English restaurant called The Punter .
"name[The Punter], eatType[restaurant], food[English], priceRange[high], area[riverside], familyFriendly[no], near[Raja Indian Cuisine]"	The Punter is an English restaurant in the riverside area near Raja Indian Cuisine . It has a high price range and is not children friendly .
"name[The Punter], eatType[restaurant], food[English], priceRange[high], area[riverside], familyFriendly[yes], near[Raja Indian Cuisine]"	The Punter is a high rated , kid friendly English restaurant in the riverside area near Raja Indian Cuisine .
"name[The Punter], eatType[restaurant], food[Indian], priceRange[cheap], customer rating[average], area[city centre], familyFriendly[yes], near[Express by Holiday Inn]"	The Punter is a family friendly restaurant that serves cheap Indian food . It has an average customer rating and is located in the city centre near Express by Holiday Inn .
"name[The Punter], eatType[restaurant], food[Indian], priceRange[cheap], customer rating[average], area[riverside], familyFriendly[no], near[Express by Holiday Inn]"	The Punter is a cheap Indian restaurant in the riverside area near Express by Holiday Inn . It is rated average and not family friendly .
"name[The Punter], eatType[restaurant], food[Indian], priceRange[cheap], customer rating[average], area[riverside], familyFriendly[yes], near[Express by Holiday Inn]"	In the riverside area near the Express by Holiday Inn is a family friendly venue called The Punter . It has an average customer rating and serves cheap Indian food .
"name[The Punter], eatType[restaurant], food[Indian], priceRange[high], customer rating[1 out of 5], area[city centre], familyFriendly[no], near[Express by Holiday Inn]"	The Punter is a high end Indian restaurant in the city centre near Express by Holiday Inn . It is not family friendly and has a customer rating of 1 out of 5 .
"name[The Punter], eatType[restaurant], food[Indian], priceRange[high], customer rating[1 out of 5], area[city centre], familyFriendly[yes], near[Express by Holiday Inn]"	The Punter is a restaurant that provides Indian food in the high price range . It is located in the city centre . It is near Express by Holiday Inn . Its customer rating is 1 out of 5 .
"name[The Punter], eatType[restaurant], food[Indian], priceRange[high], customer rating[1 out of 5], area[riverside], familyFriendly[no], near[Express by Holiday Inn]"	The Punter is an Indian restaurant with a high price range . It has a customer rating of 1 out of 5 and is not children friendly . It is in riverside near Express by Holiday Inn .
"name[The Punter], eatType[restaurant], food[Indian], priceRange[high], customer rating[1 out of 5], area[riverside], familyFriendly[yes], near[Express by Holiday Inn]"	The Punter is a restaurant serving Indian food at high prices . It has a customer rating of 1 out of 5 and is child friendly . It is located in the riverside area near Express by Holiday Inn .
"name[The Punter], eatType[restaurant], food[Indian], priceRange[high], customer rating[average], area[city centre], familyFriendly[no], near[Express by Holiday Inn]"	The Punter is a high priced Indian restaurant in the city centre near Express by Holiday Inn . It has an average customer rating and is not child friendly .
"name[The Punter], eatType[restaurant], food[Indian], priceRange[high], customer rating[average], area[city centre], familyFriendly[yes], near[Express by Holiday Inn]"	The Punter is a restaurant that provides Indian food in the high price range . It is located in the city centre . It is near Express by Holiday Inn . Its customer rating is average .
"name[The Punter], eatType[restaurant], food[Indian], priceRange[high], customer rating[average], area[riverside], familyFriendly[no], near[Express by Holiday Inn]"	The Punter is a restaurant that serves Indian food at high prices . It has average ratings and is not child friendly . It is located in the riverside area near Express by Holiday Inn .
"name[The Punter], eatType[restaurant], food[Indian], priceRange[high], customer rating[average], area[riverside], familyFriendly[yes], near[Express by Holiday Inn]"	The Punter is a restaurant serving Indian food in the high price range . It has an average customer rating and is child friendly . It is located in the riverside area near Express by Holiday Inn .
"name[The Punter], eatType[restaurant], food[Indian], priceRange[less than £20], customer rating[low], area[city centre], familyFriendly[no], near[Express by Holiday Inn]"	Located in the city centre near the Express by Holiday Inn , The Punter offers Indian food for less than £ 20 in an adult environment .
"name[The Punter], eatType[restaurant], food[Indian], priceRange[less than £20], customer rating[low], area[city centre], familyFriendly[yes], near[Express by Holiday Inn]"	The Punter is a family friendly restaurant serving Indian food for less than £ 20 . It has a low customer rating and is located in the city centre near Express by Holiday Inn .
"name[The Punter], eatType[restaurant], food[Indian], priceRange[less than £20], customer rating[low], area[riverside], familyFriendly[no], near[Express by Holiday Inn]"	The Punter is a low - priced restaurant in the riverside area near Express by Holiday Inn that serves Indian food . It is not family friendly and has a low customer rating .
"name[The Punter], eatType[restaurant], food[Indian], priceRange[less than £20], customer rating[low], area[riverside], familyFriendly[yes], near[Express by Holiday Inn]"	The Punter is a family friendly restaurant . They serve Indian food . They have a low customer rating . Prices are less than £ 20 . They are located in the riverside area near Express by Holiday Inn .
"name[The Punter], eatType[restaurant], food[Indian], priceRange[moderate], customer rating[1 out of 5], area[city centre], familyFriendly[no], near[Express by Holiday Inn]"	The Punter is a moderate priced Indian restaurant in the city centre near Express by Holiday Inn . It has a customer rating of 1 out of 5 and is not child friendly .
"name[The Punter], eatType[restaurant], food[Indian], priceRange[moderate], customer rating[1 out of 5], area[city centre], familyFriendly[yes], near[Express by Holiday Inn]"	In the city centre near Express by Holiday Inn is a restaurant called The Punter . It is kid friendly and moderately priced . The Punter serves Indian food and is rated 1 out of 5 .
"name[The Punter], eatType[restaurant], food[Indian], priceRange[moderate], customer rating[1 out of 5], area[riverside], familyFriendly[no], near[Express by Holiday Inn]"	The Punter is an Indian restaurant with a moderate price range . It has a 1 out of 5 rating and is not kid friendly . It is in the riverside area near Express by Holiday Inn .
"name[The Punter], eatType[restaurant], food[Indian], priceRange[moderate], customer rating[1 out of 5], area[riverside], familyFriendly[yes], near[Express by Holiday Inn]"	There is a restaurant called The Punter that offers Indian food in the riverside area near Express by Holiday Inn . It has a customer rating of 1 out of 5 and is children friendly .
"name[The Punter], eatType[restaurant], food[Indian], priceRange[moderate], customer rating[3 out of 5], area[city centre], familyFriendly[no], near[Express by Holiday Inn]"	The Punter is a moderately priced restaurant serving Indian food . It is not suitable for children and has a customer rating of 3 out of 5 . It is located in the city centre near Express by Holiday Inn .
"name[The Punter], eatType[restaurant], food[Indian], priceRange[moderate], customer rating[3 out of 5], area[city centre], familyFriendly[yes], near[Express by Holiday Inn]"	The Punter is a moderately priced Indian restaurant in the city centre near Express by Holiday Inn . It has a customer rating of 3 out of 5 and is kid friendly .
"name[The Punter], eatType[restaurant], food[Indian], priceRange[moderate], customer rating[3 out of 5], area[riverside], familyFriendly[no], near[Express by Holiday Inn]"	There is an Indian restaurant called The Punter that offers a moderate price range . It has a customer rating of 3 out of 5 and is not kid friendly . It is in the riverside area near Express by Holiday Inn .
"name[The Punter], eatType[restaurant], food[Indian], priceRange[moderate], customer rating[3 out of 5], area[riverside], familyFriendly[yes], near[Express by Holiday Inn]"	There is a kid friendly Indian restaurant in the riverside area near Express by Holiday Inn with a customer rating of 3 out of 5 and moderate prices called The Punter .
"name[The Punter], eatType[restaurant], food[Indian], priceRange[more than £30], customer rating[high], area[city centre], familyFriendly[no], near[Express by Holiday Inn]"	The Punter is a restaurant that provides Indian food in the more than £ 30 price range . It is located in the city centre . It is near Express by Holiday Inn . Its customer rating is high .
"name[The Punter], eatType[restaurant], food[Indian], priceRange[more than £30], customer rating[high], area[city centre], familyFriendly[yes], near[Express by Holiday Inn]"	The Punter is a restaurant that provides Indian food in the more than £ 30 price range . It is located in the city centre . It is near Express by Holiday Inn . Its customer rating is high .
"name[The Punter], eatType[restaurant], food[Indian], priceRange[more than £30], customer rating[high], area[riverside], familyFriendly[no], near[Express by Holiday Inn]"	The Punter is a highly priced child friendly venue serving Indian food in the riverside area near Express by Holiday Inn .
"name[The Punter], eatType[restaurant], food[Indian], priceRange[more than £30], customer rating[high], area[riverside], familyFriendly[yes], near[Express by Holiday Inn]"	The Punter is a highly rated restaurant that serves Indian cuisine for more than £ 30 . It is child friendly and also located in the riverside area near Express by Holiday Inn .
"name[The Punter], eatType[restaurant], food[Italian], priceRange[£20-25], customer rating[high], area[city centre], familyFriendly[no], near[Express by Holiday Inn]"	In the city centre near the Express by Holiday Inn is an Italian restaurant called The Punter . It has a high customer rating and a price range of £ 20 - 25 . Kid - friendly .
"name[The Punter], eatType[restaurant], food[Italian], priceRange[£20-25], customer rating[high], area[city centre], familyFriendly[yes], near[Express by Holiday Inn]"	The Punter is a kid friendly , highly rated , highly cost Italian restaurant in Luton near Express by Holiday Inn .
"name[The Punter], eatType[restaurant], food[Italian], priceRange[£20-25], customer rating[high], area[riverside], familyFriendly[no], near[Express by Holiday Inn]"	Located in the riverside area near Express by Holiday Inn , The Punter is an Italian restaurant with a high customer rating and a price range of £ 20 - 25 . It is not child friendly .
"name[The Punter], eatType[restaurant], food[Italian], priceRange[£20-25], customer rating[high], area[riverside], familyFriendly[yes], near[Express by Holiday Inn]"	The Punter is a child friendly Italian restaurant in the riverside area near Express by Holiday Inn . It has a high customer rating and prices ranging from £ 20 - 25 .
"name[The Punter], eatType[restaurant], food[Italian], priceRange[cheap], customer rating[5 out of 5], area[city centre], familyFriendly[no], near[Express by Holiday Inn]"	The Punter is an adult only Italian restaurant located in the city centre near Express by Holiday Inn . It has a customer rating of 5 out of 5 and is cheap .
"name[The Punter], eatType[restaurant], food[Italian], priceRange[cheap], customer rating[5 out of 5], area[city centre], familyFriendly[no], near[Rainbow Vegetarian Café]"	The Punter is a restaurant providing Italian food in the city center near Rainbow Vegetarian Café . It is cheap and not family - friendly . Its customer rating is 5 out of 5 .
"name[The Punter], eatType[restaurant], food[Italian], priceRange[cheap], customer rating[5 out of 5], area[city centre], familyFriendly[yes], near[Rainbow Vegetarian Café]"	In the city centre near Rainbow Vegetarian Café is a family - friendly Italian restaurant called The Punter . It has a customer rating of 5 out of 5 and is cheap .
"name[The Punter], eatType[restaurant], food[Italian], priceRange[cheap], customer rating[5 out of 5], area[riverside], familyFriendly[no], near[Rainbow Vegetarian Café]"	The Punter is a cheap non family - friendly Italian restaurant in the riverside area near Rainbow Vegetarian Café with a customer rating of 5 out of 5 .
"name[The Punter], eatType[restaurant], food[Italian], priceRange[cheap], customer rating[5 out of 5], area[riverside], familyFriendly[yes], near[Rainbow Vegetarian Café]"	In the riverside area near Rainbow Vegetarian Café is a cheap family friendly Italian restaurant named The Punter with a customer rating of 5 out of 5 .
"name[The Punter], eatType[restaurant], food[Italian], priceRange[cheap], customer rating[average], area[city centre], familyFriendly[no], near[Rainbow Vegetarian Café]"	The Punter serves cheap Italian food in the city centre near the Rainbow Vegetarian Café . It receives average ratings and policy not policy adult environment .
"name[The Punter], eatType[restaurant], food[Italian], priceRange[cheap], customer rating[average], area[city centre], familyFriendly[yes], near[Rainbow Vegetarian Café]"	The Punter is a restaurant providing Italian food in the cheap price range . It is located in the city centre near Rainbow Vegetarian Café .
"name[The Punter], eatType[restaurant], food[Italian], priceRange[cheap], customer rating[average], area[riverside], familyFriendly[no], near[Rainbow Vegetarian Café]"	In the riverside area near the Rainbow Vegetarian Café is an Italian restaurant called The Punter . It has an average customer rating and is not family - friendly .
"name[The Punter], eatType[restaurant], food[Italian], priceRange[cheap], customer rating[average], area[riverside], familyFriendly[yes], near[Rainbow Vegetarian Café]"	The Punter is a family friendly restaurant serving cheap Italian food . It has an average customer rating and is located in the riverside area near Rainbow Vegetarian Café .
"name[The Punter], eatType[restaurant], food[Italian], priceRange[high], customer rating[1 out of 5], area[city centre], familyFriendly[no], near[Rainbow Vegetarian Café]"	There is an Italian restaurant called The Punter near Rainbow Vegetarian Café in the city centre . Although it is not children friendly , it has a customer rating of 1 out of 5 .
"name[The Punter], eatType[restaurant], food[Italian], priceRange[high], customer rating[1 out of 5], area[city centre], familyFriendly[yes], near[Rainbow Vegetarian Café]"	The Punter is a family - friendly restaurant in the center of the city near Rainbow Vegetarian Café . It serves high priced Italian food and has a 1 out of 5 rating .
"name[The Punter], eatType[restaurant], food[Italian], priceRange[high], customer rating[1 out of 5], area[riverside], familyFriendly[no], near[Rainbow Vegetarian Café]"	The Punter is a child friendly restaurant in the riverside area near Rainbow Vegetarian Café . It serves expensive Italian food and has a customer rating of 1 out of 5 .
"name[The Punter], eatType[restaurant], food[Italian], priceRange[high], customer rating[1 out of 5], area[riverside], familyFriendly[yes], near[Rainbow Vegetarian Café]"	If you 're looking for Italian food , The Punter is currently rated 1 out of 5 by customers . It is in the riverside area near the Rainbow Vegetarian Café and is child friendly .
"name[The Vaults], eatType[pub], food[French], priceRange[high], area[riverside], familyFriendly[yes], near[Raja Indian Cuisine]"	The Vaults is a children friendly French pub in the riverside area near Raja Indian Cuisine with a high price range .
"name[The Vaults], eatType[pub], food[French], priceRange[less than £20], area[city centre], familyFriendly[no], near[Raja Indian Cuisine]"	The Vaults is a pub near Raja Indian Cuisine in the city centre that serves French food . It is priced less than £ 20 and is not family - friendly .
"name[The Vaults], eatType[pub], food[French], priceRange[less than £20], area[city centre], familyFriendly[yes], near[Raja Indian Cuisine]"	The Vaults is a family - friendly pub in the city center near Raja Indian Cuisine . It serves low cost French food .
"name[The Vaults], eatType[pub], food[French], priceRange[less than £20], area[riverside], familyFriendly[no], near[Raja Indian Cuisine]"	The Vaults is not a family - friendly pub in the riverside area near Raja Indian Cuisine . They serve French food for less than £ 20 .
"name[The Vaults], eatType[pub], food[French], priceRange[less than £20], area[riverside], familyFriendly[yes], near[Raja Indian Cuisine]"	In the riverside area near Raja Indian Cuisine is a family friendly pub called The Vaults . It serves French food for less than £ 20 .
"name[The Vaults], eatType[pub], food[French], priceRange[moderate], area[city centre], familyFriendly[no], near[Raja Indian Cuisine]"	In the city centre near Raja Indian Cuisine is a kid friendly pub called The Vaults . It serves French food and has a moderate price range .
"name[The Vaults], eatType[pub], food[French], priceRange[moderate], area[city centre], familyFriendly[yes], near[Raja Indian Cuisine]"	The Vaults is a kid friendly French pub in the city centre near Raja Indian Cuisine with a moderate price range .
"name[The Vaults], eatType[pub], food[French], priceRange[moderate], area[riverside], familyFriendly[no], near[Raja Indian Cuisine]"	Located in the riverside area near Raja Indian Cuisine , The Vaults pub serves French food at moderate prices . It is not family - friendly .
"name[The Vaults], eatType[pub], food[French], priceRange[moderate], area[riverside], familyFriendly[yes], near[Raja Indian Cuisine]"	The Vaults is a kid friendly pub with a moderate price range . It is located near Raja Indian Cuisine .
"name[The Vaults], eatType[pub], food[French], priceRange[more than £30], area[city centre], familyFriendly[no], near[Raja Indian Cuisine]"	The Vaults is a non children friendly French pub in the city centre near Raja Indian Cuisine with a price range of more than £ 30 .
"name[The Vaults], eatType[pub], food[French], priceRange[more than £30], area[city centre], familyFriendly[yes], near[Raja Indian Cuisine]"	The Vaults is a French pub in the city centre near Raja Indian Cuisine . It is children friendly and has a price range of more than £ 30 .
"name[The Vaults], eatType[pub], food[French], priceRange[more than £30], area[riverside], familyFriendly[no], near[Raja Indian Cuisine]"	Costing more than £ 30 , The Vaults is located near Raja Indian Cuisine in the riverside area . It is not child friendly .
"name[The Vaults], eatType[pub], food[French], priceRange[more than £30], area[riverside], familyFriendly[yes], near[Raja Indian Cuisine]"	In the riverside area near Raja Indian Cuisine is a child friendly pub called The Vaults . It serves French food and has a price range of more than £ 30 .
"name[The Vaults], eatType[pub], food[Indian], priceRange[£20-25], area[riverside], familyFriendly[yes], near[Raja Indian Cuisine]"	The Vaults is a high priced Indian pub in riverside near Raja Indian Cuisine . It is kids friendly .
"name[The Vaults], eatType[pub], food[Indian], priceRange[cheap], area[riverside], familyFriendly[yes], near[Raja Indian Cuisine]"	Located near Raja Indian Cuisine is a moderately priced family friendly pub called The Vaults .
"name[The Vaults], eatType[pub], food[Indian], priceRange[high], area[city centre], familyFriendly[no], near[Raja Indian Cuisine]"	The Vaults is a high priced Indian pub in the city centre near Raja Indian Cuisine . It is not children friendly .
"name[The Vaults], eatType[pub], food[Indian], priceRange[high], area[city centre], familyFriendly[yes], near[Raja Indian Cuisine]"	The Vaults is an Indian pub in the high price range . It has high ratings and is children friendly . It is located in the city centre near Raja Indian Cuisine .
"name[The Vaults], eatType[pub], food[Italian], priceRange[high], customer rating[average], area[city centre], familyFriendly[no], near[Rainbow Vegetarian Café]"	The Vaults is a pub featuring Italian food in the city centre near Rainbow Vegetarian Café . It has a high price range and an average customer rating . It is not children friendly .
"name[The Vaults], eatType[pub], food[Italian], priceRange[high], customer rating[average], area[city centre], familyFriendly[yes], near[Rainbow Vegetarian Café]"	The Vaults is a high priced family - friendly Italian pub with an average customer rating . It is located in the city centre near Rainbow Vegetarian Café .
"name[The Vaults], eatType[pub], food[Italian], priceRange[high], customer rating[average], area[riverside], familyFriendly[no], near[Rainbow Vegetarian Café]"	Near the Rainbow Vegetarian Café in the riverside area is an expensive pub called The Vaults . It serves Italian food and is not children friendly .
"name[The Vaults], eatType[pub], food[Italian], priceRange[high], customer rating[average], area[riverside], familyFriendly[yes], near[Rainbow Vegetarian Café]"	The Vaults is a pub located in the riverside area near the Rainbow Vegetarian Café . It serves high priced Italian food and is rated average by customers . They say it is children friendly .
"name[The Vaults], eatType[pub], food[Italian], priceRange[less than £20], customer rating[low], area[city centre], familyFriendly[no], near[Rainbow Vegetarian Café]"	The Vaults is a pub that serves Italian food . It is located near Rainbow Vegetarian Café in the city centre . It has a low customer rating and is not family - friendly .
"name[The Vaults], eatType[pub], food[Italian], priceRange[less than £20], customer rating[low], area[city centre], familyFriendly[yes], near[Rainbow Vegetarian Café]"	The Vaults is a low rated , family - friendly pub in the city centre near Rainbow Vegetarian Café . It serves Italian food for less than £ 20 .
"name[The Vaults], eatType[pub], food[Italian], priceRange[less than £20], customer rating[low], area[riverside], familyFriendly[no], near[Rainbow Vegetarian Café]"	The Vaults is a cheap pub located near Rainbow Vegetarian Café . It is rated one star .
"name[The Vaults], eatType[pub], food[Italian], priceRange[less than £20], customer rating[low], area[riverside], familyFriendly[yes], near[Rainbow Vegetarian Café]"	The Vaults is a family friendly pub in the riverside area near the Rainbow Vegetarian Café . It serves Italian food for less than £ 20 and has a low customer rating .
"name[The Vaults], eatType[pub], food[Italian], priceRange[moderate], customer rating[1 out of 5], area[city centre], familyFriendly[no], near[Rainbow Vegetarian Café]"	The Vaults is a pub that serves Italian food . It is located in the city centre near the Rainbow Vegetarian Café . It is not kids friendly and has a customer rating of 1 out of 5 .
"name[The Vaults], eatType[pub], food[Italian], priceRange[moderate], customer rating[1 out of 5], area[city centre], familyFriendly[yes], near[Rainbow Vegetarian Café]"	The Vaults pub serves reasonably priced Italian food . Rated 1 out of 5 , it is located in the city centre near Rainbow Vegetarian Café and is kid friendly .
"name[The Vaults], eatType[pub], food[Italian], priceRange[moderate], customer rating[1 out of 5], area[riverside], familyFriendly[no], near[Rainbow Vegetarian Café]"	The Vaults is a 1 star quality pub that does not allow children . It is located near the Rainbow Vegetarian Café .
"name[The Vaults], eatType[pub], food[Italian], priceRange[moderate], customer rating[1 out of 5], area[riverside], familyFriendly[yes], near[Rainbow Vegetarian Café]"	There is a one star pub called The Vaults located near Rainbow Vegetarian Café .
"name[The Vaults], eatType[pub], food[Italian], priceRange[moderate], customer rating[3 out of 5], area[city centre], familyFriendly[no], near[Rainbow Vegetarian Café]"	The Vaults is a non - kid friendly Italian pub in the city centre near Rainbow Vegetarian Café with a moderate price range and a customer rating of 3 out of 5 .
"name[The Vaults], eatType[pub], food[Italian], priceRange[moderate], customer rating[3 out of 5], area[city centre], familyFriendly[yes], near[Rainbow Vegetarian Café]"	The Vaults is a moderately priced Italian pub in the city centre near Rainbow Vegetarian Café . It is child friendly and has a customer rating of 3 out of 5 .
"name[The Vaults], eatType[pub], food[Italian], priceRange[moderate], customer rating[3 out of 5], area[riverside], familyFriendly[no], near[Rainbow Vegetarian Café]"	The Vaults is an Italian pub located in riverside near Rainbow Vegetarian Café . It has a moderate price range and a customer rating of 3 out of 5 . It is not kid friendly .
"name[The Vaults], eatType[pub], food[Italian], priceRange[moderate], customer rating[3 out of 5], area[riverside], familyFriendly[yes], near[Rainbow Vegetarian Café]"	The Vaults is a moderately priced family friendly pub located near Rainbow Vegetarian Café .
"name[The Vaults], eatType[pub], food[Italian], priceRange[more than £30], customer rating[high], area[city centre], familyFriendly[no], near[Rainbow Vegetarian Café]"	The Vaults is a highly rated , high priced Italian pub located in the city centre near Rainbow Vegetarian Café . It is not child friendly .
"name[The Vaults], eatType[pub], food[Italian], priceRange[more than £30], customer rating[high], area[city centre], familyFriendly[yes], near[Rainbow Vegetarian Café]"	The Vaults is a child friendly pub located in the city centre near the Rainbow Vegetarian Café . Rated high . It serves Italian cuisine .
"name[The Vaults], eatType[pub], food[Italian], priceRange[more than £30], customer rating[high], area[riverside], familyFriendly[no], near[Rainbow Vegetarian Café]"	Near the Rainbow Vegetarian Café is an expensive , highly rated pub called The Vaults . It is not child friendly .
"name[The Vaults], eatType[pub], food[Italian], priceRange[more than £30], customer rating[high], area[riverside], familyFriendly[yes], near[Rainbow Vegetarian Café]"	Located beside the Rainbow Vegetarian Café , The Vaults is an expensive family friendly pub where you can enjoy Italian food . It is rated high and is family friendly .
"name[The Vaults], eatType[pub], food[Japanese], priceRange[£20-25], customer rating[3 out of 5], area[city centre], familyFriendly[no], near[Rainbow Vegetarian Café]"	The Vaults is a pub found in the center of the city near Rainbow Vegetarian Café . It is highly rated and serves Japanese food for £ 20 - 25 and is not kid friendly .
"name[The Vaults], eatType[pub], food[Japanese], priceRange[£20-25], customer rating[3 out of 5], area[city centre], familyFriendly[yes], near[Rainbow Vegetarian Café]"	The Vaults is a Japanese pub in the city centre near Rainbow Vegetarian Café . It has a customer rating of 3 out of 5 and is kid friendly .
"name[The Vaults], eatType[pub], food[Japanese], priceRange[£20-25], customer rating[3 out of 5], area[riverside], familyFriendly[no], near[Rainbow Vegetarian Café]"	The Vaults is a Japanese pub in the riverside area near Rainbow Vegetarian Café . It is rated 3 out of 5 by customers and is not kids friendly . It is moderately priced .
"name[The Vaults], eatType[pub], food[Japanese], priceRange[£20-25], customer rating[3 out of 5], area[riverside], familyFriendly[yes], near[Rainbow Vegetarian Café]"	Located in the riverside area near Rainbow Vegetarian Café is a children friendly pub named The Vaults . They serve Japanese food and have been averagely given .
"name[The Vaults], eatType[pub], food[Japanese], priceRange[£20-25], customer rating[high], area[city centre], familyFriendly[no], near[Rainbow Vegetarian Café]"	The Vaults is a pub that features highly rated Japanese food . It is located within the city centre near the Rainbow Vegetarian Café and is not kids friendly .
"name[The Vaults], eatType[pub], food[Japanese], priceRange[£20-25], customer rating[high], area[city centre], familyFriendly[yes], near[Rainbow Vegetarian Café]"	The Vaults is a kids friendly pub in the city centre near Rainbow Vegetarian Café that sells Japanese food with a price range of £ 20 - 25 and a high customer rating .
"name[The Vaults], eatType[pub], food[Japanese], priceRange[£20-25], customer rating[high], area[riverside], familyFriendly[no], near[Rainbow Vegetarian Café]"	The Vaults is a pub that sells Japanese food with a price range of £ 20 - 25 . It has a high customer service rating and is not kid friendly . It is located in the riverside area near Rainbow Vegetarian Café .
"name[The Vaults], eatType[pub], food[Japanese], priceRange[£20-25], customer rating[high], area[riverside], familyFriendly[no], near[Raja Indian Cuisine]"	The Vaults is a Japanese pub near Raja Indian Cuisine in the riverside area . It has a high customer rating and is not kid friendly . The price range is £ 20 - 25 .
"name[The Vaults], eatType[pub], food[Japanese], priceRange[£20-25], customer rating[high], area[riverside], familyFriendly[yes], near[Raja Indian Cuisine]"	The Vaults is a child friendly Japanese pub in the riverside area near Raja Indian Cuisine with a high customer rating and a price range of £ 20 - 25 .
"name[The Vaults], eatType[pub], food[Japanese], priceRange[cheap], customer rating[5 out of 5], area[city centre], familyFriendly[no], near[Raja Indian Cuisine]"	Located in the city centre near Raja Indian Cuisine is a cheap priced Japanese pub called The Vaults . It has a customer rating of 5 out of 5 and is not recommended for kids .
"name[The Vaults], eatType[pub], food[Japanese], priceRange[cheap], customer rating[5 out of 5], area[city centre], familyFriendly[yes], near[Raja Indian Cuisine]"	The Vaults is a family - friendly pub that serves Japanese food . It is located in the city centre near Raja Indian Cuisine and has a customer rating of 5 out of 5 .
"name[The Vaults], eatType[pub], food[Japanese], priceRange[cheap], customer rating[5 out of 5], area[riverside], familyFriendly[no], near[Raja Indian Cuisine]"	The Vaults is a pub serving Japanese food in the riverside area near Raja Indian Cuisine . It is not family - friendly and has a customer rating of 5 out of 5 .
"name[The Vaults], eatType[pub], food[Japanese], priceRange[cheap], customer rating[5 out of 5], area[riverside], familyFriendly[yes], near[Raja Indian Cuisine]"	There is a low priced sushi restaurant called The Vaults near Raja Indian Cuisine .
"name[The Vaults], eatType[pub], food[Japanese], priceRange[high], customer rating[3 out of 5], area[city centre], familyFriendly[no], near[Raja Indian Cuisine]"	There is a Japanese pub near Raja Indian Cuisine in the city centre . It is not children friendly and has a 3 out of 5 rating . It is called The Vaults .
"name[The Vaults], eatType[pub], food[Japanese], priceRange[high], customer rating[3 out of 5], area[city centre], familyFriendly[yes], near[Raja Indian Cuisine]"	In the center of the city near Raja Indian Cuisine is a Japanese restaurant named The Vaults . It is kid friendly and has a high price range . It has a customer rating of 3 out of 5 .
"name[The Vaults], eatType[pub], food[Japanese], priceRange[high], customer rating[3 out of 5], area[riverside], familyFriendly[no], near[Raja Indian Cuisine]"	There is a pub known as The Vaults that provides Japanese food . It is located near Raja Indian Cuisine in the riverside area . It has a customer rating of 3 out of 5 and is not children friendly .
"name[The Vaults], eatType[pub], food[Japanese], priceRange[high], customer rating[3 out of 5], area[riverside], familyFriendly[yes], near[Raja Indian Cuisine]"	The Vaults is a 3 star pub serving pasta in a family friendly location . It is located near Raja Indian Cuisine .
"name[The Vaults], eatType[pub], food[Japanese], priceRange[less than £20], customer rating[average], area[city centre], familyFriendly[no], near[Raja Indian Cuisine]"	Adult only The Vaults pub is located in the city centre near Raja Indian Cuisine . They serve Japanese food for less than £ 20 .
"name[The Vaults], eatType[pub], food[Japanese], priceRange[less than £20], customer rating[average], area[city centre], familyFriendly[yes], near[Raja Indian Cuisine]"	The Vaults is a family - friendly Japanese pub in the city centre near Raja Indian Cuisine . It has an average customer rating and a price range of less than £ 20 .
"name[The Vaults], eatType[pub], food[Japanese], priceRange[less than £20], customer rating[average], area[riverside], familyFriendly[no], near[Raja Indian Cuisine]"	Located in the riverside area near Raja Indian Cuisine , The Vaults pub offers low priced Japanese food . It is not family - friendly and has an average customer rating .
"name[The Vaults], eatType[pub], food[Japanese], priceRange[less than £20], customer rating[average], area[riverside], familyFriendly[yes], near[Raja Indian Cuisine]"	The Vaults is a family friendly Japanese pub with an average customer rating and prices less than £ 20 . It is located in the riverside area near Raja Indian Cuisine .
"name[The Vaults], eatType[pub], food[Japanese], priceRange[less than £20], customer rating[low], area[city centre], familyFriendly[no], near[Raja Indian Cuisine]"	Offering Japanese food , The Vaults is a pub in the city centre near Raja Indian Cuisine . It has a low customer rating and is not family - friendly .
"name[The Vaults], eatType[pub], food[Japanese], priceRange[less than £20], customer rating[low], area[city centre], familyFriendly[yes], near[Raja Indian Cuisine]"	The Vaults is a family - friendly pub in the town centre near Raja Indian Cuisine serving Japanese food with prices less than £ 20 and a low customer rating .
"name[The Vaults], eatType[pub], food[Japanese], priceRange[less than £20], customer rating[low], area[riverside], familyFriendly[no], near[Raja Indian Cuisine]"	The Vaults is a pub that offers Japanese food with prices less than £ 20 . It is not family - friendly and has low customer ratings . It is located in the riverside area near Raja Indian Cuisine .
"name[The Vaults], eatType[pub], food[Japanese], priceRange[less than £20], customer rating[low], area[riverside], familyFriendly[yes], near[Raja Indian Cuisine]"	There is a low rated family friendly pub near Raja Indian Cuisine called The Vaults .
"name[The Vaults], eatType[pub], food[Japanese], priceRange[moderate], customer rating[1 out of 5], area[city centre], familyFriendly[no], near[Raja Indian Cuisine]"	The Vaults is an adult pub with moderate prices located in the city centre near Raja Indian Cuisine . It serves Japanese food and has a customer rating of 1 out of 5 .
"name[The Vaults], eatType[pub], food[Japanese], priceRange[moderate], customer rating[1 out of 5], area[city centre], familyFriendly[yes], near[Raja Indian Cuisine]"	In the city centre near Raja Indian Cuisine is a family - friendly pub called The Vaults serving Japanese dishes . The prices are moderate and the customer rating is 1 out of 5 .
"name[The Vaults], eatType[restaurant], food[French], priceRange[high], area[riverside], familyFriendly[yes], near[Raja Indian Cuisine]"	The Vaults is a child friendly restaurant in the riverside area near Raja Indian Cuisine . It serves French food and has a high price range .
"name[The Vaults], eatType[restaurant], food[French], priceRange[less than £20], area[city centre], familyFriendly[no], near[Raja Indian Cuisine]"	The Vaults restaurant serves French food in the city centre near Raja Indian Cuisine . It is not family - friendly and has a price range of less than £ 20 .
"name[The Vaults], eatType[restaurant], food[French], priceRange[less than £20], area[city centre], familyFriendly[yes], near[Raja Indian Cuisine]"	The Vaults is a family - friendly restaurant serving French food costing less than £ 20 per person . It is located in the city centre near Raja Indian Cuisine .
"name[The Vaults], eatType[restaurant], food[French], priceRange[less than £20], area[riverside], familyFriendly[no], near[Raja Indian Cuisine]"	The Vaults is a French restaurant situated close to Raja Indian Cuisine in the riverside area . It has a menu of budget per head to head .
"name[The Vaults], eatType[restaurant], food[French], priceRange[less than £20], area[riverside], familyFriendly[yes], near[Raja Indian Cuisine]"	The Vaults is a 5 Star American restaurant with low prices and is family friendly . It is located north of the city center . close to Raja Indian Cuisine .
"name[The Vaults], eatType[restaurant], food[French], priceRange[moderate], area[city centre], familyFriendly[no], near[Raja Indian Cuisine]"	Moderately priced French food can be found at The Vaults in the city centre near Raja Indian Cuisine . It is not kid friendly .
"name[The Vaults], eatType[restaurant], food[French], priceRange[moderate], area[city centre], familyFriendly[yes], near[Raja Indian Cuisine]"	The Vaults is a moderately priced restaurant that serves French food . It is kid friendly and is located in the city centre near Raja Indian Cuisine .
"name[The Vaults], eatType[restaurant], food[French], priceRange[moderate], area[riverside], familyFriendly[no], near[Raja Indian Cuisine]"	The Vaults restaurant offers moderately priced French food in the riverside area near Raja Indian Cuisine . It is not child friendly .
"name[The Vaults], eatType[restaurant], food[French], priceRange[moderate], area[riverside], familyFriendly[yes], near[Raja Indian Cuisine]"	The Vaults is a moderately priced family friendly restaurant located near Raja Indian Cuisine .
"name[The Vaults], eatType[restaurant], food[French], priceRange[more than £30], area[city centre], familyFriendly[no], near[Raja Indian Cuisine]"	The Vaults is a restaurant offering French food , however it is not children friendly . It is located near Raja Indian Cuisine in the center of the city .
"name[The Vaults], eatType[restaurant], food[French], priceRange[more than £30], area[city centre], familyFriendly[yes], near[Raja Indian Cuisine]"	In the city centre near Raja Indian Cuisine is a child friendly restaurant called The Vaults . It serves French food and has a price range of more than £ 30 .
"name[The Vaults], eatType[restaurant], food[French], priceRange[more than £30], area[riverside], familyFriendly[no], near[Raja Indian Cuisine]"	Along the riverside near Raja Indian Cuisine is a French restaurant called The Vaults . It is not children friendly and prices are more than £ 30 .
"name[The Vaults], eatType[restaurant], food[French], priceRange[more than £30], area[riverside], familyFriendly[yes], near[Raja Indian Cuisine]"	The Vaults is a child friendly restaurant in the riverside area near Raja Indian Cuisine . It serves reasonably priced French food items .
"name[The Vaults], eatType[restaurant], food[Indian], priceRange[£20-25], area[riverside], familyFriendly[yes], near[Raja Indian Cuisine]"	The Vaults is a kid friendly Indian restaurant with a price range of £ 20 - 25 . It can be found in the riverside area near Raja Indian Cuisine .
"name[The Vaults], eatType[restaurant], food[Indian], priceRange[cheap], area[riverside], familyFriendly[yes], near[Raja Indian Cuisine]"	The Vaults is a restaurant providing Indian food in the cheap price range . It is located in the riverside . It is near Raja Indian Cuisine .
"name[The Vaults], eatType[restaurant], food[Indian], priceRange[high], area[city centre], familyFriendly[no], near[Raja Indian Cuisine]"	The Vaults is a high priced Indian restaurant found in the city centre near Raja Indian Cuisine . It is not children friendly .
"name[The Vaults], eatType[restaurant], food[Indian], priceRange[high], area[city centre], familyFriendly[yes], near[Raja Indian Cuisine]"	There is an expensive Indian restaurant in the city centre near Raja Indian Cuisine called The Vaults .
"name[The Waterman], eatType[pub], food[Indian], priceRange[high], area[city centre], familyFriendly[yes], near[Raja Indian Cuisine]"	The Waterman is a pub that offers Indian food in the high price range . It is located in the city centre near Raja Indian Cuisine and is children friendly service .
"name[The Waterman], eatType[pub], food[Indian], priceRange[high], area[riverside], familyFriendly[no], near[Raja Indian Cuisine]"	In the riverside area near Raja Indian Cuisine is an Indian pub called The Waterman . It has a high price range and is not child friendly .
"name[The Waterman], eatType[pub], food[Indian], priceRange[high], area[riverside], familyFriendly[yes], near[Raja Indian Cuisine]"	The Waterman is a pub that provides Indian food in the high price range . It is located in the riverside . It is near Raja Indian Cuisine .
"name[The Waterman], eatType[pub], food[Indian], priceRange[less than £20], area[city centre], familyFriendly[no], near[Raja Indian Cuisine]"	The Waterman is an adult only Indian pub in the city centre near Raja Indian Cuisine with a price range of less than £ 20 .
"name[The Waterman], eatType[pub], food[Indian], priceRange[less than £20], area[city centre], familyFriendly[yes], near[Raja Indian Cuisine]"	The Waterman is a family friendly pub that serves Indian food at reasonable prices . It is located in the city centre near Raja Indian Cuisine .
"name[The Waterman], eatType[pub], food[Indian], priceRange[less than £20], area[riverside], familyFriendly[no], near[Raja Indian Cuisine]"	There is a pub called The Waterman in the riverside area near Raja Indian Cuisine . It serves Indian food for less than £ 20 and is not family friendly .
"name[The Waterman], eatType[pub], food[Indian], priceRange[less than £20], area[riverside], familyFriendly[yes], near[Raja Indian Cuisine]"	In the riverside area near Raja Indian Cuisine is a family friendly pub named The Waterman also serving Indian food for less than £ 20 .
"name[The Waterman], eatType[pub], food[Indian], priceRange[moderate], area[city centre], familyFriendly[no], near[Raja Indian Cuisine]"	The Waterman pub offers moderately priced Indian food in the city centre near Raja Indian Cuisine . No kids allowed .
"name[The Waterman], eatType[pub], food[Indian], priceRange[moderate], area[city centre], familyFriendly[yes], near[Raja Indian Cuisine]"	The Waterman is a pub that provides Indian food in the moderate price range . It is located in the city centre . It is near Raja Indian Cuisine .
"name[The Waterman], eatType[pub], food[Indian], priceRange[moderate], area[riverside], familyFriendly[no], near[Raja Indian Cuisine]"	The Waterman is a pub that serves Indian food in the moderate price range . It is located in the riverside area near Raja Indian Cuisine and is not kid friendly .
"name[The Waterman], eatType[pub], food[Indian], priceRange[moderate], area[riverside], familyFriendly[yes], near[Raja Indian Cuisine]"	In the riverside area near Raja Indian Cuisine is an Indian pub called The Waterman . It has a moderate price range and is kid friendly .
"name[The Waterman], eatType[pub], food[Indian], priceRange[more than £30], area[riverside], familyFriendly[yes], near[Raja Indian Cuisine]"	The Waterman is a pub featuring Indian food for a meal in the higher price range . It is located in the riverside area near Raja Indian Cuisine and is a child friendly venue .
"name[The Waterman], eatType[pub], food[Italian], priceRange[£20-25], area[riverside], familyFriendly[yes], near[Raja Indian Cuisine]"	There is an average priced pub The Waterman located in the riverside near Raja Indian Cuisine that provides Italian food .
"name[The Waterman], eatType[pub], food[Italian], priceRange[cheap], area[riverside], familyFriendly[yes], near[Raja Indian Cuisine]"	The Waterman is a family friendly pub serving Italian food at cheap prices in the riverside area near Raja Indian Cuisine .
"name[The Waterman], eatType[pub], food[Italian], priceRange[high], area[city centre], familyFriendly[no], near[Raja Indian Cuisine]"	Near Raja Indian Cuisine in the city centre is an adults only Italian pub named The Waterman that costs high .
"name[The Waterman], eatType[pub], food[Italian], priceRange[high], area[city centre], familyFriendly[yes], near[Raja Indian Cuisine]"	Located in the city centre near Raja Indian Cuisine , The Waterman is a high priced family - friendly Italian pub .
"name[The Waterman], eatType[pub], food[Italian], priceRange[high], area[riverside], familyFriendly[no], near[Raja Indian Cuisine]"	The Waterman is a high priced pub that does not allow children . It is located near Raja Indian Cuisine in the riverside area .
"name[The Waterman], eatType[pub], food[Italian], priceRange[high], area[riverside], familyFriendly[yes], near[Raja Indian Cuisine]"	The Waterman is a children friendly pub with a high price range . It is located near Raja Indian Cuisine .
"name[The Waterman], eatType[pub], food[Italian], priceRange[less than £20], area[city centre], familyFriendly[no], near[Raja Indian Cuisine]"	The Waterman is an Italian pub located in the city centre near Raja Indian Cuisine . It has prices less than £ 20 and is not family - friendly .
"name[The Waterman], eatType[pub], food[Italian], priceRange[less than £20], area[city centre], familyFriendly[yes], near[Raja Indian Cuisine]"	For less than £ 20 you can find The Waterman , a family - friendly Italian pub in the city centre near Raja Indian Cuisine .
"name[The Waterman], eatType[pub], food[Italian], priceRange[less than £20], area[riverside], familyFriendly[no], near[Raja Indian Cuisine]"	The Waterman , next to Raja Indian Cuisine , is an inexpensive pub that is not child friendly .
"name[The Waterman], eatType[restaurant], food[Indian], priceRange[high], area[city centre], familyFriendly[yes], near[Raja Indian Cuisine]"	The Waterman is a family friendly restaurant that serves Indian food in the high price range . It is located in the city centre near Raja Indian Cuisine .
"name[The Waterman], eatType[restaurant], food[Indian], priceRange[high], area[riverside], familyFriendly[no], near[Raja Indian Cuisine]"	The Waterman is a high priced Indian restaurant in riverside near Raja Indian Cuisine . It is not kid friendly .
"name[The Waterman], eatType[restaurant], food[Indian], priceRange[high], area[riverside], familyFriendly[yes], near[Raja Indian Cuisine]"	The Waterman is a kid friendly Indian restaurant with a high price range in the riverside area near Raja Indian Cuisine .
"name[The Waterman], eatType[restaurant], food[Indian], priceRange[less than £20], area[city centre], familyFriendly[no], near[Raja Indian Cuisine]"	There is an Indian restaurant in the center of the city near Raja Indian Cuisine called The Waterman . It is not family friendly and the price range is less than £ 20 .
"name[The Waterman], eatType[restaurant], food[Indian], priceRange[less than £20], area[city centre], familyFriendly[yes], near[Raja Indian Cuisine]"	The Waterman is a restaurant located in the city centre near Raja Indian Cuisine that serves Indian food in a family friendly environment for less than £ 20 .
"name[The Waterman], eatType[restaurant], food[Indian], priceRange[less than £20], area[riverside], familyFriendly[no], near[Raja Indian Cuisine]"	There is an inexpensive Indian restaurant in the riverside area near Raja Indian Cuisine called The Waterman . It is not family friendly .
"name[The Waterman], eatType[restaurant], food[Indian], priceRange[less than £20], area[riverside], familyFriendly[yes], near[Raja Indian Cuisine]"	The Waterman is a low - priced family friendly restaurant that serves Indian food . It is located in the riverside area near Raja Indian Cuisine .
"name[The Waterman], eatType[restaurant], food[Indian], priceRange[moderate], area[city centre], familyFriendly[no], near[Raja Indian Cuisine]"	The Waterman is a moderately priced restaurant that serves Indian food in the city centre near Raja Indian Cuisine . It is not family friendly .
"name[The Waterman], eatType[restaurant], food[Indian], priceRange[moderate], area[city centre], familyFriendly[yes], near[Raja Indian Cuisine]"	The Waterman is a moderately priced Indian restaurant in the city centre near Raja Indian Cuisine . It is child friendly .
"name[The Waterman], eatType[restaurant], food[Indian], priceRange[moderate], area[riverside], familyFriendly[no], near[Raja Indian Cuisine]"	The Waterman is a moderately priced Indian restaurant in the riverside area near Raja Indian Cuisine . It is not kid friendly .
"name[The Waterman], eatType[restaurant], food[Indian], priceRange[moderate], area[riverside], familyFriendly[yes], near[Raja Indian Cuisine]"	Moderately priced The Waterman restaurant is located near Raja Indian Cuisine . It is a family friendly eatery .
"name[The Waterman], eatType[restaurant], food[Indian], priceRange[more than £30], area[riverside], familyFriendly[yes], near[Raja Indian Cuisine]"	The Waterman is a high priced Indian restaurant in riverside near Raja Indian Cuisine . It is child friendly .
"name[The Waterman], eatType[restaurant], food[Italian], priceRange[£20-25], area[riverside], familyFriendly[yes], near[Raja Indian Cuisine]"	The Waterman is a restaurant offering Italian food in the riverside area near Raja Indian Cuisine . It is a kid friendly atmosphere and costs £ 20 - 25 .
"name[The Waterman], eatType[restaurant], food[Italian], priceRange[cheap], area[riverside], familyFriendly[yes], near[Raja Indian Cuisine]"	There is a cheap , family friendly Italian restaurant in riverside near Raja Indian Cuisine called The Waterman .
"name[The Waterman], eatType[restaurant], food[Italian], priceRange[high], area[city centre], familyFriendly[no], near[Raja Indian Cuisine]"	The Waterman is a high priced restaurant serving Italian food . It is not child friendly and is located in the city centre near Raja Indian Cuisine .
"name[The Waterman], eatType[restaurant], food[Italian], priceRange[high], area[city centre], familyFriendly[yes], near[Raja Indian Cuisine]"	The Waterman is a child friendly restaurant in the city centre near Raja Indian Cuisine . It serves Italian food and has a high price range .
"name[The Waterman], eatType[restaurant], food[Italian], priceRange[high], area[riverside], familyFriendly[no], near[Raja Indian Cuisine]"	In the riverside area near Raja Indian Cuisine is a restaurant serving Italian food called The Waterman . It is not children friendly and has a high price range .
"name[The Waterman], eatType[restaurant], food[Italian], priceRange[high], area[riverside], familyFriendly[yes], near[Raja Indian Cuisine]"	The Waterman is a children friendly Italian restaurant in the riverside area near Raja Indian Cuisine with a high price range .
"name[The Waterman], eatType[restaurant], food[Italian], priceRange[less than £20], area[city centre], familyFriendly[no], near[Raja Indian Cuisine]"	The Waterman is an Italian restaurant in the city centre near Raja Indian Cuisine . It has prices less than £ 20 and is not family - friendly .
"name[The Waterman], eatType[restaurant], food[Italian], priceRange[less than £20], area[city centre], familyFriendly[yes], near[Raja Indian Cuisine]"	The Waterman is a family - friendly restaurant that offers Italian food for less than £ 20 . It is located in the city centre near Raja Indian Cuisine .
"name[The Waterman], eatType[restaurant], food[Italian], priceRange[less than £20], area[riverside], familyFriendly[no], near[Raja Indian Cuisine]"	The Waterman is an inexpensive Italian restaurant in the riverside area near Raja Indian Cuisine . It is not family - friendly .
"name[The Wrestlers], eatType[pub], food[Italian], priceRange[less than £20], area[riverside], familyFriendly[no], near[Raja Indian Cuisine]"	The Wrestlers pub serves reasonably priced Italian food in the riverside area near Raja Indian Cuisine . It is not family - friendly .
"name[The Wrestlers], eatType[pub], food[Italian], priceRange[less than £20], area[riverside], familyFriendly[yes], near[Raja Indian Cuisine]"	The Wrestlers is a family friendly pub in the riverside area near Raja Indian Cuisine . They serve Italian food for less than £ 20 .
"name[The Wrestlers], eatType[pub], food[Italian], priceRange[moderate], area[city centre], familyFriendly[no], near[Raja Indian Cuisine]"	Located near Raja Indian Cuisine in the city centre is an Italian pub named The Wrestlers . It has a moderate price range and is not kids friendly .
"name[The Wrestlers], eatType[pub], food[Italian], priceRange[moderate], area[city centre], familyFriendly[yes], near[Raja Indian Cuisine]"	The Wrestlers is a pub that serves Italian food . It is located in the city centre near Raja Indian Cuisine and is kids friendly .
"name[The Wrestlers], eatType[pub], food[Italian], priceRange[moderate], area[riverside], familyFriendly[no], near[Raja Indian Cuisine]"	The Wrestlers is a pub with moderate pricing . It is located near Raja Indian Cuisine .
"name[The Wrestlers], eatType[pub], food[Italian], priceRange[moderate], area[riverside], familyFriendly[yes], near[Raja Indian Cuisine]"	The Wrestlers , located next to Raja Indian Cuisine , serves pasta dishes at mid - range prices .
"name[The Wrestlers], eatType[pub], food[Italian], priceRange[more than £30], area[riverside], familyFriendly[yes], near[Raja Indian Cuisine]"	The Wrestlers is a child friendly pub in the riverside area near Raja Indian Cuisine that sells Italian food for more than 30 pounds .
"name[The Wrestlers], eatType[pub], food[Japanese], priceRange[£20-25], area[riverside], familyFriendly[yes], near[Raja Indian Cuisine]"	The Wrestlers is a kids friendly pub serving Japanese food in the riverside area near Raja Indian Cuisine with a price range of £ 20 - 25 .
"name[The Wrestlers], eatType[pub], food[Japanese], priceRange[cheap], area[riverside], familyFriendly[yes], near[Raja Indian Cuisine]"	In the riverside area near Raja Indian Cuisine is a family friendly pub called The Wrestlers . It serves Japanese food at cheap prices .
"name[The Wrestlers], eatType[pub], food[Japanese], priceRange[high], area[riverside], familyFriendly[yes], near[Raja Indian Cuisine]"	The Wrestlers is a kid friendly pub providing Japanese food in the high price range . It is located in the riverside area near Raja Indian Cuisine .
"name[The Wrestlers], eatType[pub], food[Japanese], priceRange[less than £20], area[city centre], familyFriendly[no], near[Raja Indian Cuisine]"	The Wrestlers is a pub in the city centre near Raja Indian Cuisine . They offer Japanese food for less than £ 20 and are not family - friendly .
"name[The Wrestlers], eatType[pub], food[Japanese], priceRange[less than £20], area[city centre], familyFriendly[yes], near[Raja Indian Cuisine]"	The Wrestlers is a family - friendly pub that serves Japanese food for less than £ 20 . It is located near Raja Indian Cuisine in the city centre .
"name[The Wrestlers], eatType[pub], food[Japanese], priceRange[less than £20], area[riverside], familyFriendly[no], near[Raja Indian Cuisine]"	The Wrestlers pub is not recommended for families and is close to Raja Indian Cuisine .
"name[The Wrestlers], eatType[pub], food[Japanese], priceRange[less than £20], area[riverside], familyFriendly[yes], near[Raja Indian Cuisine]"	The Wrestlers is a family friendly pub that serves Japanese food at prices less than £ 20 . It is located in the riverside area near Raja Indian Cuisine .
"name[The Wrestlers], eatType[pub], food[Japanese], priceRange[moderate], area[city centre], familyFriendly[no], near[Raja Indian Cuisine]"	The Wrestlers is a pub located in the city center near Raja Indian Cuisine . They offer nice Japanese food at a moderate price . They are not kids friendly .
"name[The Wrestlers], eatType[pub], food[Japanese], priceRange[moderate], area[city centre], familyFriendly[yes], near[Raja Indian Cuisine]"	The Wrestlers is a moderately priced , kid friendly Japanese pub in the city centre near Raja Indian Cuisine .
"name[The Wrestlers], eatType[pub], food[Japanese], priceRange[moderate], area[riverside], familyFriendly[no], near[Raja Indian Cuisine]"	The Wrestlers is a non - kid friendly pub with a moderate price range . It is located near Raja Indian Cuisine .
"name[The Wrestlers], eatType[pub], food[Japanese], priceRange[moderate], area[riverside], familyFriendly[yes], near[Raja Indian Cuisine]"	The Wrestlers is a low - priced , family friendly pub that serves sushi . It is located near Raja Indian Cuisine .
"name[The Wrestlers], eatType[pub], food[Japanese], priceRange[moderate], customer rating[1 out of 5], area[city centre], familyFriendly[yes], near[Raja Indian Cuisine]"	The Wrestlers is a kid friendly Japanese pub in the city centre near Raja Indian Cuisine . The prices are moderate and it is rated 1 out of 5 by customers .
"name[The Wrestlers], eatType[pub], food[Japanese], priceRange[moderate], customer rating[1 out of 5], area[riverside], familyFriendly[no], near[Raja Indian Cuisine]"	The Wrestlers is a pub serving moderately priced Japanese food in the riverside area near Raja Indian Cuisine . It is not kid friendly and has a customer rating of 1 out of 5 .
"name[The Wrestlers], eatType[pub], food[Japanese], priceRange[moderate], customer rating[1 out of 5], area[riverside], familyFriendly[yes], near[Raja Indian Cuisine]"	The Wrestlers is a kid friendly pub in the riverside area near Raja Indian Cuisine . It has earned a 1 out of 5 rating and serves Japanese food at a moderate price .
"name[The Wrestlers], eatType[pub], food[Japanese], priceRange[more than £30], area[city centre], familyFriendly[no], near[Raja Indian Cuisine]"	The Wrestlers serves Japanese food for more than £ 30 . Located in the city centre near Raja Indian Cuisine , it is not child friendly .
"name[The Wrestlers], eatType[pub], food[Japanese], priceRange[more than £30], area[city centre], familyFriendly[yes], near[Raja Indian Cuisine]"	The Wrestlers is a Japanese pub in the city centre near Raja Indian Cuisine . It is children friendly and has a price range of more than 30 pounds .
"name[The Wrestlers], eatType[pub], food[Japanese], priceRange[more than £30], area[riverside], familyFriendly[no], near[Raja Indian Cuisine]"	The Wrestlers is a children friendly pub in the riverside area near Raja Indian Cuisine . It serves Japanese food for more than £ 30 .
"name[The Wrestlers], eatType[pub], food[Japanese], priceRange[more than £30], area[riverside], familyFriendly[yes], near[Raja Indian Cuisine]"	In the riverside area near Raja Indian Cuisine is a family friendly Japanese pub called The Wrestlers . It has a price range of more than £ 30 .
"name[The Wrestlers], eatType[pub], food[Japanese], priceRange[more than £30], customer rating[5 out of 5], area[city centre], familyFriendly[no], near[Raja Indian Cuisine]"	A no children friendly Japanese pub named The Wrestlers has a price range of more than £ 30 and a customer rating of 5 out of 5 . It is located in the city centre near Raja Indian Cuisine .
"name[The Wrestlers], eatType[pub], food[Japanese], priceRange[more than £30], customer rating[5 out of 5], area[city centre], familyFriendly[yes], near[Raja Indian Cuisine]"	The Wrestlers is a family - friendly pub situated in the city centre near Raja Indian Cuisine . It offers low priced Japanese food . Customers have rated it 5 out of 5 .
"name[The Wrestlers], eatType[pub], food[Japanese], priceRange[more than £30], customer rating[5 out of 5], area[riverside], familyFriendly[no], near[Raja Indian Cuisine]"	The Wrestlers is a pub with a customer rating of 5 out of 5 . They serve Japanese food and are not child unfriendly . They are located in the riverside area near Raja Indian Cuisine .
"name[The Wrestlers], eatType[pub], food[Japanese], priceRange[more than £30], customer rating[5 out of 5], area[riverside], familyFriendly[yes], near[Raja Indian Cuisine]"	The Wrestlers is a 5 star sushi restaurant located next to Raja Indian Cuisine .
"name[The Wrestlers], eatType[pub], food[Japanese], priceRange[more than £30], customer rating[low], area[city centre], familyFriendly[no], near[Raja Indian Cuisine]"	The Wrestlers is a Japanese pub located in the city centre near Raja Indian Cuisine . It is not family - friendly and is in the higher price range .
"name[The Wrestlers], eatType[pub], food[Japanese], priceRange[more than £30], customer rating[low], area[city centre], familyFriendly[yes], near[Raja Indian Cuisine]"	The Wrestlers is a children friendly Japanese pub in the city centre near Raja Indian Cuisine with a low customer rating and a price range of more than 30 euros .
"name[The Wrestlers], eatType[pub], food[Japanese], priceRange[more than £30], customer rating[low], area[riverside], familyFriendly[no], near[Raja Indian Cuisine]"	The Wrestlers is a non children friendly Japanese pub near Raja Indian Cuisine in riverside with a low customer rating and a price range of more than £ 30 .
"name[The Wrestlers], eatType[pub], food[Japanese], priceRange[more than £30], customer rating[low], area[riverside], familyFriendly[yes], near[Raja Indian Cuisine]"	The Wrestlers is a children friendly Japanese pub in the riverside area near Raja Indian Cuisine with a low customer rating and a price range of more than £ 30 .
"name[The Wrestlers], eatType[restaurant], food[Italian], priceRange[less than £20], area[riverside], familyFriendly[no], near[Raja Indian Cuisine]"	The Wrestlers is a restaurant based in the riverside area near Raja Indian Cuisine offering Italian food for less than £ 20 . It is not family - friendly .
"name[The Wrestlers], eatType[restaurant], food[Italian], priceRange[less than £20], area[riverside], familyFriendly[yes], near[Raja Indian Cuisine]"	Serving Italian food in the riverside area near Raja Indian Cuisine is The Wrestlers . It is a family friendly restaurant with a price range of less than £ 20 .
"name[The Wrestlers], eatType[restaurant], food[Italian], priceRange[moderate], area[city centre], familyFriendly[no], near[Raja Indian Cuisine]"	The Wrestlers is a no family - friendly restaurant that provides Italian food . It is located in the city centre near Raja Indian Cuisine .
"name[The Wrestlers], eatType[restaurant], food[Italian], priceRange[moderate], area[city centre], familyFriendly[yes], near[Raja Indian Cuisine]"	In the city centre near Raja Indian Cuisine is a moderately priced Italian restaurant named The Wrestlers . It is kid friendly .
"name[The Wrestlers], eatType[restaurant], food[Italian], priceRange[moderate], area[riverside], familyFriendly[no], near[Raja Indian Cuisine]"	In the riverside area near Raja Indian Cuisine is a moderate priced restaurant called The Wrestlers that serves Italian food and is not child friendly .
"name[The Wrestlers], eatType[restaurant], food[Italian], priceRange[moderate], area[riverside], familyFriendly[yes], near[Raja Indian Cuisine]"	The Wrestlers is a moderately priced , kid friendly Italian restaurant in the riverside area near Raja Indian Cuisine .
"name[The Wrestlers], eatType[restaurant], food[Italian], priceRange[more than £30], area[riverside], familyFriendly[yes], near[Raja Indian Cuisine]"	The Wrestlers is a children friendly Italian restaurant in the riverside area near Raja Indian Cuisine with a price range of more than £ 30 .
"name[The Wrestlers], eatType[restaurant], food[Japanese], priceRange[£20-25], area[riverside], familyFriendly[yes], near[Raja Indian Cuisine]"	Try The Wrestlers in the riverside area near Raja Indian Cuisine . It is a kids friendly Japanese restaurant with a price range of £ 20 - 25 .
"name[The Wrestlers], eatType[restaurant], food[Japanese], priceRange[cheap], area[riverside], familyFriendly[yes], near[Raja Indian Cuisine]"	The Wrestlers is a cheap , family friendly restaurant that provides Japanese food . It is close to Raja Indian Cuisine in the riverside area .
"name[The Wrestlers], eatType[restaurant], food[Japanese], priceRange[high], area[riverside], familyFriendly[yes], near[Raja Indian Cuisine]"	The Wrestlers is a family friendly restaurant that serves high priced Japanese food . It is located in the riverside area near Raja Indian Cuisine .
"name[The Wrestlers], eatType[restaurant], food[Japanese], priceRange[less than £20], area[city centre], familyFriendly[no], near[Raja Indian Cuisine]"	The Wrestlers is a Japanese restaurant near Raja Indian Cuisine in the center of the city that is not family - friendly .
"name[The Wrestlers], eatType[restaurant], food[Japanese], priceRange[less than £20], area[city centre], familyFriendly[yes], near[Raja Indian Cuisine]"	The Wrestlers is a family - friendly Japanese restaurant with prices less than £ 20 . It is located in the city centre near Raja Indian Cuisine .
"name[The Wrestlers], eatType[restaurant], food[Japanese], priceRange[less than £20], area[riverside], familyFriendly[no], near[Raja Indian Cuisine]"	The Wrestlers is a Japanese restaurant located beside the riverside next to Raja Indian Cuisine . It does not allow children .
"name[The Wrestlers], eatType[restaurant], food[Japanese], priceRange[less than £20], area[riverside], familyFriendly[yes], near[Raja Indian Cuisine]"	Come check out The Wrestlers , an affordable , family friendly Japanese restaurant in the riverside area near Raja Indian Cuisine .
"name[The Wrestlers], eatType[restaurant], food[Japanese], priceRange[moderate], area[city centre], familyFriendly[no], near[Raja Indian Cuisine]"	The Wrestlers is a moderately priced , adult Japanese restaurant located in the city centre near Raja Indian Cuisine .
"name[The Wrestlers], eatType[restaurant], food[Japanese], priceRange[moderate], area[city centre], familyFriendly[yes], near[Raja Indian Cuisine]"	The Wrestlers is a moderately priced restaurant in the city centre near Raja Indian Cuisine . They serve Japanese food and are child friendly .
"name[The Wrestlers], eatType[restaurant], food[Japanese], priceRange[moderate], area[riverside], familyFriendly[no], near[Raja Indian Cuisine]"	The Wrestlers restaurant serves moderately priced sushi and is located near Raja Indian Cuisine .
"name[The Wrestlers], eatType[restaurant], food[Japanese], priceRange[moderate], area[riverside], familyFriendly[yes], near[Raja Indian Cuisine]"	The Wrestlers is a Sushi restaurant outside of the city centre near Raja Indian Cuisine that provides food and is family friendly .
"name[The Wrestlers], eatType[restaurant], food[Japanese], priceRange[more than £30], area[city centre], familyFriendly[no], near[Raja Indian Cuisine]"	The Wrestlers is a Japanese restaurant located in the city centre near Raja Indian Cuisine . It has a price range of more than £ 30 and is not children - free .
"name[The Wrestlers], eatType[restaurant], food[Japanese], priceRange[more than £30], area[city centre], familyFriendly[yes], near[Raja Indian Cuisine]"	The Wrestlers is a restaurant that provides Japanese food in the city centre near Raja Indian Cuisine . It is child friendly and has a price range of more than £ 30 .
"name[The Wrestlers], eatType[restaurant], food[Japanese], priceRange[more than £30], area[riverside], familyFriendly[no], near[Raja Indian Cuisine]"	The Wrestlers is a moderately priced restaurant in the riverside area near Raja Indian Cuisine . It serves Japanese food and is not child friendly .
"name[The Wrestlers], eatType[restaurant], food[Japanese], priceRange[more than £30], area[riverside], familyFriendly[yes], near[Raja Indian Cuisine]"	The Wrestlers restaurant features a high priced menu . It is located near Raja Indian Cuisine .
"name[Wildwood], eatType[coffee shop], area[riverside]"	Wildwood is a coffee shop on the river side .
"name[Wildwood], eatType[pub], area[riverside]"	In the riverside area , there is a pub that serves pub named Wildwood .
"name[Wildwood], eatType[pub], food[French], area[riverside], familyFriendly[yes], near[Raja Indian Cuisine]"	In the riverside area near Raja Indian Cuisine is a pub called Wildwood that serves French food and is kid friendly .
"name[Wildwood], eatType[pub], food[Indian], area[city centre], familyFriendly[no], near[Raja Indian Cuisine]"	There is a pub near Raja Indian Cuisine in the city centre called Wildwood . It sells Indian food and is not family friendly .
"name[Wildwood], eatType[pub], food[Indian], area[city centre], familyFriendly[yes], near[Raja Indian Cuisine]"	Wildwood is a family friendly pub serving Indian cuisine . It is located in the city center near Raja Indian Cuisine .
"name[Wildwood], eatType[pub], food[Indian], area[riverside], familyFriendly[no], near[Raja Indian Cuisine]"	There is an Indian pub near Raja Indian Cuisine called Wildwood . It is not suitable for families .
"name[Wildwood], eatType[pub], food[Indian], area[riverside], familyFriendly[yes], near[Raja Indian Cuisine]"	In the riverside area near Raja Indian Cuisine is a family friendly pub called Wildwood that serves Indian food .
"name[Wildwood], eatType[pub], food[Italian], area[city centre], familyFriendly[no], near[Raja Indian Cuisine]"	In the city centre near Raja Indian Cuisine is an adult pub serving Italian food called Wildwood .
"name[Wildwood], eatType[pub], food[Italian], area[city centre], familyFriendly[yes], near[Raja Indian Cuisine]"	Wildwood is a pub offering Italian food . It is located near Raja Indian Cuisine in the city centre and is kid friendly .
"name[Wildwood], eatType[pub], food[Italian], area[riverside], familyFriendly[no], near[Raja Indian Cuisine]"	There is a pub near Raja Indian Cuisine near the Thames serving Italian food called Wildwood . It is not family - friendly .
"name[Wildwood], eatType[pub], food[Italian], area[riverside], familyFriendly[yes], near[Raja Indian Cuisine]"	Wildwood is a pub that provides Italian food . It is located in riverside near Raja Indian Cuisine .
"name[Wildwood], eatType[restaurant], food[French], area[riverside], familyFriendly[yes], near[Raja Indian Cuisine]"	Wildwood is a children friendly French restaurant in the riverside area near Raja Indian Cuisine .
"name[Wildwood], eatType[restaurant], food[Indian], area[city centre], familyFriendly[no], near[Raja Indian Cuisine]"	Wildwood is a restaurant that serves Indian food . It is located in the city centre near Raja Indian Cuisine and is not family friendly .
"name[Wildwood], eatType[restaurant], food[Indian], area[city centre], familyFriendly[yes], near[Raja Indian Cuisine]"	Located in the city centre near Raja Indian Cuisine , Wildwood is a family friendly Indian restaurant .
"name[Wildwood], eatType[restaurant], food[Indian], area[riverside], familyFriendly[no], near[Raja Indian Cuisine]"	The Wildwood restaurant is not family friendly and offers Indian food . It is located in the riverside area near Raja Indian Cuisine .
"name[Wildwood], eatType[restaurant], food[Indian], area[riverside], familyFriendly[yes], near[Raja Indian Cuisine]"	There is a low priced Indian restaurant in riverside near Raja Indian Cuisine named Wildwood .
"name[Wildwood], eatType[restaurant], food[Italian], area[city centre], familyFriendly[no], near[Raja Indian Cuisine]"	Wildwood is a restaurant near Raja Indian Cuisine in the center of the city that is not family - friendly .
"name[Wildwood], eatType[restaurant], food[Italian], area[city centre], familyFriendly[yes], near[Raja Indian Cuisine]"	Wildwood is a family - friendly restaurant serving Italian food in the city centre near Raja Indian Cuisine .
"name[Wildwood], eatType[restaurant], food[Italian], area[riverside], familyFriendly[no], near[Raja Indian Cuisine]"	Wildwood is a restaurant located outside of the city centre near Raja Indian Cuisine .
"name[Wildwood], eatType[restaurant], food[Italian], area[riverside], familyFriendly[yes], near[Raja Indian Cuisine]"	For a family friendly Italian restaurant in the riverside area , come to Wildwood near Raja Indian Cuisine .
"name[Zizzi], eatType[coffee shop], area[riverside]"	Zizzi is a coffee shop offering food in the riverside area .
"name[Zizzi], eatType[coffee shop], customer rating[average], near[Burger King]"	Located near Burger King , Zizzi is a average rated coffee shop .
"name[Zizzi], eatType[coffee shop], customer rating[high], near[Burger King]"	Zizzi is a highly rated coffee shop near Burger King .
"name[Zizzi], eatType[coffee shop], near[The Sorrento]"	Close to The Sorrento is a pretty pretty coffee shop Check out Zizzi . Check out Zizzi
"name[Zizzi], eatType[pub], area[riverside]"	Near the river is a pub called Zizzi .
"name[Zizzi], eatType[pub], customer rating[average], near[Burger King]"	Near Burger King is a pub named Zizzi with an average customer rating .
"name[Zizzi], eatType[pub], customer rating[high], near[Burger King]"	There is a high customer rating pub called Zizzi near Burger King .
"name[Zizzi], eatType[pub], near[The Sorrento]"	Located close to The Sorrento , Zizzi is a pub .
