name[Blue Spice], eatType[coffee shop], area[city centre]	In the city centre is a coffee shop called Blue Spice.
name[Blue Spice], eatType[coffee shop], area[riverside]	In the riverside area there is a coffee shop called Blue Spice.
name[Blue Spice], eatType[coffee shop], customer rating[5 out of 5], near[Crowne Plaza Hotel]	Blue Spice is a 5 out of 5 rated coffee shop near Crowne Plaza Hotel.
name[Blue Spice], eatType[coffee shop], customer rating[average], near[Burger King]	Blue Spice is an average rated coffee shop near Burger King.
name[Blue Spice], eatType[coffee shop], customer rating[average], near[Crowne Plaza Hotel]	Blue Spice is an average rated coffee shop near Crowne Plaza Hotel.
name[Blue Spice], eatType[pub], area[city centre]	In the city centre is a pub called Blue Spice.
name[Blue Spice], eatType[pub], area[riverside]	In the riverside area there is a pub called Blue Spice.
name[Blue Spice], eatType[pub], customer rating[5 out of 5], near[Crowne Plaza Hotel]	Blue Spice is a 5 out of 5 rated pub near Crowne Plaza Hotel.
name[Blue Spice], eatType[pub], customer rating[average], near[Burger King]	Blue Spice is an average rated pub near Burger King.
name[Blue Spice], eatType[pub], customer rating[average], near[Crowne Plaza Hotel]	Blue Spice is an average rated pub near Crowne Plaza Hotel.
name[Blue Spice], eatType[pub], food[Chinese], area[city centre], familyFriendly[no], near[Rainbow Vegetarian Café]	Blue Spice is a Chinese pub near Rainbow Vegetarian Café in the city centre it is not family-friendly.
name[Blue Spice], eatType[pub], food[Chinese], area[city centre], familyFriendly[yes], near[Rainbow Vegetarian Café]	Blue Spice is a Chinese pub near Rainbow Vegetarian Café in the city centre it is family friendly.
name[Blue Spice], eatType[pub], food[Chinese], area[riverside], familyFriendly[no], near[Rainbow Vegetarian Café]	Blue Spice is a Chinese pub near Rainbow Vegetarian Café in the riverside area it is not family-friendly.
name[Blue Spice], eatType[pub], food[Chinese], area[riverside], familyFriendly[yes], near[Rainbow Vegetarian Café]	Blue Spice is a Chinese pub near Rainbow Vegetarian Café in riverside it is family friendly.
name[Blue Spice], eatType[pub], food[English], area[city centre], familyFriendly[no], near[Rainbow Vegetarian Café]	Blue Spice is a pub that serves English food near Rainbow Vegetarian Café in the city centre it is not family-friendly.
name[Blue Spice], eatType[pub], food[English], area[city centre], familyFriendly[yes], near[Rainbow Vegetarian Café]	Blue Spice is an pub near Rainbow Vegetarian Café in the city centre it is family-friendly.
name[Blue Spice], eatType[pub], food[English], area[riverside], familyFriendly[no], near[Rainbow Vegetarian Café]	Blue Spice is an pub near Rainbow Vegetarian Café in the riverside area it is not family-friendly.
name[Blue Spice], eatType[pub], food[English], area[riverside], familyFriendly[yes], near[Rainbow Vegetarian Café]	Blue Spice is a family-friendly pub near Rainbow Vegetarian Café in riverside serves English food.
name[Blue Spice], eatType[restaurant], food[Chinese], area[city centre], familyFriendly[no], near[Rainbow Vegetarian Café]	Blue Spice is a Chinese restaurant near Rainbow Vegetarian Café in the city centre it is not family-friendly.
name[Blue Spice], eatType[restaurant], food[Chinese], area[city centre], familyFriendly[yes], near[Rainbow Vegetarian Café]	Blue Spice is a Chinese restaurant near Rainbow Vegetarian Café in the city centre it is family friendly.
name[Blue Spice], eatType[restaurant], food[Chinese], area[riverside], familyFriendly[no], near[Rainbow Vegetarian Café]	Blue Spice is a Chinese restaurant near Rainbow Vegetarian Café in riverside it is not family-friendly.
name[Blue Spice], eatType[restaurant], food[Chinese], area[riverside], familyFriendly[yes], near[Rainbow Vegetarian Café]	Blue Spice is a Chinese restaurant near Rainbow Vegetarian Café in riverside it is family friendly.
name[Blue Spice], eatType[restaurant], food[English], area[city centre], familyFriendly[no], near[Rainbow Vegetarian Café]	Blue Spice is an restaurant near Rainbow Vegetarian Café in the city centre it is not family-friendly.
name[Blue Spice], eatType[restaurant], food[English], area[city centre], familyFriendly[yes], near[Rainbow Vegetarian Café]	Blue Spice is an restaurant in the city centre near Rainbow Vegetarian Café it is family friendly.
name[Blue Spice], eatType[restaurant], food[English], area[riverside], familyFriendly[no], near[Rainbow Vegetarian Café]	Blue Spice is an restaurant near Rainbow Vegetarian Café in riverside it is not family-friendly.
name[Blue Spice], eatType[restaurant], food[English], area[riverside], familyFriendly[yes], near[Rainbow Vegetarian Café]	Blue Spice is an restaurant in riverside near Rainbow Vegetarian Café it is family friendly.
name[Clowns], eatType[coffee shop], customer rating[3 out of 5], near[All Bar One]	Clowns is a 3 out of 5 rated coffee shop near All Bar One.
name[Clowns], eatType[coffee shop], customer rating[5 out of 5], near[Crowne Plaza Hotel]	Clowns is a 5 out of 5 rated coffee shop near Crowne Plaza Hotel.
name[Clowns], eatType[coffee shop], near[The Sorrento]	Clowns is a coffee shop near The Sorrento.
name[Clowns], eatType[pub], customer rating[3 out of 5], near[All Bar One]	Clowns is a pub near All Bar One and has a customer rating of 3 out of 5.
name[Clowns], eatType[pub], customer rating[5 out of 5], near[Crowne Plaza Hotel]	Clowns is a 5 out of 5 rated pub near Crowne Plaza Hotel.
name[Clowns], eatType[pub], near[The Sorrento]	Clowns is a pub near The Sorrento.
name[Cocum], eatType[coffee shop], customer rating[high], near[Burger King]	Cocum is a highly rated coffee shop near Burger King.
name[Cocum], eatType[coffee shop], customer rating[high], near[Café Sicilia]	Cocum is a highly rated coffee shop near Café Sicilia.
name[Cocum], eatType[coffee shop], customer rating[low], near[Café Sicilia]	Cocum is a low rated coffee shop near Café Sicilia.
name[Cocum], eatType[coffee shop], customer rating[low], near[Express by Holiday Inn]	Cocum is a low rated coffee shop near Express by Holiday Inn.
name[Cocum], eatType[coffee shop], near[The Rice Boat]	Cocum is a coffee shop near The Rice Boat.
name[Cocum], eatType[coffee shop], near[The Sorrento]	Cocum is a coffee shop near The Sorrento.
name[Cocum], eatType[pub], customer rating[high], near[Burger King]	Cocum is a highly rated pub near Burger King.
name[Cocum], eatType[pub], customer rating[high], near[Café Sicilia]	Cocum is a highly rated pub near Café Sicilia.
name[Cocum], eatType[pub], customer rating[low], near[Café Sicilia]	Cocum is a low rated pub near Café Sicilia.
name[Cocum], eatType[pub], customer rating[low], near[Express by Holiday Inn]	Cocum is a low rated pub near Express by Holiday Inn.
name[Cocum], eatType[pub], near[The Rice Boat]	Cocum is a pub near The Rice Boat.
name[Cocum], eatType[pub], near[The Sorrento]	Cocum is a pub near The Sorrento.
name[Cotto], eatType[coffee shop], near[The Bakers]	Cotto is a coffee shop near The Bakers.
name[Cotto], eatType[pub], near[The Bakers]	Cotto is a pub near The Bakers.
name[Giraffe], eatType[coffee shop], near[The Bakers]	Giraffe is a coffee shop near The Bakers.
name[Giraffe], eatType[coffee shop], near[The Rice Boat]	Giraffe is a coffee shop near The Rice Boat.
name[Giraffe], eatType[pub], food[English], area[riverside], familyFriendly[yes], near[Rainbow Vegetarian Café]	Giraffe is a family-friendly pub near Rainbow Vegetarian Café in riverside serves English food.
name[Giraffe], eatType[pub], food[Fast food], area[city centre], familyFriendly[no], near[Rainbow Vegetarian Café]	Giraffe is a Fast food pub near Rainbow Vegetarian Café in the city centre it is not family-friendly.
name[Giraffe], eatType[pub], food[Fast food], area[city centre], familyFriendly[yes], near[Rainbow Vegetarian Café]	Giraffe is a Fast food pub near Rainbow Vegetarian Café in the city centre it is family-friendly.
name[Giraffe], eatType[pub], food[Fast food], area[riverside], familyFriendly[no], near[Rainbow Vegetarian Café]	Giraffe is a Fast food pub near Rainbow Vegetarian Café in the riverside area it is not family-friendly.
name[Giraffe], eatType[pub], food[Fast food], area[riverside], familyFriendly[yes], near[Rainbow Vegetarian Café]	Giraffe is a family-friendly pub near Rainbow Vegetarian Café in the riverside area that serves Fast food.
name[Giraffe], eatType[pub], food[Fast food], area[riverside], familyFriendly[yes], near[Raja Indian Cuisine]	Giraffe is a family-friendly pub near Raja Indian Cuisine in the riverside area that serves Fast food.
name[Giraffe], eatType[pub], food[French], area[city centre], familyFriendly[no], near[Raja Indian Cuisine]	Giraffe is a French pub near Raja Indian Cuisine in the city centre it is not family-friendly.
name[Giraffe], eatType[pub], food[French], area[city centre], familyFriendly[yes], near[Raja Indian Cuisine]	Giraffe is a French pub near Raja Indian Cuisine in the city centre it is family-friendly.
name[Giraffe], eatType[pub], food[French], area[riverside], familyFriendly[no], near[Raja Indian Cuisine]	Giraffe is a French pub near Raja Indian Cuisine in the riverside area it is not family-friendly.
name[Giraffe], eatType[pub], food[French], area[riverside], familyFriendly[yes], near[Raja Indian Cuisine]	Giraffe is a French pub near Raja Indian Cuisine in the riverside area it is family friendly.
name[Giraffe], eatType[pub], near[The Bakers]	Giraffe is a pub near The Bakers.
name[Giraffe], eatType[pub], near[The Rice Boat]	Giraffe is a pub near The Rice Boat.
name[Giraffe], eatType[restaurant], food[English], area[riverside], familyFriendly[yes], near[Rainbow Vegetarian Café]	Giraffe is an restaurant in riverside near Rainbow Vegetarian Café it is family friendly.
name[Giraffe], eatType[restaurant], food[Fast food], area[city centre], familyFriendly[no], near[Rainbow Vegetarian Café]	Giraffe is a Fast food coffee shop near Rainbow Vegetarian Café in the city centre it is not family-friendly.
name[Giraffe], eatType[restaurant], food[Fast food], area[city centre], familyFriendly[yes], near[Rainbow Vegetarian Café]	Giraffe is a Fast food restaurant near Rainbow Vegetarian Café in the city centre it is family-friendly.
name[Giraffe], eatType[restaurant], food[Fast food], area[riverside], familyFriendly[no], near[Rainbow Vegetarian Café]	Giraffe is a Fast food coffee shop near Rainbow Vegetarian Café in riverside it is not family-friendly.
name[Giraffe], eatType[restaurant], food[Fast food], area[riverside], familyFriendly[yes], near[Rainbow Vegetarian Café]	Giraffe is a family friendly restaurant that serves Fast food near Rainbow Vegetarian Café in riverside.
name[Giraffe], eatType[restaurant], food[Fast food], area[riverside], familyFriendly[yes], near[Raja Indian Cuisine]	Giraffe is a family friendly restaurant that serves Fast food near Raja Indian Cuisine in riverside.
name[Giraffe], eatType[restaurant], food[French], area[city centre], familyFriendly[no], near[Raja Indian Cuisine]	Giraffe is a French restaurant near Raja Indian Cuisine in the city centre it is not family-friendly.
name[Giraffe], eatType[restaurant], food[French], area[city centre], familyFriendly[yes], near[Raja Indian Cuisine]	Giraffe is a French restaurant near Raja Indian Cuisine in the city centre it is family-friendly.
name[Giraffe], eatType[restaurant], food[French], area[riverside], familyFriendly[no], near[Raja Indian Cuisine]	Giraffe is a French restaurant near Raja Indian Cuisine in riverside it is not family-friendly.
name[Giraffe], eatType[restaurant], food[French], area[riverside], familyFriendly[yes], near[Raja Indian Cuisine]	Giraffe is a French restaurant near Raja Indian Cuisine in riverside it is family friendly.
name[Green Man], eatType[coffee shop], customer rating[1 out of 5], near[All Bar One]	Green Man is a coffee shop near All Bar One and has a customer rating of 1 out of 5.
name[Green Man], eatType[coffee shop], customer rating[3 out of 5], near[All Bar One]	Green Man is a 3 out of 5 rated coffee shop near All Bar One.
name[Green Man], eatType[pub], customer rating[1 out of 5], near[All Bar One]	Green Man is a pub near All Bar One and has a customer rating of 1 out of 5.
name[Green Man], eatType[pub], customer rating[3 out of 5], near[All Bar One]	Green Man is a pub near All Bar One and has a customer rating of 3 out of 5.
name[Green Man], eatType[pub], food[Italian], area[riverside], familyFriendly[yes], near[Express by Holiday Inn]	Green Man is an Italian pub in the riverside area near Express by Holiday Inn is a family friendly.
name[Green Man], eatType[pub], food[Italian], area[riverside], familyFriendly[yes], near[Raja Indian Cuisine]	Green Man is an Italian pub in the riverside area near Raja Indian Cuisine is a family friendly.
name[Green Man], eatType[pub], food[Japanese], area[city centre], familyFriendly[no], near[Express by Holiday Inn]	Green Man is a Japanese pub near Express by Holiday Inn in the city centre it is not family-friendly.
name[Green Man], eatType[pub], food[Japanese], area[city centre], familyFriendly[yes], near[Express by Holiday Inn]	Green Man is a Japanese pub near Express by Holiday Inn in the city centre it is family-friendly.
name[Green Man], eatType[pub], food[Japanese], area[riverside], familyFriendly[no], near[Express by Holiday Inn]	Green Man is a Japanese pub near Express by Holiday Inn in the riverside area it is not family-friendly.
name[Green Man], eatType[pub], food[Japanese], area[riverside], familyFriendly[yes], near[Express by Holiday Inn]	Green Man is a family-friendly pub near Express by Holiday Inn in the riverside area serves Japanese food.
name[Green Man], eatType[restaurant], food[Italian], area[riverside], familyFriendly[yes], near[Express by Holiday Inn]	Green Man is an Italian restaurant near Express by Holiday Inn in riverside it is family friendly.
name[Green Man], eatType[restaurant], food[Italian], area[riverside], familyFriendly[yes], near[Raja Indian Cuisine]	Green Man is an Italian restaurant near Raja Indian Cuisine in riverside it is family friendly.
name[Green Man], eatType[restaurant], food[Japanese], area[city centre], familyFriendly[no], near[Express by Holiday Inn]	Green Man is a Japanese restaurant near Express by Holiday Inn in the city centre it is not family-friendly.
name[Green Man], eatType[restaurant], food[Japanese], area[city centre], familyFriendly[yes], near[Express by Holiday Inn]	Green Man is a Japanese restaurant near Express by Holiday Inn in the city centre it is family-friendly.
name[Green Man], eatType[restaurant], food[Japanese], area[riverside], familyFriendly[no], near[Express by Holiday Inn]	Green Man is a Japanese restaurant near Express by Holiday Inn in the riverside area it is not family-friendly.
name[Green Man], eatType[restaurant], food[Japanese], area[riverside], familyFriendly[yes], near[Express by Holiday Inn]	Green Man is a Japanese restaurant near Express by Holiday Inn in the riverside area it is family friendly.
name[Loch Fyne], eatType[coffee shop], area[riverside]	In the riverside area there is a coffee shop called Loch Fyne.
name[Loch Fyne], eatType[pub], area[riverside]	In the riverside area there is a pub called Loch Fyne.
name[Strada], eatType[coffee shop], area[city centre]	In the city centre is a coffee shop called Strada.
name[Strada], eatType[coffee shop], customer rating[1 out of 5], near[All Bar One]	Strada is a coffee shop near All Bar One and has a customer rating of 1 out of 5.
name[Strada], eatType[coffee shop], customer rating[1 out of 5], near[Rainbow Vegetarian Café]	Strada is a coffee shop near Rainbow Vegetarian Café and has a customer rating of 1 out of 5.
name[Strada], eatType[coffee shop], customer rating[low], near[Express by Holiday Inn]	Strada is a low rated coffee shop near Express by Holiday Inn.
name[Strada], eatType[pub], area[city centre]	In the city centre is a pub called Strada.
name[Strada], eatType[pub], customer rating[1 out of 5], near[All Bar One]	Strada is a pub near All Bar One and has a customer rating of 1 out of 5.
name[Strada], eatType[pub], customer rating[1 out of 5], near[Rainbow Vegetarian Café]	Strada is a pub near Rainbow Vegetarian Café and has a customer rating of 1 out of 5.
name[Strada], eatType[pub], customer rating[low], near[Express by Holiday Inn]	Strada is a low rated pub near Express by Holiday Inn.
name[The Cricketers], eatType[coffee shop], customer rating[1 out of 5], familyFriendly[yes], near[Avalon]	The Cricketers is a family friendly coffee shop near Avalon and has a 1 out of 5.
name[The Cricketers], eatType[coffee shop], customer rating[3 out of 5], familyFriendly[yes], near[Avalon]	The Cricketers is a family friendly coffee shop near Avalon and has a customer rating of 3 out of 5.
name[The Cricketers], eatType[coffee shop], customer rating[3 out of 5], familyFriendly[yes], near[Crowne Plaza Hotel]	The Cricketers is a family friendly coffee shop near Crowne Plaza Hotel and has a customer rating of 3 out of 5.
name[The Cricketers], eatType[coffee shop], customer rating[5 out of 5], familyFriendly[no], near[Crowne Plaza Hotel]	The Cricketers is a coffee shop near Crowne Plaza Hotel it is not family-friendly and has a customer rating of 5 out of 5.
name[The Cricketers], eatType[coffee shop], customer rating[5 out of 5], familyFriendly[yes], near[Crowne Plaza Hotel]	The Cricketers is a family friendly coffee shop near Crowne Plaza Hotel and has a customer rating of 5 out of 5.
name[The Cricketers], eatType[coffee shop], customer rating[average], familyFriendly[no], near[Café Sicilia]	The Cricketers is a coffee shop near Café Sicilia it is not family-friendly and has a customer rating of average.
name[The Cricketers], eatType[coffee shop], customer rating[average], familyFriendly[no], near[Crowne Plaza Hotel]	The Cricketers is a coffee shop near Crowne Plaza Hotel it is not family-friendly and has a customer rating of average.
name[The Cricketers], eatType[coffee shop], customer rating[average], familyFriendly[yes], near[Café Sicilia]	The Cricketers is a family friendly coffee shop near Café Sicilia and has an average customer rating.
name[The Cricketers], eatType[coffee shop], customer rating[high], familyFriendly[yes], near[Café Sicilia]	The Cricketers is a family friendly coffee shop near Café Sicilia and has a high customer rating.
name[The Cricketers], eatType[coffee shop], customer rating[high], familyFriendly[yes], near[Express by Holiday Inn]	The Cricketers is a family friendly coffee shop near Express by Holiday Inn and has a high customer rating.
name[The Cricketers], eatType[coffee shop], customer rating[low], familyFriendly[no], near[Express by Holiday Inn]	The Cricketers is a coffee shop near Express by Holiday Inn it is not family-friendly and has a low customer rating.
name[The Cricketers], eatType[coffee shop], customer rating[low], familyFriendly[no], near[Ranch]	The Cricketers is a coffee shop near Ranch it is not family-friendly and has a low customer rating.
name[The Cricketers], eatType[coffee shop], customer rating[low], familyFriendly[yes], near[Ranch]	The Cricketers is a family friendly coffee shop near Ranch and has a low customer rating.
name[The Cricketers], eatType[restaurant], customer rating[1 out of 5], familyFriendly[yes], near[Avalon]	The Cricketers is a family friendly restaurant near Avalon and has a customer rating of 1 out of 5.
name[The Cricketers], eatType[restaurant], customer rating[3 out of 5], familyFriendly[yes], near[Avalon]	The Cricketers is a family friendly restaurant with a customer rating of 3 out of 5 and is near Avalon.
name[The Cricketers], eatType[restaurant], customer rating[3 out of 5], familyFriendly[yes], near[Crowne Plaza Hotel]	The Cricketers is a family friendly restaurant with a customer rating of 3 out of 5 and is near Crowne Plaza Hotel.
name[The Cricketers], eatType[restaurant], customer rating[5 out of 5], familyFriendly[no], near[Crowne Plaza Hotel]	The Cricketers is a restaurant near Crowne Plaza Hotel it is not family-friendly and has a customer rating of 5 out of 5.
name[The Cricketers], eatType[restaurant], customer rating[5 out of 5], familyFriendly[yes], near[Crowne Plaza Hotel]	The Cricketers is a family friendly restaurant with a 5 out of 5 and is near Crowne Plaza Hotel.
name[The Cricketers], eatType[restaurant], customer rating[average], familyFriendly[no], near[Café Sicilia]	The Cricketers is a restaurant near Café Sicilia it is not family-friendly and has a customer rating of average.
name[The Cricketers], eatType[restaurant], customer rating[average], familyFriendly[no], near[Crowne Plaza Hotel]	The Cricketers is a restaurant near Crowne Plaza Hotel it is not family-friendly and has a customer rating of average.
name[The Cricketers], eatType[restaurant], customer rating[average], familyFriendly[yes], near[Café Sicilia]	The Cricketers is a family friendly restaurant with an average customer rating and is located near Café Sicilia.
name[The Cricketers], eatType[restaurant], customer rating[high], familyFriendly[yes], near[Café Sicilia]	The Cricketers is a family friendly restaurant with a high customer rating it is near Café Sicilia.
name[The Cricketers], eatType[restaurant], customer rating[high], familyFriendly[yes], near[Express by Holiday Inn]	The Cricketers is a family friendly restaurant with a high customer rating it is near Express by Holiday Inn.
name[The Cricketers], eatType[restaurant], customer rating[low], familyFriendly[no], near[Express by Holiday Inn]	The Cricketers is a restaurant near Express by Holiday Inn it is not family-friendly and has a low customer rating.
name[The Cricketers], eatType[restaurant], customer rating[low], familyFriendly[no], near[Ranch]	The Cricketers is a restaurant near Ranch it is not family-friendly and has a low customer rating.
name[The Cricketers], eatType[restaurant], customer rating[low], familyFriendly[yes], near[Ranch]	The Cricketers is a family friendly restaurant with a low customer rating and is near Ranch.
name[The Cricketers], eatType[restaurant], food[Chinese], priceRange[£20-25], customer rating[high], area[city centre], familyFriendly[no], near[All Bar One]	The Cricketers is a Chinese restaurant in the city centre near All Bar One it has a high customer rating - 25 price range it is not kids friendly.
name[The Cricketers], eatType[restaurant], food[Chinese], priceRange[£20-25], customer rating[high], area[city centre], familyFriendly[yes], near[All Bar One]	The Cricketers is a Chinese restaurant located in the city centre near All Bar One it is family friendly, has a high customer rating and has a price range of £20-25.
name[The Cricketers], eatType[restaurant], food[Chinese], priceRange[£20-25], customer rating[high], area[riverside], familyFriendly[no], near[All Bar One]	The Cricketers is a Chinese restaurant located in riverside near All Bar One it has a high customer rating - 25 price range it is not kids friendly.
name[The Cricketers], eatType[restaurant], food[Chinese], priceRange[£20-25], customer rating[high], area[riverside], familyFriendly[yes], near[All Bar One]	The Cricketers is a Chinese restaurant located in riverside near All Bar One it is family friendly, has a high customer rating and has a price range of £20-25.
name[The Cricketers], eatType[restaurant], food[Chinese], priceRange[cheap], customer rating[5 out of 5], area[city centre], familyFriendly[no], near[All Bar One]	The Cricketers is a cheap Chinese restaurant near All Bar One in the city centre it is not family-friendly and has a customer rating of 5 out of 5.
name[The Cricketers], eatType[restaurant], food[Chinese], priceRange[cheap], customer rating[5 out of 5], area[city centre], familyFriendly[yes], near[All Bar One]	The Cricketers is a cheap Chinese restaurant near All Bar One in the city centre it is family friendly and has a customer rating of 5 out of 5.
name[The Cricketers], eatType[restaurant], food[Chinese], priceRange[cheap], customer rating[5 out of 5], area[riverside], familyFriendly[no], near[All Bar One]	The Cricketers is a cheap Chinese restaurant near All Bar One in riverside it is not family-friendly and has a customer rating of 5 out of 5.
name[The Cricketers], eatType[restaurant], food[Chinese], priceRange[cheap], customer rating[5 out of 5], area[riverside], familyFriendly[yes], near[All Bar One]	The Cricketers is a cheap Chinese restaurant near All Bar One in riverside it is family friendly and has a customer rating of 5 out of 5.
name[The Cricketers], eatType[restaurant], food[Chinese], priceRange[cheap], customer rating[average], area[city centre], familyFriendly[no], near[All Bar One]	The Cricketers is a cheap Chinese restaurant near All Bar One in the city centre it is not family-friendly and has an average customer rating.
name[The Cricketers], eatType[restaurant], food[Chinese], priceRange[cheap], customer rating[average], area[city centre], familyFriendly[yes], near[All Bar One]	The Cricketers is a cheap Chinese restaurant near All Bar One in the city centre it is family friendly and has an average customer rating.
name[The Cricketers], eatType[restaurant], food[Chinese], priceRange[cheap], customer rating[average], area[riverside], familyFriendly[no], near[All Bar One]	The Cricketers is a cheap Chinese restaurant near All Bar One in riverside it is not family-friendly and has an average customer rating.
name[The Cricketers], eatType[restaurant], food[Chinese], priceRange[cheap], customer rating[average], area[riverside], familyFriendly[yes], near[All Bar One]	The Cricketers is a cheap Chinese restaurant near All Bar One in riverside it is family friendly and has an average customer rating.
name[The Cricketers], eatType[restaurant], food[Chinese], priceRange[high], customer rating[1 out of 5], area[city centre], familyFriendly[no], near[All Bar One]	The Cricketers is a Chinese restaurant near All Bar One in the city centre with a high price range and is not family friendly.
name[The Cricketers], eatType[restaurant], food[Chinese], priceRange[high], customer rating[1 out of 5], area[city centre], familyFriendly[yes], near[All Bar One]	The Cricketers is a Chinese restaurant near All Bar One in the city centre it is children friendly 1 out of 5 and has a price range.
name[The Cricketers], eatType[restaurant], food[Chinese], priceRange[high], customer rating[1 out of 5], area[riverside], familyFriendly[no], near[All Bar One]	The Cricketers is a Chinese restaurant near All Bar One in riverside with a high price range and is not family friendly.
name[The Cricketers], eatType[restaurant], food[Chinese], priceRange[high], customer rating[1 out of 5], area[riverside], familyFriendly[yes], near[All Bar One]	The Cricketers is a Chinese restaurant near All Bar One in riverside it is children friendly, has a 1 out of 5 and has a price range.
name[The Cricketers], eatType[restaurant], food[Chinese], priceRange[high], customer rating[average], area[city centre], familyFriendly[no], near[All Bar One]	The Cricketers is a Chinese restaurant near All Bar One in the city centre with an average customer rating and has a high price range it is not family friendly.
name[The Cricketers], eatType[restaurant], food[Chinese], priceRange[high], customer rating[average], area[city centre], familyFriendly[yes], near[All Bar One]	The Cricketers is a Chinese restaurant near All Bar One in the city centre with an average customer rating and a high price range but is family friendly.
name[The Cricketers], eatType[restaurant], food[Chinese], priceRange[high], customer rating[average], area[riverside], familyFriendly[no], near[All Bar One]	The Cricketers is a Chinese restaurant near All Bar One in riverside it has a high price range customer rating and is not family friendly.
name[The Cricketers], eatType[restaurant], food[Chinese], priceRange[high], customer rating[average], area[riverside], familyFriendly[yes], near[All Bar One]	The Cricketers is a Chinese restaurant near All Bar One in riverside it is family friendly and price range.
name[The Cricketers], eatType[restaurant], food[Chinese], priceRange[less than £20], customer rating[low], area[city centre], familyFriendly[no], near[All Bar One]	The Cricketers is a Chinese restaurant near All Bar One in the city centre with a low customer rating and a price range of less than £20 it is not family friendly.
name[The Cricketers], eatType[restaurant], food[Chinese], priceRange[less than £20], customer rating[low], area[city centre], familyFriendly[yes], near[All Bar One]	The Cricketers is a Chinese restaurant near All Bar One in the city centre it is family friendly, has a low customer rating and a price range of less than £20.
name[The Cricketers], eatType[restaurant], food[Chinese], priceRange[less than £20], customer rating[low], area[riverside], familyFriendly[no], near[All Bar One]	The Cricketers is a Chinese restaurant near All Bar One in riverside with a low customer rating and a price range of less than £20 it is not family friendly.
name[The Cricketers], eatType[restaurant], food[Chinese], priceRange[less than £20], customer rating[low], area[riverside], familyFriendly[yes], near[All Bar One]	The Cricketers is a Chinese restaurant near All Bar One in riverside it is family friendly, has a low customer rating and a price range of less than £20.
name[The Cricketers], eatType[restaurant], food[Chinese], priceRange[moderate], customer rating[1 out of 5], area[city centre], familyFriendly[no], near[All Bar One]	The Cricketers is a Chinese restaurant near All Bar One in the city centre it has a moderate price range with a customer rating of 1 out of 5 and is not kid friendly.
name[The Cricketers], eatType[restaurant], food[Chinese], priceRange[moderate], customer rating[1 out of 5], area[city centre], familyFriendly[yes], near[All Bar One]	The Cricketers is a Chinese restaurant near All Bar One in the city centre it has a moderate price range with a customer rating of 1 out of 5 and is kid friendly.
name[The Cricketers], eatType[restaurant], food[Chinese], priceRange[moderate], customer rating[1 out of 5], area[riverside], familyFriendly[no], near[All Bar One]	The Cricketers is a Chinese restaurant near All Bar One in riverside with a moderate price range and is not kid friendly.
name[The Cricketers], eatType[restaurant], food[Chinese], priceRange[moderate], customer rating[1 out of 5], area[riverside], familyFriendly[yes], near[All Bar One]	The Cricketers is a Chinese restaurant near All Bar One in riverside is kid friendly, has a moderate price range and a customer rating of 1 out of 5.
name[The Cricketers], eatType[restaurant], food[Chinese], priceRange[moderate], customer rating[3 out of 5], area[city centre], familyFriendly[no], near[All Bar One]	The Cricketers is a Chinese restaurant near All Bar One in the city centre it has a moderate price range with a customer rating of 3 out of 5 and is not kid friendly.
name[The Cricketers], eatType[restaurant], food[Chinese], priceRange[moderate], customer rating[3 out of 5], area[city centre], familyFriendly[yes], near[All Bar One]	The Cricketers is a Chinese restaurant near All Bar One in the city centre it has a moderate price range with a customer rating of 3 out of 5 and is kid friendly.
name[The Cricketers], eatType[restaurant], food[Chinese], priceRange[moderate], customer rating[3 out of 5], area[riverside], familyFriendly[no], near[All Bar One]	The Cricketers is a Chinese restaurant near All Bar One in riverside it has a moderate price range with a customer rating of 3 out of 5 and is not kid friendly.
name[The Cricketers], eatType[restaurant], food[Chinese], priceRange[moderate], customer rating[3 out of 5], area[riverside], familyFriendly[yes], near[All Bar One]	The Cricketers is a Chinese restaurant near All Bar One in riverside is kid friendly and has a moderate price range it has a customer rating of 3 out of 5.
name[The Cricketers], eatType[restaurant], food[Chinese], priceRange[more than £30], customer rating[high], area[city centre], familyFriendly[no], near[All Bar One]	The Cricketers is a restaurant that serves Chinese food for more than £30 it is not child friendly it has a high customer rating it near All Bar One.
name[The Cricketers], eatType[restaurant], food[Chinese], priceRange[more than £30], customer rating[high], area[city centre], familyFriendly[yes], near[All Bar One]	The Cricketers is a Chinese restaurant with a customer rating the price range is more than £30 it is children friendly and near All Bar One in the city centre.
name[The Cricketers], eatType[restaurant], food[Chinese], priceRange[more than £30], customer rating[high], area[riverside], familyFriendly[no], near[All Bar One]	The Cricketers is a Chinese restaurant with a customer rating the price range is more than £30 it is near All Bar One in riverside is not family friendly.
name[The Cricketers], eatType[restaurant], food[Chinese], priceRange[more than £30], customer rating[high], area[riverside], familyFriendly[yes], near[All Bar One]	The Cricketers is a Chinese restaurant with a customer rating the price range is more than £30 it is children friendly near All Bar One in the riverside area.
name[The Cricketers], eatType[restaurant], food[English], priceRange[£20-25], customer rating[high], area[city centre], familyFriendly[no], near[All Bar One]	The Cricketers is an restaurant in the city centre near All Bar One it has a high customer rating has a price range of £20-25 and is not kids friendly.
name[The Cricketers], eatType[restaurant], food[English], priceRange[£20-25], customer rating[high], area[city centre], familyFriendly[yes], near[All Bar One]	The Cricketers is an restaurant with a customer rating the price range is £20-25 and is kids friendly it near All Bar One.
name[The Cricketers], eatType[restaurant], food[English], priceRange[£20-25], customer rating[high], area[riverside], familyFriendly[no], near[All Bar One]	The Cricketers is an restaurant located in riverside near All Bar One it is not child friendly it has a high customer rating and has a price range of £20-25.
name[The Cricketers], eatType[restaurant], food[English], priceRange[£20-25], customer rating[high], area[riverside], familyFriendly[yes], near[All Bar One]	The Cricketers is an restaurant with a customer rating of 5 out of 5 it is family friendly it is near All Bar One and has a price range of £20-25.
name[The Cricketers], eatType[restaurant], food[English], priceRange[cheap], customer rating[5 out of 5], area[city centre], familyFriendly[no], near[Café Rouge]	The Cricketers is a cheap English restaurant near Café Rouge in the city centre it is not family-friendly and has a customer rating of 5 out of 5.
name[The Cricketers], eatType[restaurant], food[English], priceRange[cheap], customer rating[5 out of 5], area[city centre], familyFriendly[yes], near[Café Rouge]	The Cricketers is a cheap English restaurant in the city centre near Café Rouge it is family friendly and has a customer rating of 5 out of 5.
name[The Cricketers], eatType[restaurant], food[English], priceRange[cheap], customer rating[5 out of 5], area[riverside], familyFriendly[no], near[Café Rouge]	The Cricketers is a cheap English restaurant near Café Rouge in riverside it is not family-friendly and has a customer rating of 5 out of 5.
name[The Cricketers], eatType[restaurant], food[English], priceRange[cheap], customer rating[5 out of 5], area[riverside], familyFriendly[yes], near[Café Rouge]	The Cricketers is a cheap English restaurant in riverside near Café Rouge it is family friendly and has a customer rating of 5 out of 5.
name[The Cricketers], eatType[restaurant], food[English], priceRange[cheap], customer rating[average], area[city centre], familyFriendly[no], near[Café Rouge]	The Cricketers is a cheap English restaurant in the city centre near Café Rouge it has an average customer rating and is not family-friendly.
name[The Cricketers], eatType[restaurant], food[English], priceRange[cheap], customer rating[average], area[city centre], familyFriendly[yes], near[Café Rouge]	The Cricketers is a cheap English restaurant in the city centre near Café Rouge it is family friendly and has a customer rating of average.
name[The Cricketers], eatType[restaurant], food[English], priceRange[cheap], customer rating[average], area[riverside], familyFriendly[no], near[Café Rouge]	The Cricketers is a cheap English restaurant in riverside near Café Rouge it has an average customer rating and is not family-friendly.
name[The Cricketers], eatType[restaurant], food[English], priceRange[cheap], customer rating[average], area[riverside], familyFriendly[yes], near[Café Rouge]	The Cricketers is a cheap English restaurant in riverside near Café Rouge it is family friendly and has a customer rating of average.
name[The Cricketers], eatType[restaurant], food[English], priceRange[high], customer rating[1 out of 5], area[city centre], familyFriendly[no], near[Café Rouge]	The Cricketers is an restaurant near Café Rouge in the city centre with a high price range, a customer rating of 1 out of 5 and is not family-friendly.
name[The Cricketers], eatType[restaurant], food[English], priceRange[high], customer rating[1 out of 5], area[city centre], familyFriendly[yes], near[Café Rouge]	The Cricketers is an restaurant near Café Rouge in the city centre it is children friendly 1 out of 5 and has a price range.
name[The Cricketers], eatType[restaurant], food[English], priceRange[high], customer rating[1 out of 5], area[riverside], familyFriendly[no], near[Café Rouge]	The Cricketers is an restaurant near Café Rouge in riverside with a high price range, a customer rating of 1 out of 5 and is not child friendly.
name[The Cricketers], eatType[restaurant], food[English], priceRange[high], customer rating[1 out of 5], area[riverside], familyFriendly[yes], near[Café Rouge]	The Cricketers is an restaurant near Café Rouge in riverside it is children friendly, has a 1 out of 5 and has a price range.
name[The Cricketers], eatType[restaurant], food[English], priceRange[high], customer rating[average], area[city centre], familyFriendly[no], near[Café Rouge]	The Cricketers is an restaurant near Café Rouge in the city centre with an average customer rating and has a high price range it is not family-friendly.
name[The Cricketers], eatType[restaurant], food[English], priceRange[high], customer rating[average], area[city centre], familyFriendly[yes], near[Café Rouge]	The Cricketers is an restaurant in the city centre near Café Rouge it is family friendly, has a customer rating and is in the price range.
name[The Cricketers], eatType[restaurant], food[English], priceRange[high], customer rating[average], area[riverside], familyFriendly[no], near[Café Rouge]	The Cricketers is an restaurant near Café Rouge in riverside it has a high price range customer rating and is not family-friendly.
name[The Mill], eatType[pub], food[English], priceRange[high], area[riverside], familyFriendly[yes], near[Raja Indian Cuisine]	The Mill is an pub near Raja Indian Cuisine in riverside is child friendly and has a high price range.
name[The Mill], eatType[pub], food[English], priceRange[less than £20], area[city centre], familyFriendly[no], near[Raja Indian Cuisine]	The Mill is a pub that serves English food in the less than £20 is not family-friendly it near Raja Indian Cuisine.
name[The Mill], eatType[pub], food[English], priceRange[less than £20], area[city centre], familyFriendly[yes], near[Raja Indian Cuisine]	The Mill is an pub in the city centre near Raja Indian Cuisine it is family friendly and has a price range of less than £20.
name[The Mill], eatType[pub], food[English], priceRange[less than £20], area[riverside], familyFriendly[no], near[Raja Indian Cuisine]	The Mill is a pub that serves English food in the less than £20 it is not family-friendly it is near Raja Indian Cuisine.
name[The Mill], eatType[pub], food[English], priceRange[less than £20], area[riverside], familyFriendly[yes], near[Raja Indian Cuisine]	The Mill is an pub in riverside near Raja Indian Cuisine it is family friendly and has a price range of less than £20.
name[The Mill], eatType[pub], food[English], priceRange[moderate], area[city centre], familyFriendly[no], near[Raja Indian Cuisine]	The Mill is a pub that serves English food in the moderate price range it is not kid friendly it near Raja Indian Cuisine.
name[The Mill], eatType[pub], food[English], priceRange[moderate], area[city centre], familyFriendly[yes], near[Raja Indian Cuisine]	The Mill is an pub near Raja Indian Cuisine in the city centre it is kid friendly and has a moderate price range.
name[The Mill], eatType[pub], food[English], priceRange[moderate], area[riverside], familyFriendly[no], near[Raja Indian Cuisine]	The Mill is a pub that serves English food in the moderate price range it is not kid friendly and is located in the riverside area near Raja Indian Cuisine.
name[The Mill], eatType[pub], food[English], priceRange[moderate], area[riverside], familyFriendly[yes], near[Raja Indian Cuisine]	The Mill is an pub near Raja Indian Cuisine in riverside it is kid friendly and has a moderate price range.
name[The Mill], eatType[pub], food[English], priceRange[more than £30], area[riverside], familyFriendly[yes], near[Raja Indian Cuisine]	The Mill is an pub in riverside near Raja Indian Cuisine it is children friendly and has a price range of more than £30.
name[The Mill], eatType[pub], food[Fast food], priceRange[£20-25], area[riverside], familyFriendly[yes], near[Raja Indian Cuisine]	The Mill is a Fast food pub that is kid friendly and has a price range of £20-25 near Raja Indian Cuisine in riverside.
name[The Mill], eatType[pub], food[Fast food], priceRange[£20-25], customer rating[high], area[city centre], familyFriendly[no], near[Café Rouge]	The Mill is a Fast food pub near Café Rouge in the city centre it has a high customer rating, has a price range of £20-25 and is not kids friendly.
name[The Mill], eatType[pub], food[Fast food], priceRange[£20-25], customer rating[high], area[city centre], familyFriendly[yes], near[Café Rouge]	The Mill is a Fast food pub near Café Rouge in the city centre it is child friendly it has a high customer rating and has a price range of £20-25.
name[The Mill], eatType[pub], food[Fast food], priceRange[£20-25], customer rating[high], area[riverside], familyFriendly[no], near[Café Rouge]	The Mill is a Fast food pub near Café Rouge in riverside with a high customer rating, a price range of £20-25 and is not kid friendly.
name[The Mill], eatType[pub], food[Fast food], priceRange[£20-25], customer rating[high], area[riverside], familyFriendly[yes], near[Café Rouge]	The Mill is a Fast food pub near Café Rouge in riverside it is child friendly has a high customer rating and has a price range of £20-25.
name[The Mill], eatType[pub], food[Fast food], priceRange[£20-25], customer rating[high], area[riverside], familyFriendly[yes], near[Café Sicilia]	The Mill is a Fast food pub near Café Sicilia in riverside it is child friendly has a high customer rating and has a price range of £20-25.
name[The Mill], eatType[pub], food[Fast food], priceRange[cheap], area[riverside], familyFriendly[yes], near[Raja Indian Cuisine]	The Mill is a cheap Fast food pub is family friendly it is near Raja Indian Cuisine.
name[The Mill], eatType[pub], food[Fast food], priceRange[cheap], customer rating[5 out of 5], area[city centre], familyFriendly[no], near[Café Sicilia]	The Mill is a cheap Fast food pub near Café Sicilia in the city centre it is not family-friendly and has a customer rating of 5 out of 5.
name[The Mill], eatType[pub], food[Fast food], priceRange[cheap], customer rating[5 out of 5], area[city centre], familyFriendly[yes], near[Café Sicilia]	The Mill is a cheap Fast food pub near Café Sicilia in the city centre it is family-friendly and has a customer rating of 5 out of 5.
name[The Mill], eatType[pub], food[Fast food], priceRange[cheap], customer rating[5 out of 5], area[riverside], familyFriendly[no], near[Café Sicilia]	The Mill is a cheap Fast food pub near Café Sicilia in riverside it is not family-friendly and has a customer rating of 5 out of 5.
name[The Mill], eatType[pub], food[Fast food], priceRange[cheap], customer rating[5 out of 5], area[riverside], familyFriendly[yes], near[Café Sicilia]	The Mill is a cheap Fast food pub family friendly and has a customer rating of 5 out of 5 it is near Café Sicilia.
name[The Mill], eatType[pub], food[Fast food], priceRange[cheap], customer rating[average], area[city centre], familyFriendly[no], near[Café Sicilia]	The Mill is a cheap Fast food pub near Café Sicilia in the city centre it is not family-friendly and has an average customer rating.
name[The Mill], eatType[pub], food[Fast food], priceRange[cheap], customer rating[average], area[city centre], familyFriendly[yes], near[Café Sicilia]	The Mill is a cheap Fast food pub in the city centre near Café Sicilia it is family friendly and has a customer rating of average.
name[The Mill], eatType[pub], food[Fast food], priceRange[cheap], customer rating[average], area[riverside], familyFriendly[no], near[Café Sicilia]	The Mill is a cheap Fast food pub near Café Sicilia in riverside it is not family-friendly and has an average customer rating.
name[The Mill], eatType[pub], food[Fast food], priceRange[cheap], customer rating[average], area[riverside], familyFriendly[yes], near[Café Sicilia]	The Mill is a cheap Fast food pub family friendly and has a customer rating it is near Café Sicilia.
name[The Mill], eatType[pub], food[Fast food], priceRange[high], customer rating[1 out of 5], area[city centre], familyFriendly[no], near[Café Sicilia]	The Mill is a Fast food pub near Café Sicilia in the city centre with a high price range, a customer rating of 1 out of 5 and is not family-friendly.
name[The Mill], eatType[pub], food[Fast food], priceRange[high], customer rating[1 out of 5], area[city centre], familyFriendly[yes], near[Café Sicilia]	The Mill is a Fast food pub near Café Sicilia in the city centre it is children friendly 1 out of 5 and has a price range.
name[The Mill], eatType[pub], food[Fast food], priceRange[high], customer rating[1 out of 5], area[riverside], familyFriendly[no], near[Café Sicilia]	The Mill is a Fast food pub near Café Sicilia in riverside with a high price range, a customer rating of 1 out of 5 and is not child friendly.
name[The Mill], eatType[pub], food[Fast food], priceRange[high], customer rating[1 out of 5], area[riverside], familyFriendly[yes], near[Café Sicilia]	The Mill is a Fast food pub near Café Sicilia in riverside is children friendly has a high price range and a customer rating of 1 out of 5.
name[The Mill], eatType[pub], food[Fast food], priceRange[high], customer rating[average], area[city centre], familyFriendly[no], near[Café Sicilia]	The Mill is a Fast food pub near Café Sicilia in the city centre it has a high price range customer rating and is not family-friendly.
name[The Mill], eatType[pub], food[Fast food], priceRange[high], customer rating[average], area[city centre], familyFriendly[yes], near[Café Sicilia]	The Mill is a Fast food pub near Café Sicilia in the city centre it is family-friendly and price range.
name[The Mill], eatType[pub], food[Fast food], priceRange[high], customer rating[average], area[riverside], familyFriendly[no], near[Café Sicilia]	The Mill is a Fast food pub near Café Sicilia in riverside it has a high price range customer rating and is not family-friendly.
name[The Mill], eatType[pub], food[Fast food], priceRange[high], customer rating[average], area[riverside], familyFriendly[yes], near[Café Sicilia]	The Mill is a Fast food pub near Café Sicilia in riverside is children friendly and has a customer rating of average.
name[The Mill], eatType[pub], food[Fast food], priceRange[less than £20], customer rating[low], area[city centre], familyFriendly[no], near[Café Sicilia]	The Mill is a pub that serves Fast food for less than £20 it is not family-friendly and has a low customer rating it near Café Sicilia.
name[The Mill], eatType[pub], food[Fast food], priceRange[less than £20], customer rating[low], area[city centre], familyFriendly[yes], near[Café Sicilia]	The Mill is a Fast food pub near Café Sicilia in the city centre it is family-friendly and has a price range of less than £20.
name[The Mill], eatType[pub], food[Fast food], priceRange[less than £20], customer rating[low], area[riverside], familyFriendly[no], near[Café Sicilia]	The Mill is a Fast food pub near Café Sicilia in the riverside area it has a price range of less than £20 it is not family-friendly and has a low customer rating.
name[The Mill], eatType[pub], food[Fast food], priceRange[less than £20], customer rating[low], area[riverside], familyFriendly[yes], near[Café Sicilia]	The Mill is a Fast food pub that is family friendly and has a price range of less than £20 it has a low customer rating it is near Café Sicilia.
name[The Mill], eatType[pub], food[Fast food], priceRange[moderate], customer rating[1 out of 5], area[city centre], familyFriendly[no], near[Café Sicilia]	The Mill is a pub that serves Fast food at a moderate price range it is not kid friendly and has a customer rating of 1 out of 5 it near Café Sicilia.
name[The Mill], eatType[pub], food[Fast food], priceRange[moderate], customer rating[1 out of 5], area[city centre], familyFriendly[yes], near[Café Sicilia]	The Mill is a Fast food pub near Café Sicilia in the city centre it has a moderate price range with a customer rating of 1 out of 5 and is kid friendly.
name[The Mill], eatType[pub], food[Fast food], priceRange[moderate], customer rating[1 out of 5], area[riverside], familyFriendly[no], near[Café Sicilia]	The Mill is a pub that serves Fast food at a moderate price range it is not kid friendly and has a customer rating of 1 out of 5 it is near Café Sicilia.
name[The Mill], eatType[pub], food[Fast food], priceRange[moderate], customer rating[1 out of 5], area[riverside], familyFriendly[yes], near[Café Sicilia]	The Mill is a Fast food pub near Café Sicilia in riverside is kid friendly, has a moderate price range and a customer rating of 1 out of 5.
name[The Mill], eatType[pub], food[Fast food], priceRange[moderate], customer rating[3 out of 5], area[city centre], familyFriendly[no], near[Café Sicilia]	The Mill is a pub that serves Fast food at a moderate price range it is not kid friendly and has a customer rating of 3 out of 5 it near Café Sicilia.
name[The Mill], eatType[pub], food[Fast food], priceRange[moderate], customer rating[3 out of 5], area[city centre], familyFriendly[yes], near[Café Sicilia]	The Mill is a Fast food pub near Café Sicilia in the city centre it has a moderate price range with a customer rating of 3 out of 5 and is kid friendly.
name[The Mill], eatType[pub], food[Fast food], priceRange[moderate], customer rating[3 out of 5], area[riverside], familyFriendly[no], near[Café Sicilia]	The Mill is a Fast food pub near Café Sicilia in riverside it has a moderate price range and is not kid friendly.
name[The Mill], eatType[pub], food[Fast food], priceRange[moderate], customer rating[3 out of 5], area[riverside], familyFriendly[yes], near[Café Sicilia]	The Mill is a Fast food pub near Café Sicilia in riverside is kid friendly and has a moderate price range it has a customer rating of 3 out of 5.
name[The Mill], eatType[restaurant], food[English], priceRange[high], area[riverside], familyFriendly[yes], near[Raja Indian Cuisine]	The Mill is an restaurant near Raja Indian Cuisine in riverside is child friendly and has a high price range.
name[The Mill], eatType[restaurant], food[English], priceRange[high], customer rating[average], area[riverside], familyFriendly[yes], near[Café Rouge]	The Mill is an restaurant in riverside near Café Rouge is a child friendly high price range and customer rating.
name[The Mill], eatType[restaurant], food[English], priceRange[less than £20], area[city centre], familyFriendly[no], near[Raja Indian Cuisine]	The Mill is an restaurant in the city centre near Raja Indian Cuisine it is not family-friendly and has a price range of less than £20.
name[The Mill], eatType[restaurant], food[English], priceRange[less than £20], area[city centre], familyFriendly[yes], near[Raja Indian Cuisine]	The Mill is an restaurant in the city centre near Raja Indian Cuisine it is family friendly and has a price range of less than £20.
name[The Mill], eatType[restaurant], food[English], priceRange[less than £20], area[riverside], familyFriendly[no], near[Raja Indian Cuisine]	The Mill is an restaurant in riverside near Raja Indian Cuisine it is not family-friendly and has a price range of less than £20.
name[The Mill], eatType[restaurant], food[English], priceRange[less than £20], area[riverside], familyFriendly[yes], near[Raja Indian Cuisine]	The Mill is an restaurant in riverside near Raja Indian Cuisine is family friendly and has a price range of less than £20.
name[The Mill], eatType[restaurant], food[English], priceRange[less than £20], customer rating[low], area[city centre], familyFriendly[no], near[Café Rouge]	The Mill is an restaurant near Café Rouge in the city centre with a low customer rating and a price range of less than £20 it is not family-friendly.
name[The Mill], eatType[restaurant], food[English], priceRange[less than £20], customer rating[low], area[city centre], familyFriendly[yes], near[Café Rouge]	The Mill is an restaurant with a low customer rating the price range is less than £20 is family friendly it near Café Rouge.
name[The Mill], eatType[restaurant], food[English], priceRange[less than £20], customer rating[low], area[riverside], familyFriendly[no], near[Café Rouge]	The Mill is an restaurant near Café Rouge in riverside with a low customer rating and a price range of less than £20 it is not family-friendly.
name[The Mill], eatType[restaurant], food[English], priceRange[less than £20], customer rating[low], area[riverside], familyFriendly[yes], near[Café Rouge]	The Mill is an restaurant with a low customer rating the price range is less than £20 it is family friendly it is near Café Rouge.
name[The Mill], eatType[restaurant], food[English], priceRange[moderate], area[city centre], familyFriendly[no], near[Raja Indian Cuisine]	The Mill is a moderately priced restaurant in the city centre near Raja Indian Cuisine it serves English food and is not family-friendly.
name[The Mill], eatType[restaurant], food[English], priceRange[moderate], area[city centre], familyFriendly[yes], near[Raja Indian Cuisine]	The Mill is a moderately priced restaurant in the city centre near Raja Indian Cuisine it is family friendly.
name[The Mill], eatType[restaurant], food[English], priceRange[moderate], area[riverside], familyFriendly[no], near[Raja Indian Cuisine]	The Mill is a moderately priced restaurant in riverside near Raja Indian Cuisine that serves English food and is not family-friendly.
name[The Mill], eatType[restaurant], food[English], priceRange[moderate], area[riverside], familyFriendly[yes], near[Raja Indian Cuisine]	The Mill is a moderately priced restaurant in riverside near Raja Indian Cuisine it serves English food and is family friendly.
name[The Mill], eatType[restaurant], food[English], priceRange[moderate], customer rating[1 out of 5], area[city centre], familyFriendly[no], near[Café Rouge]	The Mill is an restaurant near Café Rouge in the city centre with a moderate price range and a customer rating of 1 out of 5 it is not kid friendly.
name[The Mill], eatType[restaurant], food[English], priceRange[moderate], customer rating[1 out of 5], area[city centre], familyFriendly[yes], near[Café Rouge]	The Mill is an restaurant near Café Rouge in the city centre it is kid friendly, has a 1 out of 5 and has a price range.
name[The Mill], eatType[restaurant], food[English], priceRange[moderate], customer rating[1 out of 5], area[riverside], familyFriendly[no], near[Café Rouge]	The Mill is a moderately priced restaurant that serves English food near Café Rouge it is not kid friendly and has a customer rating of 1 out of 5.
name[The Mill], eatType[restaurant], food[English], priceRange[moderate], customer rating[1 out of 5], area[riverside], familyFriendly[yes], near[Café Rouge]	The Mill is a moderately priced restaurant that serves English food near Café Rouge it is family friendly and has a customer rating of 1 out of 5.
name[The Mill], eatType[restaurant], food[English], priceRange[moderate], customer rating[3 out of 5], area[city centre], familyFriendly[no], near[Café Rouge]	The Mill is an restaurant near Café Rouge in the city centre it has a moderate price range and a customer rating of 3 out of 5 it is not kid friendly.
name[The Mill], eatType[restaurant], food[English], priceRange[moderate], customer rating[3 out of 5], area[city centre], familyFriendly[yes], near[Café Rouge]	The Mill is an restaurant near Café Rouge in the city centre it is kid friendly, has a customer rating of 3 out of 5 and is.
name[The Mill], eatType[restaurant], food[English], priceRange[moderate], customer rating[3 out of 5], area[riverside], familyFriendly[no], near[Café Rouge]	The Mill is an restaurant near Café Rouge in riverside it has a moderate price range with a customer rating of 3 out of 5 and is not kid friendly.
name[The Mill], eatType[restaurant], food[English], priceRange[moderate], customer rating[3 out of 5], area[riverside], familyFriendly[yes], near[Café Rouge]	The Mill is an restaurant near Café Rouge in riverside is a kid friendly and has a moderate price range it has a customer rating of 3 out of 5.
name[The Mill], eatType[restaurant], food[English], priceRange[more than £30], area[riverside], familyFriendly[yes], near[Raja Indian Cuisine]	The Mill is an restaurant in riverside near Raja Indian Cuisine it is children friendly and has a price range of more than £30.
name[The Mill], eatType[restaurant], food[English], priceRange[more than £30], customer rating[high], area[city centre], familyFriendly[no], near[Café Rouge]	The Mill is a restaurant that serves English food for more than £30 it has a high customer rating it is not child friendly it near Café Rouge.
name[The Mill], eatType[restaurant], food[English], priceRange[more than £30], customer rating[high], area[city centre], familyFriendly[yes], near[Café Rouge]	The Mill is an restaurant with a customer rating the price range is more than £30 and is child friendly it near Café Rouge.
name[The Mill], eatType[restaurant], food[English], priceRange[more than £30], customer rating[high], area[riverside], familyFriendly[no], near[Café Rouge]	The Mill is an restaurant with a customer rating the price range is more than £30 it is not kid friendly it is near Café Rouge.
name[The Mill], eatType[restaurant], food[English], priceRange[more than £30], customer rating[high], area[riverside], familyFriendly[yes], near[Café Rouge]	The Mill is an restaurant with a customer rating of 5 out of 5 it is children friendly and the price range is more than £30 it near Café Rouge.
name[The Mill], eatType[restaurant], food[Fast food], priceRange[£20-25], area[riverside], familyFriendly[yes], near[Raja Indian Cuisine]	The Mill is a Fast food restaurant in riverside near Raja Indian Cuisine it is family friendly and has a price range of £20-25.
name[The Mill], eatType[restaurant], food[Fast food], priceRange[cheap], area[riverside], familyFriendly[yes], near[Raja Indian Cuisine]	The Mill is a cheap Fast food restaurant near Raja Indian Cuisine in riverside is family friendly.
name[The Phoenix], eatType[pub], food[Fast food], priceRange[cheap], area[riverside], familyFriendly[yes], near[Raja Indian Cuisine]	The Phoenix is a cheap Fast food pub is family friendly it is near Raja Indian Cuisine.
name[The Phoenix], eatType[pub], food[Fast food], priceRange[high], area[city centre], familyFriendly[no], near[Raja Indian Cuisine]	The Phoenix is a Fast food pub near Raja Indian Cuisine in the city centre it has a high price range and is not child friendly.
name[The Phoenix], eatType[pub], food[Fast food], priceRange[high], area[city centre], familyFriendly[yes], near[Raja Indian Cuisine]	The Phoenix is a Fast food pub near Raja Indian Cuisine in the city centre it is children friendly and has a high price range.
name[The Phoenix], eatType[pub], food[Fast food], priceRange[high], area[riverside], familyFriendly[no], near[Raja Indian Cuisine]	The Phoenix is a Fast food pub near Raja Indian Cuisine in riverside with a high price range and is not child friendly.
name[The Phoenix], eatType[pub], food[Fast food], priceRange[high], area[riverside], familyFriendly[yes], near[Raja Indian Cuisine]	The Phoenix is a Fast food pub near Raja Indian Cuisine in riverside is child friendly and has a high price range.
name[The Phoenix], eatType[pub], food[Fast food], priceRange[less than £20], area[city centre], familyFriendly[no], near[Raja Indian Cuisine]	The Phoenix is a pub that serves Fast food for less than £20 is not family-friendly it near Raja Indian Cuisine.
name[The Phoenix], eatType[pub], food[Fast food], priceRange[less than £20], area[city centre], familyFriendly[yes], near[Raja Indian Cuisine]	The Phoenix is a Fast food pub is family friendly, has a price range of less than £20 and is near Raja Indian Cuisine in the city centre.
name[The Phoenix], eatType[pub], food[Fast food], priceRange[less than £20], area[riverside], familyFriendly[no], near[Raja Indian Cuisine]	The Phoenix is a pub that serves Fast food for less than £20 it is not family-friendly it is near Raja Indian Cuisine.
name[The Phoenix], eatType[pub], food[Fast food], priceRange[less than £20], area[riverside], familyFriendly[yes], near[Raja Indian Cuisine]	The Phoenix is a family friendly pub near Raja Indian Cuisine in riverside that serves Fast food for less than £20.
name[The Phoenix], eatType[pub], food[Fast food], priceRange[moderate], area[city centre], familyFriendly[no], near[Raja Indian Cuisine]	The Phoenix is a pub that serves Fast food at a moderate price range it is not family-friendly it near Raja Indian Cuisine.
name[The Phoenix], eatType[pub], food[Fast food], priceRange[moderate], area[city centre], familyFriendly[yes], near[Raja Indian Cuisine]	The Phoenix is a Fast food pub near Raja Indian Cuisine in the city centre it has a moderate price range and is family friendly.
name[The Phoenix], eatType[pub], food[Fast food], priceRange[moderate], area[riverside], familyFriendly[no], near[Raja Indian Cuisine]	The Phoenix is a pub that serves Fast food at a moderate price range it is not kid friendly and is located in the riverside area near Raja Indian Cuisine.
name[The Phoenix], eatType[pub], food[Fast food], priceRange[moderate], area[riverside], familyFriendly[yes], near[Raja Indian Cuisine]	The Phoenix is a Fast food pub near Raja Indian Cuisine in riverside it is kid friendly and has a moderate price range.
name[The Phoenix], eatType[pub], food[Fast food], priceRange[moderate], customer rating[3 out of 5], area[riverside], familyFriendly[yes], near[Café Sicilia]	The Phoenix is a Fast food pub near Café Sicilia in riverside is kid friendly and has a moderate price range it has a customer rating of 3 out of 5.
name[The Phoenix], eatType[pub], food[Fast food], priceRange[more than £30], area[riverside], familyFriendly[yes], near[Raja Indian Cuisine]	The Phoenix is a Fast food pub that is family friendly and the price range is more than £30 it near Raja Indian Cuisine.
name[The Phoenix], eatType[pub], food[Fast food], priceRange[more than £30], customer rating[high], area[city centre], familyFriendly[no], near[Café Sicilia]	The Phoenix is a pub that serves Fast food at more than £30 it near Café Sicilia it is not child friendly and has a high customer rating.
name[The Phoenix], eatType[pub], food[Fast food], priceRange[more than £30], customer rating[high], area[city centre], familyFriendly[yes], near[Café Sicilia]	The Phoenix is a pub that serves Fast food at a price range of more than £30 it is children friendly with a customer rating it near Café Sicilia.
name[The Phoenix], eatType[pub], food[Fast food], priceRange[more than £30], customer rating[high], area[riverside], familyFriendly[no], near[Café Sicilia]	The Phoenix is a pub that serves Fast food at more than £30 it is not child friendly and has a high customer rating it is near Café Sicilia.
name[The Phoenix], eatType[pub], food[Fast food], priceRange[more than £30], customer rating[high], area[riverside], familyFriendly[yes], near[Café Sicilia]	The Phoenix is a family friendly pub near Café Sicilia in the riverside area that serves Fast food for more than £30 and customer rating.
name[The Phoenix], eatType[pub], food[French], priceRange[£20-25], area[riverside], familyFriendly[yes], near[Raja Indian Cuisine]	The Phoenix is a French pub near Raja Indian Cuisine in riverside it is kid friendly and has a price range of £20-25.
name[The Phoenix], eatType[pub], food[French], priceRange[£20-25], customer rating[3 out of 5], area[city centre], familyFriendly[no], near[Café Sicilia]	The Phoenix is a French pub near Café Sicilia in the city centre it has a customer rating of 3 out of 5, has a price range of £20-25 and is not kid friendly.
name[The Phoenix], eatType[pub], food[French], priceRange[£20-25], customer rating[3 out of 5], area[city centre], familyFriendly[yes], near[Café Sicilia]	The Phoenix is a French pub near Café Sicilia in the city centre it is child friendly it and has a price range of £20-25.
name[The Phoenix], eatType[pub], food[French], priceRange[£20-25], customer rating[3 out of 5], area[riverside], familyFriendly[no], near[Café Sicilia]	The Phoenix is a French pub near Café Sicilia in riverside it is not child friendly has a customer rating of 3 out of 5 and has a price range of £20-25.
name[The Phoenix], eatType[pub], food[French], priceRange[£20-25], customer rating[3 out of 5], area[riverside], familyFriendly[yes], near[Café Sicilia]	The Phoenix is a French pub near Café Sicilia in riverside it is child friendly has a customer rating of 3 out of 5 and has a price range of £20-25.
name[The Phoenix], eatType[pub], food[French], priceRange[£20-25], customer rating[3 out of 5], area[riverside], familyFriendly[yes], near[Crowne Plaza Hotel]	The Phoenix is a French pub near Crowne Plaza Hotel in riverside it is child friendly has a customer rating of 3 out of 5 and has a price range of £20-25.
name[The Phoenix], eatType[pub], food[French], priceRange[£20-25], customer rating[high], area[city centre], familyFriendly[no], near[Crowne Plaza Hotel]	The Phoenix is a French pub near Crowne Plaza Hotel in the city centre it has a high customer rating prices range it is not kids friendly.
name[The Phoenix], eatType[pub], food[French], priceRange[£20-25], customer rating[high], area[city centre], familyFriendly[yes], near[Crowne Plaza Hotel]	The Phoenix is a French pub near Crowne Plaza Hotel in the city centre it is child friendly it has a high customer rating and prices range.
name[The Phoenix], eatType[pub], food[French], priceRange[£20-25], customer rating[high], area[riverside], familyFriendly[no], near[Crowne Plaza Hotel]	The Phoenix is a French pub near Crowne Plaza Hotel in riverside with a price range of £20-25 and is not kid friendly.
name[The Phoenix], eatType[pub], food[French], priceRange[£20-25], customer rating[high], area[riverside], familyFriendly[yes], near[Crowne Plaza Hotel]	The Phoenix is a French pub near Crowne Plaza Hotel in riverside it is child friendly has a high customer rating and has a price range of £20-25.
name[The Phoenix], eatType[pub], food[French], priceRange[cheap], area[riverside], familyFriendly[yes], near[Raja Indian Cuisine]	The Phoenix is a cheap French pub near Raja Indian Cuisine in riverside is family friendly.
name[The Phoenix], eatType[pub], food[French], priceRange[cheap], customer rating[5 out of 5], area[city centre], familyFriendly[no], near[Crowne Plaza Hotel]	The Phoenix is a cheap French pub near Crowne Plaza Hotel in the city centre it is not family-friendly and has a customer rating of 5 out of 5.
name[The Phoenix], eatType[pub], food[French], priceRange[cheap], customer rating[5 out of 5], area[city centre], familyFriendly[yes], near[Crowne Plaza Hotel]	The Phoenix is a cheap French pub near Crowne Plaza Hotel in the city centre it is family-friendly and has a customer rating of 5 out of 5.
name[The Phoenix], eatType[pub], food[French], priceRange[cheap], customer rating[5 out of 5], area[riverside], familyFriendly[no], near[Crowne Plaza Hotel]	The Phoenix is a cheap French pub near Crowne Plaza Hotel in riverside it is not family-friendly and has a customer rating of 5 out of 5.
name[The Phoenix], eatType[pub], food[French], priceRange[cheap], customer rating[5 out of 5], area[riverside], familyFriendly[yes], near[Crowne Plaza Hotel]	The Phoenix is a cheap French pub near Crowne Plaza Hotel in riverside it is family-friendly and has a customer rating of 5 out of 5.
name[The Phoenix], eatType[pub], food[French], priceRange[high], area[riverside], familyFriendly[yes], near[Raja Indian Cuisine]	The Phoenix is a French pub near Raja Indian Cuisine in riverside it is children friendly and has a high price range.
name[The Phoenix], eatType[pub], food[French], priceRange[high], customer rating[3 out of 5], area[city centre], familyFriendly[no], near[Crowne Plaza Hotel]	The Phoenix is a French pub near Crowne Plaza Hotel in the city centre it has a high price range and is not child friendly.
name[The Phoenix], eatType[pub], food[French], priceRange[high], customer rating[3 out of 5], area[city centre], familyFriendly[yes], near[Crowne Plaza Hotel]	The Phoenix is a French pub near Crowne Plaza Hotel in the city centre it is children friendly has a customer rating of 3 out of 5 and is in the price range.
name[The Phoenix], eatType[pub], food[French], priceRange[high], customer rating[3 out of 5], area[riverside], familyFriendly[no], near[Crowne Plaza Hotel]	The Phoenix is a French pub near Crowne Plaza Hotel in riverside it has a high price range and is not kid friendly.
name[The Phoenix], eatType[pub], food[French], priceRange[high], customer rating[3 out of 5], area[riverside], familyFriendly[yes], near[Crowne Plaza Hotel]	The Phoenix is a French pub near Crowne Plaza Hotel in riverside it is children friendly and a customer rating of 3 out of 5.
name[The Phoenix], eatType[pub], food[French], priceRange[less than £20], customer rating[average], area[city centre], familyFriendly[no], near[Crowne Plaza Hotel]	The Phoenix is a pub that serves food near Crowne Plaza Hotel it has an average customer rating and a price range of less than £20 it is not family-friendly.
name[The Phoenix], eatType[pub], food[French], priceRange[less than £20], customer rating[average], area[city centre], familyFriendly[yes], near[Crowne Plaza Hotel]	The Phoenix is a French pub near Crowne Plaza Hotel in the city centre it is family-friendly and has a price range of less than £20.
name[The Phoenix], eatType[pub], food[French], priceRange[less than £20], customer rating[average], area[riverside], familyFriendly[no], near[Crowne Plaza Hotel]	The Phoenix is a French pub near Crowne Plaza Hotel in riverside it has a price range of less than £20 it has an average customer rating and is not family-friendly.
name[The Phoenix], eatType[pub], food[French], priceRange[less than £20], customer rating[average], area[riverside], familyFriendly[yes], near[Crowne Plaza Hotel]	The Phoenix is a French pub near Crowne Plaza Hotel in riverside it is family friendly and has a price range of less than £20.
name[The Phoenix], eatType[pub], food[French], priceRange[less than £20], customer rating[low], area[city centre], familyFriendly[no], near[Crowne Plaza Hotel]	The Phoenix is a French pub near Crowne Plaza Hotel in the city centre it has a price range of less than £20 it has a low customer rating and is not family-friendly.
name[The Phoenix], eatType[pub], food[French], priceRange[less than £20], customer rating[low], area[city centre], familyFriendly[yes], near[Crowne Plaza Hotel]	The Phoenix is a French pub near Crowne Plaza Hotel in the city centre it is family-friendly and has a price range of less than £20.
name[The Phoenix], eatType[pub], food[French], priceRange[less than £20], customer rating[low], area[riverside], familyFriendly[no], near[Crowne Plaza Hotel]	The Phoenix is a French pub near Crowne Plaza Hotel in riverside it is not family-friendly the price range is less than £20 and a low customer rating.
name[The Phoenix], eatType[pub], food[French], priceRange[less than £20], customer rating[low], area[riverside], familyFriendly[yes], near[Crowne Plaza Hotel]	The Phoenix is a French pub near Crowne Plaza Hotel in riverside it is family friendly, has a low customer rating and a price range of less than £20.
name[The Phoenix], eatType[pub], food[French], priceRange[moderate], customer rating[1 out of 5], area[city centre], familyFriendly[no], near[Crowne Plaza Hotel]	The Phoenix is a French pub near Crowne Plaza Hotel in the city centre with a moderate price range it is not kid friendly and.
name[The Phoenix], eatType[pub], food[French], priceRange[moderate], customer rating[1 out of 5], area[city centre], familyFriendly[yes], near[Crowne Plaza Hotel]	The Phoenix is a French pub near Crowne Plaza Hotel in the city centre it has a moderate price range, a customer rating of 1 out of 5 and is kid friendly.
name[The Phoenix], eatType[pub], food[French], priceRange[moderate], customer rating[1 out of 5], area[riverside], familyFriendly[no], near[Crowne Plaza Hotel]	The Phoenix is a French pub near Crowne Plaza Hotel in the riverside area it has a moderate price range and is not kid friendly.
name[The Phoenix], eatType[pub], food[French], priceRange[moderate], customer rating[1 out of 5], area[riverside], familyFriendly[yes], near[Crowne Plaza Hotel]	The Phoenix is a French pub near Crowne Plaza Hotel in riverside it is children friendly has a moderate price range and a customer rating of 1 out of 5.
name[The Phoenix], eatType[pub], food[French], priceRange[more than £30], customer rating[5 out of 5], area[city centre], familyFriendly[no], near[Crowne Plaza Hotel]	The Phoenix is a French pub near Crowne Plaza Hotel in the city centre it has a customer rating of 5 out of 5 and has a price range of more than £30 it is not family-friendly.
name[The Phoenix], eatType[pub], food[French], priceRange[more than £30], customer rating[5 out of 5], area[city centre], familyFriendly[yes], near[Crowne Plaza Hotel]	The Phoenix is a French pub near Crowne Plaza Hotel in the city centre it is children friendly has a customer rating of 5 out of 5 and has a price range of more than £30.
name[The Phoenix], eatType[pub], food[French], priceRange[more than £30], customer rating[5 out of 5], area[riverside], familyFriendly[no], near[Crowne Plaza Hotel]	The Phoenix is a French pub near Crowne Plaza Hotel in the riverside area it has a price range of more than £30 and is not family-friendly.
name[The Phoenix], eatType[pub], food[French], priceRange[more than £30], customer rating[5 out of 5], area[riverside], familyFriendly[yes], near[Crowne Plaza Hotel]	The Phoenix is a French pub near Crowne Plaza Hotel in the riverside area it is children friendly has a customer rating of 5 out of 5 and has a price range of more than £30.
name[The Phoenix], eatType[pub], food[French], priceRange[more than £30], customer rating[low], area[city centre], familyFriendly[no], near[Crowne Plaza Hotel]	The Phoenix is a French pub near Crowne Plaza Hotel in the city centre it has a low customer rating, a price range of more than £30 and is not family-friendly.
name[The Phoenix], eatType[pub], food[French], priceRange[more than £30], customer rating[low], area[city centre], familyFriendly[yes], near[Crowne Plaza Hotel]	The Phoenix is a French pub near Crowne Plaza Hotel in the city centre it is children friendly has a low customer rating and a price range of more than £30.
name[The Phoenix], eatType[pub], food[French], priceRange[more than £30], customer rating[low], area[riverside], familyFriendly[no], near[Crowne Plaza Hotel]	The Phoenix is a French pub near Crowne Plaza Hotel in the riverside area it is not child friendly has a low customer rating and a price range of more than £30.
name[The Phoenix], eatType[pub], food[French], priceRange[more than £30], customer rating[low], area[riverside], familyFriendly[yes], near[Crowne Plaza Hotel]	The Phoenix is a French pub near Crowne Plaza Hotel in riverside it is child friendly, has a low customer rating and a price range of more than £30.
name[The Phoenix], eatType[restaurant], food[Fast food], priceRange[cheap], area[riverside], familyFriendly[yes], near[Raja Indian Cuisine]	The Phoenix is a cheap Fast food restaurant near Raja Indian Cuisine in riverside is family friendly.
name[The Phoenix], eatType[restaurant], food[Fast food], priceRange[high], area[city centre], familyFriendly[no], near[Raja Indian Cuisine]	The Phoenix is a Fast food restaurant near Raja Indian Cuisine in the city centre has a high price range and is not child friendly.
name[The Phoenix], eatType[restaurant], food[Fast food], priceRange[high], area[city centre], familyFriendly[yes], near[Raja Indian Cuisine]	The Phoenix is a Fast food coffee shop near Raja Indian Cuisine in the city centre it is children friendly and has a high price range.
name[The Phoenix], eatType[restaurant], food[Fast food], priceRange[high], area[riverside], familyFriendly[no], near[Raja Indian Cuisine]	The Phoenix is a Fast food restaurant near Raja Indian Cuisine in riverside with a high price range and is not child friendly.
name[The Phoenix], eatType[restaurant], food[Fast food], priceRange[high], area[riverside], familyFriendly[yes], near[Raja Indian Cuisine]	The Phoenix is a Fast food restaurant near Raja Indian Cuisine in riverside is child friendly and has a high price range.
name[The Phoenix], eatType[restaurant], food[Fast food], priceRange[less than £20], area[city centre], familyFriendly[no], near[Raja Indian Cuisine]	The Phoenix is a Fast food coffee shop near Raja Indian Cuisine in the city centre it has a price range of less than £20 is not family-friendly.
name[The Phoenix], eatType[restaurant], food[Fast food], priceRange[less than £20], area[city centre], familyFriendly[yes], near[Raja Indian Cuisine]	The Phoenix is a Fast food coffee shop near Raja Indian Cuisine in the city centre it is family-friendly and has a price range of less than £20.
name[The Phoenix], eatType[restaurant], food[Fast food], priceRange[less than £20], area[riverside], familyFriendly[no], near[Raja Indian Cuisine]	The Phoenix is a Fast food coffee shop near Raja Indian Cuisine in the riverside area it has a price range of less than £20 is not family-friendly.
name[The Phoenix], eatType[restaurant], food[Fast food], priceRange[less than £20], area[riverside], familyFriendly[yes], near[Raja Indian Cuisine]	The Phoenix is a Fast food coffee shop near Raja Indian Cuisine in riverside is family friendly and has a price range of less than £20.
name[The Phoenix], eatType[restaurant], food[Fast food], priceRange[moderate], area[city centre], familyFriendly[no], near[Raja Indian Cuisine]	The Phoenix is a moderately priced restaurant that serves Fast food it near Raja Indian Cuisine it is not family-friendly.
name[The Phoenix], eatType[restaurant], food[Fast food], priceRange[moderate], area[city centre], familyFriendly[yes], near[Raja Indian Cuisine]	The Phoenix is a moderately priced restaurant that serves Fast food it near Raja Indian Cuisine is a family friendly.
name[The Phoenix], eatType[restaurant], food[Fast food], priceRange[moderate], area[riverside], familyFriendly[no], near[Raja Indian Cuisine]	The Phoenix is a moderately priced restaurant that serves Fast food it is located in the riverside area near Raja Indian Cuisine it is not family-friendly.
name[The Phoenix], eatType[restaurant], food[Fast food], priceRange[moderate], area[riverside], familyFriendly[yes], near[Raja Indian Cuisine]	The Phoenix is a moderately priced restaurant that serves Fast food it is located in the riverside area near Raja Indian Cuisine is a family friendly.
name[The Phoenix], eatType[restaurant], food[Fast food], priceRange[more than £30], area[riverside], familyFriendly[yes], near[Raja Indian Cuisine]	The Phoenix is a Fast food restaurant near Raja Indian Cuisine in riverside it is child friendly and has a price range of more than £30.
name[The Phoenix], eatType[restaurant], food[French], priceRange[£20-25], area[riverside], familyFriendly[yes], near[Raja Indian Cuisine]	The Phoenix is a French restaurant near Raja Indian Cuisine in riverside it is kid friendly and has a price range of £20-25.
name[The Phoenix], eatType[restaurant], food[French], priceRange[cheap], area[riverside], familyFriendly[yes], near[Raja Indian Cuisine]	The Phoenix is a cheap French restaurant near Raja Indian Cuisine in riverside is family friendly.
name[The Phoenix], eatType[restaurant], food[French], priceRange[high], area[riverside], familyFriendly[yes], near[Raja Indian Cuisine]	The Phoenix is a French restaurant near Raja Indian Cuisine in riverside it is children friendly and has a high price range.
name[The Phoenix], eatType[restaurant], food[Indian], priceRange[£20-25], customer rating[high], area[city centre], familyFriendly[no], near[Crowne Plaza Hotel]	The Phoenix is an restaurant with a customer rating the price range is £20-25 near Crowne Plaza Hotel in the city centre it is not family-friendly.
name[The Phoenix], eatType[restaurant], food[Indian], priceRange[£20-25], customer rating[high], area[city centre], familyFriendly[yes], near[Crowne Plaza Hotel]	The Phoenix is an restaurant with a customer rating the price range is £20-25 and is kid friendly it is near Crowne Plaza Hotel in the city centre.
name[The Phoenix], eatType[restaurant], food[Indian], priceRange[£20-25], customer rating[high], area[riverside], familyFriendly[no], near[Crowne Plaza Hotel]	The Phoenix is an restaurant with a customer rating the price range is £20-25 near Crowne Plaza Hotel in riverside is not family friendly.
name[The Phoenix], eatType[restaurant], food[Indian], priceRange[£20-25], customer rating[high], area[riverside], familyFriendly[yes], near[Crowne Plaza Hotel]	The Phoenix is an restaurant with a customer rating the price range is £20-25 and is kid friendly it is near Crowne Plaza Hotel in riverside.
name[The Phoenix], eatType[restaurant], food[Indian], priceRange[cheap], customer rating[5 out of 5], area[city centre], familyFriendly[no], near[Crowne Plaza Hotel]	The Phoenix is a cheap italian restaurant near Crowne Plaza Hotel in the city centre it has a 5 out of 5 it is not family-friendly.
name[The Phoenix], eatType[restaurant], food[Indian], priceRange[cheap], customer rating[5 out of 5], area[city centre], familyFriendly[yes], near[Crowne Plaza Hotel]	The Phoenix is a cheap italian restaurant near Crowne Plaza Hotel in the city centre it is family friendly and has a customer rating of 5 out of 5.
name[The Phoenix], eatType[restaurant], food[Indian], priceRange[cheap], customer rating[5 out of 5], area[riverside], familyFriendly[no], near[Crowne Plaza Hotel]	The Phoenix is a cheap italian restaurant near Crowne Plaza Hotel in riverside it is not family-friendly and has a customer rating of 5 out of 5.
name[The Phoenix], eatType[restaurant], food[Indian], priceRange[cheap], customer rating[5 out of 5], area[riverside], familyFriendly[no], near[Express by Holiday Inn]	The Phoenix is a cheap italian restaurant near Express by Holiday Inn in riverside it is not family-friendly and has a customer rating of 5 out of 5.
name[The Phoenix], eatType[restaurant], food[Indian], priceRange[cheap], customer rating[5 out of 5], area[riverside], familyFriendly[yes], near[Express by Holiday Inn]	The Phoenix is a cheap italian restaurant near Express by Holiday Inn in riverside it is family friendly and has a customer rating of 5 out of 5.
name[The Phoenix], eatType[restaurant], food[Indian], priceRange[cheap], customer rating[average], area[city centre], familyFriendly[no], near[Express by Holiday Inn]	The Phoenix is a cheap italian restaurant near Express by Holiday Inn in the city centre it has an average customer rating and is not family-friendly.
name[The Plough], eatType[pub], food[Chinese], priceRange[£20-25], area[riverside], familyFriendly[yes], near[Raja Indian Cuisine]	The Plough is a Chinese pub near Raja Indian Cuisine in riverside it is family friendly and has a price range of £20-25.
name[The Plough], eatType[pub], food[Chinese], priceRange[cheap], area[riverside], familyFriendly[yes], near[Raja Indian Cuisine]	The Plough is a cheap Chinese pub near Raja Indian Cuisine in riverside is family friendly.
name[The Plough], eatType[pub], food[Chinese], priceRange[high], area[city centre], familyFriendly[no], near[Raja Indian Cuisine]	The Plough is a Chinese pub near Raja Indian Cuisine in the city centre it has a high price range and is not family-friendly.
name[The Plough], eatType[pub], food[Chinese], priceRange[high], area[city centre], familyFriendly[yes], near[Raja Indian Cuisine]	The Plough is a Chinese pub near Raja Indian Cuisine in the city centre it is children friendly and has a high price range.
name[The Plough], eatType[pub], food[Chinese], priceRange[high], area[riverside], familyFriendly[no], near[Raja Indian Cuisine]	The Plough is a Chinese pub near Raja Indian Cuisine in riverside with a high price range and is not child friendly.
name[The Plough], eatType[pub], food[Chinese], priceRange[high], area[riverside], familyFriendly[yes], near[Raja Indian Cuisine]	The Plough is a Chinese pub with a high price range and is child friendly it is near Raja Indian Cuisine in the riverside area.
name[The Plough], eatType[pub], food[Chinese], priceRange[less than £20], area[city centre], familyFriendly[no], near[Raja Indian Cuisine]	The Plough is a pub that serves Chinese food for less than £20 it is not family friendly it near Raja Indian Cuisine.
name[The Plough], eatType[restaurant], food[Chinese], priceRange[£20-25], area[riverside], familyFriendly[yes], near[Raja Indian Cuisine]	The Plough is a Chinese restaurant located in riverside near Raja Indian Cuisine it is family friendly and has a price range of £20-25.
name[The Plough], eatType[restaurant], food[Chinese], priceRange[cheap], area[riverside], familyFriendly[yes], near[Raja Indian Cuisine]	The Plough is a cheap Chinese restaurant near Raja Indian Cuisine in riverside is family friendly.
name[The Plough], eatType[restaurant], food[Chinese], priceRange[high], area[city centre], familyFriendly[no], near[Raja Indian Cuisine]	The Plough is a Chinese restaurant near Raja Indian Cuisine in the city centre has a high price range and is not child friendly.
name[The Plough], eatType[restaurant], food[Chinese], priceRange[high], area[city centre], familyFriendly[yes], near[Raja Indian Cuisine]	The Plough is a Chinese restaurant near Raja Indian Cuisine in the city centre it is children friendly and has a high price range.
name[The Plough], eatType[restaurant], food[Chinese], priceRange[high], area[riverside], familyFriendly[no], near[Raja Indian Cuisine]	The Plough is a Chinese restaurant near Raja Indian Cuisine in riverside it has a high price range and is not child friendly.
name[The Plough], eatType[restaurant], food[Chinese], priceRange[high], area[riverside], familyFriendly[yes], near[Raja Indian Cuisine]	The Plough is a Chinese restaurant near Raja Indian Cuisine in riverside is child friendly and has a high price range.
name[The Plough], eatType[restaurant], food[Chinese], priceRange[less than £20], area[city centre], familyFriendly[no], near[Raja Indian Cuisine]	The Plough is a Chinese restaurant in the city centre near Raja Indian Cuisine it is not family friendly and has a price range of less than £20.
name[The Punter], eatType[pub], food[Chinese], priceRange[less than £20], area[city centre], familyFriendly[yes], near[Raja Indian Cuisine]	The Punter is a Chinese pub with a price range of less than £20 it is family friendly and is near Raja Indian Cuisine in the city centre.
name[The Punter], eatType[pub], food[Chinese], priceRange[less than £20], area[riverside], familyFriendly[no], near[Raja Indian Cuisine]	The Punter is a pub that serves Chinese food for less than £20 it is not family friendly it is near Raja Indian Cuisine.
name[The Punter], eatType[pub], food[Chinese], priceRange[less than £20], area[riverside], familyFriendly[yes], near[Raja Indian Cuisine]	The Punter is a Chinese pub with a price range of less than £20 it is family friendly near Raja Indian Cuisine in the riverside area.
name[The Punter], eatType[pub], food[Chinese], priceRange[moderate], area[city centre], familyFriendly[no], near[Raja Indian Cuisine]	The Punter is a pub that serves Chinese food at a moderate price range it is not kid friendly and is located near Raja Indian Cuisine in the city centre.
name[The Punter], eatType[pub], food[Chinese], priceRange[moderate], area[city centre], familyFriendly[yes], near[Raja Indian Cuisine]	The Punter is a Chinese pub with a moderate price range it is kid friendly and is near Raja Indian Cuisine in the city centre.
name[The Punter], eatType[pub], food[Chinese], priceRange[moderate], area[riverside], familyFriendly[no], near[Raja Indian Cuisine]	The Punter is a pub that serves Chinese food at a moderate price range it is not kid friendly and is located in the riverside area near Raja Indian Cuisine.
name[The Punter], eatType[pub], food[Chinese], priceRange[moderate], area[riverside], familyFriendly[yes], near[Raja Indian Cuisine]	The Punter is a Chinese pub with a moderate price range it is kid friendly and is near Raja Indian Cuisine in the riverside area.
name[The Punter], eatType[pub], food[Chinese], priceRange[more than £30], area[riverside], familyFriendly[yes], near[Raja Indian Cuisine]	The Punter is a Chinese pub with a price range of more than £30 it is children friendly and is near Raja Indian Cuisine in the riverside area.
name[The Punter], eatType[pub], food[English], priceRange[£20-25], area[riverside], familyFriendly[yes], near[Raja Indian Cuisine]	The Punter is an pub in riverside near Raja Indian Cuisine it is family friendly and has a price range of £20-25.
name[The Punter], eatType[pub], food[English], priceRange[cheap], area[riverside], familyFriendly[yes], near[Raja Indian Cuisine]	The Punter is a cheap English pub in the riverside area it is family friendly near Raja Indian Cuisine.
name[The Punter], eatType[pub], food[English], priceRange[high], area[city centre], familyFriendly[no], near[Raja Indian Cuisine]	The Punter is an pub near Raja Indian Cuisine in the city centre has a high price range and is not child friendly.
name[The Punter], eatType[pub], food[English], priceRange[high], area[city centre], familyFriendly[yes], near[Raja Indian Cuisine]	The Punter is an pub near Raja Indian Cuisine in the city centre it is children friendly and has a price range.
name[The Punter], eatType[pub], food[English], priceRange[high], area[riverside], familyFriendly[no], near[Raja Indian Cuisine]	The Punter is an pub near Raja Indian Cuisine in riverside with a high price range and is not child friendly.
name[The Punter], eatType[pub], food[English], priceRange[high], area[riverside], familyFriendly[yes], near[Raja Indian Cuisine]	The Punter is an pub near Raja Indian Cuisine in riverside is child friendly and has a high price range.
name[The Punter], eatType[pub], food[Italian], priceRange[high], customer rating[average], area[city centre], familyFriendly[no], near[Rainbow Vegetarian Café]	The Punter is an Italian pub in the city centre near Rainbow Vegetarian Café it has a high price range customer rating and is not family-friendly.
name[The Punter], eatType[restaurant], food[Chinese], priceRange[less than £20], area[city centre], familyFriendly[yes], near[Raja Indian Cuisine]	The Punter is a Chinese restaurant in the city centre near Raja Indian Cuisine it is family friendly and has a price range of less than £20.
name[The Punter], eatType[restaurant], food[Chinese], priceRange[less than £20], area[riverside], familyFriendly[no], near[Raja Indian Cuisine]	The Punter is a Chinese restaurant located in riverside near Raja Indian Cuisine it is not family friendly and has a price range of less than £20.
name[The Punter], eatType[restaurant], food[Chinese], priceRange[less than £20], area[riverside], familyFriendly[yes], near[Raja Indian Cuisine]	The Punter is a Chinese restaurant located in riverside near Raja Indian Cuisine is family friendly and has a price range of less than £20.
name[The Punter], eatType[restaurant], food[Chinese], priceRange[moderate], area[city centre], familyFriendly[no], near[Raja Indian Cuisine]	The Punter is a Chinese restaurant near Raja Indian Cuisine in the city centre it has a moderate price range it is not family-friendly.
name[The Punter], eatType[restaurant], food[Chinese], priceRange[moderate], area[city centre], familyFriendly[yes], near[Raja Indian Cuisine]	The Punter is a Chinese restaurant near Raja Indian Cuisine in the city centre has a moderate price range and is family friendly.
name[The Punter], eatType[restaurant], food[Chinese], priceRange[moderate], area[riverside], familyFriendly[no], near[Raja Indian Cuisine]	The Punter is a moderately priced restaurant that serves Chinese food it is located in the riverside area near Raja Indian Cuisine it is not family friendly.
name[The Punter], eatType[restaurant], food[Chinese], priceRange[moderate], area[riverside], familyFriendly[yes], near[Raja Indian Cuisine]	The Punter is a moderately priced restaurant that serves Chinese food it is located in the riverside area near Raja Indian Cuisine is family friendly.
name[The Punter], eatType[restaurant], food[Chinese], priceRange[more than £30], area[riverside], familyFriendly[yes], near[Raja Indian Cuisine]	The Punter is a Chinese restaurant located in riverside near Raja Indian Cuisine it is children friendly and has a price range of more than £30.
name[The Punter], eatType[restaurant], food[English], priceRange[£20-25], area[riverside], familyFriendly[yes], near[Raja Indian Cuisine]	The Punter is an restaurant in riverside near Raja Indian Cuisine it is family friendly and has a price range of £20-25.
name[The Punter], eatType[restaurant], food[English], priceRange[cheap], area[riverside], familyFriendly[yes], near[Raja Indian Cuisine]	The Punter is a cheap English restaurant in riverside is family friendly near Raja Indian Cuisine.
name[The Punter], eatType[restaurant], food[English], priceRange[high], area[city centre], familyFriendly[no], near[Raja Indian Cuisine]	The Punter is an restaurant near Raja Indian Cuisine in the city centre has a high price range and is not child friendly.
name[The Punter], eatType[restaurant], food[English], priceRange[high], area[city centre], familyFriendly[yes], near[Raja Indian Cuisine]	The Punter is an restaurant near Raja Indian Cuisine in the city centre it is children friendly and has a high price range.
name[The Punter], eatType[restaurant], food[English], priceRange[high], area[riverside], familyFriendly[no], near[Raja Indian Cuisine]	The Punter is an restaurant near Raja Indian Cuisine in riverside with a high price range but is not child friendly.
name[The Punter], eatType[restaurant], food[English], priceRange[high], area[riverside], familyFriendly[yes], near[Raja Indian Cuisine]	The Punter is an restaurant near Raja Indian Cuisine in riverside is child friendly and has a high price range.
name[The Punter], eatType[restaurant], food[Indian], priceRange[cheap], customer rating[average], area[city centre], familyFriendly[yes], near[Express by Holiday Inn]	The Punter is a cheap italian restaurant in the city centre near Express by Holiday Inn it has an average customer rating and is family friendly.
name[The Punter], eatType[restaurant], food[Indian], priceRange[cheap], customer rating[average], area[riverside], familyFriendly[no], near[Express by Holiday Inn]	The Punter is a cheap italian restaurant near Express by Holiday Inn in riverside with an average customer rating and is not family friendly.
name[The Punter], eatType[restaurant], food[Indian], priceRange[cheap], customer rating[average], area[riverside], familyFriendly[yes], near[Express by Holiday Inn]	The Punter is a cheap italian restaurant in riverside near Express by Holiday Inn it has an average customer rating and is family friendly.
name[The Punter], eatType[restaurant], food[Indian], priceRange[high], customer rating[1 out of 5], area[city centre], familyFriendly[no], near[Express by Holiday Inn]	The Punter is an Indian restaurant with a customer rating of 1 out of 5 and is near Express by Holiday Inn in the city centre it is not family-friendly.
name[The Punter], eatType[restaurant], food[Indian], priceRange[high], customer rating[1 out of 5], area[city centre], familyFriendly[yes], near[Express by Holiday Inn]	The Punter is an Indian restaurant with a customer rating of 1 out of 5 and has a high price range it is children friendly it near Express by Holiday Inn.
name[The Punter], eatType[restaurant], food[Indian], priceRange[high], customer rating[1 out of 5], area[riverside], familyFriendly[no], near[Express by Holiday Inn]	The Punter is an Indian restaurant with a customer rating of 1 out of 5 and a price range it is not child friendly it is near Express by Holiday Inn in the riverside area.
name[The Punter], eatType[restaurant], food[Indian], priceRange[high], customer rating[1 out of 5], area[riverside], familyFriendly[yes], near[Express by Holiday Inn]	The Punter is an Indian restaurant with a customer rating of 1 out of 5 and a price range it is children friendly it near Express by Holiday Inn.
name[The Punter], eatType[restaurant], food[Indian], priceRange[high], customer rating[average], area[city centre], familyFriendly[no], near[Express by Holiday Inn]	The Punter is an restaurant with an average customer rating and is near Express by Holiday Inn in the city centre it is not family-friendly.
name[The Punter], eatType[restaurant], food[Indian], priceRange[high], customer rating[average], area[city centre], familyFriendly[yes], near[Express by Holiday Inn]	The Punter is an restaurant with an average customer rating and is in the high price range it is children friendly it is near Express by Holiday Inn in the city centre.
name[The Punter], eatType[restaurant], food[Indian], priceRange[high], customer rating[average], area[riverside], familyFriendly[no], near[Express by Holiday Inn]	The Punter is an restaurant with an average customer rating and a price range it is not family friendly near Express by Holiday Inn in the riverside area.
name[The Punter], eatType[restaurant], food[Indian], priceRange[high], customer rating[average], area[riverside], familyFriendly[yes], near[Express by Holiday Inn]	The Punter is an Indian restaurant with an average customer rating and is in the high price range it is children friendly near Express by Holiday Inn in the riverside area.
name[The Punter], eatType[restaurant], food[Indian], priceRange[less than £20], customer rating[low], area[city centre], familyFriendly[no], near[Express by Holiday Inn]	The Punter is an restaurant with a low customer rating the price range is less than £20 is not family-friendly it near Express by Holiday Inn.
name[The Punter], eatType[restaurant], food[Indian], priceRange[less than £20], customer rating[low], area[city centre], familyFriendly[yes], near[Express by Holiday Inn]	The Punter is an restaurant with a low customer rating the price range is less than £20 is family friendly it near Express by Holiday Inn.
name[The Punter], eatType[restaurant], food[Indian], priceRange[less than £20], customer rating[low], area[riverside], familyFriendly[no], near[Express by Holiday Inn]	The Punter is an restaurant with a low customer rating the price range is less than £20 it is not family friendly it is near Express by Holiday Inn.
name[The Punter], eatType[restaurant], food[Indian], priceRange[less than £20], customer rating[low], area[riverside], familyFriendly[yes], near[Express by Holiday Inn]	The Punter is an restaurant with a low customer rating the price range is less than £20 and is family friendly it is near Express by Holiday Inn.
name[The Punter], eatType[restaurant], food[Indian], priceRange[moderate], customer rating[1 out of 5], area[city centre], familyFriendly[no], near[Express by Holiday Inn]	The Punter is an Indian restaurant with a customer rating of 1 out of 5 and is near Express by Holiday Inn in the city centre it is not family-friendly.
name[The Punter], eatType[restaurant], food[Indian], priceRange[moderate], customer rating[1 out of 5], area[city centre], familyFriendly[yes], near[Express by Holiday Inn]	The Punter is an Indian restaurant with a customer rating of 1 out of 5 and has a moderate price range it is kid friendly it near Express by Holiday Inn.
name[The Punter], eatType[restaurant], food[Indian], priceRange[moderate], customer rating[1 out of 5], area[riverside], familyFriendly[no], near[Express by Holiday Inn]	The Punter is an Indian restaurant with a customer rating of 1 out of 5 and is in the moderate price range it is not kid friendly it is near Express by Holiday Inn.
name[The Punter], eatType[restaurant], food[Indian], priceRange[moderate], customer rating[1 out of 5], area[riverside], familyFriendly[yes], near[Express by Holiday Inn]	The Punter is an Indian restaurant with a customer rating of 1 out of 5 and is kid friendly it is near Express by Holiday Inn.
name[The Punter], eatType[restaurant], food[Indian], priceRange[moderate], customer rating[3 out of 5], area[city centre], familyFriendly[no], near[Express by Holiday Inn]	The Punter is an restaurant with a customer rating of 3 out of 5 and is near Express by Holiday Inn in the city centre it is not family-friendly.
name[The Punter], eatType[restaurant], food[Indian], priceRange[moderate], customer rating[3 out of 5], area[city centre], familyFriendly[yes], near[Express by Holiday Inn]	The Punter is an restaurant with a customer rating of 3 out of 5 and is kid friendly it near Express by Holiday Inn.
name[The Punter], eatType[restaurant], food[Indian], priceRange[moderate], customer rating[3 out of 5], area[riverside], familyFriendly[no], near[Express by Holiday Inn]	The Punter is an restaurant with a customer rating of 3 out of 5 and is in the moderate price range it is not kid friendly it is near Express by Holiday Inn.
name[The Punter], eatType[restaurant], food[Indian], priceRange[moderate], customer rating[3 out of 5], area[riverside], familyFriendly[yes], near[Express by Holiday Inn]	The Punter is an restaurant with a customer rating of 3 out of 5 and is kid friendly it is near Express by Holiday Inn.
name[The Punter], eatType[restaurant], food[Indian], priceRange[more than £30], customer rating[high], area[city centre], familyFriendly[no], near[Express by Holiday Inn]	The Punter is an Indian restaurant with a customer rating the price range is more than £30 it is near Express by Holiday Inn in the city centre is not family-friendly.
name[The Punter], eatType[restaurant], food[Indian], priceRange[more than £30], customer rating[high], area[city centre], familyFriendly[yes], near[Express by Holiday Inn]	The Punter is an Indian restaurant with a customer rating the price range is more than £30 and is child friendly it near Express by Holiday Inn.
name[The Punter], eatType[restaurant], food[Indian], priceRange[more than £30], customer rating[high], area[riverside], familyFriendly[no], near[Express by Holiday Inn]	The Punter is an Indian restaurant with a customer rating the price range is more than £30 and is not child friendly it is near Express by Holiday Inn.
name[The Punter], eatType[restaurant], food[Indian], priceRange[more than £30], customer rating[high], area[riverside], familyFriendly[yes], near[Express by Holiday Inn]	The Punter is an Indian restaurant with a customer rating the price range is more than £30 and is child friendly it is near Express by Holiday Inn.
name[The Punter], eatType[restaurant], food[Italian], priceRange[£20-25], customer rating[high], area[city centre], familyFriendly[no], near[Express by Holiday Inn]	The Punter is an Italian restaurant near Express by Holiday Inn in the city centre it has a high customer rating, has a price range of £20-25 and is not kids friendly.
name[The Punter], eatType[restaurant], food[Italian], priceRange[£20-25], customer rating[high], area[city centre], familyFriendly[yes], near[Express by Holiday Inn]	The Punter is an Italian restaurant with a customer rating the price range is £20-25 and is kid friendly it is near Express by Holiday Inn in the city centre.
name[The Punter], eatType[restaurant], food[Italian], priceRange[£20-25], customer rating[high], area[riverside], familyFriendly[no], near[Express by Holiday Inn]	The Punter is an Italian restaurant near Express by Holiday Inn in riverside with a high customer rating, a price range of £20-25 and is not kid friendly.
name[The Punter], eatType[restaurant], food[Italian], priceRange[£20-25], customer rating[high], area[riverside], familyFriendly[yes], near[Express by Holiday Inn]	The Punter is an Italian restaurant with a customer rating the price range is £20-25 and is child friendly it is near Express by Holiday Inn in riverside.
name[The Punter], eatType[restaurant], food[Italian], priceRange[cheap], customer rating[5 out of 5], area[city centre], familyFriendly[no], near[Express by Holiday Inn]	The Punter is a cheap Italian restaurant near Express by Holiday Inn in the city centre it is not family-friendly and has a customer rating of 5 out of 5.
name[The Punter], eatType[restaurant], food[Italian], priceRange[cheap], customer rating[5 out of 5], area[city centre], familyFriendly[no], near[Rainbow Vegetarian Café]	The Punter is a cheap Italian restaurant near Rainbow Vegetarian Café in the city centre it is not family-friendly and has a customer rating of 5 out of 5.
name[The Punter], eatType[restaurant], food[Italian], priceRange[cheap], customer rating[5 out of 5], area[city centre], familyFriendly[yes], near[Rainbow Vegetarian Café]	The Punter is a cheap Italian restaurant near Rainbow Vegetarian Café in the city centre it is family-friendly and has a customer rating of 5 out of 5.
name[The Punter], eatType[restaurant], food[Italian], priceRange[cheap], customer rating[5 out of 5], area[riverside], familyFriendly[no], near[Rainbow Vegetarian Café]	The Punter is a cheap Italian restaurant near Rainbow Vegetarian Café in riverside it is not family-friendly and has a customer rating of 5 out of 5.
name[The Punter], eatType[restaurant], food[Italian], priceRange[cheap], customer rating[5 out of 5], area[riverside], familyFriendly[yes], near[Rainbow Vegetarian Café]	The Punter is a cheap Italian restaurant near Rainbow Vegetarian Café in riverside it is family-friendly and has a customer rating of 5 out of 5.
name[The Punter], eatType[restaurant], food[Italian], priceRange[cheap], customer rating[average], area[city centre], familyFriendly[no], near[Rainbow Vegetarian Café]	The Punter is a cheap Italian restaurant near Rainbow Vegetarian Café in the city centre it has an average customer rating and is not family-friendly.
name[The Punter], eatType[restaurant], food[Italian], priceRange[cheap], customer rating[average], area[city centre], familyFriendly[yes], near[Rainbow Vegetarian Café]	The Punter is a cheap Italian coffee shop near Rainbow Vegetarian Café in the city centre it is family-friendly and has an average customer rating.
name[The Punter], eatType[restaurant], food[Italian], priceRange[cheap], customer rating[average], area[riverside], familyFriendly[no], near[Rainbow Vegetarian Café]	The Punter is a cheap Italian restaurant near Rainbow Vegetarian Café in riverside it is not family-friendly and has an average customer rating.
name[The Punter], eatType[restaurant], food[Italian], priceRange[cheap], customer rating[average], area[riverside], familyFriendly[yes], near[Rainbow Vegetarian Café]	The Punter is a cheap Italian restaurant near Rainbow Vegetarian Café in riverside it is family-friendly and has an average customer rating.
name[The Punter], eatType[restaurant], food[Italian], priceRange[high], customer rating[1 out of 5], area[city centre], familyFriendly[no], near[Rainbow Vegetarian Café]	The Punter is an Italian restaurant near Rainbow Vegetarian Café in the city centre with a high price range, a customer rating of 1 out of 5 and is not child friendly.
name[The Punter], eatType[restaurant], food[Italian], priceRange[high], customer rating[1 out of 5], area[city centre], familyFriendly[yes], near[Rainbow Vegetarian Café]	The Punter is an Italian restaurant near Rainbow Vegetarian Café in the city centre it is children friendly 1 out of 5 and has a price range.
name[The Punter], eatType[restaurant], food[Italian], priceRange[high], customer rating[1 out of 5], area[riverside], familyFriendly[no], near[Rainbow Vegetarian Café]	The Punter is an Italian restaurant near Rainbow Vegetarian Café in riverside with a high price range, a customer rating of 1 out of 5 and is not child friendly.
name[The Punter], eatType[restaurant], food[Italian], priceRange[high], customer rating[1 out of 5], area[riverside], familyFriendly[yes], near[Rainbow Vegetarian Café]	The Punter is an Italian restaurant near Rainbow Vegetarian Café in riverside it is children friendly, has a 1 out of 5 and has a price range.
name[The Vaults], eatType[pub], food[French], priceRange[high], area[riverside], familyFriendly[yes], near[Raja Indian Cuisine]	The Vaults is a French pub near Raja Indian Cuisine in riverside it is children friendly and has a high price range.
name[The Vaults], eatType[pub], food[French], priceRange[less than £20], area[city centre], familyFriendly[no], near[Raja Indian Cuisine]	The Vaults is a French pub near Raja Indian Cuisine in the city centre with a price range of less than £20 it is not family-friendly.
name[The Vaults], eatType[pub], food[French], priceRange[less than £20], area[city centre], familyFriendly[yes], near[Raja Indian Cuisine]	The Vaults is a French pub near Raja Indian Cuisine in the city centre it is family-friendly and has a price range of less than £20.
name[The Vaults], eatType[pub], food[French], priceRange[less than £20], area[riverside], familyFriendly[no], near[Raja Indian Cuisine]	The Vaults is a French pub near Raja Indian Cuisine in riverside it is not family-friendly and has a price range of less than £20.
name[The Vaults], eatType[pub], food[French], priceRange[less than £20], area[riverside], familyFriendly[yes], near[Raja Indian Cuisine]	The Vaults is a French pub near Raja Indian Cuisine in riverside it is family friendly and has a price range of less than £20.
name[The Vaults], eatType[pub], food[French], priceRange[moderate], area[city centre], familyFriendly[no], near[Raja Indian Cuisine]	The Vaults is a French pub near Raja Indian Cuisine in the city centre prices it is not kid friendly.
name[The Vaults], eatType[pub], food[French], priceRange[moderate], area[city centre], familyFriendly[yes], near[Raja Indian Cuisine]	The Vaults is a French pub near Raja Indian Cuisine in the city centre it is kid friendly with a price range.
name[The Vaults], eatType[pub], food[French], priceRange[moderate], area[riverside], familyFriendly[no], near[Raja Indian Cuisine]	The Vaults is a French pub near Raja Indian Cuisine in riverside with a price range it is not kid friendly.
name[The Vaults], eatType[pub], food[French], priceRange[moderate], area[riverside], familyFriendly[yes], near[Raja Indian Cuisine]	The Vaults is a French pub with a moderate price range it is kid friendly and is near Raja Indian Cuisine in the riverside area.
name[The Vaults], eatType[pub], food[French], priceRange[more than £30], area[city centre], familyFriendly[no], near[Raja Indian Cuisine]	The Vaults is a French pub near Raja Indian Cuisine in the city centre with a price range of more than £30 it is not child friendly.
name[The Vaults], eatType[pub], food[French], priceRange[more than £30], area[city centre], familyFriendly[yes], near[Raja Indian Cuisine]	The Vaults is a French pub near Raja Indian Cuisine in the city centre it is children friendly and has a price range of more than £30.
name[The Vaults], eatType[pub], food[French], priceRange[more than £30], area[riverside], familyFriendly[no], near[Raja Indian Cuisine]	The Vaults is a French pub near Raja Indian Cuisine in the riverside area it is not child friendly and has a price range of more than £30.
name[The Vaults], eatType[pub], food[French], priceRange[more than £30], area[riverside], familyFriendly[yes], near[Raja Indian Cuisine]	The Vaults is a French pub near Raja Indian Cuisine in riverside it is children friendly and has a price range of more than £30.
name[The Vaults], eatType[pub], food[Indian], priceRange[£20-25], area[riverside], familyFriendly[yes], near[Raja Indian Cuisine]	The Vaults is an Indian pub near Raja Indian Cuisine in riverside is kid friendly and has a price range of £20-25.
name[The Vaults], eatType[pub], food[Indian], priceRange[cheap], area[riverside], familyFriendly[yes], near[Raja Indian Cuisine]	The Vaults is a cheap Indian pub near Raja Indian Cuisine in the riverside area it is family friendly.
name[The Vaults], eatType[pub], food[Indian], priceRange[high], area[city centre], familyFriendly[no], near[Raja Indian Cuisine]	The Vaults is an Indian pub near Raja Indian Cuisine in the city centre it has a high price range and is not family-friendly.
name[The Vaults], eatType[pub], food[Indian], priceRange[high], area[city centre], familyFriendly[yes], near[Raja Indian Cuisine]	The Vaults is an Indian pub near Raja Indian Cuisine in the city centre it has a high price range and is child friendly.
name[The Vaults], eatType[pub], food[Italian], priceRange[high], customer rating[average], area[city centre], familyFriendly[no], near[Rainbow Vegetarian Café]	The Vaults is an Italian pub in the city centre near Rainbow Vegetarian Café it has a high price range customer rating and is not family-friendly.
name[The Vaults], eatType[pub], food[Italian], priceRange[high], customer rating[average], area[city centre], familyFriendly[yes], near[Rainbow Vegetarian Café]	The Vaults is an Italian pub in the city centre near Rainbow Vegetarian Café it is family friendly and price range.
name[The Vaults], eatType[pub], food[Italian], priceRange[high], customer rating[average], area[riverside], familyFriendly[no], near[Rainbow Vegetarian Café]	The Vaults is an Italian pub in riverside near Rainbow Vegetarian Café is not child friendly with a customer rating.
name[The Vaults], eatType[pub], food[Italian], priceRange[high], customer rating[average], area[riverside], familyFriendly[yes], near[Rainbow Vegetarian Café]	The Vaults is an Italian pub in riverside near Rainbow Vegetarian Café is a child friendly high price range and.
name[The Vaults], eatType[pub], food[Italian], priceRange[less than £20], customer rating[low], area[city centre], familyFriendly[no], near[Rainbow Vegetarian Café]	The Vaults is a pub that serves Italian food near Rainbow Vegetarian Café prices family-friendly and has a low customer rating.
name[The Vaults], eatType[pub], food[Italian], priceRange[less than £20], customer rating[low], area[city centre], familyFriendly[yes], near[Rainbow Vegetarian Café]	The Vaults is an Italian pub with a price range of less than £20 it is family-friendly and has a low customer rating it near Rainbow Vegetarian Café.
name[The Vaults], eatType[pub], food[Italian], priceRange[less than £20], customer rating[low], area[riverside], familyFriendly[no], near[Rainbow Vegetarian Café]	The Vaults is an Italian pub with a price range of less than £20 it is not family-friendly and has a low customer rating it is near Rainbow Vegetarian Café.
name[The Vaults], eatType[pub], food[Italian], priceRange[less than £20], customer rating[low], area[riverside], familyFriendly[yes], near[Rainbow Vegetarian Café]	The Vaults is an Italian pub with a price range of less than £20 it is family-friendly and has a low customer rating it is near Rainbow Vegetarian Café.
name[The Vaults], eatType[pub], food[Italian], priceRange[moderate], customer rating[1 out of 5], area[city centre], familyFriendly[no], near[Rainbow Vegetarian Café]	The Vaults is a pub that serves Italian food at a moderate price range it is not kid friendly and has a customer rating of 1 out of 5 it near Rainbow Vegetarian Café.
name[The Vaults], eatType[pub], food[Italian], priceRange[moderate], customer rating[1 out of 5], area[city centre], familyFriendly[yes], near[Rainbow Vegetarian Café]	The Vaults is an Italian pub with a moderate price near Rainbow Vegetarian Café it is family friendly and has a customer rating of 1 out of 5.
name[The Vaults], eatType[pub], food[Italian], priceRange[moderate], customer rating[1 out of 5], area[riverside], familyFriendly[no], near[Rainbow Vegetarian Café]	The Vaults is an Italian pub with a moderate price near Rainbow Vegetarian Café it is not kid friendly and has a customer rating of 1 out of 5.
name[The Vaults], eatType[pub], food[Italian], priceRange[moderate], customer rating[1 out of 5], area[riverside], familyFriendly[yes], near[Rainbow Vegetarian Café]	The Vaults is an Italian pub with a moderate price range, is kid friendly and has a 1 out of 5 it is near Rainbow Vegetarian Café.
name[The Vaults], eatType[pub], food[Italian], priceRange[moderate], customer rating[3 out of 5], area[city centre], familyFriendly[no], near[Rainbow Vegetarian Café]	The Vaults is a pub that serves Italian food at a moderate price range it is not kid friendly and has a customer rating of 3 out of 5 it near Rainbow Vegetarian Café.
name[The Vaults], eatType[pub], food[Italian], priceRange[moderate], customer rating[3 out of 5], area[city centre], familyFriendly[yes], near[Rainbow Vegetarian Café]	The Vaults is an Italian pub with a moderate price near Rainbow Vegetarian Café it is family friendly and has a customer rating of 3 out of 5.
name[The Vaults], eatType[pub], food[Italian], priceRange[moderate], customer rating[3 out of 5], area[riverside], familyFriendly[no], near[Rainbow Vegetarian Café]	The Vaults is an Italian pub with a moderate price near Rainbow Vegetarian Café it is not kid friendly and has a customer rating of 3 out of 5.
name[The Vaults], eatType[pub], food[Italian], priceRange[moderate], customer rating[3 out of 5], area[riverside], familyFriendly[yes], near[Rainbow Vegetarian Café]	The Vaults is an Italian pub with a moderate price near Rainbow Vegetarian Café it is kid friendly and has a customer rating of 3 out of 5.
name[The Vaults], eatType[pub], food[Italian], priceRange[more than £30], customer rating[high], area[city centre], familyFriendly[no], near[Rainbow Vegetarian Café]	The Vaults is a pub that serves Italian food near Rainbow Vegetarian Café it has a high customer rating the price range is more than £30 and is not child friendly.
name[The Vaults], eatType[pub], food[Italian], priceRange[more than £30], customer rating[high], area[city centre], familyFriendly[yes], near[Rainbow Vegetarian Café]	The Vaults is a pub that serves Italian food near Rainbow Vegetarian Café it is child friendly and has a high customer rating the price range is more than £30.
name[The Vaults], eatType[pub], food[Italian], priceRange[more than £30], customer rating[high], area[riverside], familyFriendly[no], near[Rainbow Vegetarian Café]	The Vaults is a pub that serves Italian food near Rainbow Vegetarian Café it has a high customer rating it is not child friendly and has a price range of more than £30.
name[The Vaults], eatType[pub], food[Italian], priceRange[more than £30], customer rating[high], area[riverside], familyFriendly[yes], near[Rainbow Vegetarian Café]	The Vaults is an Italian pub located in riverside near Rainbow Vegetarian Café it is child friendly has a high customer rating and the price range is more than £30.
name[The Vaults], eatType[pub], food[Japanese], priceRange[£20-25], customer rating[3 out of 5], area[city centre], familyFriendly[no], near[Rainbow Vegetarian Café]	The Vaults is a Japanese pub near Rainbow Vegetarian Café in the city centre it has a customer rating of 3 out of 5, has a price range of £20-25 and is not kid friendly.
name[The Vaults], eatType[pub], food[Japanese], priceRange[£20-25], customer rating[3 out of 5], area[city centre], familyFriendly[yes], near[Rainbow Vegetarian Café]	The Vaults is a Japanese pub in the city centre near Rainbow Vegetarian Café it is family friendly, has a customer rating of 3 out of 5 and has a price range of £20-25.
name[The Vaults], eatType[pub], food[Japanese], priceRange[£20-25], customer rating[3 out of 5], area[riverside], familyFriendly[no], near[Rainbow Vegetarian Café]	The Vaults is a Japanese pub in riverside near Rainbow Vegetarian Café it is not child friendly it and has a price range of £20-25.
name[The Vaults], eatType[pub], food[Japanese], priceRange[£20-25], customer rating[3 out of 5], area[riverside], familyFriendly[yes], near[Rainbow Vegetarian Café]	The Vaults is a Japanese pub in riverside near Rainbow Vegetarian Café it is child friendly has a customer rating of 3 out of 5 and has a price range of £20-25.
name[The Vaults], eatType[pub], food[Japanese], priceRange[£20-25], customer rating[high], area[city centre], familyFriendly[no], near[Rainbow Vegetarian Café]	The Vaults is a Japanese pub in the city centre near Rainbow Vegetarian Café it has a high customer rating, has a price range of £20-25 and is not child friendly.
name[The Vaults], eatType[pub], food[Japanese], priceRange[£20-25], customer rating[high], area[city centre], familyFriendly[yes], near[Rainbow Vegetarian Café]	The Vaults is a Japanese pub in the city centre near Rainbow Vegetarian Café it is family friendly, has a high customer rating and has a price range of £20-25.
name[The Vaults], eatType[pub], food[Japanese], priceRange[£20-25], customer rating[high], area[riverside], familyFriendly[no], near[Rainbow Vegetarian Café]	The Vaults is a Japanese pub in riverside near Rainbow Vegetarian Café it is not child friendly it has a high customer rating and has a price range of £20-25.
name[The Vaults], eatType[pub], food[Japanese], priceRange[£20-25], customer rating[high], area[riverside], familyFriendly[no], near[Raja Indian Cuisine]	The Vaults is a Japanese pub in riverside near Raja Indian Cuisine it is not child friendly it has a high customer rating and has a price range of £20-25.
name[The Vaults], eatType[pub], food[Japanese], priceRange[£20-25], customer rating[high], area[riverside], familyFriendly[yes], near[Raja Indian Cuisine]	The Vaults is a Japanese pub in riverside near Raja Indian Cuisine it is child friendly has a high customer rating and has a price range of £20-25.
name[The Vaults], eatType[pub], food[Japanese], priceRange[cheap], customer rating[5 out of 5], area[city centre], familyFriendly[no], near[Raja Indian Cuisine]	The Vaults is a cheap Japanese pub near Raja Indian Cuisine in the city centre it is not family-friendly and has a customer rating of 5 out of 5.
name[The Vaults], eatType[pub], food[Japanese], priceRange[cheap], customer rating[5 out of 5], area[city centre], familyFriendly[yes], near[Raja Indian Cuisine]	The Vaults is a cheap Japanese pub near Raja Indian Cuisine in the city centre it is family-friendly and has a customer rating of 5 out of 5.
name[The Vaults], eatType[pub], food[Japanese], priceRange[cheap], customer rating[5 out of 5], area[riverside], familyFriendly[no], near[Raja Indian Cuisine]	The Vaults is a cheap Japanese pub near Raja Indian Cuisine in riverside it is not family-friendly and has a customer rating of 5 out of 5.
name[The Vaults], eatType[pub], food[Japanese], priceRange[cheap], customer rating[5 out of 5], area[riverside], familyFriendly[yes], near[Raja Indian Cuisine]	The Vaults is a cheap Japanese pub near Raja Indian Cuisine in riverside it is family-friendly and has a customer rating of 5 out of 5.
name[The Vaults], eatType[pub], food[Japanese], priceRange[high], customer rating[3 out of 5], area[city centre], familyFriendly[no], near[Raja Indian Cuisine]	The Vaults is a Japanese pub near Raja Indian Cuisine in the city centre it has a high price range and is not child friendly.
name[The Vaults], eatType[pub], food[Japanese], priceRange[high], customer rating[3 out of 5], area[city centre], familyFriendly[yes], near[Raja Indian Cuisine]	The Vaults is a Japanese pub near Raja Indian Cuisine in the city centre it is child friendly has a customer rating of 3 out of 5 and is in the price range.
name[The Vaults], eatType[pub], food[Japanese], priceRange[high], customer rating[3 out of 5], area[riverside], familyFriendly[no], near[Raja Indian Cuisine]	The Vaults is a Japanese pub near Raja Indian Cuisine in riverside it has a high price range and is not child friendly.
name[The Vaults], eatType[pub], food[Japanese], priceRange[high], customer rating[3 out of 5], area[riverside], familyFriendly[yes], near[Raja Indian Cuisine]	The Vaults is a Japanese pub near Raja Indian Cuisine in riverside is children friendly and has a customer rating of 3 out of 5.
name[The Vaults], eatType[pub], food[Japanese], priceRange[less than £20], customer rating[average], area[city centre], familyFriendly[no], near[Raja Indian Cuisine]	The Vaults is a pub that serves Japanese food for less than £20 it is not family-friendly and has an average customer rating it is near Raja Indian Cuisine in the city centre.
name[The Vaults], eatType[pub], food[Japanese], priceRange[less than £20], customer rating[average], area[city centre], familyFriendly[yes], near[Raja Indian Cuisine]	The Vaults is a Japanese pub in the city centre near Raja Indian Cuisine it is family friendly, has a customer rating and is in the less than £20.
name[The Vaults], eatType[pub], food[Japanese], priceRange[less than £20], customer rating[average], area[riverside], familyFriendly[no], near[Raja Indian Cuisine]	The Vaults is a pub that serves Japanese food for less than £20 it is not family-friendly and has an average customer rating it is near Raja Indian Cuisine in the riverside area.
name[The Vaults], eatType[pub], food[Japanese], priceRange[less than £20], customer rating[average], area[riverside], familyFriendly[yes], near[Raja Indian Cuisine]	The Vaults is a Japanese pub in riverside near Raja Indian Cuisine is family friendly, has a price range of less than £20 and.
name[The Vaults], eatType[pub], food[Japanese], priceRange[less than £20], customer rating[low], area[city centre], familyFriendly[no], near[Raja Indian Cuisine]	The Vaults is a Japanese pub near Raja Indian Cuisine in the city centre it has a price range of less than £20 it has a low customer rating and is not family-friendly.
name[The Vaults], eatType[pub], food[Japanese], priceRange[less than £20], customer rating[low], area[city centre], familyFriendly[yes], near[Raja Indian Cuisine]	The Vaults is a Japanese pub near Raja Indian Cuisine in the city centre it is family-friendly and has a price range of less than £20.
name[The Vaults], eatType[pub], food[Japanese], priceRange[less than £20], customer rating[low], area[riverside], familyFriendly[no], near[Raja Indian Cuisine]	The Vaults is a Japanese pub near Raja Indian Cuisine in the riverside area it has a price range of less than £20 it is not family-friendly and has a low customer rating.
name[The Vaults], eatType[pub], food[Japanese], priceRange[less than £20], customer rating[low], area[riverside], familyFriendly[yes], near[Raja Indian Cuisine]	The Vaults is a Japanese pub near Raja Indian Cuisine in riverside it is family-friendly and has a price range of less than £20.
name[The Vaults], eatType[pub], food[Japanese], priceRange[moderate], customer rating[1 out of 5], area[city centre], familyFriendly[no], near[Raja Indian Cuisine]	The Vaults is a pub that serves Japanese food with a moderate price range it is not kid friendly, has a customer rating of 1 out of 5 and is located near Raja Indian Cuisine in the city centre.
name[The Vaults], eatType[pub], food[Japanese], priceRange[moderate], customer rating[1 out of 5], area[city centre], familyFriendly[yes], near[Raja Indian Cuisine]	The Vaults is a Japanese pub near Raja Indian Cuisine in the city centre it has a moderate price range with a customer rating of 1 out of 5 and is kid friendly.
name[The Vaults], eatType[restaurant], food[French], priceRange[high], area[riverside], familyFriendly[yes], near[Raja Indian Cuisine]	The Vaults is a French restaurant near Raja Indian Cuisine in riverside it is children friendly and has a high price range.
name[The Vaults], eatType[restaurant], food[French], priceRange[less than £20], area[city centre], familyFriendly[no], near[Raja Indian Cuisine]	The Vaults is a French restaurant near Raja Indian Cuisine in the city centre with a price range of less than £20 it is not family-friendly.
name[The Vaults], eatType[restaurant], food[French], priceRange[less than £20], area[city centre], familyFriendly[yes], near[Raja Indian Cuisine]	The Vaults is a French restaurant near Raja Indian Cuisine in the city centre it is family-friendly and has a price range of less than £20.
name[The Vaults], eatType[restaurant], food[French], priceRange[less than £20], area[riverside], familyFriendly[no], near[Raja Indian Cuisine]	The Vaults is a French restaurant near Raja Indian Cuisine in riverside it is not family-friendly and has a price range of less than £20.
name[The Vaults], eatType[restaurant], food[French], priceRange[less than £20], area[riverside], familyFriendly[yes], near[Raja Indian Cuisine]	The Vaults is a French restaurant near Raja Indian Cuisine in riverside it is family friendly and has a price range of less than £20.
name[The Vaults], eatType[restaurant], food[French], priceRange[moderate], area[city centre], familyFriendly[no], near[Raja Indian Cuisine]	The Vaults is a moderately priced restaurant that serves food near Raja Indian Cuisine it is not family-friendly.
name[The Vaults], eatType[restaurant], food[French], priceRange[moderate], area[city centre], familyFriendly[yes], near[Raja Indian Cuisine]	The Vaults is a moderately priced restaurant that serves French food in the city centre near Raja Indian Cuisine it is family friendly.
name[The Vaults], eatType[restaurant], food[French], priceRange[moderate], area[riverside], familyFriendly[no], near[Raja Indian Cuisine]	The Vaults is a moderately priced restaurant that serves French food near Raja Indian Cuisine it is not family friendly.
name[The Vaults], eatType[restaurant], food[French], priceRange[moderate], area[riverside], familyFriendly[yes], near[Raja Indian Cuisine]	The Vaults is a moderately priced restaurant that serves French food near Raja Indian Cuisine it is family friendly.
name[The Vaults], eatType[restaurant], food[French], priceRange[more than £30], area[city centre], familyFriendly[no], near[Raja Indian Cuisine]	The Vaults is a French restaurant near Raja Indian Cuisine in the city centre with a price range of more than £30 it is not child friendly.
name[The Vaults], eatType[restaurant], food[French], priceRange[more than £30], area[city centre], familyFriendly[yes], near[Raja Indian Cuisine]	The Vaults is a French restaurant near Raja Indian Cuisine in the city centre it is children friendly and has a price range of more than £30.
name[The Vaults], eatType[restaurant], food[French], priceRange[more than £30], area[riverside], familyFriendly[no], near[Raja Indian Cuisine]	The Vaults is a French restaurant near Raja Indian Cuisine in riverside it is not child friendly and has a price range of more than £30.
name[The Vaults], eatType[restaurant], food[French], priceRange[more than £30], area[riverside], familyFriendly[yes], near[Raja Indian Cuisine]	The Vaults is a French restaurant near Raja Indian Cuisine in riverside it is children friendly and has a price range of more than £30.
name[The Vaults], eatType[restaurant], food[Indian], priceRange[£20-25], area[riverside], familyFriendly[yes], near[Raja Indian Cuisine]	The Vaults is an Indian restaurant in riverside near Raja Indian Cuisine is a kid friendly and has a price range of £20-25.
name[The Vaults], eatType[restaurant], food[Indian], priceRange[cheap], area[riverside], familyFriendly[yes], near[Raja Indian Cuisine]	The Vaults is a cheap italian restaurant in the riverside area near Raja Indian Cuisine is family friendly.
name[The Vaults], eatType[restaurant], food[Indian], priceRange[high], area[city centre], familyFriendly[no], near[Raja Indian Cuisine]	The Vaults is an Indian restaurant in the city centre near Raja Indian Cuisine it has a high price range and is not family friendly.
name[The Vaults], eatType[restaurant], food[Indian], priceRange[high], area[city centre], familyFriendly[yes], near[Raja Indian Cuisine]	The Vaults is an Indian restaurant in the city centre near Raja Indian Cuisine it is children friendly and has a high price range.
name[The Waterman], eatType[pub], food[Indian], priceRange[high], area[city centre], familyFriendly[yes], near[Raja Indian Cuisine]	The Waterman is an Indian pub near Raja Indian Cuisine in the city centre it has a high price range and is child friendly.
name[The Waterman], eatType[pub], food[Indian], priceRange[high], area[riverside], familyFriendly[no], near[Raja Indian Cuisine]	The Waterman is an Indian pub near Raja Indian Cuisine in riverside it has a high price range and is not child friendly.
name[The Waterman], eatType[pub], food[Indian], priceRange[high], area[riverside], familyFriendly[yes], near[Raja Indian Cuisine]	The Waterman is an Indian pub near Raja Indian Cuisine in riverside it has a high price range but is child friendly.
name[The Waterman], eatType[pub], food[Indian], priceRange[less than £20], area[city centre], familyFriendly[no], near[Raja Indian Cuisine]	The Waterman is a pub that serves Indian food in the less than £20 is not family friendly it near Raja Indian Cuisine.
name[The Waterman], eatType[pub], food[Indian], priceRange[less than £20], area[city centre], familyFriendly[yes], near[Raja Indian Cuisine]	The Waterman is an Indian pub near Raja Indian Cuisine in the city centre it is family friendly and has a price range of less than £20.
name[The Waterman], eatType[pub], food[Indian], priceRange[less than £20], area[riverside], familyFriendly[no], near[Raja Indian Cuisine]	The Waterman is a pub that serves Indian food for less than £20 it is not family friendly it is near Raja Indian Cuisine.
name[The Waterman], eatType[pub], food[Indian], priceRange[less than £20], area[riverside], familyFriendly[yes], near[Raja Indian Cuisine]	The Waterman is an Indian pub near Raja Indian Cuisine in riverside is family friendly and has a price range of less than £20.
name[The Waterman], eatType[pub], food[Indian], priceRange[moderate], area[city centre], familyFriendly[no], near[Raja Indian Cuisine]	The Waterman is a pub that serves Indian food at a moderate price range it is not family friendly it near Raja Indian Cuisine.
name[The Waterman], eatType[pub], food[Indian], priceRange[moderate], area[city centre], familyFriendly[yes], near[Raja Indian Cuisine]	The Waterman is an Indian pub near Raja Indian Cuisine in the city centre it has a moderate price range and is family friendly.
name[The Waterman], eatType[pub], food[Indian], priceRange[moderate], area[riverside], familyFriendly[no], near[Raja Indian Cuisine]	The Waterman is a pub that serves Indian food at a moderate price range it is not kid friendly and is located in the riverside area near Raja Indian Cuisine.
name[The Waterman], eatType[pub], food[Indian], priceRange[moderate], area[riverside], familyFriendly[yes], near[Raja Indian Cuisine]	The Waterman is an Indian pub near Raja Indian Cuisine in riverside it has a moderate price range it is kid friendly.
name[The Waterman], eatType[pub], food[Indian], priceRange[more than £30], area[riverside], familyFriendly[yes], near[Raja Indian Cuisine]	The Waterman is an Indian pub near Raja Indian Cuisine in riverside it is children friendly and has a price range of more than £30.
name[The Waterman], eatType[pub], food[Italian], priceRange[£20-25], area[riverside], familyFriendly[yes], near[Raja Indian Cuisine]	The Waterman is an Italian pub in riverside near Raja Indian Cuisine it is family friendly and has a price range of £20-25.
name[The Waterman], eatType[pub], food[Italian], priceRange[cheap], area[riverside], familyFriendly[yes], near[Raja Indian Cuisine]	The Waterman is a cheap Italian pub near Raja Indian Cuisine in riverside is family friendly.
name[The Waterman], eatType[pub], food[Italian], priceRange[high], area[city centre], familyFriendly[no], near[Raja Indian Cuisine]	The Waterman is an Italian pub with a high price range near Raja Indian Cuisine in the city centre it is not family-friendly.
name[The Waterman], eatType[pub], food[Italian], priceRange[high], area[city centre], familyFriendly[yes], near[Raja Indian Cuisine]	The Waterman is an Italian pub with a high price range and is child friendly it is located near Raja Indian Cuisine in the city centre.
name[The Waterman], eatType[pub], food[Italian], priceRange[high], area[riverside], familyFriendly[no], near[Raja Indian Cuisine]	The Waterman is an Italian pub with a high price range near Raja Indian Cuisine in riverside is not family-friendly.
name[The Waterman], eatType[pub], food[Italian], priceRange[high], area[riverside], familyFriendly[yes], near[Raja Indian Cuisine]	The Waterman is an Italian pub with a high price range but is child friendly it is near Raja Indian Cuisine in the riverside area.
name[The Waterman], eatType[pub], food[Italian], priceRange[less than £20], area[city centre], familyFriendly[no], near[Raja Indian Cuisine]	The Waterman is a pub that serves Italian food near Raja Indian Cuisine it has a price range of less than £20 is not family-friendly.
name[The Waterman], eatType[pub], food[Italian], priceRange[less than £20], area[city centre], familyFriendly[yes], near[Raja Indian Cuisine]	The Waterman is an Italian pub with a price range of less than £20 it is family-friendly it is located near Raja Indian Cuisine in the city centre.
name[The Waterman], eatType[pub], food[Italian], priceRange[less than £20], area[riverside], familyFriendly[no], near[Raja Indian Cuisine]	The Waterman is an Italian pub with a price range of less than £20 it is not family-friendly it is located near Raja Indian Cuisine in riverside.
name[The Waterman], eatType[restaurant], food[Indian], priceRange[high], area[city centre], familyFriendly[yes], near[Raja Indian Cuisine]	The Waterman is an Indian restaurant in the city centre near Raja Indian Cuisine it is children friendly and has a high price range.
name[The Waterman], eatType[restaurant], food[Indian], priceRange[high], area[riverside], familyFriendly[no], near[Raja Indian Cuisine]	The Waterman is an Indian restaurant in riverside near Raja Indian Cuisine it has a high price range and is not family friendly.
name[The Waterman], eatType[restaurant], food[Indian], priceRange[high], area[riverside], familyFriendly[yes], near[Raja Indian Cuisine]	The Waterman is an Indian restaurant in riverside near Raja Indian Cuisine is a child friendly and has a high.
name[The Waterman], eatType[restaurant], food[Indian], priceRange[less than £20], area[city centre], familyFriendly[no], near[Raja Indian Cuisine]	The Waterman is an restaurant in the city centre near Raja Indian Cuisine it is not family friendly and has a price range of less than £20.
name[The Waterman], eatType[restaurant], food[Indian], priceRange[less than £20], area[city centre], familyFriendly[yes], near[Raja Indian Cuisine]	The Waterman is an Indian restaurant is family friendly, has a price range of less than £20 and is near Raja Indian Cuisine in the city centre.
name[The Waterman], eatType[restaurant], food[Indian], priceRange[less than £20], area[riverside], familyFriendly[no], near[Raja Indian Cuisine]	The Waterman is an Indian restaurant in riverside near Raja Indian Cuisine is not family friendly and has a price range of less than £20.
name[The Waterman], eatType[restaurant], food[Indian], priceRange[less than £20], area[riverside], familyFriendly[yes], near[Raja Indian Cuisine]	The Waterman is an Indian restaurant is family friendly and has a price range of less than £20 it is near Raja Indian Cuisine in riverside.
name[The Waterman], eatType[restaurant], food[Indian], priceRange[moderate], area[city centre], familyFriendly[no], near[Raja Indian Cuisine]	The Waterman is an Indian restaurant in the city centre near Raja Indian Cuisine it has a moderate price range it is not kid friendly and.
name[The Waterman], eatType[restaurant], food[Indian], priceRange[moderate], area[city centre], familyFriendly[yes], near[Raja Indian Cuisine]	The Waterman is an Indian restaurant in the city centre near Raja Indian Cuisine it is family friendly and has a moderate price range.
name[The Waterman], eatType[restaurant], food[Indian], priceRange[moderate], area[riverside], familyFriendly[no], near[Raja Indian Cuisine]	The Waterman is a moderately priced restaurant that serves Indian food near Raja Indian Cuisine it is not family friendly.
name[The Waterman], eatType[restaurant], food[Indian], priceRange[moderate], area[riverside], familyFriendly[yes], near[Raja Indian Cuisine]	The Waterman is an Indian restaurant is family friendly and has a moderate price range it is near Raja Indian Cuisine in riverside.
name[The Waterman], eatType[restaurant], food[Indian], priceRange[more than £30], area[riverside], familyFriendly[yes], near[Raja Indian Cuisine]	The Waterman is an Indian restaurant is children friendly with a price range of more than £30 it near Raja Indian Cuisine.
name[The Waterman], eatType[restaurant], food[Italian], priceRange[£20-25], area[riverside], familyFriendly[yes], near[Raja Indian Cuisine]	The Waterman is an Italian restaurant located in riverside near Raja Indian Cuisine it is family friendly and has a price range of £20-25.
name[The Waterman], eatType[restaurant], food[Italian], priceRange[cheap], area[riverside], familyFriendly[yes], near[Raja Indian Cuisine]	The Waterman is a cheap Italian restaurant near Raja Indian Cuisine in riverside is family friendly.
name[The Waterman], eatType[restaurant], food[Italian], priceRange[high], area[city centre], familyFriendly[no], near[Raja Indian Cuisine]	The Waterman is an Italian restaurant near Raja Indian Cuisine in the city centre prices is not child friendly.
name[The Waterman], eatType[restaurant], food[Italian], priceRange[high], area[city centre], familyFriendly[yes], near[Raja Indian Cuisine]	The Waterman is an Italian restaurant near Raja Indian Cuisine in the city centre it is children friendly with a price range.
name[The Waterman], eatType[restaurant], food[Italian], priceRange[high], area[riverside], familyFriendly[no], near[Raja Indian Cuisine]	The Waterman is a high priced restaurant near Raja Indian Cuisine in riverside serves Italian food and is not family-friendly.
name[The Waterman], eatType[restaurant], food[Italian], priceRange[high], area[riverside], familyFriendly[yes], near[Raja Indian Cuisine]	The Waterman is a high priced restaurant near Raja Indian Cuisine in riverside is family friendly Italian.
name[The Waterman], eatType[restaurant], food[Italian], priceRange[less than £20], area[city centre], familyFriendly[no], near[Raja Indian Cuisine]	The Waterman is an Italian restaurant near Raja Indian Cuisine in the city centre with a price range of less than £20 is not family-friendly.
name[The Waterman], eatType[restaurant], food[Italian], priceRange[less than £20], area[city centre], familyFriendly[yes], near[Raja Indian Cuisine]	The Waterman is an Italian restaurant located in the city centre near Raja Indian Cuisine it is family friendly and has a price range of less than £20.
name[The Waterman], eatType[restaurant], food[Italian], priceRange[less than £20], area[riverside], familyFriendly[no], near[Raja Indian Cuisine]	The Waterman is an Italian restaurant near Raja Indian Cuisine in riverside with a price range of less than £20 it is not family-friendly.
name[The Wrestlers], eatType[pub], food[Italian], priceRange[less than £20], area[riverside], familyFriendly[no], near[Raja Indian Cuisine]	The Wrestlers is an Italian pub with a price range of less than £20 it is not family-friendly it is located near Raja Indian Cuisine in riverside.
name[The Wrestlers], eatType[pub], food[Italian], priceRange[less than £20], area[riverside], familyFriendly[yes], near[Raja Indian Cuisine]	The Wrestlers is an Italian pub with a price range of less than £20 it is family friendly near Raja Indian Cuisine in the riverside area.
name[The Wrestlers], eatType[pub], food[Italian], priceRange[moderate], area[city centre], familyFriendly[no], near[Raja Indian Cuisine]	The Wrestlers is a pub that serves Italian food at a moderate price range it is not kid friendly it near Raja Indian Cuisine.
name[The Wrestlers], eatType[pub], food[Italian], priceRange[moderate], area[city centre], familyFriendly[yes], near[Raja Indian Cuisine]	The Wrestlers is a moderately priced pub that serves Italian food near Raja Indian Cuisine it is family friendly.
name[The Wrestlers], eatType[pub], food[Italian], priceRange[moderate], area[riverside], familyFriendly[no], near[Raja Indian Cuisine]	The Wrestlers is a moderately priced pub near Raja Indian Cuisine it serves Italian food it is not family-friendly.
name[The Wrestlers], eatType[pub], food[Italian], priceRange[moderate], area[riverside], familyFriendly[yes], near[Raja Indian Cuisine]	The Wrestlers is a moderately priced pub that serves Italian food near Raja Indian Cuisine it is family friendly.
name[The Wrestlers], eatType[pub], food[Italian], priceRange[more than £30], area[riverside], familyFriendly[yes], near[Raja Indian Cuisine]	The Wrestlers is an Italian pub in riverside near Raja Indian Cuisine it is child friendly and has a price range of more than £30.
name[The Wrestlers], eatType[pub], food[Japanese], priceRange[£20-25], area[riverside], familyFriendly[yes], near[Raja Indian Cuisine]	The Wrestlers is a Japanese pub in riverside near Raja Indian Cuisine it is family friendly and has a price range of £20-25.
name[The Wrestlers], eatType[pub], food[Japanese], priceRange[cheap], area[riverside], familyFriendly[yes], near[Raja Indian Cuisine]	The Wrestlers is a cheap Japanese pub near Raja Indian Cuisine in the riverside area it is family friendly.
name[The Wrestlers], eatType[pub], food[Japanese], priceRange[high], area[riverside], familyFriendly[yes], near[Raja Indian Cuisine]	The Wrestlers is a Japanese pub near Raja Indian Cuisine in riverside is child friendly and has a high price range.
name[The Wrestlers], eatType[pub], food[Japanese], priceRange[less than £20], area[city centre], familyFriendly[no], near[Raja Indian Cuisine]	The Wrestlers is a pub that serves Japanese food for less than £20 it is not family-friendly it is located near Raja Indian Cuisine in the city centre.
name[The Wrestlers], eatType[pub], food[Japanese], priceRange[less than £20], area[city centre], familyFriendly[yes], near[Raja Indian Cuisine]	The Wrestlers is a Japanese pub in the city centre near Raja Indian Cuisine it is family friendly and has a price range of less than £20.
name[The Wrestlers], eatType[pub], food[Japanese], priceRange[less than £20], area[riverside], familyFriendly[no], near[Raja Indian Cuisine]	The Wrestlers is a Japanese pub near Raja Indian Cuisine in the riverside area it has a price range of less than £20 is not family-friendly.
name[The Wrestlers], eatType[pub], food[Japanese], priceRange[less than £20], area[riverside], familyFriendly[yes], near[Raja Indian Cuisine]	The Wrestlers is a Japanese pub in riverside near Raja Indian Cuisine it is family friendly and has a price range of less than £20.
name[The Wrestlers], eatType[pub], food[Japanese], priceRange[moderate], area[city centre], familyFriendly[no], near[Raja Indian Cuisine]	The Wrestlers is a pub that serves Japanese food with a moderate price range it is not kid friendly and is located near Raja Indian Cuisine in the city centre.
name[The Wrestlers], eatType[pub], food[Japanese], priceRange[moderate], area[city centre], familyFriendly[yes], near[Raja Indian Cuisine]	The Wrestlers is a Japanese pub near Raja Indian Cuisine in the city centre it has a moderate price range and is child friendly.
name[The Wrestlers], eatType[pub], food[Japanese], priceRange[moderate], area[riverside], familyFriendly[no], near[Raja Indian Cuisine]	The Wrestlers is a Japanese pub near Raja Indian Cuisine in riverside it has a moderate price range it is not kid friendly.
name[The Wrestlers], eatType[pub], food[Japanese], priceRange[moderate], area[riverside], familyFriendly[yes], near[Raja Indian Cuisine]	The Wrestlers is a Japanese pub near Raja Indian Cuisine in riverside it is kid friendly and has a moderate price range.
name[The Wrestlers], eatType[pub], food[Japanese], priceRange[moderate], customer rating[1 out of 5], area[city centre], familyFriendly[yes], near[Raja Indian Cuisine]	The Wrestlers is a Japanese pub near Raja Indian Cuisine in the city centre it has a moderate price range with a customer rating of 1 out of 5 and is kid friendly.
name[The Wrestlers], eatType[pub], food[Japanese], priceRange[moderate], customer rating[1 out of 5], area[riverside], familyFriendly[no], near[Raja Indian Cuisine]	The Wrestlers is a Japanese pub near Raja Indian Cuisine in the riverside area it has a moderate price range and is not kid friendly.
name[The Wrestlers], eatType[pub], food[Japanese], priceRange[moderate], customer rating[1 out of 5], area[riverside], familyFriendly[yes], near[Raja Indian Cuisine]	The Wrestlers is a Japanese pub near Raja Indian Cuisine in riverside is kid friendly, has a moderate price range and a customer rating of 1 out of 5.
name[The Wrestlers], eatType[pub], food[Japanese], priceRange[more than £30], area[city centre], familyFriendly[no], near[Raja Indian Cuisine]	The Wrestlers is a Japanese pub in the city centre near Raja Indian Cuisine it is not child friendly and has a price range of more than £30.
name[The Wrestlers], eatType[pub], food[Japanese], priceRange[more than £30], area[city centre], familyFriendly[yes], near[Raja Indian Cuisine]	The Wrestlers is a Japanese pub in the city centre near Raja Indian Cuisine it is children friendly and has a price range of more than £30.
name[The Wrestlers], eatType[pub], food[Japanese], priceRange[more than £30], area[riverside], familyFriendly[no], near[Raja Indian Cuisine]	The Wrestlers is a Japanese pub in riverside near Raja Indian Cuisine it is not child friendly and has a price range of more than £30.
name[The Wrestlers], eatType[pub], food[Japanese], priceRange[more than £30], area[riverside], familyFriendly[yes], near[Raja Indian Cuisine]	The Wrestlers is a Japanese pub in riverside near Raja Indian Cuisine it is child friendly and has a price range of more than £30.
name[The Wrestlers], eatType[pub], food[Japanese], priceRange[more than £30], customer rating[5 out of 5], area[city centre], familyFriendly[no], near[Raja Indian Cuisine]	The Wrestlers is a Japanese pub near Raja Indian Cuisine in the city centre with a customer rating of 5 out of 5 and has a price range of more than £30 it is not family-friendly.
name[The Wrestlers], eatType[pub], food[Japanese], priceRange[more than £30], customer rating[5 out of 5], area[city centre], familyFriendly[yes], near[Raja Indian Cuisine]	The Wrestlers is a Japanese pub in the city centre near Raja Indian Cuisine it is children friendly has a customer rating of 5 out of 5 and has a price range of more than £30.
name[The Wrestlers], eatType[pub], food[Japanese], priceRange[more than £30], customer rating[5 out of 5], area[riverside], familyFriendly[no], near[Raja Indian Cuisine]	The Wrestlers is a Japanese pub near Raja Indian Cuisine in the riverside area with a 5 out of 5 and has a price range of more than £30 it is not family-friendly.
name[The Wrestlers], eatType[pub], food[Japanese], priceRange[more than £30], customer rating[5 out of 5], area[riverside], familyFriendly[yes], near[Raja Indian Cuisine]	The Wrestlers is a Japanese pub in the riverside near Raja Indian Cuisine it is children friendly has a customer rating of 5 out of 5 and has a price range of more than £30.
name[The Wrestlers], eatType[pub], food[Japanese], priceRange[more than £30], customer rating[low], area[city centre], familyFriendly[no], near[Raja Indian Cuisine]	The Wrestlers is a Japanese pub near Raja Indian Cuisine in the city centre it has a low customer rating, a price range of more than £30 and is not family-friendly.
name[The Wrestlers], eatType[pub], food[Japanese], priceRange[more than £30], customer rating[low], area[city centre], familyFriendly[yes], near[Raja Indian Cuisine]	The Wrestlers is a Japanese pub near Raja Indian Cuisine in the city centre it is child friendly has a low customer rating and a price range of more than £30.
name[The Wrestlers], eatType[pub], food[Japanese], priceRange[more than £30], customer rating[low], area[riverside], familyFriendly[no], near[Raja Indian Cuisine]	The Wrestlers is a Japanese pub near Raja Indian Cuisine in the riverside area it has a low customer rating, a price range of more than £30 and is not kid friendly.
name[The Wrestlers], eatType[pub], food[Japanese], priceRange[more than £30], customer rating[low], area[riverside], familyFriendly[yes], near[Raja Indian Cuisine]	The Wrestlers is a Japanese pub near Raja Indian Cuisine in the riverside area it is child friendly, has a low customer rating and a price range of more than £30.
name[The Wrestlers], eatType[restaurant], food[Italian], priceRange[less than £20], area[riverside], familyFriendly[no], near[Raja Indian Cuisine]	The Wrestlers is an Italian restaurant near Raja Indian Cuisine in riverside with a price range of less than £20 it is not family-friendly.
name[The Wrestlers], eatType[restaurant], food[Italian], priceRange[less than £20], area[riverside], familyFriendly[yes], near[Raja Indian Cuisine]	The Wrestlers is an Italian restaurant located in riverside near Raja Indian Cuisine it is family friendly and has a price range of less than £20.
name[The Wrestlers], eatType[restaurant], food[Italian], priceRange[moderate], area[city centre], familyFriendly[no], near[Raja Indian Cuisine]	The Wrestlers is a moderately priced restaurant that serves Italian food near Raja Indian Cuisine it is not family-friendly.
name[The Wrestlers], eatType[restaurant], food[Italian], priceRange[moderate], area[city centre], familyFriendly[yes], near[Raja Indian Cuisine]	The Wrestlers is a moderately priced restaurant that serves Italian food near Raja Indian Cuisine it is family friendly.
name[The Wrestlers], eatType[restaurant], food[Italian], priceRange[moderate], area[riverside], familyFriendly[no], near[Raja Indian Cuisine]	The Wrestlers is a moderately priced restaurant that serves Italian food near Raja Indian Cuisine it is not family-friendly.
name[The Wrestlers], eatType[restaurant], food[Italian], priceRange[moderate], area[riverside], familyFriendly[yes], near[Raja Indian Cuisine]	The Wrestlers is a moderately priced restaurant that serves Italian food near Raja Indian Cuisine it is family friendly.
name[The Wrestlers], eatType[restaurant], food[Italian], priceRange[more than £30], area[riverside], familyFriendly[yes], near[Raja Indian Cuisine]	The Wrestlers is an Italian restaurant located in riverside near Raja Indian Cuisine it is children friendly and has a price range of more than £30.
name[The Wrestlers], eatType[restaurant], food[Japanese], priceRange[£20-25], area[riverside], familyFriendly[yes], near[Raja Indian Cuisine]	The Wrestlers is a Japanese restaurant near Raja Indian Cuisine in riverside is kid friendly and has a price range of £20-25.
name[The Wrestlers], eatType[restaurant], food[Japanese], priceRange[cheap], area[riverside], familyFriendly[yes], near[Raja Indian Cuisine]	The Wrestlers is a cheap Japanese restaurant near Raja Indian Cuisine in riverside is family friendly.
name[The Wrestlers], eatType[restaurant], food[Japanese], priceRange[high], area[riverside], familyFriendly[yes], near[Raja Indian Cuisine]	The Wrestlers is a Japanese restaurant near Raja Indian Cuisine in riverside is child friendly and has a high price range.
name[The Wrestlers], eatType[restaurant], food[Japanese], priceRange[less than £20], area[city centre], familyFriendly[no], near[Raja Indian Cuisine]	The Wrestlers is a Japanese restaurant near Raja Indian Cuisine in the city centre it has a price range of less than £20 is not family-friendly.
name[The Wrestlers], eatType[restaurant], food[Japanese], priceRange[less than £20], area[city centre], familyFriendly[yes], near[Raja Indian Cuisine]	The Wrestlers is a Japanese restaurant near Raja Indian Cuisine in the city centre it is family-friendly and has a price range of less than £20.
name[The Wrestlers], eatType[restaurant], food[Japanese], priceRange[less than £20], area[riverside], familyFriendly[no], near[Raja Indian Cuisine]	The Wrestlers is a Japanese restaurant near Raja Indian Cuisine in the riverside area it has a price range of less than £20 is not family-friendly.
name[The Wrestlers], eatType[restaurant], food[Japanese], priceRange[less than £20], area[riverside], familyFriendly[yes], near[Raja Indian Cuisine]	The Wrestlers is a Japanese restaurant near Raja Indian Cuisine in riverside is family friendly and has a price range less than £20.
name[The Wrestlers], eatType[restaurant], food[Japanese], priceRange[moderate], area[city centre], familyFriendly[no], near[Raja Indian Cuisine]	The Wrestlers is a Japanese restaurant near Raja Indian Cuisine in the city centre it has a moderate price range it is not kid friendly.
name[The Wrestlers], eatType[restaurant], food[Japanese], priceRange[moderate], area[city centre], familyFriendly[yes], near[Raja Indian Cuisine]	The Wrestlers is a Japanese restaurant near Raja Indian Cuisine in the city centre it has a moderate price range and is child friendly.
name[The Wrestlers], eatType[restaurant], food[Japanese], priceRange[moderate], area[riverside], familyFriendly[no], near[Raja Indian Cuisine]	The Wrestlers is a moderately priced restaurant that serves Japanese food it is located in the riverside area near Raja Indian Cuisine it is not family-friendly.
name[The Wrestlers], eatType[restaurant], food[Japanese], priceRange[moderate], area[riverside], familyFriendly[yes], near[Raja Indian Cuisine]	The Wrestlers is a Japanese restaurant near Raja Indian Cuisine in riverside it is kid friendly and has a moderate price range.
name[The Wrestlers], eatType[restaurant], food[Japanese], priceRange[more than £30], area[city centre], familyFriendly[no], near[Raja Indian Cuisine]	The Wrestlers is a Japanese restaurant near Raja Indian Cuisine in the city centre with a price range of more than £30 and is not child friendly.
name[The Wrestlers], eatType[restaurant], food[Japanese], priceRange[more than £30], area[city centre], familyFriendly[yes], near[Raja Indian Cuisine]	The Wrestlers is a Japanese restaurant near Raja Indian Cuisine in the city centre it is children friendly and has a price range of more than £30.
name[The Wrestlers], eatType[restaurant], food[Japanese], priceRange[more than £30], area[riverside], familyFriendly[no], near[Raja Indian Cuisine]	The Wrestlers is a Japanese restaurant near Raja Indian Cuisine in riverside it is not child friendly and has a price range of more than £30.
name[The Wrestlers], eatType[restaurant], food[Japanese], priceRange[more than £30], area[riverside], familyFriendly[yes], near[Raja Indian Cuisine]	The Wrestlers is a Japanese restaurant near Raja Indian Cuisine in riverside it is children friendly and has a price range of more than £30.
name[Wildwood], eatType[coffee shop], area[riverside]	In the riverside area there is a coffee shop called Wildwood.
name[Wildwood], eatType[pub], area[riverside]	In the riverside area there is a pub called Wildwood.
name[Wildwood], eatType[pub], food[French], area[riverside], familyFriendly[yes], near[Raja Indian Cuisine]	Wildwood is a French pub near Raja Indian Cuisine in the riverside area it is family friendly.
name[Wildwood], eatType[pub], food[Indian], area[city centre], familyFriendly[no], near[Raja Indian Cuisine]	Wildwood is an Indian pub near Raja Indian Cuisine in the city centre it is not family-friendly.
name[Wildwood], eatType[pub], food[Indian], area[city centre], familyFriendly[yes], near[Raja Indian Cuisine]	Wildwood is an Indian pub near Raja Indian Cuisine in the city centre it is family friendly.
name[Wildwood], eatType[pub], food[Indian], area[riverside], familyFriendly[no], near[Raja Indian Cuisine]	Wildwood is an Indian pub near Raja Indian Cuisine in the riverside area it is not family-friendly.
name[Wildwood], eatType[pub], food[Indian], area[riverside], familyFriendly[yes], near[Raja Indian Cuisine]	Wildwood is an Indian pub near Raja Indian Cuisine in the riverside area it is family friendly.
name[Wildwood], eatType[pub], food[Italian], area[city centre], familyFriendly[no], near[Raja Indian Cuisine]	Wildwood is an Italian pub in the city centre near Raja Indian Cuisine it is not family-friendly.
name[Wildwood], eatType[pub], food[Italian], area[city centre], familyFriendly[yes], near[Raja Indian Cuisine]	Wildwood is an Italian pub in the city centre near Raja Indian Cuisine it is family friendly.
name[Wildwood], eatType[pub], food[Italian], area[riverside], familyFriendly[no], near[Raja Indian Cuisine]	Wildwood is an Italian pub in riverside near Raja Indian Cuisine it is not family-friendly.
name[Wildwood], eatType[pub], food[Italian], area[riverside], familyFriendly[yes], near[Raja Indian Cuisine]	Wildwood is an Italian pub in the riverside area near Raja Indian Cuisine is a family friendly.
name[Wildwood], eatType[restaurant], food[French], area[riverside], familyFriendly[yes], near[Raja Indian Cuisine]	Wildwood is a French restaurant near Raja Indian Cuisine in riverside it is family friendly.
name[Wildwood], eatType[restaurant], food[Indian], area[city centre], familyFriendly[no], near[Raja Indian Cuisine]	Wildwood is an Indian restaurant located in the city centre near Raja Indian Cuisine it is not family friendly.
name[Wildwood], eatType[restaurant], food[Indian], area[city centre], familyFriendly[yes], near[Raja Indian Cuisine]	Wildwood is an Indian restaurant is family friendly it is near Raja Indian Cuisine in the city centre.
name[Wildwood], eatType[restaurant], food[Indian], area[riverside], familyFriendly[no], near[Raja Indian Cuisine]	Wildwood is an Indian restaurant located in riverside near Raja Indian Cuisine it is not family friendly.
name[Wildwood], eatType[restaurant], food[Indian], area[riverside], familyFriendly[yes], near[Raja Indian Cuisine]	Wildwood is an Indian restaurant is family friendly it is near Raja Indian Cuisine in the riverside area.
name[Wildwood], eatType[restaurant], food[Italian], area[city centre], familyFriendly[no], near[Raja Indian Cuisine]	Wildwood is an Italian restaurant near Raja Indian Cuisine in the city centre it is not family-friendly.
name[Wildwood], eatType[restaurant], food[Italian], area[city centre], familyFriendly[yes], near[Raja Indian Cuisine]	Wildwood is an Italian restaurant near Raja Indian Cuisine in the city centre it is family-friendly.
name[Wildwood], eatType[restaurant], food[Italian], area[riverside], familyFriendly[no], near[Raja Indian Cuisine]	Wildwood is an Italian restaurant near Raja Indian Cuisine in riverside it is not family-friendly.
name[Wildwood], eatType[restaurant], food[Italian], area[riverside], familyFriendly[yes], near[Raja Indian Cuisine]	Wildwood is an Italian restaurant near Raja Indian Cuisine in riverside it is family friendly.
name[Zizzi], eatType[coffee shop], area[riverside]	In the riverside area there is a coffee shop called Zizzi.
name[Zizzi], eatType[coffee shop], customer rating[average], near[Burger King]	Zizzi is an average rated coffee shop near Burger King.
name[Zizzi], eatType[coffee shop], customer rating[high], near[Burger King]	Zizzi is a highly rated coffee shop near Burger King.
name[Zizzi], eatType[coffee shop], near[The Sorrento]	Zizzi is a coffee shop near The Sorrento.
name[Zizzi], eatType[pub], area[riverside]	In the riverside area there is a pub called Zizzi.
name[Zizzi], eatType[pub], customer rating[average], near[Burger King]	Zizzi is an average rated pub near Burger King.
name[Zizzi], eatType[pub], customer rating[high], near[Burger King]	Zizzi is a highly rated pub near Burger King.
name[Zizzi], eatType[pub], near[The Sorrento]	Zizzi is a pub near The Sorrento.