name[Blue Spice], eatType[coffee shop], area[city centre]	Blue Spice is a coffee shop in the city centre.
name[Blue Spice], eatType[coffee shop], area[riverside]	Blue Spice is a coffee shop in the riverside area.
name[Blue Spice], eatType[coffee shop], customer rating[5 out of 5], near[Crowne Plaza Hotel]	Blue Spice is a coffee shop near Crowne Plaza Hotel it has a customer rating of 5 out of 5.
name[Blue Spice], eatType[coffee shop], customer rating[average], near[Burger King]	Blue Spice is a coffee shop near Burger King it has an average customer rating.
name[Blue Spice], eatType[coffee shop], customer rating[average], near[Crowne Plaza Hotel]	Blue Spice is a coffee shop near Crowne Plaza Hotel it has an average customer rating.
name[Blue Spice], eatType[pub], area[city centre]	Blue Spice is a pub located in the city centre.
name[Blue Spice], eatType[pub], area[riverside]	Blue Spice is a pub located in the riverside area.
name[Blue Spice], eatType[pub], customer rating[5 out of 5], near[Crowne Plaza Hotel]	Blue Spice is a pub near Crowne Plaza Hotel it has a customer rating of 5 out of 5.
name[Blue Spice], eatType[pub], customer rating[average], near[Burger King]	Blue Spice is a pub near Burger King it has an average customer rating.
name[Blue Spice], eatType[pub], customer rating[average], near[Crowne Plaza Hotel]	Blue Spice is a pub near Crowne Plaza Hotel it has an average customer rating.
name[Blue Spice], eatType[pub], food[Chinese], area[city centre], familyFriendly[no], near[Rainbow Vegetarian Café]	Blue Spice is a pub that serves Chinese food in the city centre near Rainbow Vegetarian Café it is not family-friendly.
name[Blue Spice], eatType[pub], food[Chinese], area[city centre], familyFriendly[yes], near[Rainbow Vegetarian Café]	Blue Spice is a Chinese pub in the city centre near Rainbow Vegetarian Café it is family friendly.
name[Blue Spice], eatType[pub], food[Chinese], area[riverside], familyFriendly[no], near[Rainbow Vegetarian Café]	Blue Spice is a pub that serves Chinese food in the riverside area near Rainbow Vegetarian Café it is not family friendly.
name[Blue Spice], eatType[pub], food[Chinese], area[riverside], familyFriendly[yes], near[Rainbow Vegetarian Café]	Blue Spice is a family friendly pub serving Chinese food it is located in the riverside area near Rainbow Vegetarian Café.
name[Blue Spice], eatType[pub], food[English], area[city centre], familyFriendly[no], near[Rainbow Vegetarian Café]	Blue Spice is a pub that serves English food in the city centre near Rainbow Vegetarian Café it is not family-friendly.
name[Blue Spice], eatType[pub], food[English], area[city centre], familyFriendly[yes], near[Rainbow Vegetarian Café]	Blue Spice is a family-friendly pub serving English food in the city centre near Rainbow Vegetarian Café.
name[Blue Spice], eatType[pub], food[English], area[riverside], familyFriendly[no], near[Rainbow Vegetarian Café]	Blue Spice is a pub that serves English food in the riverside area near Rainbow Vegetarian Café it is not family-friendly.
name[Blue Spice], eatType[pub], food[English], area[riverside], familyFriendly[yes], near[Rainbow Vegetarian Café]	Blue Spice is a family friendly pub serving English food in the riverside area near Rainbow Vegetarian Café.
name[Blue Spice], eatType[restaurant], food[Chinese], area[city centre], familyFriendly[no], near[Rainbow Vegetarian Café]	Blue Spice is a Chinese restaurant in the city centre near Rainbow Vegetarian Café it is not family-friendly.
name[Blue Spice], eatType[restaurant], food[Chinese], area[city centre], familyFriendly[yes], near[Rainbow Vegetarian Café]	Blue Spice is a Chinese restaurant in the city centre near Rainbow Vegetarian Café it is family friendly.
name[Blue Spice], eatType[restaurant], food[Chinese], area[riverside], familyFriendly[no], near[Rainbow Vegetarian Café]	Blue Spice is a restaurant that serves Chinese food in the riverside area near Rainbow Vegetarian Café it is not family friendly.
name[Blue Spice], eatType[restaurant], food[Chinese], area[riverside], familyFriendly[yes], near[Rainbow Vegetarian Café]	Blue Spice is a Chinese restaurant near Rainbow Vegetarian Café in the riverside area it is family friendly.
name[Blue Spice], eatType[restaurant], food[English], area[city centre], familyFriendly[no], near[Rainbow Vegetarian Café]	Blue Spice is a restaurant that serves English food in the city centre near Rainbow Vegetarian Café it is not family-friendly.
name[Blue Spice], eatType[restaurant], food[English], area[city centre], familyFriendly[yes], near[Rainbow Vegetarian Café]	Blue Spice is a family friendly restaurant serving English food it is located in the city centre near Rainbow Vegetarian Café.
name[Blue Spice], eatType[restaurant], food[English], area[riverside], familyFriendly[no], near[Rainbow Vegetarian Café]	Blue Spice is a restaurant near Rainbow Vegetarian Café in the riverside area it serves English food and is not family-friendly.
name[Blue Spice], eatType[restaurant], food[English], area[riverside], familyFriendly[yes], near[Rainbow Vegetarian Café]	Blue Spice is a family friendly restaurant serving English food in the riverside area near Rainbow Vegetarian Café.
name[Clowns], eatType[coffee shop], customer rating[3 out of 5], near[All Bar One]	Clowns is a coffee shop near All Bar One it has a customer rating of 3 out of 5.
name[Clowns], eatType[coffee shop], customer rating[5 out of 5], near[Crowne Plaza Hotel]	Clowns is a coffee shop near Crowne Plaza Hotel it has a customer rating of 5 out of 5.
name[Clowns], eatType[coffee shop], near[The Sorrento]	Clowns is a coffee shop near The Sorrento.
name[Clowns], eatType[pub], customer rating[3 out of 5], near[All Bar One]	Clowns is a pub near All Bar One it has a customer rating of 3 out of 5.
name[Clowns], eatType[pub], customer rating[5 out of 5], near[Crowne Plaza Hotel]	Clowns is a pub near Crowne Plaza Hotel it has a customer rating of 5 out of 5.
name[Clowns], eatType[pub], near[The Sorrento]	Clowns is a pub near The Sorrento.
name[Cocum], eatType[coffee shop], customer rating[high], near[Burger King]	Cocum is a coffee shop near Burger King it has a high customer rating.
name[Cocum], eatType[coffee shop], customer rating[high], near[Café Sicilia]	Cocum is a coffee shop near Café Sicilia it has a high customer rating.
name[Cocum], eatType[coffee shop], customer rating[low], near[Café Sicilia]	Cocum is a coffee shop near Café Sicilia it has a low customer rating.
name[Cocum], eatType[coffee shop], customer rating[low], near[Express by Holiday Inn]	Cocum is a coffee shop near Express by Holiday Inn it has a low customer rating.
name[Cocum], eatType[coffee shop], near[The Rice Boat]	Cocum is a coffee shop near The Rice Boat.
name[Cocum], eatType[coffee shop], near[The Sorrento]	Cocum is a coffee shop near The Sorrento.
name[Cocum], eatType[pub], customer rating[high], near[Burger King]	Cocum is a pub near Burger King it has a high customer rating.
name[Cocum], eatType[pub], customer rating[high], near[Café Sicilia]	Cocum is a pub near Café Sicilia it has a high customer rating.
name[Cocum], eatType[pub], customer rating[low], near[Café Sicilia]	Cocum is a pub near Café Sicilia it has a low customer rating.
name[Cocum], eatType[pub], customer rating[low], near[Express by Holiday Inn]	Cocum is a pub near Express by Holiday Inn it has a low customer rating.
name[Cocum], eatType[pub], near[The Rice Boat]	Cocum is a pub near The Rice Boat.
name[Cocum], eatType[pub], near[The Sorrento]	Cocum is a pub near The Sorrento.
name[Cotto], eatType[coffee shop], near[The Bakers]	Cotto is a coffee shop near The Bakers.
name[Cotto], eatType[pub], near[The Bakers]	Cotto is a pub near The Bakers.
name[Giraffe], eatType[coffee shop], near[The Bakers]	Giraffe is a coffee shop near The Bakers.
name[Giraffe], eatType[coffee shop], near[The Rice Boat]	Giraffe is a coffee shop near The Rice Boat.
name[Giraffe], eatType[pub], food[English], area[riverside], familyFriendly[yes], near[Rainbow Vegetarian Café]	Giraffe is a family friendly pub serving English food in the riverside area near Rainbow Vegetarian Café.
name[Giraffe], eatType[pub], food[Fast food], area[city centre], familyFriendly[no], near[Rainbow Vegetarian Café]	Giraffe is a pub that serves Fast food it is located in the city centre near Rainbow Vegetarian Café it is not family-friendly.
name[Giraffe], eatType[pub], food[Fast food], area[city centre], familyFriendly[yes], near[Rainbow Vegetarian Café]	Giraffe is a family friendly pub serving Fast food in the city centre near Rainbow Vegetarian Café.
name[Giraffe], eatType[pub], food[Fast food], area[riverside], familyFriendly[no], near[Rainbow Vegetarian Café]	Giraffe is a pub that serves Fast food it is located in the riverside area near Rainbow Vegetarian Café it is not family-friendly.
name[Giraffe], eatType[pub], food[Fast food], area[riverside], familyFriendly[yes], near[Rainbow Vegetarian Café]	Giraffe is a family friendly pub serving Fast food it is located in the riverside area near Rainbow Vegetarian Café.
name[Giraffe], eatType[pub], food[Fast food], area[riverside], familyFriendly[yes], near[Raja Indian Cuisine]	Giraffe is a family friendly pub serving Fast food it is located in the riverside area near Raja Indian Cuisine.
name[Giraffe], eatType[pub], food[French], area[city centre], familyFriendly[no], near[Raja Indian Cuisine]	Giraffe is a pub that serves French food in the city centre near Raja Indian Cuisine it is not family-friendly.
name[Giraffe], eatType[pub], food[French], area[city centre], familyFriendly[yes], near[Raja Indian Cuisine]	Giraffe is a family-friendly pub serving French food in the city centre near Raja Indian Cuisine.
name[Giraffe], eatType[pub], food[French], area[riverside], familyFriendly[no], near[Raja Indian Cuisine]	Giraffe is a pub that serves French food it is located in the riverside area near Raja Indian Cuisine it is not family-friendly.
name[Giraffe], eatType[pub], food[French], area[riverside], familyFriendly[yes], near[Raja Indian Cuisine]	Giraffe is a family friendly pub serving French food it is located in the riverside area near Raja Indian Cuisine.
name[Giraffe], eatType[pub], near[The Bakers]	Giraffe is a pub near The Bakers.
name[Giraffe], eatType[pub], near[The Rice Boat]	Giraffe is a pub near The Rice Boat.
name[Giraffe], eatType[restaurant], food[English], area[riverside], familyFriendly[yes], near[Rainbow Vegetarian Café]	Giraffe is a family friendly restaurant serving English food in the riverside area near Rainbow Vegetarian Café.
name[Giraffe], eatType[restaurant], food[Fast food], area[city centre], familyFriendly[no], near[Rainbow Vegetarian Café]	Giraffe is a restaurant that serves Fast food it is located in the city centre near Rainbow Vegetarian Café it is not family-friendly.
name[Giraffe], eatType[restaurant], food[Fast food], area[city centre], familyFriendly[yes], near[Rainbow Vegetarian Café]	Giraffe is a family friendly restaurant that serves Fast food it is located in the city centre near Rainbow Vegetarian Café.
name[Giraffe], eatType[restaurant], food[Fast food], area[riverside], familyFriendly[no], near[Rainbow Vegetarian Café]	Giraffe is a restaurant that serves Fast food it is located in the riverside area near Rainbow Vegetarian Café it is not family-friendly.
name[Giraffe], eatType[restaurant], food[Fast food], area[riverside], familyFriendly[yes], near[Rainbow Vegetarian Café]	Giraffe is a family friendly restaurant that serves Fast food it is located in the riverside area near Rainbow Vegetarian Café.
name[Giraffe], eatType[restaurant], food[Fast food], area[riverside], familyFriendly[yes], near[Raja Indian Cuisine]	Giraffe is a family friendly restaurant that serves Fast food it is located in the riverside area near Raja Indian Cuisine.
name[Giraffe], eatType[restaurant], food[French], area[city centre], familyFriendly[no], near[Raja Indian Cuisine]	Giraffe is a restaurant that serves French food in the city centre near Raja Indian Cuisine it is not family-friendly.
name[Giraffe], eatType[restaurant], food[French], area[city centre], familyFriendly[yes], near[Raja Indian Cuisine]	Giraffe is a family friendly restaurant serving French food in the city centre near Raja Indian Cuisine.
name[Giraffe], eatType[restaurant], food[French], area[riverside], familyFriendly[no], near[Raja Indian Cuisine]	Giraffe is a restaurant near Raja Indian Cuisine in the riverside area it is not family-friendly.
name[Giraffe], eatType[restaurant], food[French], area[riverside], familyFriendly[yes], near[Raja Indian Cuisine]	Giraffe is a family friendly restaurant serving French food it is located in the riverside area near Raja Indian Cuisine.
name[Green Man], eatType[coffee shop], customer rating[1 out of 5], near[All Bar One]	Green Man is a coffee shop near All Bar One it has a customer rating of 1 out of 5.
name[Green Man], eatType[coffee shop], customer rating[3 out of 5], near[All Bar One]	Green Man is a coffee shop near All Bar One it has a customer rating of 3 out of 5.
name[Green Man], eatType[pub], customer rating[1 out of 5], near[All Bar One]	Green Man is a pub near All Bar One it has a customer rating of 1 out of 5.
name[Green Man], eatType[pub], customer rating[3 out of 5], near[All Bar One]	Green Man is a pub near All Bar One it has a customer rating of 3 out of 5.
name[Green Man], eatType[pub], food[Italian], area[riverside], familyFriendly[yes], near[Express by Holiday Inn]	Green Man is a family friendly pub serving Italian food in the riverside area near Express by Holiday Inn.
name[Green Man], eatType[pub], food[Italian], area[riverside], familyFriendly[yes], near[Raja Indian Cuisine]	Green Man is a family friendly pub serving Italian food in the riverside area near Raja Indian Cuisine.
name[Green Man], eatType[pub], food[Japanese], area[city centre], familyFriendly[no], near[Express by Holiday Inn]	Green Man is a pub that serves Japanese food in the city centre near Express by Holiday Inn it is not family-friendly.
name[Green Man], eatType[pub], food[Japanese], area[city centre], familyFriendly[yes], near[Express by Holiday Inn]	Green Man is a family friendly pub serving Japanese food in the city centre near Express by Holiday Inn.
name[Green Man], eatType[pub], food[Japanese], area[riverside], familyFriendly[no], near[Express by Holiday Inn]	Green Man is a pub that serves Japanese food in the riverside area near Express by Holiday Inn it is not family-friendly.
name[Green Man], eatType[pub], food[Japanese], area[riverside], familyFriendly[yes], near[Express by Holiday Inn]	Green Man is a family friendly pub serving Japanese food in the riverside area near Express by Holiday Inn.
name[Green Man], eatType[restaurant], food[Italian], area[riverside], familyFriendly[yes], near[Express by Holiday Inn]	Green Man is a family friendly restaurant that serves Italian food in the riverside area near Express by Holiday Inn.
name[Green Man], eatType[restaurant], food[Italian], area[riverside], familyFriendly[yes], near[Raja Indian Cuisine]	Green Man is a family friendly restaurant that serves Italian food in the riverside area near Raja Indian Cuisine.
name[Green Man], eatType[restaurant], food[Japanese], area[city centre], familyFriendly[no], near[Express by Holiday Inn]	Green Man is a restaurant that serves Japanese food in the city centre near Express by Holiday Inn it is not family-friendly.
name[Green Man], eatType[restaurant], food[Japanese], area[city centre], familyFriendly[yes], near[Express by Holiday Inn]	Green Man is a family friendly restaurant serving Japanese food in the city centre near Express by Holiday Inn.
name[Green Man], eatType[restaurant], food[Japanese], area[riverside], familyFriendly[no], near[Express by Holiday Inn]	Green Man is a restaurant near Express by Holiday Inn in the riverside area Japanese food and is not family-friendly.
name[Green Man], eatType[restaurant], food[Japanese], area[riverside], familyFriendly[yes], near[Express by Holiday Inn]	Green Man is a family friendly restaurant serving Japanese food in the riverside area near Express by Holiday Inn.
name[Loch Fyne], eatType[coffee shop], area[riverside]	Loch Fyne is a coffee shop in the riverside area.
name[Loch Fyne], eatType[pub], area[riverside]	Loch Fyne is a pub located in the riverside area.
name[Strada], eatType[coffee shop], area[city centre]	Strada is a coffee shop in the city centre.
name[Strada], eatType[coffee shop], customer rating[1 out of 5], near[All Bar One]	Strada is a coffee shop near All Bar One it has a customer rating of 1 out of 5.
name[Strada], eatType[coffee shop], customer rating[1 out of 5], near[Rainbow Vegetarian Café]	Strada is a coffee shop near Rainbow Vegetarian Café it has a customer rating of 1 out of 5.
name[Strada], eatType[coffee shop], customer rating[low], near[Express by Holiday Inn]	Strada is a coffee shop near Express by Holiday Inn it has a low customer rating.
name[Strada], eatType[pub], area[city centre]	Strada is a pub located in the city centre.
name[Strada], eatType[pub], customer rating[1 out of 5], near[All Bar One]	Strada is a pub near All Bar One it has a customer rating of 1 out of 5.
name[Strada], eatType[pub], customer rating[1 out of 5], near[Rainbow Vegetarian Café]	Strada is a pub near Rainbow Vegetarian Café it has a customer rating of 1 out of 5.
name[Strada], eatType[pub], customer rating[low], near[Express by Holiday Inn]	Strada is a pub near Express by Holiday Inn it has a low customer rating.
name[The Cricketers], eatType[coffee shop], customer rating[1 out of 5], familyFriendly[yes], near[Avalon]	The Cricketers is a family friendly coffee shop near Avalon it has a customer rating of 1 out of 5.
name[The Cricketers], eatType[coffee shop], customer rating[3 out of 5], familyFriendly[yes], near[Avalon]	The Cricketers is a family friendly coffee shop near Avalon it has a customer rating of 3 out of 5.
name[The Cricketers], eatType[coffee shop], customer rating[3 out of 5], familyFriendly[yes], near[Crowne Plaza Hotel]	The Cricketers is a family friendly coffee shop near Crowne Plaza Hotel it has a customer rating of 3 out of 5.
name[The Cricketers], eatType[coffee shop], customer rating[5 out of 5], familyFriendly[no], near[Crowne Plaza Hotel]	The Cricketers is a coffee shop near Crowne Plaza Hotel it has a customer rating of 5 out of 5 and is not family-friendly.
name[The Cricketers], eatType[coffee shop], customer rating[5 out of 5], familyFriendly[yes], near[Crowne Plaza Hotel]	The Cricketers is a family friendly coffee shop near Crowne Plaza Hotel it has a customer rating of 5 out of 5.
name[The Cricketers], eatType[coffee shop], customer rating[average], familyFriendly[no], near[Café Sicilia]	The Cricketers is a coffee shop near Café Sicilia it has an average customer rating it is not family-friendly.
name[The Cricketers], eatType[coffee shop], customer rating[average], familyFriendly[no], near[Crowne Plaza Hotel]	The Cricketers is a coffee shop near Crowne Plaza Hotel it has an average customer rating it is not family-friendly.
name[The Cricketers], eatType[coffee shop], customer rating[average], familyFriendly[yes], near[Café Sicilia]	The Cricketers is a family friendly coffee shop near Café Sicilia it has an average customer rating.
name[The Cricketers], eatType[coffee shop], customer rating[high], familyFriendly[yes], near[Café Sicilia]	The Cricketers is a family friendly coffee shop near Café Sicilia it has a high customer rating.
name[The Cricketers], eatType[coffee shop], customer rating[high], familyFriendly[yes], near[Express by Holiday Inn]	The Cricketers is a family friendly coffee shop near Express by Holiday Inn it has a high customer rating.
name[The Cricketers], eatType[coffee shop], customer rating[low], familyFriendly[no], near[Express by Holiday Inn]	The Cricketers is a coffee shop near Express by Holiday Inn it has a low customer rating and is not family-friendly.
name[The Cricketers], eatType[coffee shop], customer rating[low], familyFriendly[no], near[Ranch]	The Cricketers is a coffee shop near Ranch it has a low customer rating and is not family-friendly.
name[The Cricketers], eatType[coffee shop], customer rating[low], familyFriendly[yes], near[Ranch]	The Cricketers is a family friendly coffee shop near Ranch it has a low customer rating.
name[The Cricketers], eatType[restaurant], customer rating[1 out of 5], familyFriendly[yes], near[Avalon]	The Cricketers is a family friendly restaurant with a customer rating of 1 out of 5 it is located near Avalon.
name[The Cricketers], eatType[restaurant], customer rating[3 out of 5], familyFriendly[yes], near[Avalon]	The Cricketers is a family friendly restaurant near Avalon it has a customer rating of 3 out of 5.
name[The Cricketers], eatType[restaurant], customer rating[3 out of 5], familyFriendly[yes], near[Crowne Plaza Hotel]	The Cricketers is a family friendly restaurant near Crowne Plaza Hotel it has a customer rating of 3 out of 5.
name[The Cricketers], eatType[restaurant], customer rating[5 out of 5], familyFriendly[no], near[Crowne Plaza Hotel]	The Cricketers is a restaurant near Crowne Plaza Hotel it has a customer rating of 5 out of 5 and is not family-friendly.
name[The Cricketers], eatType[restaurant], customer rating[5 out of 5], familyFriendly[yes], near[Crowne Plaza Hotel]	The Cricketers is a family friendly restaurant with a customer rating of 5 and is located near Crowne Plaza Hotel.
name[The Cricketers], eatType[restaurant], customer rating[average], familyFriendly[no], near[Café Sicilia]	The Cricketers is a restaurant near Café Sicilia it has an average customer rating it is not family-friendly.
name[The Cricketers], eatType[restaurant], customer rating[average], familyFriendly[no], near[Crowne Plaza Hotel]	The Cricketers is a restaurant near Crowne Plaza Hotel it has an average customer rating it is not family-friendly.
name[The Cricketers], eatType[restaurant], customer rating[average], familyFriendly[yes], near[Café Sicilia]	The Cricketers is a family friendly restaurant with an average customer rating it is located near Café Sicilia.
name[The Cricketers], eatType[restaurant], customer rating[high], familyFriendly[yes], near[Café Sicilia]	The Cricketers is a family friendly restaurant with a high customer rating it is located near Café Sicilia.
name[The Cricketers], eatType[restaurant], customer rating[high], familyFriendly[yes], near[Express by Holiday Inn]	The Cricketers is a family friendly restaurant with a high customer rating it is located near Express by Holiday Inn.
name[The Cricketers], eatType[restaurant], customer rating[low], familyFriendly[no], near[Express by Holiday Inn]	The Cricketers is a restaurant near Express by Holiday Inn it has a low customer rating and is not family-friendly.
name[The Cricketers], eatType[restaurant], customer rating[low], familyFriendly[no], near[Ranch]	The Cricketers is a restaurant near Ranch it has a low customer rating and is not family-friendly.
name[The Cricketers], eatType[restaurant], customer rating[low], familyFriendly[yes], near[Ranch]	The Cricketers is a family friendly restaurant near Ranch it has a low customer rating.
name[The Cricketers], eatType[restaurant], food[Chinese], priceRange[£20-25], customer rating[high], area[city centre], familyFriendly[no], near[All Bar One]	The Cricketers is a restaurant that serves Chinese food in the £20-25 it has a high customer rating and is not kid friendly it is located in the city centre near All Bar One.
name[The Cricketers], eatType[restaurant], food[Chinese], priceRange[£20-25], customer rating[high], area[city centre], familyFriendly[yes], near[All Bar One]	The Cricketers is a Chinese restaurant near All Bar One in the city centre it has a high customer rating, a price range of £20-25 and is kid friendly.
name[The Cricketers], eatType[restaurant], food[Chinese], priceRange[£20-25], customer rating[high], area[riverside], familyFriendly[no], near[All Bar One]	The Cricketers is a restaurant that serves Chinese food in the £20-25 it has a high customer rating and is not kid friendly it is located in the riverside area near All Bar One.
name[The Cricketers], eatType[restaurant], food[Chinese], priceRange[£20-25], customer rating[high], area[riverside], familyFriendly[yes], near[All Bar One]	The Cricketers is a restaurant that serves Chinese food in the £20-25 it has a high customer rating and is kid friendly it is located in the riverside area near All Bar One.
name[The Cricketers], eatType[restaurant], food[Chinese], priceRange[cheap], customer rating[5 out of 5], area[city centre], familyFriendly[no], near[All Bar One]	The Cricketers is a restaurant that serves Chinese food in the cheap price range it is located in the city centre near All Bar One it has a customer rating of 5 out of 5.
name[The Cricketers], eatType[restaurant], food[Chinese], priceRange[cheap], customer rating[5 out of 5], area[city centre], familyFriendly[yes], near[All Bar One]	The Cricketers is a Chinese restaurant with a cheap price range, a customer rating of 5 out of 5 and is family friendly it is located in the city centre near All Bar One.
name[The Cricketers], eatType[restaurant], food[Chinese], priceRange[cheap], customer rating[5 out of 5], area[riverside], familyFriendly[no], near[All Bar One]	The Cricketers is a restaurant that serves Chinese food in the cheap price range it is located in the riverside area near All Bar One its customer rating is 5 out of 5.
name[The Cricketers], eatType[restaurant], food[Chinese], priceRange[cheap], customer rating[5 out of 5], area[riverside], familyFriendly[yes], near[All Bar One]	The Cricketers is a restaurant that serves Chinese food in the cheap price range it is located in the riverside area near All Bar One its customer rating is 5 out of 5.
name[The Cricketers], eatType[restaurant], food[Chinese], priceRange[cheap], customer rating[average], area[city centre], familyFriendly[no], near[All Bar One]	The Cricketers is a restaurant that serves Chinese food in the cheap price range it is located in the city centre near All Bar One it has an average customer rating.
name[The Cricketers], eatType[restaurant], food[Chinese], priceRange[cheap], customer rating[average], area[city centre], familyFriendly[yes], near[All Bar One]	The Cricketers is a Chinese restaurant with a cheap price range and has an average customer rating it is located in the city centre near All Bar One.
name[The Cricketers], eatType[restaurant], food[Chinese], priceRange[cheap], customer rating[average], area[riverside], familyFriendly[no], near[All Bar One]	The Cricketers is a restaurant that serves Chinese food in the cheap price range it is located in the riverside it is near All Bar One its customer rating is average.
name[The Cricketers], eatType[restaurant], food[Chinese], priceRange[cheap], customer rating[average], area[riverside], familyFriendly[yes], near[All Bar One]	The Cricketers is a restaurant that serves Chinese food in the cheap price range it is located in the riverside it is near All Bar One its customer rating is average.
name[The Cricketers], eatType[restaurant], food[Chinese], priceRange[high], customer rating[1 out of 5], area[city centre], familyFriendly[no], near[All Bar One]	The Cricketers is a restaurant that serves Chinese food in the high price range it is located in the city centre near All Bar One it has a customer rating of 1 out of 5.
name[The Cricketers], eatType[restaurant], food[Chinese], priceRange[high], customer rating[1 out of 5], area[city centre], familyFriendly[yes], near[All Bar One]	The Cricketers is a Chinese restaurant with a high price range it has a customer rating of 1 out of 5 and is kid friendly it is located in the city centre near All Bar One.
name[The Cricketers], eatType[restaurant], food[Chinese], priceRange[high], customer rating[1 out of 5], area[riverside], familyFriendly[no], near[All Bar One]	The Cricketers is a restaurant that serves Chinese food in the high price range it is located in the riverside area near All Bar One it has a customer rating of 1 out of 5.
name[The Cricketers], eatType[restaurant], food[Chinese], priceRange[high], customer rating[1 out of 5], area[riverside], familyFriendly[yes], near[All Bar One]	The Cricketers is a restaurant that serves Chinese food in the high price range it is located in the riverside area near All Bar One its customer rating is 1 out of 5.
name[The Cricketers], eatType[restaurant], food[Chinese], priceRange[high], customer rating[average], area[city centre], familyFriendly[no], near[All Bar One]	The Cricketers is a Chinese restaurant near All Bar One in the city centre it has an average customer rating and a high price range.
name[The Cricketers], eatType[restaurant], food[Chinese], priceRange[high], customer rating[average], area[city centre], familyFriendly[yes], near[All Bar One]	The Cricketers is a Chinese restaurant near All Bar One in the city centre it has an average customer rating and a high price range.
name[The Cricketers], eatType[restaurant], food[Chinese], priceRange[high], customer rating[average], area[riverside], familyFriendly[no], near[All Bar One]	The Cricketers is a restaurant that serves Chinese food in the high price range it is located in the riverside area near All Bar One it has an average customer rating.
name[The Cricketers], eatType[restaurant], food[Chinese], priceRange[high], customer rating[average], area[riverside], familyFriendly[yes], near[All Bar One]	The Cricketers is a restaurant that serves Chinese food in the high price range it is located in the riverside area near All Bar One its customer rating is average.
name[The Cricketers], eatType[restaurant], food[Chinese], priceRange[less than £20], customer rating[low], area[city centre], familyFriendly[no], near[All Bar One]	The Cricketers is a restaurant that serves Chinese food in the less than £20 it is located in the city centre near All Bar One it has a low customer rating.
name[The Cricketers], eatType[restaurant], food[Chinese], priceRange[less than £20], customer rating[low], area[city centre], familyFriendly[yes], near[All Bar One]	The Cricketers is a restaurant that serves Chinese food in the less than £20 it is located in the city centre near All Bar One it has a low customer rating.
name[The Cricketers], eatType[restaurant], food[Chinese], priceRange[less than £20], customer rating[low], area[riverside], familyFriendly[no], near[All Bar One]	The Cricketers is a restaurant that serves Chinese food in the less than £20 it is located in the riverside area near All Bar One it has a low customer rating.
name[The Cricketers], eatType[restaurant], food[Chinese], priceRange[less than £20], customer rating[low], area[riverside], familyFriendly[yes], near[All Bar One]	The Cricketers is a restaurant that serves Chinese food in the less than £20 it is located in the riverside area near All Bar One its customer rating is low.
name[The Cricketers], eatType[restaurant], food[Chinese], priceRange[moderate], customer rating[1 out of 5], area[city centre], familyFriendly[no], near[All Bar One]	The Cricketers is a restaurant that serves Chinese food in the moderate price range it has a customer rating of 1 out of 5 it is located in the city centre near All Bar One.
name[The Cricketers], eatType[restaurant], food[Chinese], priceRange[moderate], customer rating[1 out of 5], area[city centre], familyFriendly[yes], near[All Bar One]	The Cricketers is a restaurant that serves Chinese food in the moderate price range it has a customer rating of 1 out of 5 it is located in the city centre near All Bar One.
name[The Cricketers], eatType[restaurant], food[Chinese], priceRange[moderate], customer rating[1 out of 5], area[riverside], familyFriendly[no], near[All Bar One]	The Cricketers is a restaurant that serves Chinese food in the moderate price range it has a customer rating of 5 it is located in the riverside area near All Bar One.
name[The Cricketers], eatType[restaurant], food[Chinese], priceRange[moderate], customer rating[1 out of 5], area[riverside], familyFriendly[yes], near[All Bar One]	The Cricketers is a restaurant that serves Chinese food in the moderate price range it has a customer rating of 1 out of 5 it is located in the riverside area near All Bar One.
name[The Cricketers], eatType[restaurant], food[Chinese], priceRange[moderate], customer rating[3 out of 5], area[city centre], familyFriendly[no], near[All Bar One]	The Cricketers is a restaurant that serves Chinese food in the moderate price range it is located in the city centre near All Bar One it has a customer rating of 3 out of 5.
name[The Cricketers], eatType[restaurant], food[Chinese], priceRange[moderate], customer rating[3 out of 5], area[city centre], familyFriendly[yes], near[All Bar One]	The Cricketers is a restaurant that serves Chinese food in the moderate price range it has a customer rating of 3 out of 5, is kid friendly and is located in the city centre near All Bar One.
name[The Cricketers], eatType[restaurant], food[Chinese], priceRange[moderate], customer rating[3 out of 5], area[riverside], familyFriendly[no], near[All Bar One]	The Cricketers is a restaurant that serves Chinese food in the moderate price range it is located in the riverside area near All Bar One it has a customer rating of 3 out of 5.
name[The Cricketers], eatType[restaurant], food[Chinese], priceRange[moderate], customer rating[3 out of 5], area[riverside], familyFriendly[yes], near[All Bar One]	The Cricketers is a restaurant that serves Chinese food in the moderate price range it has a customer rating of 3 out of 5, is kid friendly and is located in the riverside area near All Bar One.
name[The Cricketers], eatType[restaurant], food[Chinese], priceRange[more than £30], customer rating[high], area[city centre], familyFriendly[no], near[All Bar One]	The Cricketers is a restaurant that serves Chinese food in the more than £30 it is located in the city centre near All Bar One its customer rating is high.
name[The Cricketers], eatType[restaurant], food[Chinese], priceRange[more than £30], customer rating[high], area[city centre], familyFriendly[yes], near[All Bar One]	The Cricketers is a Chinese restaurant near All Bar One in the city centre it has a high customer rating and a price range of more than £30 it is children friendly.
name[The Cricketers], eatType[restaurant], food[Chinese], priceRange[more than £30], customer rating[high], area[riverside], familyFriendly[no], near[All Bar One]	The Cricketers is a restaurant that serves Chinese food in the more than £30 it has a high customer rating it is located in the riverside area near All Bar One it is not child friendly.
name[The Cricketers], eatType[restaurant], food[Chinese], priceRange[more than £30], customer rating[high], area[riverside], familyFriendly[yes], near[All Bar One]	The Cricketers is a restaurant that serves Chinese food in the more than £30 it has a high customer rating and is kid friendly it is located in the riverside area near All Bar One.
name[The Cricketers], eatType[restaurant], food[English], priceRange[£20-25], customer rating[high], area[city centre], familyFriendly[no], near[All Bar One]	The Cricketers is a restaurant that serves English food in the £20-25 it is located in the city centre near All Bar One it has a high customer rating.
name[The Cricketers], eatType[restaurant], food[English], priceRange[£20-25], customer rating[high], area[city centre], familyFriendly[yes], near[All Bar One]	The Cricketers is a restaurant near All Bar One in the city centre it serves English food, is kid friendly has a high customer rating and a price range of £20-25.
name[The Cricketers], eatType[restaurant], food[English], priceRange[£20-25], customer rating[high], area[riverside], familyFriendly[no], near[All Bar One]	The Cricketers is a restaurant near All Bar One in the riverside area English food, has a high customer rating, is not kid friendly and the price range is £20-25.
name[The Cricketers], eatType[restaurant], food[English], priceRange[£20-25], customer rating[high], area[riverside], familyFriendly[yes], near[All Bar One]	The Cricketers is a restaurant near All Bar One in the riverside area English food, is kid friendly has a high customer rating and a price range of £20-25.
name[The Cricketers], eatType[restaurant], food[English], priceRange[cheap], customer rating[5 out of 5], area[city centre], familyFriendly[no], near[Café Rouge]	The Cricketers is a restaurant that serves English food in the cheap price range it is located in the city centre near Café Rouge it has a customer rating of 5 out of 5.
name[The Cricketers], eatType[restaurant], food[English], priceRange[cheap], customer rating[5 out of 5], area[city centre], familyFriendly[yes], near[Café Rouge]	The Cricketers is a restaurant that serves English food in the cheap price range, has a customer rating of 5 out of 5 and is family friendly it is located in the city centre near Café Rouge.
name[The Cricketers], eatType[restaurant], food[English], priceRange[cheap], customer rating[5 out of 5], area[riverside], familyFriendly[no], near[Café Rouge]	The Cricketers is a restaurant near Café Rouge in the riverside area English food at a cheap price range, has a customer rating of 5 out of 5 and is not family-friendly.
name[The Cricketers], eatType[restaurant], food[English], priceRange[cheap], customer rating[5 out of 5], area[riverside], familyFriendly[yes], near[Café Rouge]	The Cricketers is a restaurant near Café Rouge in the riverside area English food at a cheap price range it is family friendly and has a customer rating of 5 out of 5.
name[The Cricketers], eatType[restaurant], food[English], priceRange[cheap], customer rating[average], area[city centre], familyFriendly[no], near[Café Rouge]	The Cricketers is a restaurant near Café Rouge in the city centre it serves English food in the cheap price range and has an average customer rating it is not family-friendly.
name[The Cricketers], eatType[restaurant], food[English], priceRange[cheap], customer rating[average], area[city centre], familyFriendly[yes], near[Café Rouge]	The Cricketers is a restaurant near Café Rouge in the city centre it serves English food at a cheap price range it is family friendly and has an average customer rating.
name[The Cricketers], eatType[restaurant], food[English], priceRange[cheap], customer rating[average], area[riverside], familyFriendly[no], near[Café Rouge]	The Cricketers is a restaurant near Café Rouge in the riverside area English food in the cheap price range and has an average customer rating it is not family-friendly.
name[The Cricketers], eatType[restaurant], food[English], priceRange[cheap], customer rating[average], area[riverside], familyFriendly[yes], near[Café Rouge]	The Cricketers is a restaurant near Café Rouge in the riverside area English food at a cheap price range it is family friendly and has an average customer rating.
name[The Cricketers], eatType[restaurant], food[English], priceRange[high], customer rating[1 out of 5], area[city centre], familyFriendly[no], near[Café Rouge]	The Cricketers is a restaurant that serves English food in the high price range it is located in the city centre near Café Rouge it has a customer rating of 1 out of 5.
name[The Cricketers], eatType[restaurant], food[English], priceRange[high], customer rating[1 out of 5], area[city centre], familyFriendly[yes], near[Café Rouge]	The Cricketers is a restaurant that serves English food in the high price range it is located in the city centre near Café Rouge it has a customer rating of 1 out of 5.
name[The Cricketers], eatType[restaurant], food[English], priceRange[high], customer rating[1 out of 5], area[riverside], familyFriendly[no], near[Café Rouge]	The Cricketers is a restaurant near Café Rouge in the riverside area it serves English food in the high price range it has a customer rating of 1 out of 5 and is not child friendly.
name[The Cricketers], eatType[restaurant], food[English], priceRange[high], customer rating[1 out of 5], area[riverside], familyFriendly[yes], near[Café Rouge]	The Cricketers is a restaurant near Café Rouge in the riverside area that serves English food in the high price range it has a customer rating of 1 out of 5 and is kid friendly.
name[The Cricketers], eatType[restaurant], food[English], priceRange[high], customer rating[average], area[city centre], familyFriendly[no], near[Café Rouge]	The Cricketers is a restaurant that serves English food in the high price range it is located in the city centre near Café Rouge it has an average customer rating.
name[The Cricketers], eatType[restaurant], food[English], priceRange[high], customer rating[average], area[city centre], familyFriendly[yes], near[Café Rouge]	The Cricketers is a restaurant that serves English food in the high price range it is located in the city centre near Café Rouge it has an average customer rating.
name[The Cricketers], eatType[restaurant], food[English], priceRange[high], customer rating[average], area[riverside], familyFriendly[no], near[Café Rouge]	The Cricketers is a restaurant near Café Rouge in the riverside area English food in the high price range it has an average customer rating it is not family-friendly.
name[The Mill], eatType[pub], food[English], priceRange[high], area[riverside], familyFriendly[yes], near[Raja Indian Cuisine]	The Mill is a pub that serves English food in the high price range it is located in the riverside area near Raja Indian Cuisine.
name[The Mill], eatType[pub], food[English], priceRange[less than £20], area[city centre], familyFriendly[no], near[Raja Indian Cuisine]	The Mill is a pub that serves English food in the city centre near Raja Indian Cuisine.
name[The Mill], eatType[pub], food[English], priceRange[less than £20], area[city centre], familyFriendly[yes], near[Raja Indian Cuisine]	The Mill is a pub that serves English food in the city centre near Raja Indian Cuisine.
name[The Mill], eatType[pub], food[English], priceRange[less than £20], area[riverside], familyFriendly[no], near[Raja Indian Cuisine]	The Mill is a pub that serves English food in the riverside near Raja Indian Cuisine.
name[The Mill], eatType[pub], food[English], priceRange[less than £20], area[riverside], familyFriendly[yes], near[Raja Indian Cuisine]	The Mill is a pub near Raja Indian Cuisine in the riverside area, serves English food for less than £20 and is family friendly.
name[The Mill], eatType[pub], food[English], priceRange[moderate], area[city centre], familyFriendly[no], near[Raja Indian Cuisine]	The Mill is a pub that serves English food in the moderate price range it is located in the city centre near Raja Indian Cuisine.
name[The Mill], eatType[pub], food[English], priceRange[moderate], area[city centre], familyFriendly[yes], near[Raja Indian Cuisine]	The Mill is a pub that serves English food in the moderate price range it is located in the city centre near Raja Indian Cuisine.
name[The Mill], eatType[pub], food[English], priceRange[moderate], area[riverside], familyFriendly[no], near[Raja Indian Cuisine]	The Mill is a pub near Raja Indian Cuisine in the riverside area that serves English food at a moderate price range it is not family-friendly.
name[The Mill], eatType[pub], food[English], priceRange[moderate], area[riverside], familyFriendly[yes], near[Raja Indian Cuisine]	The Mill is a pub near Raja Indian Cuisine in the riverside area that serves English food at a moderate price range it is kid friendly.
name[The Mill], eatType[pub], food[English], priceRange[more than £30], area[riverside], familyFriendly[yes], near[Raja Indian Cuisine]	The Mill is a family friendly pub serving English food in the riverside area near Raja Indian Cuisine and has a price range of more than £30.
name[The Mill], eatType[pub], food[Fast food], priceRange[£20-25], area[riverside], familyFriendly[yes], near[Raja Indian Cuisine]	The Mill is a family friendly pub serving Fast food in the riverside area near Raja Indian Cuisine with a price range of £20-25.
name[The Mill], eatType[pub], food[Fast food], priceRange[£20-25], customer rating[high], area[city centre], familyFriendly[no], near[Café Rouge]	The Mill is a pub that serves Fast food it is located in the city centre near Café Rouge it has a high customer rating, a price range of £20-25 and is not kid friendly.
name[The Mill], eatType[pub], food[Fast food], priceRange[£20-25], customer rating[high], area[city centre], familyFriendly[yes], near[Café Rouge]	The Mill is a pub that serves Fast food in the £20-25 it has a high customer rating, is kid friendly and is located in the city centre near Café Rouge.
name[The Mill], eatType[pub], food[Fast food], priceRange[£20-25], customer rating[high], area[riverside], familyFriendly[no], near[Café Rouge]	The Mill is a pub that serves Fast food in the £20-25 it is located in the riverside area near Café Rouge it has a high customer rating.
name[The Mill], eatType[pub], food[Fast food], priceRange[£20-25], customer rating[high], area[riverside], familyFriendly[yes], near[Café Rouge]	The Mill is a pub that serves Fast food in the £20-25 it has a high customer rating and is kid friendly it is located in the riverside area near Café Rouge.
name[The Mill], eatType[pub], food[Fast food], priceRange[£20-25], customer rating[high], area[riverside], familyFriendly[yes], near[Café Sicilia]	The Mill is a pub that serves Fast food in the £20-25 it has a high customer rating and is kid friendly it is located in the riverside area near Café Sicilia.
name[The Mill], eatType[pub], food[Fast food], priceRange[cheap], area[riverside], familyFriendly[yes], near[Raja Indian Cuisine]	The Mill is a cheap family friendly pub serving Fast food it is located in the riverside area near Raja Indian Cuisine.
name[The Mill], eatType[pub], food[Fast food], priceRange[cheap], customer rating[5 out of 5], area[city centre], familyFriendly[no], near[Café Sicilia]	The Mill is a pub that serves Fast food in the cheap price range it is located in the city centre near Café Sicilia it has a customer rating of 5 out of 5.
name[The Mill], eatType[pub], food[Fast food], priceRange[cheap], customer rating[5 out of 5], area[city centre], familyFriendly[yes], near[Café Sicilia]	The Mill is a cheap Fast food pub in the city centre near Café Sicilia it has a customer rating of 5 out of 5 and is family friendly.
name[The Mill], eatType[pub], food[Fast food], priceRange[cheap], customer rating[5 out of 5], area[riverside], familyFriendly[no], near[Café Sicilia]	The Mill is a pub that serves Fast food in the cheap price range it is located in the riverside area near Café Sicilia it has a customer rating of 5 out of 5.
name[The Mill], eatType[pub], food[Fast food], priceRange[cheap], customer rating[5 out of 5], area[riverside], familyFriendly[yes], near[Café Sicilia]	The Mill is a cheap Fast food pub in the riverside area near Café Sicilia it has a customer rating of 5 out of 5 and is family friendly.
name[The Mill], eatType[pub], food[Fast food], priceRange[cheap], customer rating[average], area[city centre], familyFriendly[no], near[Café Sicilia]	The Mill is a pub that serves Fast food in the cheap price range it is located in the city centre near Café Sicilia it has an average customer rating.
name[The Mill], eatType[pub], food[Fast food], priceRange[cheap], customer rating[average], area[city centre], familyFriendly[yes], near[Café Sicilia]	The Mill is a cheap Fast food pub in the city centre near Café Sicilia it has an average customer rating it is family friendly.
name[The Mill], eatType[pub], food[Fast food], priceRange[cheap], customer rating[average], area[riverside], familyFriendly[no], near[Café Sicilia]	The Mill is a pub that serves Fast food in the cheap price range it is located in the riverside area near Café Sicilia it has an average customer rating.
name[The Mill], eatType[pub], food[Fast food], priceRange[cheap], customer rating[average], area[riverside], familyFriendly[yes], near[Café Sicilia]	The Mill is a cheap Fast food pub in the riverside area near Café Sicilia it has an average customer rating it is family friendly.
name[The Mill], eatType[pub], food[Fast food], priceRange[high], customer rating[1 out of 5], area[city centre], familyFriendly[no], near[Café Sicilia]	The Mill is a pub that serves Fast food in the high price range it is located in the city centre near Café Sicilia it has a customer rating of 1 out of 5.
name[The Mill], eatType[pub], food[Fast food], priceRange[high], customer rating[1 out of 5], area[city centre], familyFriendly[yes], near[Café Sicilia]	The Mill is a pub that serves Fast food in the high price range it is located in the city centre near Café Sicilia it has a customer rating of 1 out of 5.
name[The Mill], eatType[pub], food[Fast food], priceRange[high], customer rating[1 out of 5], area[riverside], familyFriendly[no], near[Café Sicilia]	The Mill is a pub that serves Fast food in the high price range it is located in the riverside area near Café Sicilia it has a customer rating of 1 out of 5.
name[The Mill], eatType[pub], food[Fast food], priceRange[high], customer rating[1 out of 5], area[riverside], familyFriendly[yes], near[Café Sicilia]	The Mill is a pub that serves Fast food at a high price range it has a customer rating of 1 out of 5 and is kid friendly it is located in the riverside area near Café Sicilia.
name[The Mill], eatType[pub], food[Fast food], priceRange[high], customer rating[average], area[city centre], familyFriendly[no], near[Café Sicilia]	The Mill is a pub that serves Fast food in the high price range it is located in the city centre near Café Sicilia it has an average customer rating.
name[The Mill], eatType[pub], food[Fast food], priceRange[high], customer rating[average], area[city centre], familyFriendly[yes], near[Café Sicilia]	The Mill is a family friendly pub serving Fast food in the city centre near Café Sicilia it has an average customer rating and a high price range.
name[The Mill], eatType[pub], food[Fast food], priceRange[high], customer rating[average], area[riverside], familyFriendly[no], near[Café Sicilia]	The Mill is a pub that serves Fast food in the high price range it is located in the riverside area near Café Sicilia it has an average customer rating.
name[The Mill], eatType[pub], food[Fast food], priceRange[high], customer rating[average], area[riverside], familyFriendly[yes], near[Café Sicilia]	The Mill is a pub that serves Fast food at a high price range it has an average customer rating it is located in the riverside area near Café Sicilia.
name[The Mill], eatType[pub], food[Fast food], priceRange[less than £20], customer rating[low], area[city centre], familyFriendly[no], near[Café Sicilia]	The Mill is a pub that serves Fast food in the city centre near Café Sicilia it has a low customer rating.
name[The Mill], eatType[pub], food[Fast food], priceRange[less than £20], customer rating[low], area[city centre], familyFriendly[yes], near[Café Sicilia]	The Mill is a pub that serves Fast food in the city centre near Café Sicilia it has a low customer rating.
name[The Mill], eatType[pub], food[Fast food], priceRange[less than £20], customer rating[low], area[riverside], familyFriendly[no], near[Café Sicilia]	The Mill is a pub that serves Fast food in the riverside near Café Sicilia it has a low customer rating.
name[The Mill], eatType[pub], food[Fast food], priceRange[less than £20], customer rating[low], area[riverside], familyFriendly[yes], near[Café Sicilia]	The Mill is a pub that serves Fast food in the riverside it is near Café Sicilia its customer rating is low.
name[The Mill], eatType[pub], food[Fast food], priceRange[moderate], customer rating[1 out of 5], area[city centre], familyFriendly[no], near[Café Sicilia]	The Mill is a pub that serves Fast food at a moderate price range it has a customer rating of 1 out of 5 it is located in the city centre near Café Sicilia.
name[The Mill], eatType[pub], food[Fast food], priceRange[moderate], customer rating[1 out of 5], area[city centre], familyFriendly[yes], near[Café Sicilia]	The Mill is a pub that serves Fast food at a moderate price range it has a customer rating of 1 out of 5 it is located in the city centre near Café Sicilia.
name[The Mill], eatType[pub], food[Fast food], priceRange[moderate], customer rating[1 out of 5], area[riverside], familyFriendly[no], near[Café Sicilia]	The Mill is a pub that serves Fast food at a moderate price range it has a customer rating of the riverside near Café Sicilia.
name[The Mill], eatType[pub], food[Fast food], priceRange[moderate], customer rating[1 out of 5], area[riverside], familyFriendly[yes], near[Café Sicilia]	The Mill is a pub that serves Fast food at a moderate price range it has a customer rating of the riverside near Café Sicilia.
name[The Mill], eatType[pub], food[Fast food], priceRange[moderate], customer rating[3 out of 5], area[city centre], familyFriendly[no], near[Café Sicilia]	The Mill is a pub that serves Fast food in the moderate price range it is located in the city centre near Café Sicilia it has a customer rating of 3 out of 5.
name[The Mill], eatType[pub], food[Fast food], priceRange[moderate], customer rating[3 out of 5], area[city centre], familyFriendly[yes], near[Café Sicilia]	The Mill is a pub that serves Fast food at a moderate price range it has a customer rating of 3 out of 5, is kid friendly and is located in the city centre near Café Sicilia.
name[The Mill], eatType[pub], food[Fast food], priceRange[moderate], customer rating[3 out of 5], area[riverside], familyFriendly[no], near[Café Sicilia]	The Mill is a pub that serves Fast food in the moderate price range it is located in the riverside area near Café Sicilia it has a customer rating of 3 out of 5.
name[The Mill], eatType[pub], food[Fast food], priceRange[moderate], customer rating[3 out of 5], area[riverside], familyFriendly[yes], near[Café Sicilia]	The Mill is a pub that serves Fast food at a moderate price range it has a customer rating of 3 out of 5, is kid friendly and is located in the riverside area near Café Sicilia.
name[The Mill], eatType[restaurant], food[English], priceRange[high], area[riverside], familyFriendly[yes], near[Raja Indian Cuisine]	The Mill is a restaurant near Raja Indian Cuisine in the riverside area it serves English food in the high price range and is child friendly.
name[The Mill], eatType[restaurant], food[English], priceRange[high], customer rating[average], area[riverside], familyFriendly[yes], near[Café Rouge]	The Mill is a restaurant near Café Rouge in the riverside area and serves English food in the high price range it has an average customer rating it is family friendly.
name[The Mill], eatType[restaurant], food[English], priceRange[less than £20], area[city centre], familyFriendly[no], near[Raja Indian Cuisine]	The Mill is a restaurant that serves English food in the city centre near Raja Indian Cuisine.
name[The Mill], eatType[restaurant], food[English], priceRange[less than £20], area[city centre], familyFriendly[yes], near[Raja Indian Cuisine]	The Mill is a restaurant near Raja Indian Cuisine in the city centre it serves English food for less than £20 it is family friendly.
name[The Mill], eatType[restaurant], food[English], priceRange[less than £20], area[riverside], familyFriendly[no], near[Raja Indian Cuisine]	The Mill is a restaurant near Raja Indian Cuisine in the riverside area it serves English food for less than £20 it is not family-friendly.
name[The Mill], eatType[restaurant], food[English], priceRange[less than £20], area[riverside], familyFriendly[yes], near[Raja Indian Cuisine]	The Mill is a restaurant near Raja Indian Cuisine in the riverside area it serves English food for less than £20 and is family friendly.
name[The Mill], eatType[restaurant], food[English], priceRange[less than £20], customer rating[low], area[city centre], familyFriendly[no], near[Café Rouge]	The Mill is a restaurant that serves English food in the city centre near Café Rouge it has a low customer rating.
name[The Mill], eatType[restaurant], food[English], priceRange[less than £20], customer rating[low], area[city centre], familyFriendly[yes], near[Café Rouge]	The Mill is a restaurant near Café Rouge in the city centre it serves English food in the low and is family friendly.
name[The Mill], eatType[restaurant], food[English], priceRange[less than £20], customer rating[low], area[riverside], familyFriendly[no], near[Café Rouge]	The Mill is a restaurant near Café Rouge in the riverside area, serves English food for less than £20 it has a low customer rating and is not family-friendly.
name[The Mill], eatType[restaurant], food[English], priceRange[less than £20], customer rating[low], area[riverside], familyFriendly[yes], near[Café Rouge]	The Mill is a restaurant near Café Rouge in the riverside area, serves English food for less than £20 it is family friendly and has a low customer rating.
name[The Mill], eatType[restaurant], food[English], priceRange[moderate], area[city centre], familyFriendly[no], near[Raja Indian Cuisine]	The Mill is a restaurant near Raja Indian Cuisine in the city centre it serves English food at a moderate price range it is not family-friendly.
name[The Mill], eatType[restaurant], food[English], priceRange[moderate], area[city centre], familyFriendly[yes], near[Raja Indian Cuisine]	The Mill is a restaurant near Raja Indian Cuisine in the city centre it serves English food in the moderate price range and is kid friendly.
name[The Mill], eatType[restaurant], food[English], priceRange[moderate], area[riverside], familyFriendly[no], near[Raja Indian Cuisine]	The Mill is a restaurant near Raja Indian Cuisine in the riverside area it serves English food at a moderate price range it is not family-friendly.
name[The Mill], eatType[restaurant], food[English], priceRange[moderate], area[riverside], familyFriendly[yes], near[Raja Indian Cuisine]	The Mill is a restaurant near Raja Indian Cuisine in the riverside area it serves English food at a moderate price range and is kid friendly.
name[The Mill], eatType[restaurant], food[English], priceRange[moderate], customer rating[1 out of 5], area[city centre], familyFriendly[no], near[Café Rouge]	The Mill is a restaurant that serves English food in the moderate price range it is located in the city centre near Café Rouge it has a customer rating of 1 out of 5.
name[The Mill], eatType[restaurant], food[English], priceRange[moderate], customer rating[1 out of 5], area[city centre], familyFriendly[yes], near[Café Rouge]	The Mill is a restaurant that serves English food in the moderate price range it has a customer rating of 1 out of 5, is kid friendly and is located in the city centre near Café Rouge.
name[The Mill], eatType[restaurant], food[English], priceRange[moderate], customer rating[1 out of 5], area[riverside], familyFriendly[no], near[Café Rouge]	The Mill is a restaurant near Café Rouge in the riverside area that serves English food in the moderate price range it has a customer rating of 1 out of 5 and is not kid friendly.
name[The Mill], eatType[restaurant], food[English], priceRange[moderate], customer rating[1 out of 5], area[riverside], familyFriendly[yes], near[Café Rouge]	The Mill is a restaurant near Café Rouge in the riverside area English food at a moderate price range it is kid friendly and has a customer rating of 1 out of 5.
name[The Mill], eatType[restaurant], food[English], priceRange[moderate], customer rating[3 out of 5], area[city centre], familyFriendly[no], near[Café Rouge]	The Mill is a restaurant that serves English food in the moderate price range it is located in the city centre near Café Rouge it has a customer rating of 3 out of 5.
name[The Mill], eatType[restaurant], food[English], priceRange[moderate], customer rating[3 out of 5], area[city centre], familyFriendly[yes], near[Café Rouge]	The Mill is a restaurant that serves English food in the moderate price range it is located in the city centre near Café Rouge it has a customer rating of 3 out of 5.
name[The Mill], eatType[restaurant], food[English], priceRange[moderate], customer rating[3 out of 5], area[riverside], familyFriendly[no], near[Café Rouge]	The Mill is a restaurant near Café Rouge in the riverside area that serves English food at a moderate price range and is not kid friendly.
name[The Mill], eatType[restaurant], food[English], priceRange[moderate], customer rating[3 out of 5], area[riverside], familyFriendly[yes], near[Café Rouge]	The Mill is a restaurant near Café Rouge in the riverside area, serves English food at a moderate price range it is kid friendly and has a customer rating of 3 out of 5.
name[The Mill], eatType[restaurant], food[English], priceRange[more than £30], area[riverside], familyFriendly[yes], near[Raja Indian Cuisine]	The Mill is a restaurant near Raja Indian Cuisine in the riverside area serves English food, is child friendly and the price range is more than £30.
name[The Mill], eatType[restaurant], food[English], priceRange[more than £30], customer rating[high], area[city centre], familyFriendly[no], near[Café Rouge]	The Mill is a restaurant that serves English food in the more than £30 it is located in the city centre near Café Rouge it has a high customer rating.
name[The Mill], eatType[restaurant], food[English], priceRange[more than £30], customer rating[high], area[city centre], familyFriendly[yes], near[Café Rouge]	The Mill is a restaurant that serves English food, is kid friendly, has a high customer rating and a price range of more than £30 it is located in the city centre near Café Rouge.
name[The Mill], eatType[restaurant], food[English], priceRange[more than £30], customer rating[high], area[riverside], familyFriendly[no], near[Café Rouge]	The Mill is a restaurant near Café Rouge in the riverside area it serves English food in the high and is not child friendly.
name[The Mill], eatType[restaurant], food[English], priceRange[more than £30], customer rating[high], area[riverside], familyFriendly[yes], near[Café Rouge]	The Mill is a restaurant near Café Rouge in the riverside area English food, is child friendly, has a high customer rating and a price range of more than £30.
name[The Mill], eatType[restaurant], food[Fast food], priceRange[£20-25], area[riverside], familyFriendly[yes], near[Raja Indian Cuisine]	The Mill is a restaurant near Raja Indian Cuisine in the riverside area Fast food it is in the price range and is kid friendly.
name[The Mill], eatType[restaurant], food[Fast food], priceRange[cheap], area[riverside], familyFriendly[yes], near[Raja Indian Cuisine]	The Mill is a cheap family friendly restaurant that serves Fast food it is located in the riverside area near Raja Indian Cuisine.
name[The Phoenix], eatType[pub], food[Fast food], priceRange[cheap], area[riverside], familyFriendly[yes], near[Raja Indian Cuisine]	The Phoenix is a cheap family friendly pub serving Fast food it is located in the riverside area near Raja Indian Cuisine.
name[The Phoenix], eatType[pub], food[Fast food], priceRange[high], area[city centre], familyFriendly[no], near[Raja Indian Cuisine]	The Phoenix is a pub that serves Fast food in the high price range it is located in the city centre near Raja Indian Cuisine.
name[The Phoenix], eatType[pub], food[Fast food], priceRange[high], area[city centre], familyFriendly[yes], near[Raja Indian Cuisine]	The Phoenix is a family friendly pub serving Fast food in the high price range it is located in the city centre near Raja Indian Cuisine.
name[The Phoenix], eatType[pub], food[Fast food], priceRange[high], area[riverside], familyFriendly[no], near[Raja Indian Cuisine]	The Phoenix is a pub that serves Fast food in the high price range it is located in the riverside area near Raja Indian Cuisine.
name[The Phoenix], eatType[pub], food[Fast food], priceRange[high], area[riverside], familyFriendly[yes], near[Raja Indian Cuisine]	The Phoenix is a family friendly pub that serves Fast food in the high price range it is located in the riverside area near Raja Indian Cuisine.
name[The Phoenix], eatType[pub], food[Fast food], priceRange[less than £20], area[city centre], familyFriendly[no], near[Raja Indian Cuisine]	The Phoenix is a pub that serves Fast food in the city centre near Raja Indian Cuisine.
name[The Phoenix], eatType[pub], food[Fast food], priceRange[less than £20], area[city centre], familyFriendly[yes], near[Raja Indian Cuisine]	The Phoenix is a family friendly pub serving Fast food in the city centre near Raja Indian Cuisine.
name[The Phoenix], eatType[pub], food[Fast food], priceRange[less than £20], area[riverside], familyFriendly[no], near[Raja Indian Cuisine]	The Phoenix is a pub that serves Fast food at a price range of less than £20 it is located in the riverside area near Raja Indian Cuisine.
name[The Phoenix], eatType[pub], food[Fast food], priceRange[less than £20], area[riverside], familyFriendly[yes], near[Raja Indian Cuisine]	The Phoenix is a family friendly pub serving Fast food in the riverside area near Raja Indian Cuisine.
name[The Phoenix], eatType[pub], food[Fast food], priceRange[moderate], area[city centre], familyFriendly[no], near[Raja Indian Cuisine]	The Phoenix is a pub that serves Fast food in the moderate price range it is located in the city centre near Raja Indian Cuisine.
name[The Phoenix], eatType[pub], food[Fast food], priceRange[moderate], area[city centre], familyFriendly[yes], near[Raja Indian Cuisine]	The Phoenix is a family friendly pub serving Fast food in the moderate price range it is located in the city centre near Raja Indian Cuisine.
name[The Phoenix], eatType[pub], food[Fast food], priceRange[moderate], area[riverside], familyFriendly[no], near[Raja Indian Cuisine]	The Phoenix is a pub that serves Fast food at a moderate price range it is located in the riverside area near Raja Indian Cuisine.
name[The Phoenix], eatType[pub], food[Fast food], priceRange[moderate], area[riverside], familyFriendly[yes], near[Raja Indian Cuisine]	The Phoenix is a family friendly pub serving Fast food in the moderate price range it is located in the riverside area near Raja Indian Cuisine.
name[The Phoenix], eatType[pub], food[Fast food], priceRange[moderate], customer rating[3 out of 5], area[riverside], familyFriendly[yes], near[Café Sicilia]	The Phoenix is a pub that serves Fast food at a moderate price range it has a customer rating of 3 out of 5, is kid friendly and is located in the riverside area near Café Sicilia.
name[The Phoenix], eatType[pub], food[Fast food], priceRange[more than £30], area[riverside], familyFriendly[yes], near[Raja Indian Cuisine]	The Phoenix is a family friendly pub serving Fast food in the riverside area near Raja Indian Cuisine and has a price range of more than £30.
name[The Phoenix], eatType[pub], food[Fast food], priceRange[more than £30], customer rating[high], area[city centre], familyFriendly[no], near[Café Sicilia]	The Phoenix is a pub that serves Fast food in the city centre near Café Sicilia it has a high customer rating.
name[The Phoenix], eatType[pub], food[Fast food], priceRange[more than £30], customer rating[high], area[city centre], familyFriendly[yes], near[Café Sicilia]	The Phoenix is a family-friendly pub serving Fast food in the city centre near Café Sicilia it has a high customer rating and a price range of more than £30.
name[The Phoenix], eatType[pub], food[Fast food], priceRange[more than £30], customer rating[high], area[riverside], familyFriendly[no], near[Café Sicilia]	The Phoenix is a pub that serves Fast food in the riverside it is near Café Sicilia its customer rating is high.
name[The Phoenix], eatType[pub], food[Fast food], priceRange[more than £30], customer rating[high], area[riverside], familyFriendly[yes], near[Café Sicilia]	The Phoenix is a pub that serves Fast food at a price range of more than £30 it has a high customer rating and is kid friendly it is located in the riverside area near Café Sicilia.
name[The Phoenix], eatType[pub], food[French], priceRange[£20-25], area[riverside], familyFriendly[yes], near[Raja Indian Cuisine]	The Phoenix is a family friendly pub serving French food in the riverside area near Raja Indian Cuisine and is in the £20-25.
name[The Phoenix], eatType[pub], food[French], priceRange[£20-25], customer rating[3 out of 5], area[city centre], familyFriendly[no], near[Café Sicilia]	The Phoenix is a pub that serves French food in the city centre near Café Sicilia it has a customer rating of 3 out of 5 and a price range of £20-25.
name[The Phoenix], eatType[pub], food[French], priceRange[£20-25], customer rating[3 out of 5], area[city centre], familyFriendly[yes], near[Café Sicilia]	The Phoenix is a pub that serves French food in the city centre near Café Sicilia it has a customer rating of 3 out of 5 and is kid friendly.
name[The Phoenix], eatType[pub], food[French], priceRange[£20-25], customer rating[3 out of 5], area[riverside], familyFriendly[no], near[Café Sicilia]	The Phoenix is a pub that serves French food it is located in the riverside area near Café Sicilia it has a customer rating of 3 out of 5 and a price range of £20-25.
name[The Phoenix], eatType[pub], food[French], priceRange[£20-25], customer rating[3 out of 5], area[riverside], familyFriendly[yes], near[Café Sicilia]	The Phoenix is a pub that serves French food in the £20-25 it is located in the riverside area near Café Sicilia it has a customer rating of 3 out of 5.
name[The Phoenix], eatType[pub], food[French], priceRange[£20-25], customer rating[3 out of 5], area[riverside], familyFriendly[yes], near[Crowne Plaza Hotel]	The Phoenix is a pub that serves French food in the £20-25 it is located in the riverside area near Crowne Plaza Hotel it has a customer rating of 3 out of 5.
name[The Phoenix], eatType[pub], food[French], priceRange[£20-25], customer rating[high], area[city centre], familyFriendly[no], near[Crowne Plaza Hotel]	The Phoenix is a pub that serves French food in the city centre near Crowne Plaza Hotel it has a high customer rating, a price range of £20-25 and is not kid friendly.
name[The Phoenix], eatType[pub], food[French], priceRange[£20-25], customer rating[high], area[city centre], familyFriendly[yes], near[Crowne Plaza Hotel]	The Phoenix is a pub that serves French food in the city centre near Crowne Plaza Hotel it has a high customer rating, a price range of £20-25 and is kid friendly.
name[The Phoenix], eatType[pub], food[French], priceRange[£20-25], customer rating[high], area[riverside], familyFriendly[no], near[Crowne Plaza Hotel]	The Phoenix is a pub that serves French food it is located in the riverside area near Crowne Plaza Hotel it has a high customer rating, a price range of £20-25 and is not kid friendly.
name[The Phoenix], eatType[pub], food[French], priceRange[£20-25], customer rating[high], area[riverside], familyFriendly[yes], near[Crowne Plaza Hotel]	The Phoenix is a pub that serves French food it is located in the riverside area near Crowne Plaza Hotel it has a high customer rating, a price range of £20-25 and is kid friendly.
name[The Phoenix], eatType[pub], food[French], priceRange[cheap], area[riverside], familyFriendly[yes], near[Raja Indian Cuisine]	The Phoenix is a cheap family friendly pub serving French food it is located in the riverside area near Raja Indian Cuisine.
name[The Phoenix], eatType[pub], food[French], priceRange[cheap], customer rating[5 out of 5], area[city centre], familyFriendly[no], near[Crowne Plaza Hotel]	The Phoenix is a pub that serves French food in the cheap price range it is located in the city centre near Crowne Plaza Hotel it has a customer rating of 5 out of 5.
name[The Phoenix], eatType[pub], food[French], priceRange[cheap], customer rating[5 out of 5], area[city centre], familyFriendly[yes], near[Crowne Plaza Hotel]	The Phoenix is a family-friendly pub serving French food in the cheap price range it is located in the city centre near Crowne Plaza Hotel it has a customer rating of 5 out of 5.
name[The Phoenix], eatType[pub], food[French], priceRange[cheap], customer rating[5 out of 5], area[riverside], familyFriendly[no], near[Crowne Plaza Hotel]	The Phoenix is a pub that serves French food in the cheap price range it is located in the riverside area near Crowne Plaza Hotel it has a customer rating of 5 out of 5.
name[The Phoenix], eatType[pub], food[French], priceRange[cheap], customer rating[5 out of 5], area[riverside], familyFriendly[yes], near[Crowne Plaza Hotel]	The Phoenix is a cheap family friendly pub serving French food it is located in the riverside area near Crowne Plaza Hotel it has a customer rating of 5 out of 5.
name[The Phoenix], eatType[pub], food[French], priceRange[high], area[riverside], familyFriendly[yes], near[Raja Indian Cuisine]	The Phoenix is a family friendly pub serving French food in the riverside area near Raja Indian Cuisine and is a high price range.
name[The Phoenix], eatType[pub], food[French], priceRange[high], customer rating[3 out of 5], area[city centre], familyFriendly[no], near[Crowne Plaza Hotel]	The Phoenix is a pub that serves French food in the high price range it is located in the city centre near Crowne Plaza Hotel it has a customer rating of 3 out of 5.
name[The Phoenix], eatType[pub], food[French], priceRange[high], customer rating[3 out of 5], area[city centre], familyFriendly[yes], near[Crowne Plaza Hotel]	The Phoenix is a pub that serves French food in the high price range it is located in the city centre near Crowne Plaza Hotel it has a customer rating of 3 out of 5.
name[The Phoenix], eatType[pub], food[French], priceRange[high], customer rating[3 out of 5], area[riverside], familyFriendly[no], near[Crowne Plaza Hotel]	The Phoenix is a pub that serves French food in the high price range it is located in the riverside area near Crowne Plaza Hotel it has a customer rating of 3 out of 5.
name[The Phoenix], eatType[pub], food[French], priceRange[high], customer rating[3 out of 5], area[riverside], familyFriendly[yes], near[Crowne Plaza Hotel]	The Phoenix is a pub that serves French food in the high price range it is located in the riverside area near Crowne Plaza Hotel it has a customer rating of 3 out of 5.
name[The Phoenix], eatType[pub], food[French], priceRange[less than £20], customer rating[average], area[city centre], familyFriendly[no], near[Crowne Plaza Hotel]	The Phoenix is a pub that serves French food in the city centre near Crowne Plaza Hotel it has an average customer rating.
name[The Phoenix], eatType[pub], food[French], priceRange[less than £20], customer rating[average], area[city centre], familyFriendly[yes], near[Crowne Plaza Hotel]	The Phoenix is a pub that serves French food in the city centre near Crowne Plaza Hotel it has an average customer rating.
name[The Phoenix], eatType[pub], food[French], priceRange[less than £20], customer rating[average], area[riverside], familyFriendly[no], near[Crowne Plaza Hotel]	The Phoenix is a pub that serves French food in the riverside near Crowne Plaza Hotel it has an average customer rating.
name[The Phoenix], eatType[pub], food[French], priceRange[less than £20], customer rating[average], area[riverside], familyFriendly[yes], near[Crowne Plaza Hotel]	The Phoenix is a pub that serves French food in the riverside it is near Crowne Plaza Hotel its customer rating is average.
name[The Phoenix], eatType[pub], food[French], priceRange[less than £20], customer rating[low], area[city centre], familyFriendly[no], near[Crowne Plaza Hotel]	The Phoenix is a pub that serves French food in the city centre near Crowne Plaza Hotel it has a low customer rating.
name[The Phoenix], eatType[pub], food[French], priceRange[less than £20], customer rating[low], area[city centre], familyFriendly[yes], near[Crowne Plaza Hotel]	The Phoenix is a pub that serves French food in the city centre near Crowne Plaza Hotel it has a low customer rating.
name[The Phoenix], eatType[pub], food[French], priceRange[less than £20], customer rating[low], area[riverside], familyFriendly[no], near[Crowne Plaza Hotel]	The Phoenix is a pub that serves French food in the riverside near Crowne Plaza Hotel it has a low customer rating.
name[The Phoenix], eatType[pub], food[French], priceRange[less than £20], customer rating[low], area[riverside], familyFriendly[yes], near[Crowne Plaza Hotel]	The Phoenix is a pub that serves French food in the riverside it is near Crowne Plaza Hotel its customer rating is low.
name[The Phoenix], eatType[pub], food[French], priceRange[moderate], customer rating[1 out of 5], area[city centre], familyFriendly[no], near[Crowne Plaza Hotel]	The Phoenix is a pub that serves French food in the moderate price range it is located in the city centre near Crowne Plaza Hotel it has a customer rating of 1 out of 5.
name[The Phoenix], eatType[pub], food[French], priceRange[moderate], customer rating[1 out of 5], area[city centre], familyFriendly[yes], near[Crowne Plaza Hotel]	The Phoenix is a pub that serves French food in the moderate price range it is located in the city centre near Crowne Plaza Hotel it has a customer rating of 1 out of 5.
name[The Phoenix], eatType[pub], food[French], priceRange[moderate], customer rating[1 out of 5], area[riverside], familyFriendly[no], near[Crowne Plaza Hotel]	The Phoenix is a pub that serves French food in the moderate price range it is located in the riverside area near Crowne Plaza Hotel it has a customer rating of 1 out of 5.
name[The Phoenix], eatType[pub], food[French], priceRange[moderate], customer rating[1 out of 5], area[riverside], familyFriendly[yes], near[Crowne Plaza Hotel]	The Phoenix is a pub that serves French food in the moderate price range it is located in the riverside area near Crowne Plaza Hotel it has a customer rating of 1 out of 5.
name[The Phoenix], eatType[pub], food[French], priceRange[more than £30], customer rating[5 out of 5], area[city centre], familyFriendly[no], near[Crowne Plaza Hotel]	The Phoenix is a pub that serves French food in the city centre near Crowne Plaza Hotel it has a customer rating of 5 out of 5.
name[The Phoenix], eatType[pub], food[French], priceRange[more than £30], customer rating[5 out of 5], area[city centre], familyFriendly[yes], near[Crowne Plaza Hotel]	The Phoenix is a family-friendly pub serving French food in the city centre near Crowne Plaza Hotel it has a customer rating of 5 out of 5 and a price range.
name[The Phoenix], eatType[pub], food[French], priceRange[more than £30], customer rating[5 out of 5], area[riverside], familyFriendly[no], near[Crowne Plaza Hotel]	The Phoenix is a pub that serves French food in the riverside near Crowne Plaza Hotel it has a customer rating of 5 out of 5.
name[The Phoenix], eatType[pub], food[French], priceRange[more than £30], customer rating[5 out of 5], area[riverside], familyFriendly[yes], near[Crowne Plaza Hotel]	The Phoenix is a family friendly pub serving French food in the riverside area near Crowne Plaza Hotel it has a customer rating of 5 out of 5 and a price range.
name[The Phoenix], eatType[pub], food[French], priceRange[more than £30], customer rating[low], area[city centre], familyFriendly[no], near[Crowne Plaza Hotel]	The Phoenix is a pub that serves French food in the city centre near Crowne Plaza Hotel it has a low customer rating and a price range of more than £30.
name[The Phoenix], eatType[pub], food[French], priceRange[more than £30], customer rating[low], area[city centre], familyFriendly[yes], near[Crowne Plaza Hotel]	The Phoenix is a family-friendly pub serving French food in the city centre near Crowne Plaza Hotel it has a low customer rating and a price range of more than £30.
name[The Phoenix], eatType[pub], food[French], priceRange[more than £30], customer rating[low], area[riverside], familyFriendly[no], near[Crowne Plaza Hotel]	The Phoenix is a pub that serves French food in the riverside near Crowne Plaza Hotel it has a low customer rating.
name[The Phoenix], eatType[pub], food[French], priceRange[more than £30], customer rating[low], area[riverside], familyFriendly[yes], near[Crowne Plaza Hotel]	The Phoenix is a family friendly pub serving French food in the riverside area near Crowne Plaza Hotel it has a low customer rating and a price range of more than £30.
name[The Phoenix], eatType[restaurant], food[Fast food], priceRange[cheap], area[riverside], familyFriendly[yes], near[Raja Indian Cuisine]	The Phoenix is a cheap family friendly restaurant that serves Fast food it is located in the riverside area near Raja Indian Cuisine.
name[The Phoenix], eatType[restaurant], food[Fast food], priceRange[high], area[city centre], familyFriendly[no], near[Raja Indian Cuisine]	The Phoenix is a restaurant that serves Fast food in the high price range it is located in the city centre near Raja Indian Cuisine.
name[The Phoenix], eatType[restaurant], food[Fast food], priceRange[high], area[city centre], familyFriendly[yes], near[Raja Indian Cuisine]	The Phoenix is a family friendly restaurant that serves Fast food in the high price range it is located in the city centre near Raja Indian Cuisine.
name[The Phoenix], eatType[restaurant], food[Fast food], priceRange[high], area[riverside], familyFriendly[no], near[Raja Indian Cuisine]	The Phoenix is a restaurant near Raja Indian Cuisine in the riverside area it serves Fast food at a high price range it is not child friendly.
name[The Phoenix], eatType[restaurant], food[Fast food], priceRange[high], area[riverside], familyFriendly[yes], near[Raja Indian Cuisine]	The Phoenix is a family friendly restaurant that serves Fast food in the high price range it is located in the riverside area near Raja Indian Cuisine.
name[The Phoenix], eatType[restaurant], food[Fast food], priceRange[less than £20], area[city centre], familyFriendly[no], near[Raja Indian Cuisine]	The Phoenix is a restaurant that serves Fast food in the city centre near Raja Indian Cuisine.
name[The Phoenix], eatType[restaurant], food[Fast food], priceRange[less than £20], area[city centre], familyFriendly[yes], near[Raja Indian Cuisine]	The Phoenix is a restaurant that serves Fast food in the city centre near Raja Indian Cuisine.
name[The Phoenix], eatType[restaurant], food[Fast food], priceRange[less than £20], area[riverside], familyFriendly[no], near[Raja Indian Cuisine]	The Phoenix is a restaurant near Raja Indian Cuisine in the riverside area Fast food it has a price range of less than £20 it is not family-friendly.
name[The Phoenix], eatType[restaurant], food[Fast food], priceRange[less than £20], area[riverside], familyFriendly[yes], near[Raja Indian Cuisine]	The Phoenix is a restaurant near Raja Indian Cuisine in the riverside area Fast food it is less than £20 and is family friendly.
name[The Phoenix], eatType[restaurant], food[Fast food], priceRange[moderate], area[city centre], familyFriendly[no], near[Raja Indian Cuisine]	The Phoenix is a restaurant that serves Fast food in the moderate price range it is located in the city centre near Raja Indian Cuisine.
name[The Phoenix], eatType[restaurant], food[Fast food], priceRange[moderate], area[city centre], familyFriendly[yes], near[Raja Indian Cuisine]	The Phoenix is a family friendly restaurant that serves Fast food in the moderate price range it is located in the city centre near Raja Indian Cuisine.
name[The Phoenix], eatType[restaurant], food[Fast food], priceRange[moderate], area[riverside], familyFriendly[no], near[Raja Indian Cuisine]	The Phoenix is a restaurant near Raja Indian Cuisine in the riverside area Fast food it is moderately priced and is not family-friendly.
name[The Phoenix], eatType[restaurant], food[Fast food], priceRange[moderate], area[riverside], familyFriendly[yes], near[Raja Indian Cuisine]	The Phoenix is a moderately priced restaurant near Raja Indian Cuisine in the riverside area it is family friendly.
name[The Phoenix], eatType[restaurant], food[Fast food], priceRange[more than £30], area[riverside], familyFriendly[yes], near[Raja Indian Cuisine]	The Phoenix is a family friendly restaurant that serves Fast food at a price range of more than £30 it is located in the riverside area near Raja Indian Cuisine.
name[The Phoenix], eatType[restaurant], food[French], priceRange[£20-25], area[riverside], familyFriendly[yes], near[Raja Indian Cuisine]	The Phoenix is a family friendly restaurant that serves French food in the riverside area near Raja Indian Cuisine with a price range of £20-25.
name[The Phoenix], eatType[restaurant], food[French], priceRange[cheap], area[riverside], familyFriendly[yes], near[Raja Indian Cuisine]	The Phoenix is a cheap family friendly restaurant that serves French food it is located in the riverside area near Raja Indian Cuisine.
name[The Phoenix], eatType[restaurant], food[French], priceRange[high], area[riverside], familyFriendly[yes], near[Raja Indian Cuisine]	The Phoenix is a family friendly restaurant that serves French food in the high price range it is located in the riverside area near Raja Indian Cuisine.
name[The Phoenix], eatType[restaurant], food[Indian], priceRange[£20-25], customer rating[high], area[city centre], familyFriendly[no], near[Crowne Plaza Hotel]	The Phoenix is a restaurant that serves Indian food in the £20-25 it is located in the city centre near Crowne Plaza Hotel its customer rating is high.
name[The Phoenix], eatType[restaurant], food[Indian], priceRange[£20-25], customer rating[high], area[city centre], familyFriendly[yes], near[Crowne Plaza Hotel]	The Phoenix is a restaurant that serves Indian food in the £20-25 it is located in the city centre near Crowne Plaza Hotel its customer rating is high.
name[The Phoenix], eatType[restaurant], food[Indian], priceRange[£20-25], customer rating[high], area[riverside], familyFriendly[no], near[Crowne Plaza Hotel]	The Phoenix is a restaurant that serves Indian food in the £20-25 it is located in the riverside area near Crowne Plaza Hotel its customer rating is high.
name[The Phoenix], eatType[restaurant], food[Indian], priceRange[£20-25], customer rating[high], area[riverside], familyFriendly[yes], near[Crowne Plaza Hotel]	The Phoenix is a restaurant that serves Indian food in the £20-25 it has a high customer rating and is kid friendly it is located in the riverside area near Crowne Plaza Hotel.
name[The Phoenix], eatType[restaurant], food[Indian], priceRange[cheap], customer rating[5 out of 5], area[city centre], familyFriendly[no], near[Crowne Plaza Hotel]	The Phoenix is a restaurant that serves Indian food in the cheap price range it is located in the city centre near Crowne Plaza Hotel it has a customer rating of 5 out of 5.
name[The Phoenix], eatType[restaurant], food[Indian], priceRange[cheap], customer rating[5 out of 5], area[city centre], familyFriendly[yes], near[Crowne Plaza Hotel]	The Phoenix is a restaurant that serves Indian food in the cheap price range it is located in the city centre near Crowne Plaza Hotel its customer rating is 5 out of 5.
name[The Phoenix], eatType[restaurant], food[Indian], priceRange[cheap], customer rating[5 out of 5], area[riverside], familyFriendly[no], near[Crowne Plaza Hotel]	The Phoenix is a restaurant that serves Indian food in the cheap price range it is located in the riverside area near Crowne Plaza Hotel its customer rating is 5 out of 5.
name[The Phoenix], eatType[restaurant], food[Indian], priceRange[cheap], customer rating[5 out of 5], area[riverside], familyFriendly[no], near[Express by Holiday Inn]	The Phoenix is a restaurant that serves Indian food in the cheap price range it is located in the riverside area near Express by Holiday Inn its customer rating is 5 out of 5.
name[The Phoenix], eatType[restaurant], food[Indian], priceRange[cheap], customer rating[5 out of 5], area[riverside], familyFriendly[yes], near[Express by Holiday Inn]	The Phoenix is a restaurant that serves Indian food in the cheap price range and has a customer rating of 5 it is located in the riverside area near Express by Holiday Inn it is family friendly.
name[The Phoenix], eatType[restaurant], food[Indian], priceRange[cheap], customer rating[average], area[city centre], familyFriendly[no], near[Express by Holiday Inn]	The Phoenix is a restaurant that serves Indian food in the cheap price range it is located in the city centre near Express by Holiday Inn its customer rating is average.
name[The Plough], eatType[pub], food[Chinese], priceRange[£20-25], area[riverside], familyFriendly[yes], near[Raja Indian Cuisine]	The Plough is a pub that serves Chinese food in the £20-25 it is located in the riverside area near Raja Indian Cuisine.
name[The Plough], eatType[pub], food[Chinese], priceRange[cheap], area[riverside], familyFriendly[yes], near[Raja Indian Cuisine]	The Plough is a pub that serves Chinese food in the cheap price range it is located in the riverside area near Raja Indian Cuisine.
name[The Plough], eatType[pub], food[Chinese], priceRange[high], area[city centre], familyFriendly[no], near[Raja Indian Cuisine]	The Plough is a pub that serves Chinese food in the high price range it is located in the city centre near Raja Indian Cuisine.
name[The Plough], eatType[pub], food[Chinese], priceRange[high], area[city centre], familyFriendly[yes], near[Raja Indian Cuisine]	The Plough is a Chinese pub in the city centre near Raja Indian Cuisine it is high and is family friendly.
name[The Plough], eatType[pub], food[Chinese], priceRange[high], area[riverside], familyFriendly[no], near[Raja Indian Cuisine]	The Plough is a pub that serves Chinese food in the high price range it is located in the riverside area near Raja Indian Cuisine.
name[The Plough], eatType[pub], food[Chinese], priceRange[high], area[riverside], familyFriendly[yes], near[Raja Indian Cuisine]	The Plough is a pub that serves Chinese food in the high price range it is located in the riverside area near Raja Indian Cuisine.
name[The Plough], eatType[pub], food[Chinese], priceRange[less than £20], area[city centre], familyFriendly[no], near[Raja Indian Cuisine]	The Plough is a pub that serves Chinese food in the less than £20 it is located in the city centre near Raja Indian Cuisine.
name[The Plough], eatType[restaurant], food[Chinese], priceRange[£20-25], area[riverside], familyFriendly[yes], near[Raja Indian Cuisine]	The Plough is a restaurant that serves Chinese food in the £20-25 it is located in the riverside area near Raja Indian Cuisine.
name[The Plough], eatType[restaurant], food[Chinese], priceRange[cheap], area[riverside], familyFriendly[yes], near[Raja Indian Cuisine]	The Plough is a restaurant that serves Chinese food in the cheap price range it is located in the riverside area near Raja Indian Cuisine.
name[The Plough], eatType[restaurant], food[Chinese], priceRange[high], area[city centre], familyFriendly[no], near[Raja Indian Cuisine]	The Plough is a restaurant that serves Chinese food in the high price range it is located in the city centre near Raja Indian Cuisine.
name[The Plough], eatType[restaurant], food[Chinese], priceRange[high], area[city centre], familyFriendly[yes], near[Raja Indian Cuisine]	The Plough is a Chinese restaurant with a high price range it is located in the city centre near Raja Indian Cuisine it is family friendly.
name[The Plough], eatType[restaurant], food[Chinese], priceRange[high], area[riverside], familyFriendly[no], near[Raja Indian Cuisine]	The Plough is a restaurant that serves Chinese food in the high price range it is located in the riverside area near Raja Indian Cuisine.
name[The Plough], eatType[restaurant], food[Chinese], priceRange[high], area[riverside], familyFriendly[yes], near[Raja Indian Cuisine]	The Plough is a restaurant that serves Chinese food in the high price range it is located in the riverside area near Raja Indian Cuisine.
name[The Plough], eatType[restaurant], food[Chinese], priceRange[less than £20], area[city centre], familyFriendly[no], near[Raja Indian Cuisine]	The Plough is a restaurant that serves Chinese food in the less than £20 it is located in the city centre near Raja Indian Cuisine.
name[The Punter], eatType[pub], food[Chinese], priceRange[less than £20], area[city centre], familyFriendly[yes], near[Raja Indian Cuisine]	The Punter is a pub that serves Chinese food in the less than £20 it is located in the city centre near Raja Indian Cuisine.
name[The Punter], eatType[pub], food[Chinese], priceRange[less than £20], area[riverside], familyFriendly[no], near[Raja Indian Cuisine]	The Punter is a pub that serves Chinese food in the less than £20 it is located in the riverside area near Raja Indian Cuisine.
name[The Punter], eatType[pub], food[Chinese], priceRange[less than £20], area[riverside], familyFriendly[yes], near[Raja Indian Cuisine]	The Punter is a pub that serves Chinese food in the less than £20 it is located in the riverside area near Raja Indian Cuisine.
name[The Punter], eatType[pub], food[Chinese], priceRange[moderate], area[city centre], familyFriendly[no], near[Raja Indian Cuisine]	The Punter is a pub that serves Chinese food in the moderate price range it is located in the city centre near Raja Indian Cuisine.
name[The Punter], eatType[pub], food[Chinese], priceRange[moderate], area[city centre], familyFriendly[yes], near[Raja Indian Cuisine]	The Punter is a pub that serves Chinese food in the moderate price range it is located in the city centre near Raja Indian Cuisine.
name[The Punter], eatType[pub], food[Chinese], priceRange[moderate], area[riverside], familyFriendly[no], near[Raja Indian Cuisine]	The Punter is a pub that serves Chinese food in the moderate price range it is located in the riverside area near Raja Indian Cuisine.
name[The Punter], eatType[pub], food[Chinese], priceRange[moderate], area[riverside], familyFriendly[yes], near[Raja Indian Cuisine]	The Punter is a pub that serves Chinese food in the moderate price range it is located in the riverside area near Raja Indian Cuisine.
name[The Punter], eatType[pub], food[Chinese], priceRange[more than £30], area[riverside], familyFriendly[yes], near[Raja Indian Cuisine]	The Punter is a pub that serves Chinese food in the more than £30 it is located in the riverside area near Raja Indian Cuisine.
name[The Punter], eatType[pub], food[English], priceRange[£20-25], area[riverside], familyFriendly[yes], near[Raja Indian Cuisine]	The Punter is a pub that serves English food in the £20-25 it is located in the riverside area near Raja Indian Cuisine.
name[The Punter], eatType[pub], food[English], priceRange[cheap], area[riverside], familyFriendly[yes], near[Raja Indian Cuisine]	The Punter is a cheap family friendly pub located in the riverside area near Raja Indian Cuisine it serves English food.
name[The Punter], eatType[pub], food[English], priceRange[high], area[city centre], familyFriendly[no], near[Raja Indian Cuisine]	The Punter is a pub that serves English food in the high price range it is located in the city centre near Raja Indian Cuisine.
name[The Punter], eatType[pub], food[English], priceRange[high], area[city centre], familyFriendly[yes], near[Raja Indian Cuisine]	The Punter is a family friendly pub serving English food in the city centre near Raja Indian Cuisine it is in the high price range.
name[The Punter], eatType[pub], food[English], priceRange[high], area[riverside], familyFriendly[no], near[Raja Indian Cuisine]	The Punter is a pub that serves English food in the high price range it is located in the riverside area near Raja Indian Cuisine.
name[The Punter], eatType[pub], food[English], priceRange[high], area[riverside], familyFriendly[yes], near[Raja Indian Cuisine]	The Punter is a pub that serves English food in the high price range it is located in the riverside area near Raja Indian Cuisine.
name[The Punter], eatType[pub], food[Italian], priceRange[high], customer rating[average], area[city centre], familyFriendly[no], near[Rainbow Vegetarian Café]	The Punter is a pub that serves Italian food in the high price range it is located in the city centre near Rainbow Vegetarian Café it has an average customer rating.
name[The Punter], eatType[restaurant], food[Chinese], priceRange[less than £20], area[city centre], familyFriendly[yes], near[Raja Indian Cuisine]	The Punter is a restaurant that serves Chinese food in the less than £20 it is located in the city centre near Raja Indian Cuisine.
name[The Punter], eatType[restaurant], food[Chinese], priceRange[less than £20], area[riverside], familyFriendly[no], near[Raja Indian Cuisine]	The Punter is a restaurant that serves Chinese food in the less than £20 it is located in the riverside area near Raja Indian Cuisine.
name[The Punter], eatType[restaurant], food[Chinese], priceRange[less than £20], area[riverside], familyFriendly[yes], near[Raja Indian Cuisine]	The Punter is a restaurant that serves Chinese food in the less than £20 it is located in the riverside area near Raja Indian Cuisine.
name[The Punter], eatType[restaurant], food[Chinese], priceRange[moderate], area[city centre], familyFriendly[no], near[Raja Indian Cuisine]	The Punter is a restaurant that serves Chinese food in the moderate price range it is located in the city centre near Raja Indian Cuisine.
name[The Punter], eatType[restaurant], food[Chinese], priceRange[moderate], area[city centre], familyFriendly[yes], near[Raja Indian Cuisine]	The Punter is a restaurant that serves Chinese food in the moderate price range it is located in the city centre near Raja Indian Cuisine.
name[The Punter], eatType[restaurant], food[Chinese], priceRange[moderate], area[riverside], familyFriendly[no], near[Raja Indian Cuisine]	The Punter is a restaurant that serves Chinese food in the moderate price range it is located in the riverside area near Raja Indian Cuisine.
name[The Punter], eatType[restaurant], food[Chinese], priceRange[moderate], area[riverside], familyFriendly[yes], near[Raja Indian Cuisine]	The Punter is a restaurant that serves Chinese food in the moderate price range it is located in the riverside area near Raja Indian Cuisine.
name[The Punter], eatType[restaurant], food[Chinese], priceRange[more than £30], area[riverside], familyFriendly[yes], near[Raja Indian Cuisine]	The Punter is a restaurant that serves Chinese food in the more than £30 it is located in the riverside area near Raja Indian Cuisine.
name[The Punter], eatType[restaurant], food[English], priceRange[£20-25], area[riverside], familyFriendly[yes], near[Raja Indian Cuisine]	The Punter is a restaurant near Raja Indian Cuisine in the riverside area English food, is kid friendly and the price range is £20-25.
name[The Punter], eatType[restaurant], food[English], priceRange[cheap], area[riverside], familyFriendly[yes], near[Raja Indian Cuisine]	The Punter is a cheap family friendly restaurant serving English food in the riverside area near Raja Indian Cuisine.
name[The Punter], eatType[restaurant], food[English], priceRange[high], area[city centre], familyFriendly[no], near[Raja Indian Cuisine]	The Punter is a restaurant that serves English food in the high price range it is located in the city centre near Raja Indian Cuisine.
name[The Punter], eatType[restaurant], food[English], priceRange[high], area[city centre], familyFriendly[yes], near[Raja Indian Cuisine]	The Punter is a restaurant that serves English food in the high price range it is located in the city centre near Raja Indian Cuisine it is family friendly.
name[The Punter], eatType[restaurant], food[English], priceRange[high], area[riverside], familyFriendly[no], near[Raja Indian Cuisine]	The Punter is a restaurant near Raja Indian Cuisine in the riverside area it serves English food in the high price range it is not child friendly.
name[The Punter], eatType[restaurant], food[English], priceRange[high], area[riverside], familyFriendly[yes], near[Raja Indian Cuisine]	The Punter is a restaurant near Raja Indian Cuisine in the riverside area it serves English food in the high price range and is child friendly.
name[The Punter], eatType[restaurant], food[Indian], priceRange[cheap], customer rating[average], area[city centre], familyFriendly[yes], near[Express by Holiday Inn]	The Punter is a restaurant that serves Indian food in the cheap price range it is located in the city centre near Express by Holiday Inn its customer rating is average.
name[The Punter], eatType[restaurant], food[Indian], priceRange[cheap], customer rating[average], area[riverside], familyFriendly[no], near[Express by Holiday Inn]	The Punter is a restaurant that serves Indian food in the cheap price range it is located in the riverside it is near Express by Holiday Inn its customer rating is average.
name[The Punter], eatType[restaurant], food[Indian], priceRange[cheap], customer rating[average], area[riverside], familyFriendly[yes], near[Express by Holiday Inn]	The Punter is a restaurant that serves Indian food in the cheap price range and has an average customer rating it is located in the riverside area near Express by Holiday Inn it is family friendly.
name[The Punter], eatType[restaurant], food[Indian], priceRange[high], customer rating[1 out of 5], area[city centre], familyFriendly[no], near[Express by Holiday Inn]	The Punter is a restaurant that serves Indian food in the high price range it is located in the city centre near Express by Holiday Inn it has a customer rating of 1 out of 5.
name[The Punter], eatType[restaurant], food[Indian], priceRange[high], customer rating[1 out of 5], area[city centre], familyFriendly[yes], near[Express by Holiday Inn]	The Punter is a restaurant that serves Indian food in the high price range it is located in the city centre near Express by Holiday Inn its customer rating is 1 out of 5.
name[The Punter], eatType[restaurant], food[Indian], priceRange[high], customer rating[1 out of 5], area[riverside], familyFriendly[no], near[Express by Holiday Inn]	The Punter is a restaurant that serves Indian food in the high price range it is located in the riverside area near Express by Holiday Inn it has a customer rating of 1 out of 5.
name[The Punter], eatType[restaurant], food[Indian], priceRange[high], customer rating[1 out of 5], area[riverside], familyFriendly[yes], near[Express by Holiday Inn]	The Punter is a restaurant that serves Indian food in the high price range it is located in the riverside area near Express by Holiday Inn its customer rating is 1 out of 5.
name[The Punter], eatType[restaurant], food[Indian], priceRange[high], customer rating[average], area[city centre], familyFriendly[no], near[Express by Holiday Inn]	The Punter is a restaurant that serves Indian food in the high price range it is located in the city centre near Express by Holiday Inn it has an average customer rating.
name[The Punter], eatType[restaurant], food[Indian], priceRange[high], customer rating[average], area[city centre], familyFriendly[yes], near[Express by Holiday Inn]	The Punter is a restaurant that serves Indian food in the high price range it is located in the city centre near Express by Holiday Inn its customer rating is average.
name[The Punter], eatType[restaurant], food[Indian], priceRange[high], customer rating[average], area[riverside], familyFriendly[no], near[Express by Holiday Inn]	The Punter is a restaurant that serves Indian food in the high price range it is located in the riverside area near Express by Holiday Inn it has an average customer rating.
name[The Punter], eatType[restaurant], food[Indian], priceRange[high], customer rating[average], area[riverside], familyFriendly[yes], near[Express by Holiday Inn]	The Punter is a restaurant that serves Indian food in the high price range it is located in the riverside area near Express by Holiday Inn its customer rating is average.
name[The Punter], eatType[restaurant], food[Indian], priceRange[less than £20], customer rating[low], area[city centre], familyFriendly[no], near[Express by Holiday Inn]	The Punter is a restaurant that serves Indian food in the less than £20 it is located in the city centre near Express by Holiday Inn it has a low customer rating.
name[The Punter], eatType[restaurant], food[Indian], priceRange[less than £20], customer rating[low], area[city centre], familyFriendly[yes], near[Express by Holiday Inn]	The Punter is a restaurant that serves Indian food in the less than £20 it is located in the city centre near Express by Holiday Inn it has a low customer rating.
name[The Punter], eatType[restaurant], food[Indian], priceRange[less than £20], customer rating[low], area[riverside], familyFriendly[no], near[Express by Holiday Inn]	The Punter is a restaurant that serves Indian food in the less than £20 it is located in the riverside area near Express by Holiday Inn it has a low customer rating.
name[The Punter], eatType[restaurant], food[Indian], priceRange[less than £20], customer rating[low], area[riverside], familyFriendly[yes], near[Express by Holiday Inn]	The Punter is a restaurant that serves Indian food in the less than £20 it is located in the riverside area near Express by Holiday Inn its customer rating is low.
name[The Punter], eatType[restaurant], food[Indian], priceRange[moderate], customer rating[1 out of 5], area[city centre], familyFriendly[no], near[Express by Holiday Inn]	The Punter is a restaurant that serves Indian food in the moderate price range it is located in the city centre near Express by Holiday Inn it has a customer rating of 1 out of 5.
name[The Punter], eatType[restaurant], food[Indian], priceRange[moderate], customer rating[1 out of 5], area[city centre], familyFriendly[yes], near[Express by Holiday Inn]	The Punter is a restaurant that serves Indian food at a moderate price range it has a customer rating of 1 out of 5 it is located in the city centre near Express by Holiday Inn.
name[The Punter], eatType[restaurant], food[Indian], priceRange[moderate], customer rating[1 out of 5], area[riverside], familyFriendly[no], near[Express by Holiday Inn]	The Punter is a restaurant that serves Indian food in the moderate price range it is located in the riverside area near Express by Holiday Inn it has a customer rating of 1 out of 5.
name[The Punter], eatType[restaurant], food[Indian], priceRange[moderate], customer rating[1 out of 5], area[riverside], familyFriendly[yes], near[Express by Holiday Inn]	The Punter is a restaurant that serves Indian food at a moderate price range it has a customer rating of the riverside near Express by Holiday Inn.
name[The Punter], eatType[restaurant], food[Indian], priceRange[moderate], customer rating[3 out of 5], area[city centre], familyFriendly[no], near[Express by Holiday Inn]	The Punter is a restaurant that serves Indian food in the moderate price range it is located in the city centre near Express by Holiday Inn it has a customer rating of 3 out of 5.
name[The Punter], eatType[restaurant], food[Indian], priceRange[moderate], customer rating[3 out of 5], area[city centre], familyFriendly[yes], near[Express by Holiday Inn]	The Punter is a restaurant that serves Indian food in the moderate price range it is located in the city centre near Express by Holiday Inn it has a customer rating of 3 out of 5.
name[The Punter], eatType[restaurant], food[Indian], priceRange[moderate], customer rating[3 out of 5], area[riverside], familyFriendly[no], near[Express by Holiday Inn]	The Punter is a restaurant that serves Indian food in the moderate price range it is located in the riverside area near Express by Holiday Inn it has a customer rating of 3 out of 5.
name[The Punter], eatType[restaurant], food[Indian], priceRange[moderate], customer rating[3 out of 5], area[riverside], familyFriendly[yes], near[Express by Holiday Inn]	The Punter is a restaurant that serves Indian food in the moderate price range it is located in the riverside area near Express by Holiday Inn it has a customer rating of 3 out of 5.
name[The Punter], eatType[restaurant], food[Indian], priceRange[more than £30], customer rating[high], area[city centre], familyFriendly[no], near[Express by Holiday Inn]	The Punter is a restaurant that serves Indian food in the more than £30 it is located in the city centre near Express by Holiday Inn its customer rating is high.
name[The Punter], eatType[restaurant], food[Indian], priceRange[more than £30], customer rating[high], area[city centre], familyFriendly[yes], near[Express by Holiday Inn]	The Punter is a restaurant that serves Indian food in the more than £30 it has a high customer rating and is kid friendly it is located in the city centre near Express by Holiday Inn.
name[The Punter], eatType[restaurant], food[Indian], priceRange[more than £30], customer rating[high], area[riverside], familyFriendly[no], near[Express by Holiday Inn]	The Punter is a restaurant that serves Indian food in the more than £30 it has a high customer rating it is located in the riverside area near Express by Holiday Inn it is not child friendly.
name[The Punter], eatType[restaurant], food[Indian], priceRange[more than £30], customer rating[high], area[riverside], familyFriendly[yes], near[Express by Holiday Inn]	The Punter is a restaurant that serves Indian food in the more than £30 it has a high customer rating and is kid friendly it is located in the riverside area near Express by Holiday Inn.
name[The Punter], eatType[restaurant], food[Italian], priceRange[£20-25], customer rating[high], area[city centre], familyFriendly[no], near[Express by Holiday Inn]	The Punter is a restaurant that serves Italian food in the city centre near Express by Holiday Inn it has a high customer rating, a price range of £20-25 and is not kid friendly.
name[The Punter], eatType[restaurant], food[Italian], priceRange[£20-25], customer rating[high], area[city centre], familyFriendly[yes], near[Express by Holiday Inn]	The Punter is an Italian restaurant near Express by Holiday Inn in the city centre it has a high customer rating, a price range of £20-25 and is kid friendly.
name[The Punter], eatType[restaurant], food[Italian], priceRange[£20-25], customer rating[high], area[riverside], familyFriendly[no], near[Express by Holiday Inn]	The Punter is a restaurant near Express by Holiday Inn in the riverside area it food with a price range of £20-25 it has a high customer rating and is not kid friendly.
name[The Punter], eatType[restaurant], food[Italian], priceRange[£20-25], customer rating[high], area[riverside], familyFriendly[yes], near[Express by Holiday Inn]	The Punter is a restaurant near Express by Holiday Inn in the riverside area it is kid friendly, has a high customer rating and a price range of £20-25.
name[The Punter], eatType[restaurant], food[Italian], priceRange[cheap], customer rating[5 out of 5], area[city centre], familyFriendly[no], near[Express by Holiday Inn]	The Punter is a restaurant that serves Italian food in the cheap price range it is located in the city centre near Express by Holiday Inn it has a customer rating of 5 out of 5.
name[The Punter], eatType[restaurant], food[Italian], priceRange[cheap], customer rating[5 out of 5], area[city centre], familyFriendly[no], near[Rainbow Vegetarian Café]	The Punter is a restaurant that serves Italian food in the cheap price range it is located in the city centre near Rainbow Vegetarian Café it has a customer rating of 5 out of 5.
name[The Punter], eatType[restaurant], food[Italian], priceRange[cheap], customer rating[5 out of 5], area[city centre], familyFriendly[yes], near[Rainbow Vegetarian Café]	The Punter is an Italian restaurant with a cheap price range it is family friendly and is located in the city centre near Rainbow Vegetarian Café it has a customer rating of 5 out of 5.
name[The Punter], eatType[restaurant], food[Italian], priceRange[cheap], customer rating[5 out of 5], area[riverside], familyFriendly[no], near[Rainbow Vegetarian Café]	The Punter is a restaurant that serves Italian food in the cheap price range it is located in the riverside area near Rainbow Vegetarian Café it has a customer rating of 5 out of 5.
name[The Punter], eatType[restaurant], food[Italian], priceRange[cheap], customer rating[5 out of 5], area[riverside], familyFriendly[yes], near[Rainbow Vegetarian Café]	The Punter is a cheap Italian restaurant in the riverside area near Rainbow Vegetarian Café it has a customer rating of 5 out of 5 and is family friendly.
name[The Punter], eatType[restaurant], food[Italian], priceRange[cheap], customer rating[average], area[city centre], familyFriendly[no], near[Rainbow Vegetarian Café]	The Punter is a restaurant that serves Italian food in the cheap price range it is located in the city centre near Rainbow Vegetarian Café it has an average customer rating.
name[The Punter], eatType[restaurant], food[Italian], priceRange[cheap], customer rating[average], area[city centre], familyFriendly[yes], near[Rainbow Vegetarian Café]	The Punter is an Italian restaurant near Rainbow Vegetarian Café in the city centre it has an average customer rating and cheap family friendly.
name[The Punter], eatType[restaurant], food[Italian], priceRange[cheap], customer rating[average], area[riverside], familyFriendly[no], near[Rainbow Vegetarian Café]	The Punter is a restaurant near Rainbow Vegetarian Café in the riverside area it is cheap and has an average customer rating it is not family-friendly.
name[The Punter], eatType[restaurant], food[Italian], priceRange[cheap], customer rating[average], area[riverside], familyFriendly[yes], near[Rainbow Vegetarian Café]	The Punter is a cheap Italian restaurant in the riverside area near Rainbow Vegetarian Café it has an average customer rating it is family friendly.
name[The Punter], eatType[restaurant], food[Italian], priceRange[high], customer rating[1 out of 5], area[city centre], familyFriendly[no], near[Rainbow Vegetarian Café]	The Punter is a restaurant that serves Italian food in the high price range it is located in the city centre near Rainbow Vegetarian Café it has a customer rating of 1 out of 5.
name[The Punter], eatType[restaurant], food[Italian], priceRange[high], customer rating[1 out of 5], area[city centre], familyFriendly[yes], near[Rainbow Vegetarian Café]	The Punter is an Italian restaurant near Rainbow Vegetarian Café in the city centre it has a high price range and a customer rating of 1 out of 5.
name[The Punter], eatType[restaurant], food[Italian], priceRange[high], customer rating[1 out of 5], area[riverside], familyFriendly[no], near[Rainbow Vegetarian Café]	The Punter is a restaurant that serves Italian food in the high price range it is located in the riverside area near Rainbow Vegetarian Café it has a customer rating of 1 out of 5.
name[The Punter], eatType[restaurant], food[Italian], priceRange[high], customer rating[1 out of 5], area[riverside], familyFriendly[yes], near[Rainbow Vegetarian Café]	The Punter is a restaurant that serves Italian food in the high price range it is located in the riverside area near Rainbow Vegetarian Café it has a customer rating of 1 out of 5.
name[The Vaults], eatType[pub], food[French], priceRange[high], area[riverside], familyFriendly[yes], near[Raja Indian Cuisine]	The Vaults is a family friendly pub serving French food in the riverside area near Raja Indian Cuisine and is a high price range.
name[The Vaults], eatType[pub], food[French], priceRange[less than £20], area[city centre], familyFriendly[no], near[Raja Indian Cuisine]	The Vaults is a pub that serves French food in the city centre near Raja Indian Cuisine.
name[The Vaults], eatType[pub], food[French], priceRange[less than £20], area[city centre], familyFriendly[yes], near[Raja Indian Cuisine]	The Vaults is a family-friendly pub serving French food in the city centre near Raja Indian Cuisine it is less than £20.
name[The Vaults], eatType[pub], food[French], priceRange[less than £20], area[riverside], familyFriendly[no], near[Raja Indian Cuisine]	The Vaults is a pub that serves French food in the riverside area near Raja Indian Cuisine.
name[The Vaults], eatType[pub], food[French], priceRange[less than £20], area[riverside], familyFriendly[yes], near[Raja Indian Cuisine]	The Vaults is a family friendly pub serving French food in the riverside area near Raja Indian Cuisine and has a price range of less than £20.
name[The Vaults], eatType[pub], food[French], priceRange[moderate], area[city centre], familyFriendly[no], near[Raja Indian Cuisine]	The Vaults is a pub that serves French food in the moderate price range it is located in the city centre near Raja Indian Cuisine.
name[The Vaults], eatType[pub], food[French], priceRange[moderate], area[city centre], familyFriendly[yes], near[Raja Indian Cuisine]	The Vaults is a family friendly pub serving French food in the city centre near Raja Indian Cuisine it is moderately priced.
name[The Vaults], eatType[pub], food[French], priceRange[moderate], area[riverside], familyFriendly[no], near[Raja Indian Cuisine]	The Vaults is a pub that serves French food in the moderate price range it is located in the riverside area near Raja Indian Cuisine.
name[The Vaults], eatType[pub], food[French], priceRange[moderate], area[riverside], familyFriendly[yes], near[Raja Indian Cuisine]	The Vaults is a family friendly pub serving French food at a moderate price range it is located in the riverside area near Raja Indian Cuisine.
name[The Vaults], eatType[pub], food[French], priceRange[more than £30], area[city centre], familyFriendly[no], near[Raja Indian Cuisine]	The Vaults is a pub that serves French food in the city centre near Raja Indian Cuisine.
name[The Vaults], eatType[pub], food[French], priceRange[more than £30], area[city centre], familyFriendly[yes], near[Raja Indian Cuisine]	The Vaults is a family-friendly pub serving French food in the city centre near Raja Indian Cuisine with a price range of more than £30.
name[The Vaults], eatType[pub], food[French], priceRange[more than £30], area[riverside], familyFriendly[no], near[Raja Indian Cuisine]	The Vaults is a pub that serves French food in the riverside area near Raja Indian Cuisine.
name[The Vaults], eatType[pub], food[French], priceRange[more than £30], area[riverside], familyFriendly[yes], near[Raja Indian Cuisine]	The Vaults is a family friendly pub serving French food in the riverside area near Raja Indian Cuisine and has a price range of more than £30.
name[The Vaults], eatType[pub], food[Indian], priceRange[£20-25], area[riverside], familyFriendly[yes], near[Raja Indian Cuisine]	The Vaults is a pub that serves Indian food in the £20-25 it is located in the riverside area near Raja Indian Cuisine.
name[The Vaults], eatType[pub], food[Indian], priceRange[cheap], area[riverside], familyFriendly[yes], near[Raja Indian Cuisine]	The Vaults is a pub that serves Indian food in the cheap price range it is located in the riverside area near Raja Indian Cuisine.
name[The Vaults], eatType[pub], food[Indian], priceRange[high], area[city centre], familyFriendly[no], near[Raja Indian Cuisine]	The Vaults is a pub that serves Indian food in the high price range it is located in the city centre near Raja Indian Cuisine.
name[The Vaults], eatType[pub], food[Indian], priceRange[high], area[city centre], familyFriendly[yes], near[Raja Indian Cuisine]	The Vaults is a pub that serves Indian food in the high price range it is located in the city centre near Raja Indian Cuisine.
name[The Vaults], eatType[pub], food[Italian], priceRange[high], customer rating[average], area[city centre], familyFriendly[no], near[Rainbow Vegetarian Café]	The Vaults is a pub that serves Italian food in the high price range it is located in the city centre near Rainbow Vegetarian Café it has an average customer rating.
name[The Vaults], eatType[pub], food[Italian], priceRange[high], customer rating[average], area[city centre], familyFriendly[yes], near[Rainbow Vegetarian Café]	The Vaults is an Italian pub near Rainbow Vegetarian Café in the city centre it has an average customer rating and a high price range.
name[The Vaults], eatType[pub], food[Italian], priceRange[high], customer rating[average], area[riverside], familyFriendly[no], near[Rainbow Vegetarian Café]	The Vaults is a pub that serves Italian food in the high price range it is located in the riverside area near Rainbow Vegetarian Café it has an average customer rating.
name[The Vaults], eatType[pub], food[Italian], priceRange[high], customer rating[average], area[riverside], familyFriendly[yes], near[Rainbow Vegetarian Café]	The Vaults is a family friendly pub serving Italian food in the riverside area near Rainbow Vegetarian Café it has an average customer rating and a high price range.
name[The Vaults], eatType[pub], food[Italian], priceRange[less than £20], customer rating[low], area[city centre], familyFriendly[no], near[Rainbow Vegetarian Café]	The Vaults is a pub that serves Italian food in the city centre near Rainbow Vegetarian Café it has a low customer rating.
name[The Vaults], eatType[pub], food[Italian], priceRange[less than £20], customer rating[low], area[city centre], familyFriendly[yes], near[Rainbow Vegetarian Café]	The Vaults is a pub that serves Italian food in the city centre near Rainbow Vegetarian Café it has a low customer rating.
name[The Vaults], eatType[pub], food[Italian], priceRange[less than £20], customer rating[low], area[riverside], familyFriendly[no], near[Rainbow Vegetarian Café]	The Vaults is a pub that serves Italian food in the riverside near Rainbow Vegetarian Café it has a low customer rating.
name[The Vaults], eatType[pub], food[Italian], priceRange[less than £20], customer rating[low], area[riverside], familyFriendly[yes], near[Rainbow Vegetarian Café]	The Vaults is a pub that serves Italian food in the riverside it is near Rainbow Vegetarian Café its customer rating is low.
name[The Vaults], eatType[pub], food[Italian], priceRange[moderate], customer rating[1 out of 5], area[city centre], familyFriendly[no], near[Rainbow Vegetarian Café]	The Vaults is a pub that serves Italian food in the moderate price range it is located in the city centre near Rainbow Vegetarian Café it has a customer rating of 1 out of 5.
name[The Vaults], eatType[pub], food[Italian], priceRange[moderate], customer rating[1 out of 5], area[city centre], familyFriendly[yes], near[Rainbow Vegetarian Café]	The Vaults is a pub that serves Italian food in the moderate price range it is located in the city centre near Rainbow Vegetarian Café it has a customer rating of 1 out of 5.
name[The Vaults], eatType[pub], food[Italian], priceRange[moderate], customer rating[1 out of 5], area[riverside], familyFriendly[no], near[Rainbow Vegetarian Café]	The Vaults is a pub that serves Italian food in the moderate price range it is located in the riverside area near Rainbow Vegetarian Café it has a customer rating of 1 out of 5.
name[The Vaults], eatType[pub], food[Italian], priceRange[moderate], customer rating[1 out of 5], area[riverside], familyFriendly[yes], near[Rainbow Vegetarian Café]	The Vaults is a pub that serves Italian food in the moderate price range it is located in the riverside area near Rainbow Vegetarian Café it has a customer rating of 1 out of 5.
name[The Vaults], eatType[pub], food[Italian], priceRange[moderate], customer rating[3 out of 5], area[city centre], familyFriendly[no], near[Rainbow Vegetarian Café]	The Vaults is a pub that serves Italian food in the moderate price range it is located in the city centre near Rainbow Vegetarian Café it has a customer rating of 3 out of 5.
name[The Vaults], eatType[pub], food[Italian], priceRange[moderate], customer rating[3 out of 5], area[city centre], familyFriendly[yes], near[Rainbow Vegetarian Café]	The Vaults is a pub that serves Italian food in the moderate price range it is located in the city centre near Rainbow Vegetarian Café it has a customer rating of 3 out of 5.
name[The Vaults], eatType[pub], food[Italian], priceRange[moderate], customer rating[3 out of 5], area[riverside], familyFriendly[no], near[Rainbow Vegetarian Café]	The Vaults is a pub that serves Italian food at a moderate price range it is located in the riverside area near Rainbow Vegetarian Café it has a customer rating of 3 out of 5.
name[The Vaults], eatType[pub], food[Italian], priceRange[moderate], customer rating[3 out of 5], area[riverside], familyFriendly[yes], near[Rainbow Vegetarian Café]	The Vaults is a pub that serves Italian food in the moderate price range it is located in the riverside area near Rainbow Vegetarian Café it has a customer rating of 3 out of 5.
name[The Vaults], eatType[pub], food[Italian], priceRange[more than £30], customer rating[high], area[city centre], familyFriendly[no], near[Rainbow Vegetarian Café]	The Vaults is a pub that serves Italian food in the more than £30 it is located in the city centre near Rainbow Vegetarian Café it has a high customer rating.
name[The Vaults], eatType[pub], food[Italian], priceRange[more than £30], customer rating[high], area[city centre], familyFriendly[yes], near[Rainbow Vegetarian Café]	The Vaults is a family-friendly pub serving Italian food in the city centre near Rainbow Vegetarian Café it has a high customer rating and a price range of more than £30.
name[The Vaults], eatType[pub], food[Italian], priceRange[more than £30], customer rating[high], area[riverside], familyFriendly[no], near[Rainbow Vegetarian Café]	The Vaults is a pub that serves Italian food in the riverside it is near Rainbow Vegetarian Café its customer rating is high.
name[The Vaults], eatType[pub], food[Italian], priceRange[more than £30], customer rating[high], area[riverside], familyFriendly[yes], near[Rainbow Vegetarian Café]	The Vaults is a family friendly pub serving Italian food in the riverside area near Rainbow Vegetarian Café it has a high customer rating and a price range of more than £30.
name[The Vaults], eatType[pub], food[Japanese], priceRange[£20-25], customer rating[3 out of 5], area[city centre], familyFriendly[no], near[Rainbow Vegetarian Café]	The Vaults is a pub that serves Japanese food in the £20-25 it is located in the city centre near Rainbow Vegetarian Café it has a customer rating of 3 out of 5.
name[The Vaults], eatType[pub], food[Japanese], priceRange[£20-25], customer rating[3 out of 5], area[city centre], familyFriendly[yes], near[Rainbow Vegetarian Café]	The Vaults is a pub that serves Japanese food in the £20-25 it is located in the city centre near Rainbow Vegetarian Café it has a customer rating of 3 out of 5.
name[The Vaults], eatType[pub], food[Japanese], priceRange[£20-25], customer rating[3 out of 5], area[riverside], familyFriendly[no], near[Rainbow Vegetarian Café]	The Vaults is a pub that serves Japanese food in the £20-25 it is located in the riverside area near Rainbow Vegetarian Café it has a customer rating of 3 out of 5.
name[The Vaults], eatType[pub], food[Japanese], priceRange[£20-25], customer rating[3 out of 5], area[riverside], familyFriendly[yes], near[Rainbow Vegetarian Café]	The Vaults is a pub that serves Japanese food in the £20-25 it is located in the riverside area near Rainbow Vegetarian Café it has a customer rating of 3 out of 5.
name[The Vaults], eatType[pub], food[Japanese], priceRange[£20-25], customer rating[high], area[city centre], familyFriendly[no], near[Rainbow Vegetarian Café]	The Vaults is a pub that serves Japanese food in the £20-25 it is located in the city centre near Rainbow Vegetarian Café it has a high customer rating.
name[The Vaults], eatType[pub], food[Japanese], priceRange[£20-25], customer rating[high], area[city centre], familyFriendly[yes], near[Rainbow Vegetarian Café]	The Vaults is a pub that serves Japanese food in the £20-25 it is located in the city centre near Rainbow Vegetarian Café it has a high customer rating.
name[The Vaults], eatType[pub], food[Japanese], priceRange[£20-25], customer rating[high], area[riverside], familyFriendly[no], near[Rainbow Vegetarian Café]	The Vaults is a pub that serves Japanese food in the £20-25 it is located in the riverside area near Rainbow Vegetarian Café it has a high customer rating.
name[The Vaults], eatType[pub], food[Japanese], priceRange[£20-25], customer rating[high], area[riverside], familyFriendly[no], near[Raja Indian Cuisine]	The Vaults is a pub that serves Japanese food in the £20-25 it is located in the riverside area near Raja Indian Cuisine it has a high customer rating.
name[The Vaults], eatType[pub], food[Japanese], priceRange[£20-25], customer rating[high], area[riverside], familyFriendly[yes], near[Raja Indian Cuisine]	The Vaults is a pub that serves Japanese food in the £20-25 it is located in the riverside area near Raja Indian Cuisine it has a high customer rating.
name[The Vaults], eatType[pub], food[Japanese], priceRange[cheap], customer rating[5 out of 5], area[city centre], familyFriendly[no], near[Raja Indian Cuisine]	The Vaults is a pub that serves Japanese food in the cheap price range it is located in the city centre near Raja Indian Cuisine it has a customer rating of 5 out of 5.
name[The Vaults], eatType[pub], food[Japanese], priceRange[cheap], customer rating[5 out of 5], area[city centre], familyFriendly[yes], near[Raja Indian Cuisine]	The Vaults is a cheap Japanese pub in the city centre near Raja Indian Cuisine it has a customer rating of 5 out of 5 and is family friendly.
name[The Vaults], eatType[pub], food[Japanese], priceRange[cheap], customer rating[5 out of 5], area[riverside], familyFriendly[no], near[Raja Indian Cuisine]	The Vaults is a pub that serves Japanese food in the cheap price range it is located in the riverside area near Raja Indian Cuisine it has a customer rating of 5 out of 5.
name[The Vaults], eatType[pub], food[Japanese], priceRange[cheap], customer rating[5 out of 5], area[riverside], familyFriendly[yes], near[Raja Indian Cuisine]	The Vaults is a cheap family friendly pub serving Japanese food in the riverside area near Raja Indian Cuisine it has a customer rating of 5 out of 5.
name[The Vaults], eatType[pub], food[Japanese], priceRange[high], customer rating[3 out of 5], area[city centre], familyFriendly[no], near[Raja Indian Cuisine]	The Vaults is a pub that serves Japanese food in the high price range it is located in the city centre near Raja Indian Cuisine it has a customer rating of 3 out of 5.
name[The Vaults], eatType[pub], food[Japanese], priceRange[high], customer rating[3 out of 5], area[city centre], familyFriendly[yes], near[Raja Indian Cuisine]	The Vaults is a pub that serves Japanese food in the high price range it is located in the city centre near Raja Indian Cuisine it has a customer rating of 3 out of 5.
name[The Vaults], eatType[pub], food[Japanese], priceRange[high], customer rating[3 out of 5], area[riverside], familyFriendly[no], near[Raja Indian Cuisine]	The Vaults is a pub that serves Japanese food in the high price range it is located in the riverside area near Raja Indian Cuisine it has a customer rating of 3 out of 5.
name[The Vaults], eatType[pub], food[Japanese], priceRange[high], customer rating[3 out of 5], area[riverside], familyFriendly[yes], near[Raja Indian Cuisine]	The Vaults is a pub that serves Japanese food in the high price range it is located in the riverside area near Raja Indian Cuisine it has a customer rating of 3 out of 5.
name[The Vaults], eatType[pub], food[Japanese], priceRange[less than £20], customer rating[average], area[city centre], familyFriendly[no], near[Raja Indian Cuisine]	The Vaults is a pub that serves Japanese food in the city centre near Raja Indian Cuisine it has an average customer rating.
name[The Vaults], eatType[pub], food[Japanese], priceRange[less than £20], customer rating[average], area[city centre], familyFriendly[yes], near[Raja Indian Cuisine]	The Vaults is a pub that serves Japanese food in the city centre near Raja Indian Cuisine it has an average customer rating.
name[The Vaults], eatType[pub], food[Japanese], priceRange[less than £20], customer rating[average], area[riverside], familyFriendly[no], near[Raja Indian Cuisine]	The Vaults is a pub that serves Japanese food in the riverside near Raja Indian Cuisine it has an average customer rating.
name[The Vaults], eatType[pub], food[Japanese], priceRange[less than £20], customer rating[average], area[riverside], familyFriendly[yes], near[Raja Indian Cuisine]	The Vaults is a pub that serves Japanese food in the riverside it is near Raja Indian Cuisine its customer rating is average.
name[The Vaults], eatType[pub], food[Japanese], priceRange[less than £20], customer rating[low], area[city centre], familyFriendly[no], near[Raja Indian Cuisine]	The Vaults is a pub that serves Japanese food in the city centre near Raja Indian Cuisine it has a low customer rating.
name[The Vaults], eatType[pub], food[Japanese], priceRange[less than £20], customer rating[low], area[city centre], familyFriendly[yes], near[Raja Indian Cuisine]	The Vaults is a pub that serves Japanese food in the city centre near Raja Indian Cuisine it has a low customer rating.
name[The Vaults], eatType[pub], food[Japanese], priceRange[less than £20], customer rating[low], area[riverside], familyFriendly[no], near[Raja Indian Cuisine]	The Vaults is a pub that serves Japanese food in the riverside it is near Raja Indian Cuisine its customer rating is low.
name[The Vaults], eatType[pub], food[Japanese], priceRange[less than £20], customer rating[low], area[riverside], familyFriendly[yes], near[Raja Indian Cuisine]	The Vaults is a pub that serves Japanese food in the riverside it is near Raja Indian Cuisine its customer rating is low.
name[The Vaults], eatType[pub], food[Japanese], priceRange[moderate], customer rating[1 out of 5], area[city centre], familyFriendly[no], near[Raja Indian Cuisine]	The Vaults is a pub that serves Japanese food in the moderate price range it is located in the city centre near Raja Indian Cuisine it has a customer rating of 1 out of 5.
name[The Vaults], eatType[pub], food[Japanese], priceRange[moderate], customer rating[1 out of 5], area[city centre], familyFriendly[yes], near[Raja Indian Cuisine]	The Vaults is a pub that serves Japanese food in the moderate price range it is located in the city centre near Raja Indian Cuisine it has a customer rating of 1 out of 5.
name[The Vaults], eatType[restaurant], food[French], priceRange[high], area[riverside], familyFriendly[yes], near[Raja Indian Cuisine]	The Vaults is a family friendly restaurant that serves French food in the high price range it is located in the riverside area near Raja Indian Cuisine.
name[The Vaults], eatType[restaurant], food[French], priceRange[less than £20], area[city centre], familyFriendly[no], near[Raja Indian Cuisine]	The Vaults is a restaurant that serves French food in the city centre near Raja Indian Cuisine.
name[The Vaults], eatType[restaurant], food[French], priceRange[less than £20], area[city centre], familyFriendly[yes], near[Raja Indian Cuisine]	The Vaults is a restaurant that serves French food in the city centre near Raja Indian Cuisine.
name[The Vaults], eatType[restaurant], food[French], priceRange[less than £20], area[riverside], familyFriendly[no], near[Raja Indian Cuisine]	The Vaults is a restaurant near Raja Indian Cuisine in the riverside area with a price range of less than £20 it is not family-friendly.
name[The Vaults], eatType[restaurant], food[French], priceRange[less than £20], area[riverside], familyFriendly[yes], near[Raja Indian Cuisine]	The Vaults is a restaurant near Raja Indian Cuisine in the riverside area price range it is family friendly.
name[The Vaults], eatType[restaurant], food[French], priceRange[moderate], area[city centre], familyFriendly[no], near[Raja Indian Cuisine]	The Vaults is a restaurant that serves French food in the moderate price range it is located in the city centre near Raja Indian Cuisine.
name[The Vaults], eatType[restaurant], food[French], priceRange[moderate], area[city centre], familyFriendly[yes], near[Raja Indian Cuisine]	The Vaults is a family friendly restaurant that serves French food in the moderate price range it is located in the city centre near Raja Indian Cuisine.
name[The Vaults], eatType[restaurant], food[French], priceRange[moderate], area[riverside], familyFriendly[no], near[Raja Indian Cuisine]	The Vaults is a restaurant near Raja Indian Cuisine in the riverside area with a moderate price range and is not family-friendly.
name[The Vaults], eatType[restaurant], food[French], priceRange[moderate], area[riverside], familyFriendly[yes], near[Raja Indian Cuisine]	The Vaults is a restaurant near Raja Indian Cuisine in the riverside area it is moderately priced and is kid friendly.
name[The Vaults], eatType[restaurant], food[French], priceRange[more than £30], area[city centre], familyFriendly[no], near[Raja Indian Cuisine]	The Vaults is a restaurant that serves French food in the city centre near Raja Indian Cuisine.
name[The Vaults], eatType[restaurant], food[French], priceRange[more than £30], area[city centre], familyFriendly[yes], near[Raja Indian Cuisine]	The Vaults is a family friendly restaurant serving French food in the city centre near Raja Indian Cuisine with a price range of more than £30.
name[The Vaults], eatType[restaurant], food[French], priceRange[more than £30], area[riverside], familyFriendly[no], near[Raja Indian Cuisine]	The Vaults is a restaurant near Raja Indian Cuisine in the riverside area price range it is not child friendly.
name[The Vaults], eatType[restaurant], food[French], priceRange[more than £30], area[riverside], familyFriendly[yes], near[Raja Indian Cuisine]	The Vaults is a family friendly restaurant serving French food in the riverside area near Raja Indian Cuisine and has a price range of more than £30.
name[The Vaults], eatType[restaurant], food[Indian], priceRange[£20-25], area[riverside], familyFriendly[yes], near[Raja Indian Cuisine]	The Vaults is a restaurant that serves Indian food in the £20-25 it is located in the riverside area near Raja Indian Cuisine.
name[The Vaults], eatType[restaurant], food[Indian], priceRange[cheap], area[riverside], familyFriendly[yes], near[Raja Indian Cuisine]	The Vaults is a restaurant that serves Indian food in the cheap price range it is located in the riverside area near Raja Indian Cuisine.
name[The Vaults], eatType[restaurant], food[Indian], priceRange[high], area[city centre], familyFriendly[no], near[Raja Indian Cuisine]	The Vaults is a restaurant that serves Indian food in the high price range it is located in the city centre near Raja Indian Cuisine.
name[The Vaults], eatType[restaurant], food[Indian], priceRange[high], area[city centre], familyFriendly[yes], near[Raja Indian Cuisine]	The Vaults is a restaurant that serves Indian food in the high price range it is located in the city centre near Raja Indian Cuisine.
name[The Waterman], eatType[pub], food[Indian], priceRange[high], area[city centre], familyFriendly[yes], near[Raja Indian Cuisine]	The Waterman is a pub that serves Indian food in the high price range it is located in the city centre near Raja Indian Cuisine.
name[The Waterman], eatType[pub], food[Indian], priceRange[high], area[riverside], familyFriendly[no], near[Raja Indian Cuisine]	The Waterman is a pub that serves Indian food in the high price range it is located in the riverside area near Raja Indian Cuisine.
name[The Waterman], eatType[pub], food[Indian], priceRange[high], area[riverside], familyFriendly[yes], near[Raja Indian Cuisine]	The Waterman is a pub that serves Indian food in the high price range it is located in the riverside area near Raja Indian Cuisine.
name[The Waterman], eatType[pub], food[Indian], priceRange[less than £20], area[city centre], familyFriendly[no], near[Raja Indian Cuisine]	The Waterman is a pub that serves Indian food in the less than £20 it is located in the city centre near Raja Indian Cuisine.
name[The Waterman], eatType[pub], food[Indian], priceRange[less than £20], area[city centre], familyFriendly[yes], near[Raja Indian Cuisine]	The Waterman is a pub that serves Indian food in the less than £20 it is located in the city centre near Raja Indian Cuisine.
name[The Waterman], eatType[pub], food[Indian], priceRange[less than £20], area[riverside], familyFriendly[no], near[Raja Indian Cuisine]	The Waterman is a pub that serves Indian food for less than £20 it is located in the riverside area near Raja Indian Cuisine.
name[The Waterman], eatType[pub], food[Indian], priceRange[less than £20], area[riverside], familyFriendly[yes], near[Raja Indian Cuisine]	The Waterman is a pub that serves Indian food for less than £20 it is located in the riverside area near Raja Indian Cuisine.
name[The Waterman], eatType[pub], food[Indian], priceRange[moderate], area[city centre], familyFriendly[no], near[Raja Indian Cuisine]	The Waterman is a pub that serves Indian food in the moderate price range it is located in the city centre near Raja Indian Cuisine.
name[The Waterman], eatType[pub], food[Indian], priceRange[moderate], area[city centre], familyFriendly[yes], near[Raja Indian Cuisine]	The Waterman is a pub that serves Indian food in the moderate price range it is located in the city centre near Raja Indian Cuisine.
name[The Waterman], eatType[pub], food[Indian], priceRange[moderate], area[riverside], familyFriendly[no], near[Raja Indian Cuisine]	The Waterman is a pub that serves Indian food in the moderate price range it is located in the riverside area near Raja Indian Cuisine.
name[The Waterman], eatType[pub], food[Indian], priceRange[moderate], area[riverside], familyFriendly[yes], near[Raja Indian Cuisine]	The Waterman is a pub that serves Indian food in the moderate price range it is located in the riverside area near Raja Indian Cuisine.
name[The Waterman], eatType[pub], food[Indian], priceRange[more than £30], area[riverside], familyFriendly[yes], near[Raja Indian Cuisine]	The Waterman is a pub that serves Indian food in the price range is more than £30 it is located in the riverside area near Raja Indian Cuisine.
name[The Waterman], eatType[pub], food[Italian], priceRange[£20-25], area[riverside], familyFriendly[yes], near[Raja Indian Cuisine]	The Waterman is a family friendly pub serving Italian food in the riverside area near Raja Indian Cuisine with a price range of £20-25.
name[The Waterman], eatType[pub], food[Italian], priceRange[cheap], area[riverside], familyFriendly[yes], near[Raja Indian Cuisine]	The Waterman is a family friendly pub serving Italian food in the cheap price range it is located in the riverside area near Raja Indian Cuisine.
name[The Waterman], eatType[pub], food[Italian], priceRange[high], area[city centre], familyFriendly[no], near[Raja Indian Cuisine]	The Waterman is a pub that serves Italian food in the high price range it is located in the city centre near Raja Indian Cuisine.
name[The Waterman], eatType[pub], food[Italian], priceRange[high], area[city centre], familyFriendly[yes], near[Raja Indian Cuisine]	The Waterman is a family friendly pub serving Italian food in the city centre near Raja Indian Cuisine it is a high price range.
name[The Waterman], eatType[pub], food[Italian], priceRange[high], area[riverside], familyFriendly[no], near[Raja Indian Cuisine]	The Waterman is a pub that serves Italian food in the high price range it is located in the riverside area near Raja Indian Cuisine.
name[The Waterman], eatType[pub], food[Italian], priceRange[high], area[riverside], familyFriendly[yes], near[Raja Indian Cuisine]	The Waterman is a family friendly pub serving Italian food in the riverside area near Raja Indian Cuisine with a high price range.
name[The Waterman], eatType[pub], food[Italian], priceRange[less than £20], area[city centre], familyFriendly[no], near[Raja Indian Cuisine]	The Waterman is a pub that serves Italian food for less than £20 it is located in the city centre near Raja Indian Cuisine.
name[The Waterman], eatType[pub], food[Italian], priceRange[less than £20], area[city centre], familyFriendly[yes], near[Raja Indian Cuisine]	The Waterman is a family-friendly pub serving Italian food in the city centre near Raja Indian Cuisine it is a price range of less than £20.
name[The Waterman], eatType[pub], food[Italian], priceRange[less than £20], area[riverside], familyFriendly[no], near[Raja Indian Cuisine]	The Waterman is a pub that serves Italian food for less than £20 it is located in the riverside area near Raja Indian Cuisine.
name[The Waterman], eatType[restaurant], food[Indian], priceRange[high], area[city centre], familyFriendly[yes], near[Raja Indian Cuisine]	The Waterman is a restaurant that serves Indian food in the high price range it is located in the city centre near Raja Indian Cuisine.
name[The Waterman], eatType[restaurant], food[Indian], priceRange[high], area[riverside], familyFriendly[no], near[Raja Indian Cuisine]	The Waterman is a restaurant that serves Indian food in the high price range it is located in the riverside area near Raja Indian Cuisine.
name[The Waterman], eatType[restaurant], food[Indian], priceRange[high], area[riverside], familyFriendly[yes], near[Raja Indian Cuisine]	The Waterman is a restaurant that serves Indian food in the high price range it is located in the riverside area near Raja Indian Cuisine.
name[The Waterman], eatType[restaurant], food[Indian], priceRange[less than £20], area[city centre], familyFriendly[no], near[Raja Indian Cuisine]	The Waterman is a restaurant that serves Indian food in the less than £20 it is located in the city centre near Raja Indian Cuisine.
name[The Waterman], eatType[restaurant], food[Indian], priceRange[less than £20], area[city centre], familyFriendly[yes], near[Raja Indian Cuisine]	The Waterman is a restaurant that serves Indian food in the less than £20 it is located in the city centre near Raja Indian Cuisine.
name[The Waterman], eatType[restaurant], food[Indian], priceRange[less than £20], area[riverside], familyFriendly[no], near[Raja Indian Cuisine]	The Waterman is a restaurant that serves Indian food for less than £20 it is located in the riverside area near Raja Indian Cuisine.
name[The Waterman], eatType[restaurant], food[Indian], priceRange[less than £20], area[riverside], familyFriendly[yes], near[Raja Indian Cuisine]	The Waterman is a restaurant that serves Indian food for less than £20 it is located in the riverside area near Raja Indian Cuisine.
name[The Waterman], eatType[restaurant], food[Indian], priceRange[moderate], area[city centre], familyFriendly[no], near[Raja Indian Cuisine]	The Waterman is a restaurant that serves Indian food in the moderate price range it is located in the city centre near Raja Indian Cuisine.
name[The Waterman], eatType[restaurant], food[Indian], priceRange[moderate], area[city centre], familyFriendly[yes], near[Raja Indian Cuisine]	The Waterman is a restaurant that serves Indian food in the moderate price range it is located in the city centre near Raja Indian Cuisine.
name[The Waterman], eatType[restaurant], food[Indian], priceRange[moderate], area[riverside], familyFriendly[no], near[Raja Indian Cuisine]	The Waterman is a restaurant that serves Indian food in the moderate price range it is located in the riverside area near Raja Indian Cuisine.
name[The Waterman], eatType[restaurant], food[Indian], priceRange[moderate], area[riverside], familyFriendly[yes], near[Raja Indian Cuisine]	The Waterman is a restaurant that serves Indian food in the moderate price range it is located in the riverside area near Raja Indian Cuisine.
name[The Waterman], eatType[restaurant], food[Indian], priceRange[more than £30], area[riverside], familyFriendly[yes], near[Raja Indian Cuisine]	The Waterman is a restaurant that serves Indian food in the price range is more than £30 it is located in the riverside area near Raja Indian Cuisine.
name[The Waterman], eatType[restaurant], food[Italian], priceRange[£20-25], area[riverside], familyFriendly[yes], near[Raja Indian Cuisine]	The Waterman is a family friendly restaurant that serves Italian food in the riverside area near Raja Indian Cuisine with a price range of £20-25.
name[The Waterman], eatType[restaurant], food[Italian], priceRange[cheap], area[riverside], familyFriendly[yes], near[Raja Indian Cuisine]	The Waterman is a cheap Italian restaurant in the riverside area near Raja Indian Cuisine it is family friendly.
name[The Waterman], eatType[restaurant], food[Italian], priceRange[high], area[city centre], familyFriendly[no], near[Raja Indian Cuisine]	The Waterman is a restaurant that serves Italian food in the high price range it is located in the city centre near Raja Indian Cuisine.
name[The Waterman], eatType[restaurant], food[Italian], priceRange[high], area[city centre], familyFriendly[yes], near[Raja Indian Cuisine]	The Waterman is a family friendly restaurant that serves Italian food in the high price range it is located in the city centre near Raja Indian Cuisine.
name[The Waterman], eatType[restaurant], food[Italian], priceRange[high], area[riverside], familyFriendly[no], near[Raja Indian Cuisine]	The Waterman is a restaurant near Raja Indian Cuisine in the riverside area it serves Italian food at a high price range it is not child friendly.
name[The Waterman], eatType[restaurant], food[Italian], priceRange[high], area[riverside], familyFriendly[yes], near[Raja Indian Cuisine]	The Waterman is a family friendly restaurant that serves Italian food in the high price range it is located in the riverside area near Raja Indian Cuisine.
name[The Waterman], eatType[restaurant], food[Italian], priceRange[less than £20], area[city centre], familyFriendly[no], near[Raja Indian Cuisine]	The Waterman is a restaurant that serves Italian food for less than £20 it is located in the city centre near Raja Indian Cuisine.
name[The Waterman], eatType[restaurant], food[Italian], priceRange[less than £20], area[city centre], familyFriendly[yes], near[Raja Indian Cuisine]	The Waterman is a family friendly restaurant that serves Italian food for less than £20 it is located in the city centre near Raja Indian Cuisine.
name[The Waterman], eatType[restaurant], food[Italian], priceRange[less than £20], area[riverside], familyFriendly[no], near[Raja Indian Cuisine]	The Waterman is a restaurant near Raja Indian Cuisine in the riverside area it serves Italian food for less than £20 it is not family-friendly.
name[The Wrestlers], eatType[pub], food[Italian], priceRange[less than £20], area[riverside], familyFriendly[no], near[Raja Indian Cuisine]	The Wrestlers is a pub that serves Italian food for less than £20 it is located in the riverside area near Raja Indian Cuisine.
name[The Wrestlers], eatType[pub], food[Italian], priceRange[less than £20], area[riverside], familyFriendly[yes], near[Raja Indian Cuisine]	The Wrestlers is a family friendly pub serving Italian food in the riverside area near Raja Indian Cuisine.
name[The Wrestlers], eatType[pub], food[Italian], priceRange[moderate], area[city centre], familyFriendly[no], near[Raja Indian Cuisine]	The Wrestlers is a pub that serves Italian food at a moderate price range it is located in the city centre near Raja Indian Cuisine.
name[The Wrestlers], eatType[pub], food[Italian], priceRange[moderate], area[city centre], familyFriendly[yes], near[Raja Indian Cuisine]	The Wrestlers is a family friendly pub serving Italian food in the moderate price range it is located in the city centre near Raja Indian Cuisine.
name[The Wrestlers], eatType[pub], food[Italian], priceRange[moderate], area[riverside], familyFriendly[no], near[Raja Indian Cuisine]	The Wrestlers is a pub that serves Italian food at a moderate price range it is located in the riverside area near Raja Indian Cuisine.
name[The Wrestlers], eatType[pub], food[Italian], priceRange[moderate], area[riverside], familyFriendly[yes], near[Raja Indian Cuisine]	The Wrestlers is a family friendly pub serving Italian food at a moderate price range it is located in the riverside area near Raja Indian Cuisine.
name[The Wrestlers], eatType[pub], food[Italian], priceRange[more than £30], area[riverside], familyFriendly[yes], near[Raja Indian Cuisine]	The Wrestlers is a family friendly pub serving Italian food in the riverside area near Raja Indian Cuisine and has a price range of more than £30.
name[The Wrestlers], eatType[pub], food[Japanese], priceRange[£20-25], area[riverside], familyFriendly[yes], near[Raja Indian Cuisine]	The Wrestlers is a family friendly pub serving Japanese food in the riverside area near Raja Indian Cuisine with a price range of £20-25.
name[The Wrestlers], eatType[pub], food[Japanese], priceRange[cheap], area[riverside], familyFriendly[yes], near[Raja Indian Cuisine]	The Wrestlers is a cheap family friendly pub serving Japanese food in the riverside area near Raja Indian Cuisine.
name[The Wrestlers], eatType[pub], food[Japanese], priceRange[high], area[riverside], familyFriendly[yes], near[Raja Indian Cuisine]	The Wrestlers is a family friendly pub serving Japanese food in the riverside area near Raja Indian Cuisine and is a high price range.
name[The Wrestlers], eatType[pub], food[Japanese], priceRange[less than £20], area[city centre], familyFriendly[no], near[Raja Indian Cuisine]	The Wrestlers is a pub that serves Japanese food for less than £20 it is located in the city centre near Raja Indian Cuisine.
name[The Wrestlers], eatType[pub], food[Japanese], priceRange[less than £20], area[city centre], familyFriendly[yes], near[Raja Indian Cuisine]	The Wrestlers is a family friendly pub serving Japanese food in the city centre near Raja Indian Cuisine it is in the.
name[The Wrestlers], eatType[pub], food[Japanese], priceRange[less than £20], area[riverside], familyFriendly[no], near[Raja Indian Cuisine]	The Wrestlers is a pub that serves Japanese food for less than £20 it is located in the riverside area near Raja Indian Cuisine.
name[The Wrestlers], eatType[pub], food[Japanese], priceRange[less than £20], area[riverside], familyFriendly[yes], near[Raja Indian Cuisine]	The Wrestlers is a family friendly pub serving Japanese food in the riverside area near Raja Indian Cuisine and has a price range of less than £20.
name[The Wrestlers], eatType[pub], food[Japanese], priceRange[moderate], area[city centre], familyFriendly[no], near[Raja Indian Cuisine]	The Wrestlers is a pub that serves Japanese food in the moderate price range it is located in the city centre near Raja Indian Cuisine.
name[The Wrestlers], eatType[pub], food[Japanese], priceRange[moderate], area[city centre], familyFriendly[yes], near[Raja Indian Cuisine]	The Wrestlers is a family friendly pub serving Japanese food in the moderate price range it is located in the city centre near Raja Indian Cuisine.
name[The Wrestlers], eatType[pub], food[Japanese], priceRange[moderate], area[riverside], familyFriendly[no], near[Raja Indian Cuisine]	The Wrestlers is a pub that serves Japanese food in the moderate price range it is located in the riverside area near Raja Indian Cuisine.
name[The Wrestlers], eatType[pub], food[Japanese], priceRange[moderate], area[riverside], familyFriendly[yes], near[Raja Indian Cuisine]	The Wrestlers is a family friendly pub serving Japanese food in the moderate price range it is located in the riverside area near Raja Indian Cuisine.
name[The Wrestlers], eatType[pub], food[Japanese], priceRange[moderate], customer rating[1 out of 5], area[city centre], familyFriendly[yes], near[Raja Indian Cuisine]	The Wrestlers is a pub that serves Japanese food in the moderate price range it is located in the city centre near Raja Indian Cuisine it has a customer rating of 1 out of 5.
name[The Wrestlers], eatType[pub], food[Japanese], priceRange[moderate], customer rating[1 out of 5], area[riverside], familyFriendly[no], near[Raja Indian Cuisine]	The Wrestlers is a pub that serves Japanese food in the moderate price range it is located in the riverside area near Raja Indian Cuisine it has a customer rating of 1 out of 5.
name[The Wrestlers], eatType[pub], food[Japanese], priceRange[moderate], customer rating[1 out of 5], area[riverside], familyFriendly[yes], near[Raja Indian Cuisine]	The Wrestlers is a pub that serves Japanese food in the moderate price range it is located in the riverside area near Raja Indian Cuisine it has a customer rating of 1 out of 5.
name[The Wrestlers], eatType[pub], food[Japanese], priceRange[more than £30], area[city centre], familyFriendly[no], near[Raja Indian Cuisine]	The Wrestlers is a pub that serves Japanese food in the more than £30 it is located in the city centre near Raja Indian Cuisine.
name[The Wrestlers], eatType[pub], food[Japanese], priceRange[more than £30], area[city centre], familyFriendly[yes], near[Raja Indian Cuisine]	The Wrestlers is a family friendly pub serving Japanese food in the city centre near Raja Indian Cuisine with a price range of more than £30.
name[The Wrestlers], eatType[pub], food[Japanese], priceRange[more than £30], area[riverside], familyFriendly[no], near[Raja Indian Cuisine]	The Wrestlers is a pub that serves Japanese food in the riverside area near Raja Indian Cuisine.
name[The Wrestlers], eatType[pub], food[Japanese], priceRange[more than £30], area[riverside], familyFriendly[yes], near[Raja Indian Cuisine]	The Wrestlers is a family friendly pub serving Japanese food in the riverside area near Raja Indian Cuisine and has a price range of more than £30.
name[The Wrestlers], eatType[pub], food[Japanese], priceRange[more than £30], customer rating[5 out of 5], area[city centre], familyFriendly[no], near[Raja Indian Cuisine]	The Wrestlers is a pub that serves Japanese food in the city centre near Raja Indian Cuisine it has a customer rating of 5 out of 5.
name[The Wrestlers], eatType[pub], food[Japanese], priceRange[more than £30], customer rating[5 out of 5], area[city centre], familyFriendly[yes], near[Raja Indian Cuisine]	The Wrestlers is a family-friendly pub serving Japanese food in the city centre near Raja Indian Cuisine it has a customer rating of 5 out of 5 and a price range.
name[The Wrestlers], eatType[pub], food[Japanese], priceRange[more than £30], customer rating[5 out of 5], area[riverside], familyFriendly[no], near[Raja Indian Cuisine]	The Wrestlers is a pub that serves Japanese food in the riverside near Raja Indian Cuisine it has a customer rating of 5 out of 5.
name[The Wrestlers], eatType[pub], food[Japanese], priceRange[more than £30], customer rating[5 out of 5], area[riverside], familyFriendly[yes], near[Raja Indian Cuisine]	The Wrestlers is a pub that serves Japanese food in the riverside near Raja Indian Cuisine it has a customer rating of 5 out of 5.
name[The Wrestlers], eatType[pub], food[Japanese], priceRange[more than £30], customer rating[low], area[city centre], familyFriendly[no], near[Raja Indian Cuisine]	The Wrestlers is a pub that serves Japanese food in the city centre near Raja Indian Cuisine it has a low customer rating.
name[The Wrestlers], eatType[pub], food[Japanese], priceRange[more than £30], customer rating[low], area[city centre], familyFriendly[yes], near[Raja Indian Cuisine]	The Wrestlers is a pub that serves Japanese food in the city centre near Raja Indian Cuisine it has a low customer rating.
name[The Wrestlers], eatType[pub], food[Japanese], priceRange[more than £30], customer rating[low], area[riverside], familyFriendly[no], near[Raja Indian Cuisine]	The Wrestlers is a pub that serves Japanese food in the riverside near Raja Indian Cuisine it has a low customer rating.
name[The Wrestlers], eatType[pub], food[Japanese], priceRange[more than £30], customer rating[low], area[riverside], familyFriendly[yes], near[Raja Indian Cuisine]	The Wrestlers is a pub that serves Japanese food in the riverside near Raja Indian Cuisine it has a low customer rating.
name[The Wrestlers], eatType[restaurant], food[Italian], priceRange[less than £20], area[riverside], familyFriendly[no], near[Raja Indian Cuisine]	The Wrestlers is a restaurant near Raja Indian Cuisine in the riverside area it serves Italian food for less than £20 it is not family-friendly.
name[The Wrestlers], eatType[restaurant], food[Italian], priceRange[less than £20], area[riverside], familyFriendly[yes], near[Raja Indian Cuisine]	The Wrestlers is a restaurant near Raja Indian Cuisine in the riverside area it food for less than £20 and is family friendly.
name[The Wrestlers], eatType[restaurant], food[Italian], priceRange[moderate], area[city centre], familyFriendly[no], near[Raja Indian Cuisine]	The Wrestlers is a restaurant that serves Italian food at a moderate price range it is located in the city centre near Raja Indian Cuisine.
name[The Wrestlers], eatType[restaurant], food[Italian], priceRange[moderate], area[city centre], familyFriendly[yes], near[Raja Indian Cuisine]	The Wrestlers is a family friendly restaurant that serves Italian food at a moderate price range it is located in the city centre near Raja Indian Cuisine.
name[The Wrestlers], eatType[restaurant], food[Italian], priceRange[moderate], area[riverside], familyFriendly[no], near[Raja Indian Cuisine]	The Wrestlers is a restaurant near Raja Indian Cuisine in the riverside area it serves Italian food at a moderate price range it is not family-friendly.
name[The Wrestlers], eatType[restaurant], food[Italian], priceRange[moderate], area[riverside], familyFriendly[yes], near[Raja Indian Cuisine]	The Wrestlers is a family friendly restaurant that serves Italian food at a moderate price range it is located in the riverside area near Raja Indian Cuisine.
name[The Wrestlers], eatType[restaurant], food[Italian], priceRange[more than £30], area[riverside], familyFriendly[yes], near[Raja Indian Cuisine]	The Wrestlers is a family friendly restaurant that serves Italian food at a price range of more than £30 it is located in the riverside area near Raja Indian Cuisine.
name[The Wrestlers], eatType[restaurant], food[Japanese], priceRange[£20-25], area[riverside], familyFriendly[yes], near[Raja Indian Cuisine]	The Wrestlers is a restaurant near Raja Indian Cuisine in the riverside area Japanese food, is kid friendly and the price range is £20-25.
name[The Wrestlers], eatType[restaurant], food[Japanese], priceRange[cheap], area[riverside], familyFriendly[yes], near[Raja Indian Cuisine]	The Wrestlers is a cheap family friendly restaurant that serves Japanese food in the riverside area near Raja Indian Cuisine.
name[The Wrestlers], eatType[restaurant], food[Japanese], priceRange[high], area[riverside], familyFriendly[yes], near[Raja Indian Cuisine]	The Wrestlers is a restaurant near Raja Indian Cuisine in the riverside area it serves Japanese food in the high price range and is child friendly.
name[The Wrestlers], eatType[restaurant], food[Japanese], priceRange[less than £20], area[city centre], familyFriendly[no], near[Raja Indian Cuisine]	The Wrestlers is a restaurant that serves Japanese food in the city centre near Raja Indian Cuisine.
name[The Wrestlers], eatType[restaurant], food[Japanese], priceRange[less than £20], area[city centre], familyFriendly[yes], near[Raja Indian Cuisine]	The Wrestlers is a restaurant that serves Japanese food in the city centre near Raja Indian Cuisine it is family friendly.
name[The Wrestlers], eatType[restaurant], food[Japanese], priceRange[less than £20], area[riverside], familyFriendly[no], near[Raja Indian Cuisine]	The Wrestlers is a restaurant near Raja Indian Cuisine in the riverside area Japanese food for less than £20 it is not family-friendly.
name[The Wrestlers], eatType[restaurant], food[Japanese], priceRange[less than £20], area[riverside], familyFriendly[yes], near[Raja Indian Cuisine]	The Wrestlers is a restaurant near Raja Indian Cuisine in the riverside area Japanese food, is family friendly and the price range is less than £20.
name[The Wrestlers], eatType[restaurant], food[Japanese], priceRange[moderate], area[city centre], familyFriendly[no], near[Raja Indian Cuisine]	The Wrestlers is a restaurant that serves Japanese food in the moderate price range it is located in the city centre near Raja Indian Cuisine.
name[The Wrestlers], eatType[restaurant], food[Japanese], priceRange[moderate], area[city centre], familyFriendly[yes], near[Raja Indian Cuisine]	The Wrestlers is a restaurant that serves Japanese food in the moderate price range it is located in the city centre near Raja Indian Cuisine it is kid friendly.
name[The Wrestlers], eatType[restaurant], food[Japanese], priceRange[moderate], area[riverside], familyFriendly[no], near[Raja Indian Cuisine]	The Wrestlers is a restaurant near Raja Indian Cuisine in the riverside area Japanese food at a moderate price range it is not family-friendly.
name[The Wrestlers], eatType[restaurant], food[Japanese], priceRange[moderate], area[riverside], familyFriendly[yes], near[Raja Indian Cuisine]	The Wrestlers is a restaurant near Raja Indian Cuisine in the riverside area Japanese food at a moderate price range and is kid friendly.
name[The Wrestlers], eatType[restaurant], food[Japanese], priceRange[more than £30], area[city centre], familyFriendly[no], near[Raja Indian Cuisine]	The Wrestlers is a restaurant that serves Japanese food in the city centre near Raja Indian Cuisine it is not family-friendly.
name[The Wrestlers], eatType[restaurant], food[Japanese], priceRange[more than £30], area[city centre], familyFriendly[yes], near[Raja Indian Cuisine]	The Wrestlers is a family friendly restaurant serving Japanese food in the city centre near Raja Indian Cuisine with a price range of more than £30.
name[The Wrestlers], eatType[restaurant], food[Japanese], priceRange[more than £30], area[riverside], familyFriendly[no], near[Raja Indian Cuisine]	The Wrestlers is a restaurant near Raja Indian Cuisine in the riverside area Japanese food in the it is not child friendly.
name[The Wrestlers], eatType[restaurant], food[Japanese], priceRange[more than £30], area[riverside], familyFriendly[yes], near[Raja Indian Cuisine]	The Wrestlers is a family friendly restaurant serving Japanese food in the riverside area near Raja Indian Cuisine and has a price range of more than £30.
name[Wildwood], eatType[coffee shop], area[riverside]	Wildwood is a coffee shop in the riverside area.
name[Wildwood], eatType[pub], area[riverside]	Wildwood is a pub located in the riverside area.
name[Wildwood], eatType[pub], food[French], area[riverside], familyFriendly[yes], near[Raja Indian Cuisine]	Wildwood is a family friendly pub serving French food it is located in the riverside area near Raja Indian Cuisine.
name[Wildwood], eatType[pub], food[Indian], area[city centre], familyFriendly[no], near[Raja Indian Cuisine]	Wildwood is a pub that serves Indian food in the city centre near Raja Indian Cuisine it is not family friendly.
name[Wildwood], eatType[pub], food[Indian], area[city centre], familyFriendly[yes], near[Raja Indian Cuisine]	Wildwood is a family friendly pub serving Indian food in the city centre near Raja Indian Cuisine.
name[Wildwood], eatType[pub], food[Indian], area[riverside], familyFriendly[no], near[Raja Indian Cuisine]	Wildwood is a pub that serves Indian food in the riverside area near Raja Indian Cuisine it is not family friendly.
name[Wildwood], eatType[pub], food[Indian], area[riverside], familyFriendly[yes], near[Raja Indian Cuisine]	Wildwood is a pub that serves Indian food in the riverside area near Raja Indian Cuisine it is family friendly.
name[Wildwood], eatType[pub], food[Italian], area[city centre], familyFriendly[no], near[Raja Indian Cuisine]	Wildwood is a pub that serves Italian food in the city centre near Raja Indian Cuisine it is not family-friendly.
name[Wildwood], eatType[pub], food[Italian], area[city centre], familyFriendly[yes], near[Raja Indian Cuisine]	Wildwood is a family-friendly pub serving Italian food in the city centre near Raja Indian Cuisine.
name[Wildwood], eatType[pub], food[Italian], area[riverside], familyFriendly[no], near[Raja Indian Cuisine]	Wildwood is a pub that serves Italian food in the riverside area near Raja Indian Cuisine it is not family-friendly.
name[Wildwood], eatType[pub], food[Italian], area[riverside], familyFriendly[yes], near[Raja Indian Cuisine]	Wildwood is a family friendly pub serving Italian food in the riverside area near Raja Indian Cuisine.
name[Wildwood], eatType[restaurant], food[French], area[riverside], familyFriendly[yes], near[Raja Indian Cuisine]	Wildwood is a family friendly restaurant serving French food it is located in the riverside area near Raja Indian Cuisine.
name[Wildwood], eatType[restaurant], food[Indian], area[city centre], familyFriendly[no], near[Raja Indian Cuisine]	Wildwood is a restaurant that serves Indian food in the city centre near Raja Indian Cuisine it is not family friendly.
name[Wildwood], eatType[restaurant], food[Indian], area[city centre], familyFriendly[yes], near[Raja Indian Cuisine]	Wildwood is an Indian restaurant in the city centre near Raja Indian Cuisine it is family friendly.
name[Wildwood], eatType[restaurant], food[Indian], area[riverside], familyFriendly[no], near[Raja Indian Cuisine]	Wildwood is a restaurant that serves Indian food in the riverside area near Raja Indian Cuisine it is not family friendly.
name[Wildwood], eatType[restaurant], food[Indian], area[riverside], familyFriendly[yes], near[Raja Indian Cuisine]	Wildwood is a restaurant that serves Indian food in the riverside area near Raja Indian Cuisine it is family friendly.
name[Wildwood], eatType[restaurant], food[Italian], area[city centre], familyFriendly[no], near[Raja Indian Cuisine]	Wildwood is an Italian restaurant near Raja Indian Cuisine in the city centre it is not family-friendly.
name[Wildwood], eatType[restaurant], food[Italian], area[city centre], familyFriendly[yes], near[Raja Indian Cuisine]	Wildwood is a family friendly restaurant serving Italian food in the city centre near Raja Indian Cuisine.
name[Wildwood], eatType[restaurant], food[Italian], area[riverside], familyFriendly[no], near[Raja Indian Cuisine]	Wildwood is a restaurant that serves Italian food in the riverside area near Raja Indian Cuisine it is not family-friendly.
name[Wildwood], eatType[restaurant], food[Italian], area[riverside], familyFriendly[yes], near[Raja Indian Cuisine]	Wildwood is a family friendly restaurant that serves Italian food in the riverside area near Raja Indian Cuisine.
name[Zizzi], eatType[coffee shop], area[riverside]	Zizzi is a coffee shop in the riverside area.
name[Zizzi], eatType[coffee shop], customer rating[average], near[Burger King]	Zizzi is a coffee shop near Burger King it has an average customer rating.
name[Zizzi], eatType[coffee shop], customer rating[high], near[Burger King]	Zizzi is a coffee shop near Burger King it has a high customer rating.
name[Zizzi], eatType[coffee shop], near[The Sorrento]	Zizzi is a coffee shop near The Sorrento.
name[Zizzi], eatType[pub], area[riverside]	Zizzi is a pub located in the riverside area.
name[Zizzi], eatType[pub], customer rating[average], near[Burger King]	Zizzi is a pub near Burger King it has an average customer rating.
name[Zizzi], eatType[pub], customer rating[high], near[Burger King]	Zizzi is a pub near Burger King it has a high customer rating.
name[Zizzi], eatType[pub], near[The Sorrento]	Zizzi is a pub near The Sorrento.