name[Blue Spice], eatType[coffee shop], area[city centre]	In the city centre is a coffee shop named Blue Spice.
name[Blue Spice], eatType[coffee shop], area[riverside]	For a coffee shop in the riverside area, Blue Spice is a coffee shop.
name[Blue Spice], eatType[coffee shop], customer rating[5 out of 5], near[Crowne Plaza Hotel]	For a coffee shop near Crowne Plaza Hotel is Blue Spice.
name[Blue Spice], eatType[coffee shop], customer rating[average], near[Burger King]	For a coffee shop near Burger King is Blue Spice.
name[Blue Spice], eatType[coffee shop], customer rating[average], near[Crowne Plaza Hotel]	For a coffee shop near Crowne Plaza Hotel is Blue Spice.
name[Blue Spice], eatType[pub], area[city centre]	In the city centre is a pub called Blue Spice.
name[Blue Spice], eatType[pub], area[riverside]	In riverside is a pub called Blue Spice.
name[Blue Spice], eatType[pub], customer rating[5 out of 5], near[Crowne Plaza Hotel]	For a pub near Crowne Plaza Hotel, Blue Spice is a pub.
name[Blue Spice], eatType[pub], customer rating[average], near[Burger King]	For a pub near Burger King, Blue Spice is a pub.
name[Blue Spice], eatType[pub], customer rating[average], near[Crowne Plaza Hotel]	For a pub near Crowne Plaza Hotel, Blue Spice is a pub.
name[Blue Spice], eatType[pub], food[Chinese], area[city centre], familyFriendly[no], near[Rainbow Vegetarian Café]	In the city centre, near Rainbow Vegetarian Café, is a pub called Blue Spice. It serves Chinese food and is not family friendly.
name[Blue Spice], eatType[pub], food[Chinese], area[city centre], familyFriendly[yes], near[Rainbow Vegetarian Café]	In the city centre, near Rainbow Vegetarian Café, is a family friendly pub called Blue Spice.
name[Blue Spice], eatType[pub], food[Chinese], area[riverside], familyFriendly[no], near[Rainbow Vegetarian Café]	Near Rainbow Vegetarian Café, there is a pub called Blue Spice. It serves Chinese food and is not family friendly.
name[Blue Spice], eatType[pub], food[Chinese], area[riverside], familyFriendly[yes], near[Rainbow Vegetarian Café]	Near Rainbow Vegetarian Café, is a pub that serves Chinese food and is family friendly.
name[Blue Spice], eatType[pub], food[English], area[city centre], familyFriendly[no], near[Rainbow Vegetarian Café]	In the city centre, near Rainbow Vegetarian Café, is a pub called Blue Spice. It serves English food and is not family-friendly.
name[Blue Spice], eatType[pub], food[English], area[city centre], familyFriendly[yes], near[Rainbow Vegetarian Café]	In the city centre, near Rainbow Vegetarian Café, is a family-friendly pub serving English food.
name[Blue Spice], eatType[pub], food[English], area[riverside], familyFriendly[no], near[Rainbow Vegetarian Café]	Near the Rainbow Vegetarian Café, there is a pub called Blue Spice. It serves English food and is not family-friendly.
name[Blue Spice], eatType[pub], food[English], area[riverside], familyFriendly[yes], near[Rainbow Vegetarian Café]	Near the Rainbow Vegetarian Café is a family friendly pub that serves English food.
name[Blue Spice], eatType[restaurant], food[Chinese], area[city centre], familyFriendly[no], near[Rainbow Vegetarian Café]	In the city centre near Rainbow Vegetarian Café, there is a Chinese restaurant called Blue Spice. It is not family friendly.
name[Blue Spice], eatType[restaurant], food[Chinese], area[city centre], familyFriendly[yes], near[Rainbow Vegetarian Café]	In the city centre near Rainbow Vegetarian Café, there is a family friendly Chinese restaurant called Blue Spice.
name[Blue Spice], eatType[restaurant], food[Chinese], area[riverside], familyFriendly[no], near[Rainbow Vegetarian Café]	Near Rainbow Vegetarian Café, there is a Chinese restaurant called Blue Spice. It is not family friendly.
name[Blue Spice], eatType[restaurant], food[Chinese], area[riverside], familyFriendly[yes], near[Rainbow Vegetarian Café]	Near the Rainbow Vegetarian Café, there is a family friendly Chinese restaurant called Blue Spice.
name[Blue Spice], eatType[restaurant], food[English], area[city centre], familyFriendly[no], near[Rainbow Vegetarian Café]	In the city centre near Rainbow Vegetarian Café, there is a restaurant called Blue Spice. It serves English food and is not family-friendly.
name[Blue Spice], eatType[restaurant], food[English], area[city centre], familyFriendly[yes], near[Rainbow Vegetarian Café]	In the city centre near Rainbow Vegetarian Café is a family-friendly restaurant serving English food.
name[Blue Spice], eatType[restaurant], food[English], area[riverside], familyFriendly[no], near[Rainbow Vegetarian Café]	In the riverside area near Rainbow Vegetarian Café, is a non family-friendly restaurant called Blue Spice.
name[Blue Spice], eatType[restaurant], food[English], area[riverside], familyFriendly[yes], near[Rainbow Vegetarian Café]	In the riverside area near Rainbow Vegetarian Café is a family friendly restaurant called Blue Spice.
name[Clowns], eatType[coffee shop], customer rating[3 out of 5], near[All Bar One]	For a coffee shop near All Bar One is Clowns.
name[Clowns], eatType[coffee shop], customer rating[5 out of 5], near[Crowne Plaza Hotel]	For a coffee shop near Crowne Plaza Hotel is Clowns.
name[Clowns], eatType[coffee shop], near[The Sorrento]	For a coffee shop near The Sorrento is Clowns.
name[Clowns], eatType[pub], customer rating[3 out of 5], near[All Bar One]	For a pub near All Bar One, Clowns is a pub.
name[Clowns], eatType[pub], customer rating[5 out of 5], near[Crowne Plaza Hotel]	For a pub near Crowne Plaza Hotel, Clowns is a pub.
name[Clowns], eatType[pub], near[The Sorrento]	For a pub near The Sorrento, Clowns is a pub.
name[Cocum], eatType[coffee shop], customer rating[high], near[Burger King]	For a coffee shop near Burger King is Cocum.
name[Cocum], eatType[coffee shop], customer rating[high], near[Café Sicilia]	For a coffee shop near Café Sicilia is Cocum.
name[Cocum], eatType[coffee shop], customer rating[low], near[Café Sicilia]	For a coffee shop near Café Sicilia is Cocum.
name[Cocum], eatType[coffee shop], customer rating[low], near[Express by Holiday Inn]	For a coffee shop near Express by Holiday Inn is Cocum.
name[Cocum], eatType[coffee shop], near[The Rice Boat]	For a coffee shop near The Rice Boat is Cocum.
name[Cocum], eatType[coffee shop], near[The Sorrento]	For a coffee shop near The Sorrento is Cocum.
name[Cocum], eatType[pub], customer rating[high], near[Burger King]	For a pub near Burger King, Cocum is a pub.
name[Cocum], eatType[pub], customer rating[high], near[Café Sicilia]	For a pub near Café Sicilia, Cocum is a pub.
name[Cocum], eatType[pub], customer rating[low], near[Café Sicilia]	For a pub near Café Sicilia, Cocum is a pub.
name[Cocum], eatType[pub], customer rating[low], near[Express by Holiday Inn]	For a pub near Express by Holiday Inn, Cocum is a pub.
name[Cocum], eatType[pub], near[The Rice Boat]	For a pub near The Rice Boat, Cocum is a pub.
name[Cocum], eatType[pub], near[The Sorrento]	For a pub near The Sorrento, Cocum is a pub.
name[Cotto], eatType[coffee shop], near[The Bakers]	For a coffee shop near The Bakers is Cotto.
name[Cotto], eatType[pub], near[The Bakers]	For a pub near The Bakers, Cotto is a pub.
name[Giraffe], eatType[coffee shop], near[The Bakers]	For a coffee shop near The Bakers is Giraffe.
name[Giraffe], eatType[coffee shop], near[The Rice Boat]	For a coffee shop near The Rice Boat is Giraffe.
name[Giraffe], eatType[pub], food[English], area[riverside], familyFriendly[yes], near[Rainbow Vegetarian Café]	In the riverside area, near Rainbow Vegetarian Café, is a family friendly pub called Giraffe.
name[Giraffe], eatType[pub], food[Fast food], area[city centre], familyFriendly[no], near[Rainbow Vegetarian Café]	In the city centre, near Rainbow Vegetarian Café, is a Fast food pub called Giraffe. It is not family-friendly.
name[Giraffe], eatType[pub], food[Fast food], area[city centre], familyFriendly[yes], near[Rainbow Vegetarian Café]	In the city centre, near Rainbow Vegetarian Café, is a family-friendly Fast food pub called Giraffe.
name[Giraffe], eatType[pub], food[Fast food], area[riverside], familyFriendly[no], near[Rainbow Vegetarian Café]	Near the Rainbow Vegetarian Café is a pub that is not family-friendly, and is a Fast food pub.
name[Giraffe], eatType[pub], food[Fast food], area[riverside], familyFriendly[yes], near[Rainbow Vegetarian Café]	In the riverside area, near Rainbow Vegetarian Café, is a family friendly pub called Giraffe.
name[Giraffe], eatType[pub], food[Fast food], area[riverside], familyFriendly[yes], near[Raja Indian Cuisine]	Near the Raja Indian Cuisine is a family friendly pub called Giraffe.
name[Giraffe], eatType[pub], food[French], area[city centre], familyFriendly[no], near[Raja Indian Cuisine]	In the city centre, near Raja Indian Cuisine, is a French pub called Giraffe. It is not family-friendly.
name[Giraffe], eatType[pub], food[French], area[city centre], familyFriendly[yes], near[Raja Indian Cuisine]	In the city centre, near Raja Indian Cuisine, is a French pub called Giraffe. It is family friendly.
name[Giraffe], eatType[pub], food[French], area[riverside], familyFriendly[no], near[Raja Indian Cuisine]	Near the Raja Indian Cuisine is a pub called Giraffe. It serves French food and is not family-friendly.
name[Giraffe], eatType[pub], food[French], area[riverside], familyFriendly[yes], near[Raja Indian Cuisine]	Near the Raja Indian Cuisine is a family friendly pub called Giraffe.
name[Giraffe], eatType[pub], near[The Bakers]	For a pub near The Bakers, Giraffe is a pub.
name[Giraffe], eatType[pub], near[The Rice Boat]	For a pub near The Rice Boat, Giraffe is a pub.
name[Giraffe], eatType[restaurant], food[English], area[riverside], familyFriendly[yes], near[Rainbow Vegetarian Café]	In the riverside area near Rainbow Vegetarian Café is a family friendly restaurant called Giraffe.
name[Giraffe], eatType[restaurant], food[Fast food], area[city centre], familyFriendly[no], near[Rainbow Vegetarian Café]	In the city centre, near Rainbow Vegetarian Café, there is a Fast food restaurant called Giraffe. It is not family-friendly.
name[Giraffe], eatType[restaurant], food[Fast food], area[city centre], familyFriendly[yes], near[Rainbow Vegetarian Café]	In the city centre, near Rainbow Vegetarian Café, is a family-friendly Fast food restaurant called Giraffe.
name[Giraffe], eatType[restaurant], food[Fast food], area[riverside], familyFriendly[no], near[Rainbow Vegetarian Café]	Near the Rainbow Vegetarian Café is a Fast food restaurant called Giraffe. It is not family-friendly.
name[Giraffe], eatType[restaurant], food[Fast food], area[riverside], familyFriendly[yes], near[Rainbow Vegetarian Café]	Near the Rainbow Vegetarian Café is a family friendly Fast food restaurant called Giraffe.
name[Giraffe], eatType[restaurant], food[Fast food], area[riverside], familyFriendly[yes], near[Raja Indian Cuisine]	In the riverside area, near Raja Indian Cuisine, is a family friendly Fast food restaurant called Giraffe.
name[Giraffe], eatType[restaurant], food[French], area[city centre], familyFriendly[no], near[Raja Indian Cuisine]	In the city centre, near Raja Indian Cuisine, there is a French restaurant called Giraffe. It is not family-friendly.
name[Giraffe], eatType[restaurant], food[French], area[city centre], familyFriendly[yes], near[Raja Indian Cuisine]	In the city centre, near Raja Indian Cuisine, is a French restaurant called Giraffe. It is family friendly.
name[Giraffe], eatType[restaurant], food[French], area[riverside], familyFriendly[no], near[Raja Indian Cuisine]	Near the Raja Indian Cuisine, there is a French restaurant called Giraffe. It is not family-friendly.
name[Giraffe], eatType[restaurant], food[French], area[riverside], familyFriendly[yes], near[Raja Indian Cuisine]	In the riverside area, near Raja Indian Cuisine, is a French restaurant called Giraffe. It is family friendly.
name[Green Man], eatType[coffee shop], customer rating[1 out of 5], near[All Bar One]	For a coffee shop near All Bar One is Green Man.
name[Green Man], eatType[coffee shop], customer rating[3 out of 5], near[All Bar One]	For a coffee shop near All Bar One is Green Man.
name[Green Man], eatType[pub], customer rating[1 out of 5], near[All Bar One]	For a pub near All Bar One, Green Man is a pub.
name[Green Man], eatType[pub], customer rating[3 out of 5], near[All Bar One]	For a pub near All Bar One, Green Man is a pub.
name[Green Man], eatType[pub], food[Italian], area[riverside], familyFriendly[yes], near[Express by Holiday Inn]	In the riverside area, near Express by Holiday Inn, is a family friendly pub called Green Man.
name[Green Man], eatType[pub], food[Italian], area[riverside], familyFriendly[yes], near[Raja Indian Cuisine]	For a family friendly pub serving Italian food, Green Man is located near Raja Indian Cuisine.
name[Green Man], eatType[pub], food[Japanese], area[city centre], familyFriendly[no], near[Express by Holiday Inn]	In the city centre, near Express by Holiday Inn, is a Japanese pub called Green Man. It is not family-friendly.
name[Green Man], eatType[pub], food[Japanese], area[city centre], familyFriendly[yes], near[Express by Holiday Inn]	In the city centre, near Express by Holiday Inn, is a family-friendly pub called Green Man.
name[Green Man], eatType[pub], food[Japanese], area[riverside], familyFriendly[no], near[Express by Holiday Inn]	Near the Express by Holiday Inn, there is a pub called Green Man. It serves Japanese food and is not family-friendly.
name[Green Man], eatType[pub], food[Japanese], area[riverside], familyFriendly[yes], near[Express by Holiday Inn]	In the riverside area, near Express by Holiday Inn, is a family friendly pub called Green Man.
name[Green Man], eatType[restaurant], food[Italian], area[riverside], familyFriendly[yes], near[Express by Holiday Inn]	For a family friendly Italian restaurant, Green Man, is located near Express by Holiday Inn.
name[Green Man], eatType[restaurant], food[Italian], area[riverside], familyFriendly[yes], near[Raja Indian Cuisine]	In the riverside area, near Raja Indian Cuisine, is a family friendly restaurant called Green Man.
name[Green Man], eatType[restaurant], food[Japanese], area[city centre], familyFriendly[no], near[Express by Holiday Inn]	In the city centre near Express by Holiday Inn, there is a Japanese restaurant called Green Man. It is not family-friendly.
name[Green Man], eatType[restaurant], food[Japanese], area[city centre], familyFriendly[yes], near[Express by Holiday Inn]	In the city centre near Express by Holiday Inn is a Japanese restaurant called Green Man. It is family friendly.
name[Green Man], eatType[restaurant], food[Japanese], area[riverside], familyFriendly[no], near[Express by Holiday Inn]	Near the Express by Holiday Inn, there is a Japanese restaurant called Green Man. It is not family-friendly.
name[Green Man], eatType[restaurant], food[Japanese], area[riverside], familyFriendly[yes], near[Express by Holiday Inn]	Near the Express by Holiday Inn is a family friendly restaurant called Green Man.
name[Loch Fyne], eatType[coffee shop], area[riverside]	For a coffee shop in the riverside area, Loch Fyne is a coffee shop.
name[Loch Fyne], eatType[pub], area[riverside]	For a pub in the riverside area, Loch Fyne is a pub.
name[Strada], eatType[coffee shop], area[city centre]	In the city centre is a coffee shop called Strada.
name[Strada], eatType[coffee shop], customer rating[1 out of 5], near[All Bar One]	For a coffee shop near All Bar One is Strada.
name[Strada], eatType[coffee shop], customer rating[1 out of 5], near[Rainbow Vegetarian Café]	For a coffee shop near Rainbow Vegetarian Café is Strada.
name[Strada], eatType[coffee shop], customer rating[low], near[Express by Holiday Inn]	For a coffee shop near Express by Holiday Inn is Strada.
name[Strada], eatType[pub], area[city centre]	In the city centre is a pub called Strada.
name[Strada], eatType[pub], customer rating[1 out of 5], near[All Bar One]	For a pub near All Bar One, Strada is a pub.
name[Strada], eatType[pub], customer rating[1 out of 5], near[Rainbow Vegetarian Café]	For a pub near Rainbow Vegetarian Café, Strada is a pub.
name[Strada], eatType[pub], customer rating[low], near[Express by Holiday Inn]	For a pub near Express by Holiday Inn, Strada is a pub.
name[The Cricketers], eatType[coffee shop], customer rating[1 out of 5], familyFriendly[yes], near[Avalon]	For a family friendly coffee shop near Avalon.
name[The Cricketers], eatType[coffee shop], customer rating[3 out of 5], familyFriendly[yes], near[Avalon]	For a family friendly coffee shop near Avalon.
name[The Cricketers], eatType[coffee shop], customer rating[3 out of 5], familyFriendly[yes], near[Crowne Plaza Hotel]	For a family friendly coffee shop near Crowne Plaza Hotel.
name[The Cricketers], eatType[coffee shop], customer rating[5 out of 5], familyFriendly[no], near[Crowne Plaza Hotel]	For a coffee shop with a non-friendly environment and is near Crowne Plaza Hotel.
name[The Cricketers], eatType[coffee shop], customer rating[5 out of 5], familyFriendly[yes], near[Crowne Plaza Hotel]	For a family friendly coffee shop near Crowne Plaza Hotel.
name[The Cricketers], eatType[coffee shop], customer rating[average], familyFriendly[no], near[Café Sicilia]	For a coffee shop near Café Sicilia, is not family-friendly.
name[The Cricketers], eatType[coffee shop], customer rating[average], familyFriendly[no], near[Crowne Plaza Hotel]	For a coffee shop with a non-friendly environment and is near Crowne Plaza Hotel.
name[The Cricketers], eatType[coffee shop], customer rating[average], familyFriendly[yes], near[Café Sicilia]	For a family friendly coffee shop near Café Sicilia.
name[The Cricketers], eatType[coffee shop], customer rating[high], familyFriendly[yes], near[Café Sicilia]	For a family friendly coffee shop near Café Sicilia.
name[The Cricketers], eatType[coffee shop], customer rating[high], familyFriendly[yes], near[Express by Holiday Inn]	For a family friendly coffee shop near Express by Holiday Inn.
name[The Cricketers], eatType[coffee shop], customer rating[low], familyFriendly[no], near[Express by Holiday Inn]	Near Express by Holiday Inn is a coffee shop that is not family-friendly.
name[The Cricketers], eatType[coffee shop], customer rating[low], familyFriendly[no], near[Ranch]	For a coffee shop with a non-friendly environment and is near Ranch.
name[The Cricketers], eatType[coffee shop], customer rating[low], familyFriendly[yes], near[Ranch]	For a family friendly coffee shop near Ranch.
name[The Cricketers], eatType[restaurant], customer rating[1 out of 5], familyFriendly[yes], near[Avalon]	For a family friendly restaurant, The Cricketers is located near Avalon.
name[The Cricketers], eatType[restaurant], customer rating[3 out of 5], familyFriendly[yes], near[Avalon]	For a family friendly restaurant, The Cricketers is located near Avalon.
name[The Cricketers], eatType[restaurant], customer rating[3 out of 5], familyFriendly[yes], near[Crowne Plaza Hotel]	For a family friendly restaurant, The Cricketers is located near Crowne Plaza Hotel.
name[The Cricketers], eatType[restaurant], customer rating[5 out of 5], familyFriendly[no], near[Crowne Plaza Hotel]	There is a restaurant near Crowne Plaza Hotel, The Cricketers is not family-friendly.
name[The Cricketers], eatType[restaurant], customer rating[5 out of 5], familyFriendly[yes], near[Crowne Plaza Hotel]	For a family friendly restaurant, The Cricketers is located near Crowne Plaza Hotel.
name[The Cricketers], eatType[restaurant], customer rating[average], familyFriendly[no], near[Café Sicilia]	For a restaurant with a non-friendly environment and is near Café Sicilia.
name[The Cricketers], eatType[restaurant], customer rating[average], familyFriendly[no], near[Crowne Plaza Hotel]	There is a restaurant near Crowne Plaza Hotel, The Cricketers is not family-friendly.
name[The Cricketers], eatType[restaurant], customer rating[average], familyFriendly[yes], near[Café Sicilia]	For a family friendly restaurant, The Cricketers is located near Café Sicilia.
name[The Cricketers], eatType[restaurant], customer rating[high], familyFriendly[yes], near[Café Sicilia]	For a family friendly restaurant, The Cricketers is located near Café Sicilia.
name[The Cricketers], eatType[restaurant], customer rating[high], familyFriendly[yes], near[Express by Holiday Inn]	For a family friendly restaurant, The Cricketers is located near Express by Holiday Inn.
name[The Cricketers], eatType[restaurant], customer rating[low], familyFriendly[no], near[Express by Holiday Inn]	There is a restaurant near Express by Holiday Inn, The Cricketers is not family-friendly.
name[The Cricketers], eatType[restaurant], customer rating[low], familyFriendly[no], near[Ranch]	There is a restaurant near Ranch, The Cricketers is not family-friendly.
name[The Cricketers], eatType[restaurant], customer rating[low], familyFriendly[yes], near[Ranch]	For a family friendly restaurant, The Cricketers is a restaurant.
name[The Cricketers], eatType[restaurant], food[Chinese], priceRange[£20-25], customer rating[high], area[city centre], familyFriendly[no], near[All Bar One]	In the city centre, near All Bar One, is a Chinese restaurant called The Cricketers. It is not kid friendly and has a price range of £20-25.
name[The Cricketers], eatType[restaurant], food[Chinese], priceRange[£20-25], customer rating[high], area[city centre], familyFriendly[yes], near[All Bar One]	In the city centre, near All Bar One, is a kid friendly Chinese restaurant called The Cricketers. It is in the £20-25 price range.
name[The Cricketers], eatType[restaurant], food[Chinese], priceRange[£20-25], customer rating[high], area[riverside], familyFriendly[no], near[All Bar One]	In the riverside area, The Cricketers is a Chinese restaurant with a price range of £20-25. It is not kid friendly.
name[The Cricketers], eatType[restaurant], food[Chinese], priceRange[£20-25], customer rating[high], area[riverside], familyFriendly[yes], near[All Bar One]	Near the All Bar One, there is a kid friendly Chinese restaurant called The Cricketers. It is in the £20-25 price range.
name[The Cricketers], eatType[restaurant], food[Chinese], priceRange[cheap], customer rating[5 out of 5], area[city centre], familyFriendly[no], near[All Bar One]	In the city centre, near All Bar One, there is a cheap Chinese restaurant called The Cricketers. It is not family friendly.
name[The Cricketers], eatType[restaurant], food[Chinese], priceRange[cheap], customer rating[5 out of 5], area[city centre], familyFriendly[yes], near[All Bar One]	There is a cheap Chinese restaurant in the city centre, near All Bar One called The Cricketers. It is family friendly.
name[The Cricketers], eatType[restaurant], food[Chinese], priceRange[cheap], customer rating[5 out of 5], area[riverside], familyFriendly[no], near[All Bar One]	In the riverside area near All Bar One, there is a cheap Chinese restaurant called The Cricketers. It is not family friendly.
name[The Cricketers], eatType[restaurant], food[Chinese], priceRange[cheap], customer rating[5 out of 5], area[riverside], familyFriendly[yes], near[All Bar One]	There is a cheap Chinese restaurant called The Cricketers, located near All Bar One in the riverside area. It is family friendly.
name[The Cricketers], eatType[restaurant], food[Chinese], priceRange[cheap], customer rating[average], area[city centre], familyFriendly[no], near[All Bar One]	In the city centre, near All Bar One, there is a cheap Chinese restaurant called The Cricketers. It is not family friendly.
name[The Cricketers], eatType[restaurant], food[Chinese], priceRange[cheap], customer rating[average], area[city centre], familyFriendly[yes], near[All Bar One]	In the city centre, near All Bar One, is a cheap Chinese restaurant called The Cricketers. It is family friendly.
name[The Cricketers], eatType[restaurant], food[Chinese], priceRange[cheap], customer rating[average], area[riverside], familyFriendly[no], near[All Bar One]	Near All Bar One, there is a cheap restaurant that serves Chinese food. It is called The Cricketers.
name[The Cricketers], eatType[restaurant], food[Chinese], priceRange[cheap], customer rating[average], area[riverside], familyFriendly[yes], near[All Bar One]	There is a cheap Chinese restaurant called The Cricketers, near All Bar One in riverside.
name[The Cricketers], eatType[restaurant], food[Chinese], priceRange[high], customer rating[1 out of 5], area[city centre], familyFriendly[no], near[All Bar One]	In the city centre, near All Bar One, there is a Chinese restaurant called The Cricketers. It is not child friendly and has a high price range.
name[The Cricketers], eatType[restaurant], food[Chinese], priceRange[high], customer rating[1 out of 5], area[city centre], familyFriendly[yes], near[All Bar One]	In the city centre, near All Bar One, there is a high priced Chinese restaurant called The Cricketers. It is child friendly.
name[The Cricketers], eatType[restaurant], food[Chinese], priceRange[high], customer rating[1 out of 5], area[riverside], familyFriendly[no], near[All Bar One]	Near the All Bar One, there is a high priced Chinese restaurant called The Cricketers. It is not child friendly.
name[The Cricketers], eatType[restaurant], food[Chinese], priceRange[high], customer rating[1 out of 5], area[riverside], familyFriendly[yes], near[All Bar One]	There is a high priced Chinese restaurant in the riverside area near All Bar One called The Cricketers.
name[The Cricketers], eatType[restaurant], food[Chinese], priceRange[high], customer rating[average], area[city centre], familyFriendly[no], near[All Bar One]	In the city centre, near All Bar One, there is a Chinese restaurant called The Cricketers. It is not child friendly and has a high price range.
name[The Cricketers], eatType[restaurant], food[Chinese], priceRange[high], customer rating[average], area[city centre], familyFriendly[yes], near[All Bar One]	There is a high priced Chinese restaurant called The Cricketers. It is located in the city centre near All Bar One.
name[The Cricketers], eatType[restaurant], food[Chinese], priceRange[high], customer rating[average], area[riverside], familyFriendly[no], near[All Bar One]	There is a high priced Chinese restaurant in the riverside area near All Bar One. It is called The Cricketers.
name[The Cricketers], eatType[restaurant], food[Chinese], priceRange[high], customer rating[average], area[riverside], familyFriendly[yes], near[All Bar One]	Near the All Bar One is a high priced restaurant that is family friendly.
name[The Cricketers], eatType[restaurant], food[Chinese], priceRange[less than £20], customer rating[low], area[city centre], familyFriendly[no], near[All Bar One]	In the city centre, near All Bar One, is a Chinese restaurant called The Cricketers. It is not family friendly and has a price range of less than £20.
name[The Cricketers], eatType[restaurant], food[Chinese], priceRange[less than £20], customer rating[low], area[city centre], familyFriendly[yes], near[All Bar One]	There is a family friendly Chinese restaurant called The Cricketers, near All Bar One in the city centre. It is a family friendly restaurant.
name[The Cricketers], eatType[restaurant], food[Chinese], priceRange[less than £20], customer rating[low], area[riverside], familyFriendly[no], near[All Bar One]	Near the All Bar One, there is a Chinese restaurant called The Cricketers. It is not family friendly and has a price range of less than £20.
name[The Cricketers], eatType[restaurant], food[Chinese], priceRange[less than £20], customer rating[low], area[riverside], familyFriendly[yes], near[All Bar One]	For a family friendly Chinese restaurant, The Cricketers, is located near All Bar One.
name[The Cricketers], eatType[restaurant], food[Chinese], priceRange[moderate], customer rating[1 out of 5], area[city centre], familyFriendly[no], near[All Bar One]	In the city centre, near All Bar One, there is a Chinese restaurant called The Cricketers. It is not kid friendly and has a moderate price range.
name[The Cricketers], eatType[restaurant], food[Chinese], priceRange[moderate], customer rating[1 out of 5], area[city centre], familyFriendly[yes], near[All Bar One]	There is a kid friendly Chinese restaurant called The Cricketers in the city centre near All Bar One. It is moderately priced.
name[The Cricketers], eatType[restaurant], food[Chinese], priceRange[moderate], customer rating[1 out of 5], area[riverside], familyFriendly[no], near[All Bar One]	There is a Chinese restaurant called The Cricketers in riverside near All Bar One. It is not kid friendly and has a moderate price range.
name[The Cricketers], eatType[restaurant], food[Chinese], priceRange[moderate], customer rating[1 out of 5], area[riverside], familyFriendly[yes], near[All Bar One]	There is a kid friendly Chinese restaurant called The Cricketers in riverside near All Bar One.
name[The Cricketers], eatType[restaurant], food[Chinese], priceRange[moderate], customer rating[3 out of 5], area[city centre], familyFriendly[no], near[All Bar One]	There is a Chinese restaurant called The Cricketers in the city centre, near All Bar One, is not kid friendly and has a moderate price range.
name[The Cricketers], eatType[restaurant], food[Chinese], priceRange[moderate], customer rating[3 out of 5], area[city centre], familyFriendly[yes], near[All Bar One]	There is a Chinese restaurant called The Cricketers in the city centre, near All Bar One. It is kid friendly and has a moderate price range.
name[The Cricketers], eatType[restaurant], food[Chinese], priceRange[moderate], customer rating[3 out of 5], area[riverside], familyFriendly[no], near[All Bar One]	The Cricketers is a Chinese restaurant in the riverside area near All Bar One. It is not kid friendly and has a moderate price range.
name[The Cricketers], eatType[restaurant], food[Chinese], priceRange[moderate], customer rating[3 out of 5], area[riverside], familyFriendly[yes], near[All Bar One]	There is a kid friendly Chinese restaurant called The Cricketers in riverside near All Bar One.
name[The Cricketers], eatType[restaurant], food[Chinese], priceRange[more than £30], customer rating[high], area[city centre], familyFriendly[no], near[All Bar One]	In the city centre, near All Bar One, there is a Chinese restaurant called The Cricketers. It is not child friendly and has a price range of more than £30.
name[The Cricketers], eatType[restaurant], food[Chinese], priceRange[more than £30], customer rating[high], area[city centre], familyFriendly[yes], near[All Bar One]	In the city centre, near All Bar One, is a Chinese restaurant called The Cricketers. It is a child friendly restaurant with a price range of more than £30.
name[The Cricketers], eatType[restaurant], food[Chinese], priceRange[more than £30], customer rating[high], area[riverside], familyFriendly[no], near[All Bar One]	Near the All Bar One, there is a Chinese restaurant called The Cricketers. It is not child friendly and has a price range of more than £30.
name[The Cricketers], eatType[restaurant], food[Chinese], priceRange[more than £30], customer rating[high], area[riverside], familyFriendly[yes], near[All Bar One]	Near All Bar One, there is a Chinese restaurant called The Cricketers. It is a child friendly restaurant with a price range of more than £30.
name[The Cricketers], eatType[restaurant], food[English], priceRange[£20-25], customer rating[high], area[city centre], familyFriendly[no], near[All Bar One]	In the city centre, near All Bar One, is a restaurant called The Cricketers. It serves English food and is not kid friendly and has a price range of £20-25.
name[The Cricketers], eatType[restaurant], food[English], priceRange[£20-25], customer rating[high], area[city centre], familyFriendly[yes], near[All Bar One]	In the city centre near All Bar One is a kid friendly restaurant called The Cricketers. It serves English food and has a price range of £20-25.
name[The Cricketers], eatType[restaurant], food[English], priceRange[£20-25], customer rating[high], area[riverside], familyFriendly[no], near[All Bar One]	In the riverside area, near All Bar One, is a restaurant called The Cricketers. It serves English food and is not kid friendly.
name[The Cricketers], eatType[restaurant], food[English], priceRange[£20-25], customer rating[high], area[riverside], familyFriendly[yes], near[All Bar One]	In the riverside area near All Bar One is a kid friendly restaurant called The Cricketers. It serves English food and has a price range of £20-25.
name[The Cricketers], eatType[restaurant], food[English], priceRange[cheap], customer rating[5 out of 5], area[city centre], familyFriendly[no], near[Café Rouge]	In the city centre, near Café Rouge, is a cheap restaurant called The Cricketers. It serves English food and is not family-friendly.
name[The Cricketers], eatType[restaurant], food[English], priceRange[cheap], customer rating[5 out of 5], area[city centre], familyFriendly[yes], near[Café Rouge]	In the city centre, near Café Rouge, is a cheap restaurant called The Cricketers. It serves English food and is family-friendly.
name[The Cricketers], eatType[restaurant], food[English], priceRange[cheap], customer rating[5 out of 5], area[riverside], familyFriendly[no], near[Café Rouge]	In the riverside area near Café Rouge, is a cheap restaurant called The Cricketers. It serves English food and is not family-friendly.
name[The Cricketers], eatType[restaurant], food[English], priceRange[cheap], customer rating[5 out of 5], area[riverside], familyFriendly[yes], near[Café Rouge]	In the riverside area near Café Rouge, is a cheap restaurant called The Cricketers. It serves English food and is family friendly.
name[The Cricketers], eatType[restaurant], food[English], priceRange[cheap], customer rating[average], area[city centre], familyFriendly[no], near[Café Rouge]	In the city centre, near Café Rouge, is a cheap restaurant called The Cricketers. It serves English food and is not family-friendly.
name[The Cricketers], eatType[restaurant], food[English], priceRange[cheap], customer rating[average], area[city centre], familyFriendly[yes], near[Café Rouge]	In the city centre, near Café Rouge, is a cheap restaurant called The Cricketers. It serves English food and is family-friendly.
name[The Cricketers], eatType[restaurant], food[English], priceRange[cheap], customer rating[average], area[riverside], familyFriendly[no], near[Café Rouge]	In the riverside area near Café Rouge, is a cheap restaurant called The Cricketers. It serves English food and is not family-friendly.
name[The Cricketers], eatType[restaurant], food[English], priceRange[cheap], customer rating[average], area[riverside], familyFriendly[yes], near[Café Rouge]	In the riverside area near Café Rouge is a family friendly restaurant called The Cricketers. It serves English food and is cheap.
name[The Cricketers], eatType[restaurant], food[English], priceRange[high], customer rating[1 out of 5], area[city centre], familyFriendly[no], near[Café Rouge]	In the city centre near Café Rouge is a high priced English restaurant called The Cricketers. It is not child friendly.
name[The Cricketers], eatType[restaurant], food[English], priceRange[high], customer rating[1 out of 5], area[city centre], familyFriendly[yes], near[Café Rouge]	In the city centre near Café Rouge is a high priced restaurant called The Cricketers. It serves English food and is child friendly.
name[The Cricketers], eatType[restaurant], food[English], priceRange[high], customer rating[1 out of 5], area[riverside], familyFriendly[no], near[Café Rouge]	In the riverside area near Café Rouge is a high priced restaurant called The Cricketers. It serves English food and is not child friendly.
name[The Cricketers], eatType[restaurant], food[English], priceRange[high], customer rating[1 out of 5], area[riverside], familyFriendly[yes], near[Café Rouge]	In the riverside area near Café Rouge is a high priced restaurant called The Cricketers.
name[The Cricketers], eatType[restaurant], food[English], priceRange[high], customer rating[average], area[city centre], familyFriendly[no], near[Café Rouge]	In the city centre near Café Rouge is a high priced English restaurant called The Cricketers. It is not child friendly.
name[The Cricketers], eatType[restaurant], food[English], priceRange[high], customer rating[average], area[city centre], familyFriendly[yes], near[Café Rouge]	In the city centre area near Café Rouge is a high priced restaurant called The Cricketers.
name[The Cricketers], eatType[restaurant], food[English], priceRange[high], customer rating[average], area[riverside], familyFriendly[no], near[Café Rouge]	In the riverside area near Café Rouge is a high priced restaurant called The Cricketers. It serves English food and is not child friendly.
name[The Mill], eatType[pub], food[English], priceRange[high], area[riverside], familyFriendly[yes], near[Raja Indian Cuisine]	In the riverside area near Raja Indian Cuisine is a child friendly pub called The Mill. It serves English food and is high priced.
name[The Mill], eatType[pub], food[English], priceRange[less than £20], area[city centre], familyFriendly[no], near[Raja Indian Cuisine]	In the city centre, near Raja Indian Cuisine, is a pub called The Mill. It serves English food for less than £20. It is not family-friendly.
name[The Mill], eatType[pub], food[English], priceRange[less than £20], area[city centre], familyFriendly[yes], near[Raja Indian Cuisine]	In the city centre, near Raja Indian Cuisine, is a family-friendly pub serving English food. It is called The Mill.
name[The Mill], eatType[pub], food[English], priceRange[less than £20], area[riverside], familyFriendly[no], near[Raja Indian Cuisine]	In the riverside area near Raja Indian Cuisine, is a pub called The Mill. It serves English food and is not family-friendly.
name[The Mill], eatType[pub], food[English], priceRange[less than £20], area[riverside], familyFriendly[yes], near[Raja Indian Cuisine]	In the riverside area near Raja Indian Cuisine is a family friendly pub called The Mill. It serves English food for less than £20.
name[The Mill], eatType[pub], food[English], priceRange[moderate], area[city centre], familyFriendly[no], near[Raja Indian Cuisine]	In the city centre, near Raja Indian Cuisine, is a pub called The Mill. It serves English food and is not kid friendly.
name[The Mill], eatType[pub], food[English], priceRange[moderate], area[city centre], familyFriendly[yes], near[Raja Indian Cuisine]	In the city centre, near Raja Indian Cuisine, is a family-friendly pub called The Mill. It serves English food and is moderately priced.
name[The Mill], eatType[pub], food[English], priceRange[moderate], area[riverside], familyFriendly[no], near[Raja Indian Cuisine]	Near Raja Indian Cuisine, is a pub called The Mill. It serves English food and is not kid friendly.
name[The Mill], eatType[pub], food[English], priceRange[moderate], area[riverside], familyFriendly[yes], near[Raja Indian Cuisine]	Near Raja Indian Cuisine in the riverside area is a kid friendly pub that serves English food at a moderate price.
name[The Mill], eatType[pub], food[English], priceRange[more than £30], area[riverside], familyFriendly[yes], near[Raja Indian Cuisine]	Near the Raja Indian Cuisine is a child friendly pub that serves English food at a price range of more than £30.
name[The Mill], eatType[pub], food[Fast food], priceRange[£20-25], area[riverside], familyFriendly[yes], near[Raja Indian Cuisine]	There is a kid friendly pub that serves Fast food, The Mill, is located near Raja Indian Cuisine.
name[The Mill], eatType[pub], food[Fast food], priceRange[£20-25], customer rating[high], area[city centre], familyFriendly[no], near[Café Rouge]	In the city centre, near Café Rouge, is a Fast food pub called The Mill. It is not kid friendly and has a price range of £20-25.
name[The Mill], eatType[pub], food[Fast food], priceRange[£20-25], customer rating[high], area[city centre], familyFriendly[yes], near[Café Rouge]	In the city centre, near Café Rouge, is a Fast food pub called The Mill. It is kid friendly and has a price range of £20-25.
name[The Mill], eatType[pub], food[Fast food], priceRange[£20-25], customer rating[high], area[riverside], familyFriendly[no], near[Café Rouge]	There is a pub called The Mill, near Café Rouge. It is not kid friendly and serves Fast food and is in the £20-25 price range.
name[The Mill], eatType[pub], food[Fast food], priceRange[£20-25], customer rating[high], area[riverside], familyFriendly[yes], near[Café Rouge]	There is a kid friendly pub that serves Fast food, The Mill, is located near Café Rouge.
name[The Mill], eatType[pub], food[Fast food], priceRange[£20-25], customer rating[high], area[riverside], familyFriendly[yes], near[Café Sicilia]	There is a kid friendly pub that serves Fast food, The Mill, is located near Café Sicilia.
name[The Mill], eatType[pub], food[Fast food], priceRange[cheap], area[riverside], familyFriendly[yes], near[Raja Indian Cuisine]	Near Raja Indian Cuisine, is a cheap pub that is family friendly, and serves Fast food.
name[The Mill], eatType[pub], food[Fast food], priceRange[cheap], customer rating[5 out of 5], area[city centre], familyFriendly[no], near[Café Sicilia]	In the city centre, near Café Sicilia, is a cheap Fast food pub called The Mill. It is not family-friendly.
name[The Mill], eatType[pub], food[Fast food], priceRange[cheap], customer rating[5 out of 5], area[city centre], familyFriendly[yes], near[Café Sicilia]	There is a cheap pub that serves Fast food, is family-friendly, The Mill, is located near Café Sicilia in the city centre.
name[The Mill], eatType[pub], food[Fast food], priceRange[cheap], customer rating[5 out of 5], area[riverside], familyFriendly[no], near[Café Sicilia]	Near the Café Sicilia, there is a cheap Fast food pub called The Mill. It is not family-friendly.
name[The Mill], eatType[pub], food[Fast food], priceRange[cheap], customer rating[5 out of 5], area[riverside], familyFriendly[yes], near[Café Sicilia]	Near Café Sicilia, is a cheap pub that is family friendly, and serves Fast food.
name[The Mill], eatType[pub], food[Fast food], priceRange[cheap], customer rating[average], area[city centre], familyFriendly[no], near[Café Sicilia]	In the city centre, near Café Sicilia, is a cheap Fast food pub called The Mill. It is not family-friendly.
name[The Mill], eatType[pub], food[Fast food], priceRange[cheap], customer rating[average], area[city centre], familyFriendly[yes], near[Café Sicilia]	In the city centre, near Café Sicilia, is a cheap Fast food pub called The Mill. It is family-friendly.
name[The Mill], eatType[pub], food[Fast food], priceRange[cheap], customer rating[average], area[riverside], familyFriendly[no], near[Café Sicilia]	Near the Café Sicilia, is a cheap pub called The Mill. It is not family friendly.
name[The Mill], eatType[pub], food[Fast food], priceRange[cheap], customer rating[average], area[riverside], familyFriendly[yes], near[Café Sicilia]	There is a cheap pub that serves Fast food, is family friendly, and is located near Café Sicilia in the riverside area.
name[The Mill], eatType[pub], food[Fast food], priceRange[high], customer rating[1 out of 5], area[city centre], familyFriendly[no], near[Café Sicilia]	In the city centre, near Café Sicilia, is a high priced Fast food pub called The Mill.
name[The Mill], eatType[pub], food[Fast food], priceRange[high], customer rating[1 out of 5], area[city centre], familyFriendly[yes], near[Café Sicilia]	There is a high priced pub that is family friendly, serving Fast food, is located near Café Sicilia in the city centre.
name[The Mill], eatType[pub], food[Fast food], priceRange[high], customer rating[1 out of 5], area[riverside], familyFriendly[no], near[Café Sicilia]	There is a high priced pub that serves Fast food, is located near Café Sicilia in the riverside area. It is not child friendly.
name[The Mill], eatType[pub], food[Fast food], priceRange[high], customer rating[1 out of 5], area[riverside], familyFriendly[yes], near[Café Sicilia]	There is a high priced pub that is family friendly, and serves Fast food. It is located near Café Sicilia in the riverside area.
name[The Mill], eatType[pub], food[Fast food], priceRange[high], customer rating[average], area[city centre], familyFriendly[no], near[Café Sicilia]	In the city centre, near Café Sicilia, is a high priced Fast food pub called The Mill. It is not child friendly.
name[The Mill], eatType[pub], food[Fast food], priceRange[high], customer rating[average], area[city centre], familyFriendly[yes], near[Café Sicilia]	There is a pub called The Mill that serves Fast food. It is a child friendly pub in the city centre near Café Sicilia.
name[The Mill], eatType[pub], food[Fast food], priceRange[high], customer rating[average], area[riverside], familyFriendly[no], near[Café Sicilia]	There is a high priced pub that serves Fast food, is located near Café Sicilia in the riverside area. It is not child friendly.
name[The Mill], eatType[pub], food[Fast food], priceRange[high], customer rating[average], area[riverside], familyFriendly[yes], near[Café Sicilia]	Near the Café Sicilia is a high priced pub that is family friendly.
name[The Mill], eatType[pub], food[Fast food], priceRange[less than £20], customer rating[low], area[city centre], familyFriendly[no], near[Café Sicilia]	In the city centre, near Café Sicilia, is a Fast food pub called The Mill. It is not family-friendly and has a price range of less than £20.
name[The Mill], eatType[pub], food[Fast food], priceRange[less than £20], customer rating[low], area[city centre], familyFriendly[yes], near[Café Sicilia]	There is a family-friendly pub serving Fast food, The Mill, is located near Café Sicilia in the city centre.
name[The Mill], eatType[pub], food[Fast food], priceRange[less than £20], customer rating[low], area[riverside], familyFriendly[no], near[Café Sicilia]	Near the Café Sicilia, is a pub that serves Fast food at a price range of less than £20. It is not family-friendly.
name[The Mill], eatType[pub], food[Fast food], priceRange[less than £20], customer rating[low], area[riverside], familyFriendly[yes], near[Café Sicilia]	For a family friendly pub that is a Fast food pub near Café Sicilia in the riverside area.
name[The Mill], eatType[pub], food[Fast food], priceRange[moderate], customer rating[1 out of 5], area[city centre], familyFriendly[no], near[Café Sicilia]	In the city centre, near Café Sicilia, is a Fast food pub called The Mill. It is not kid friendly and has a moderate price range.
name[The Mill], eatType[pub], food[Fast food], priceRange[moderate], customer rating[1 out of 5], area[city centre], familyFriendly[yes], near[Café Sicilia]	There is a kid-friendly pub serving Fast food, The Mill, is located near Café Sicilia in the city centre.
name[The Mill], eatType[pub], food[Fast food], priceRange[moderate], customer rating[1 out of 5], area[riverside], familyFriendly[no], near[Café Sicilia]	Near the Café Sicilia, there is a pub called The Mill. It is not kid friendly and serves Fast food at a moderate price range.
name[The Mill], eatType[pub], food[Fast food], priceRange[moderate], customer rating[1 out of 5], area[riverside], familyFriendly[yes], near[Café Sicilia]	There is a kid friendly pub that serves Fast food, is located near Café Sicilia in the riverside area.
name[The Mill], eatType[pub], food[Fast food], priceRange[moderate], customer rating[3 out of 5], area[city centre], familyFriendly[no], near[Café Sicilia]	In the city centre, near Café Sicilia, is a Fast food pub called The Mill. It is not kid friendly and has a moderate price range.
name[The Mill], eatType[pub], food[Fast food], priceRange[moderate], customer rating[3 out of 5], area[city centre], familyFriendly[yes], near[Café Sicilia]	In the city centre, near Café Sicilia, is a pub called The Mill. It serves Fast food and is kid friendly.
name[The Mill], eatType[pub], food[Fast food], priceRange[moderate], customer rating[3 out of 5], area[riverside], familyFriendly[no], near[Café Sicilia]	Near Café Sicilia in the riverside area is a pub called The Mill. It serves Fast food and is not kid friendly.
name[The Mill], eatType[pub], food[Fast food], priceRange[moderate], customer rating[3 out of 5], area[riverside], familyFriendly[yes], near[Café Sicilia]	Near Café Sicilia, is a pub that is kid friendly and serves Fast food. It is moderately priced and is located near Café Sicilia.
name[The Mill], eatType[restaurant], food[English], priceRange[high], area[riverside], familyFriendly[yes], near[Raja Indian Cuisine]	In the riverside area near Raja Indian Cuisine is a high priced restaurant called The Mill.
name[The Mill], eatType[restaurant], food[English], priceRange[high], customer rating[average], area[riverside], familyFriendly[yes], near[Café Rouge]	In the riverside area near Café Rouge is a high priced restaurant that serves English food.
name[The Mill], eatType[restaurant], food[English], priceRange[less than £20], area[city centre], familyFriendly[no], near[Raja Indian Cuisine]	In the city centre, near Raja Indian Cuisine, is a non family-friendly English restaurant called The Mill. It is not family-friendly.
name[The Mill], eatType[restaurant], food[English], priceRange[less than £20], area[city centre], familyFriendly[yes], near[Raja Indian Cuisine]	In the city centre near Raja Indian Cuisine is a family-friendly restaurant that serves English food for less than £20.
name[The Mill], eatType[restaurant], food[English], priceRange[less than £20], area[riverside], familyFriendly[no], near[Raja Indian Cuisine]	In the riverside area near Raja Indian Cuisine, is a non family friendly restaurant serving English food at less than £20.
name[The Mill], eatType[restaurant], food[English], priceRange[less than £20], area[riverside], familyFriendly[yes], near[Raja Indian Cuisine]	In the riverside area near Raja Indian Cuisine is a family friendly restaurant called The Mill. It serves English food for less than £20.
name[The Mill], eatType[restaurant], food[English], priceRange[less than £20], customer rating[low], area[city centre], familyFriendly[no], near[Café Rouge]	In the city centre, near Café Rouge, is a non family-friendly English restaurant called The Mill. It is not family-friendly.
name[The Mill], eatType[restaurant], food[English], priceRange[less than £20], customer rating[low], area[city centre], familyFriendly[yes], near[Café Rouge]	In the city centre, near Café Rouge, is a family-friendly restaurant called The Mill. It serves English food for less than £20.
name[The Mill], eatType[restaurant], food[English], priceRange[less than £20], customer rating[low], area[riverside], familyFriendly[no], near[Café Rouge]	In the riverside area near Café Rouge, is a non family friendly restaurant serving English food at less than £20.
name[The Mill], eatType[restaurant], food[English], priceRange[less than £20], customer rating[low], area[riverside], familyFriendly[yes], near[Café Rouge]	In the riverside area near Café Rouge is a family friendly restaurant called The Mill. It serves English food for less than £20.
name[The Mill], eatType[restaurant], food[English], priceRange[moderate], area[city centre], familyFriendly[no], near[Raja Indian Cuisine]	In the city centre, near Raja Indian Cuisine, is a restaurant called The Mill. It serves English food and is not kid friendly.
name[The Mill], eatType[restaurant], food[English], priceRange[moderate], area[city centre], familyFriendly[yes], near[Raja Indian Cuisine]	In the city centre, near Raja Indian Cuisine, is a family friendly restaurant called The Mill. It serves English food and is moderately priced.
name[The Mill], eatType[restaurant], food[English], priceRange[moderate], area[riverside], familyFriendly[no], near[Raja Indian Cuisine]	In the riverside area near Raja Indian Cuisine, is a moderately priced English restaurant called The Mill. It is not kid friendly.
name[The Mill], eatType[restaurant], food[English], priceRange[moderate], area[riverside], familyFriendly[yes], near[Raja Indian Cuisine]	In the riverside area near Raja Indian Cuisine is a kid friendly restaurant called The Mill. It serves English food and is moderately priced.
name[The Mill], eatType[restaurant], food[English], priceRange[moderate], customer rating[1 out of 5], area[city centre], familyFriendly[no], near[Café Rouge]	In the city centre, near Café Rouge, is a restaurant called The Mill. It serves English food and is not kid friendly.
name[The Mill], eatType[restaurant], food[English], priceRange[moderate], customer rating[1 out of 5], area[city centre], familyFriendly[yes], near[Café Rouge]	In the city centre, near Café Rouge, is a kid friendly restaurant called The Mill. It serves English food and is moderately priced.
name[The Mill], eatType[restaurant], food[English], priceRange[moderate], customer rating[1 out of 5], area[riverside], familyFriendly[no], near[Café Rouge]	In the riverside area near Café Rouge, is a moderately priced English restaurant called The Mill. It is not kid friendly.
name[The Mill], eatType[restaurant], food[English], priceRange[moderate], customer rating[1 out of 5], area[riverside], familyFriendly[yes], near[Café Rouge]	In the riverside area near Café Rouge is a kid friendly restaurant called The Mill. It serves English food and is moderately priced.
name[The Mill], eatType[restaurant], food[English], priceRange[moderate], customer rating[3 out of 5], area[city centre], familyFriendly[no], near[Café Rouge]	In the city centre, near Café Rouge, is a restaurant called The Mill. It serves English food and is not kid friendly.
name[The Mill], eatType[restaurant], food[English], priceRange[moderate], customer rating[3 out of 5], area[city centre], familyFriendly[yes], near[Café Rouge]	In the city centre, near Café Rouge, is a kid friendly restaurant called The Mill. It serves English food and is moderately priced.
name[The Mill], eatType[restaurant], food[English], priceRange[moderate], customer rating[3 out of 5], area[riverside], familyFriendly[no], near[Café Rouge]	In the riverside area near Café Rouge, is a moderately priced English restaurant called The Mill. It is not kid friendly.
name[The Mill], eatType[restaurant], food[English], priceRange[moderate], customer rating[3 out of 5], area[riverside], familyFriendly[yes], near[Café Rouge]	In the riverside area near Café Rouge is a kid friendly restaurant called The Mill. It serves English food and is moderately priced.
name[The Mill], eatType[restaurant], food[English], priceRange[more than £30], area[riverside], familyFriendly[yes], near[Raja Indian Cuisine]	In the riverside area near Raja Indian Cuisine is a child friendly restaurant called The Mill. It serves English food at a price range of more than £30.
name[The Mill], eatType[restaurant], food[English], priceRange[more than £30], customer rating[high], area[city centre], familyFriendly[no], near[Café Rouge]	In the city centre, near Café Rouge, is a restaurant called The Mill. It serves English food and is not child friendly.
name[The Mill], eatType[restaurant], food[English], priceRange[more than £30], customer rating[high], area[city centre], familyFriendly[yes], near[Café Rouge]	In the city centre, near Café Rouge, is a child friendly restaurant called The Mill. It serves English food and is more than £30.
name[The Mill], eatType[restaurant], food[English], priceRange[more than £30], customer rating[high], area[riverside], familyFriendly[no], near[Café Rouge]	In the riverside area near Café Rouge is a non friendly restaurant called The Mill. It serves English food and is not child friendly.
name[The Mill], eatType[restaurant], food[English], priceRange[more than £30], customer rating[high], area[riverside], familyFriendly[yes], near[Café Rouge]	In the riverside area near Café Rouge is a child friendly restaurant called The Mill. It serves English food at a price range of more than £30.
name[The Mill], eatType[restaurant], food[Fast food], priceRange[£20-25], area[riverside], familyFriendly[yes], near[Raja Indian Cuisine]	There is a kid friendly Fast food restaurant called The Mill. It is located near Raja Indian Cuisine.
name[The Mill], eatType[restaurant], food[Fast food], priceRange[cheap], area[riverside], familyFriendly[yes], near[Raja Indian Cuisine]	Near the Raja Indian Cuisine, there is a cheap Fast food restaurant called The Mill. It is family friendly.
name[The Phoenix], eatType[pub], food[Fast food], priceRange[cheap], area[riverside], familyFriendly[yes], near[Raja Indian Cuisine]	There is a cheap pub near Raja Indian Cuisine in the riverside area. It is a family friendly pub that serves Fast food.
name[The Phoenix], eatType[pub], food[Fast food], priceRange[high], area[city centre], familyFriendly[no], near[Raja Indian Cuisine]	In the city centre, near Raja Indian Cuisine, is a high priced Fast food pub called The Phoenix. It is not child friendly.
name[The Phoenix], eatType[pub], food[Fast food], priceRange[high], area[city centre], familyFriendly[yes], near[Raja Indian Cuisine]	There is a high priced pub that is family friendly, serving Fast food, is located near Raja Indian Cuisine in the city centre.
name[The Phoenix], eatType[pub], food[Fast food], priceRange[high], area[riverside], familyFriendly[no], near[Raja Indian Cuisine]	There is a high priced pub that serves Fast food, is located near Raja Indian Cuisine in the riverside area. It is not child friendly.
name[The Phoenix], eatType[pub], food[Fast food], priceRange[high], area[riverside], familyFriendly[yes], near[Raja Indian Cuisine]	There is a high priced pub that is family friendly, and serves Fast food. It is located near Raja Indian Cuisine in the riverside area.
name[The Phoenix], eatType[pub], food[Fast food], priceRange[less than £20], area[city centre], familyFriendly[no], near[Raja Indian Cuisine]	In the city centre, near Raja Indian Cuisine, is a Fast food pub called The Phoenix. It is not family-friendly and has a price range of less than £20.
name[The Phoenix], eatType[pub], food[Fast food], priceRange[less than £20], area[city centre], familyFriendly[yes], near[Raja Indian Cuisine]	In the city centre, near Raja Indian Cuisine, is a family-friendly Fast food pub called The Phoenix.
name[The Phoenix], eatType[pub], food[Fast food], priceRange[less than £20], area[riverside], familyFriendly[no], near[Raja Indian Cuisine]	There is a pub called The Phoenix, it is not family friendly. It is located near Raja Indian Cuisine.
name[The Phoenix], eatType[pub], food[Fast food], priceRange[less than £20], area[riverside], familyFriendly[yes], near[Raja Indian Cuisine]	For a family friendly pub that serves Fast food at a pub near Raja Indian Cuisine.
name[The Phoenix], eatType[pub], food[Fast food], priceRange[moderate], area[city centre], familyFriendly[no], near[Raja Indian Cuisine]	In the city centre, near Raja Indian Cuisine, is a Fast food pub called The Phoenix. It is not kid friendly and has a moderate price range.
name[The Phoenix], eatType[pub], food[Fast food], priceRange[moderate], area[city centre], familyFriendly[yes], near[Raja Indian Cuisine]	In the city centre, near Raja Indian Cuisine, is a pub called The Phoenix. It serves Fast food and is kid friendly.
name[The Phoenix], eatType[pub], food[Fast food], priceRange[moderate], area[riverside], familyFriendly[no], near[Raja Indian Cuisine]	Near the Raja Indian Cuisine, there is a pub called The Phoenix. It is not kid friendly and serves Fast food at a moderate price range.
name[The Phoenix], eatType[pub], food[Fast food], priceRange[moderate], area[riverside], familyFriendly[yes], near[Raja Indian Cuisine]	There is a kid friendly pub that serves Fast food, is located near Raja Indian Cuisine in the riverside area.
name[The Phoenix], eatType[pub], food[Fast food], priceRange[moderate], customer rating[3 out of 5], area[riverside], familyFriendly[yes], near[Café Sicilia]	There is a kid friendly pub that serves Fast food, is located near Café Sicilia in the riverside area.
name[The Phoenix], eatType[pub], food[Fast food], priceRange[more than £30], area[riverside], familyFriendly[yes], near[Raja Indian Cuisine]	Near the Raja Indian Cuisine is a pub that is children friendly, serves Fast food at a price range of more than £30.
name[The Phoenix], eatType[pub], food[Fast food], priceRange[more than £30], customer rating[high], area[city centre], familyFriendly[no], near[Café Sicilia]	In the city centre, near Café Sicilia, is a Fast food pub called The Phoenix. It is not child friendly and has a price range of more than £30.
name[The Phoenix], eatType[pub], food[Fast food], priceRange[more than £30], customer rating[high], area[city centre], familyFriendly[yes], near[Café Sicilia]	In the city centre, near Café Sicilia, is a pub called The Phoenix. It serves Fast food and is child friendly.
name[The Phoenix], eatType[pub], food[Fast food], priceRange[more than £30], customer rating[high], area[riverside], familyFriendly[no], near[Café Sicilia]	Near the Café Sicilia, is a pub that serves Fast food, is not child friendly, and is more than £30.
name[The Phoenix], eatType[pub], food[Fast food], priceRange[more than £30], customer rating[high], area[riverside], familyFriendly[yes], near[Café Sicilia]	For a pub that is a Fast food pub that is children friendly, and is near Café Sicilia.
name[The Phoenix], eatType[pub], food[French], priceRange[£20-25], area[riverside], familyFriendly[yes], near[Raja Indian Cuisine]	Near the Raja Indian Cuisine, is a kid friendly pub that serves French food at £20-25.
name[The Phoenix], eatType[pub], food[French], priceRange[£20-25], customer rating[3 out of 5], area[city centre], familyFriendly[no], near[Café Sicilia]	In the city centre, near Café Sicilia, is a French pub called The Phoenix. It is not kid friendly and has a price range of £20-25.
name[The Phoenix], eatType[pub], food[French], priceRange[£20-25], customer rating[3 out of 5], area[city centre], familyFriendly[yes], near[Café Sicilia]	In the city centre, near Café Sicilia, is a French pub called The Phoenix. It is kid friendly and has a price range of £20-25.
name[The Phoenix], eatType[pub], food[French], priceRange[£20-25], customer rating[3 out of 5], area[riverside], familyFriendly[no], near[Café Sicilia]	In the riverside area, near Café Sicilia, is a pub called The Phoenix. It serves French food and is not kid friendly and has a price range of £20-25.
name[The Phoenix], eatType[pub], food[French], priceRange[£20-25], customer rating[3 out of 5], area[riverside], familyFriendly[yes], near[Café Sicilia]	In the riverside area, near Café Sicilia, is a kid friendly French pub called The Phoenix. It is in the £20-25 price range.
name[The Phoenix], eatType[pub], food[French], priceRange[£20-25], customer rating[3 out of 5], area[riverside], familyFriendly[yes], near[Crowne Plaza Hotel]	Near the Crowne Plaza Hotel, is a kid friendly pub called The Phoenix. It serves French food and is in the £20-25 price range.
name[The Phoenix], eatType[pub], food[French], priceRange[£20-25], customer rating[high], area[city centre], familyFriendly[no], near[Crowne Plaza Hotel]	In the city centre, near Crowne Plaza Hotel, is a French pub called The Phoenix. It is not kid friendly and has a price range of £20-25.
name[The Phoenix], eatType[pub], food[French], priceRange[£20-25], customer rating[high], area[city centre], familyFriendly[yes], near[Crowne Plaza Hotel]	In the city centre, near Crowne Plaza Hotel, is a French pub called The Phoenix. It is kid friendly and has a price range of £20-25.
name[The Phoenix], eatType[pub], food[French], priceRange[£20-25], customer rating[high], area[riverside], familyFriendly[no], near[Crowne Plaza Hotel]	In the riverside area, near Crowne Plaza Hotel, is a pub called The Phoenix. It serves French food and is not kid friendly and has a price range of £20-25.
name[The Phoenix], eatType[pub], food[French], priceRange[£20-25], customer rating[high], area[riverside], familyFriendly[yes], near[Crowne Plaza Hotel]	Near the Crowne Plaza Hotel, is a kid friendly pub that serves French food at £20-25.
name[The Phoenix], eatType[pub], food[French], priceRange[cheap], area[riverside], familyFriendly[yes], near[Raja Indian Cuisine]	Near the Raja Indian Cuisine, is a family friendly pub that serves French food. It is called The Phoenix and is cheap and and is cheap.
name[The Phoenix], eatType[pub], food[French], priceRange[cheap], customer rating[5 out of 5], area[city centre], familyFriendly[no], near[Crowne Plaza Hotel]	In the city centre, near Crowne Plaza Hotel, is a French pub called The Phoenix. It is not family-friendly and has a cheap price range.
name[The Phoenix], eatType[pub], food[French], priceRange[cheap], customer rating[5 out of 5], area[city centre], familyFriendly[yes], near[Crowne Plaza Hotel]	In the city centre, near Crowne Plaza Hotel, is a French pub called The Phoenix. It is cheap and family-friendly.
name[The Phoenix], eatType[pub], food[French], priceRange[cheap], customer rating[5 out of 5], area[riverside], familyFriendly[no], near[Crowne Plaza Hotel]	In the riverside area near Crowne Plaza Hotel, is a cheap French pub called The Phoenix. It is not family-friendly.
name[The Phoenix], eatType[pub], food[French], priceRange[cheap], customer rating[5 out of 5], area[riverside], familyFriendly[yes], near[Crowne Plaza Hotel]	In the riverside area, near Crowne Plaza Hotel, is a cheap French pub called The Phoenix. It is family friendly.
name[The Phoenix], eatType[pub], food[French], priceRange[high], area[riverside], familyFriendly[yes], near[Raja Indian Cuisine]	In the riverside area, near Raja Indian Cuisine, is a high priced French pub called The Phoenix. It is child friendly.
name[The Phoenix], eatType[pub], food[French], priceRange[high], customer rating[3 out of 5], area[city centre], familyFriendly[no], near[Crowne Plaza Hotel]	In the city centre, near Crowne Plaza Hotel, is a French pub called The Phoenix. It is not child friendly and has a high price range.
name[The Phoenix], eatType[pub], food[French], priceRange[high], customer rating[3 out of 5], area[city centre], familyFriendly[yes], near[Crowne Plaza Hotel]	In the city centre, near Crowne Plaza Hotel, is a French pub called The Phoenix. It is child friendly and has a high price range.
name[The Phoenix], eatType[pub], food[French], priceRange[high], customer rating[3 out of 5], area[riverside], familyFriendly[no], near[Crowne Plaza Hotel]	In the riverside area, near Crowne Plaza Hotel, is a high priced French pub called The Phoenix. It is not child friendly.
name[The Phoenix], eatType[pub], food[French], priceRange[high], customer rating[3 out of 5], area[riverside], familyFriendly[yes], near[Crowne Plaza Hotel]	In the riverside area, near Crowne Plaza Hotel, is a high priced French pub called The Phoenix. It is child friendly.
name[The Phoenix], eatType[pub], food[French], priceRange[less than £20], customer rating[average], area[city centre], familyFriendly[no], near[Crowne Plaza Hotel]	In the city centre, near Crowne Plaza Hotel, is a French pub called The Phoenix. It is not family-friendly and has a price range of less than £20.
name[The Phoenix], eatType[pub], food[French], priceRange[less than £20], customer rating[average], area[city centre], familyFriendly[yes], near[Crowne Plaza Hotel]	In the city centre, near Crowne Plaza Hotel, is a family-friendly French pub called The Phoenix. It is less than £20.
name[The Phoenix], eatType[pub], food[French], priceRange[less than £20], customer rating[average], area[riverside], familyFriendly[no], near[Crowne Plaza Hotel]	For a pub serving French food at a £20 price range. It is located near Crowne Plaza Hotel in the riverside area. It is not family-friendly.
name[The Phoenix], eatType[pub], food[French], priceRange[less than £20], customer rating[average], area[riverside], familyFriendly[yes], near[Crowne Plaza Hotel]	For a family friendly pub serving French food at less than £20 pounds. It is located near Crowne Plaza Hotel in the riverside area.
name[The Phoenix], eatType[pub], food[French], priceRange[less than £20], customer rating[low], area[city centre], familyFriendly[no], near[Crowne Plaza Hotel]	In the city centre, near Crowne Plaza Hotel, is a French pub called The Phoenix. It is not family-friendly and has a price range of less than £20.
name[The Phoenix], eatType[pub], food[French], priceRange[less than £20], customer rating[low], area[city centre], familyFriendly[yes], near[Crowne Plaza Hotel]	In the city centre, near Crowne Plaza Hotel, is a family-friendly French pub called The Phoenix. It is less than £20.
name[The Phoenix], eatType[pub], food[French], priceRange[less than £20], customer rating[low], area[riverside], familyFriendly[no], near[Crowne Plaza Hotel]	For a pub serving French food at a £20 price range. It is located near Crowne Plaza Hotel in the riverside area. It is not family-friendly.
name[The Phoenix], eatType[pub], food[French], priceRange[less than £20], customer rating[low], area[riverside], familyFriendly[yes], near[Crowne Plaza Hotel]	For a family friendly pub serving French food at a £20 price range. It is located near Crowne Plaza Hotel in the riverside area.
name[The Phoenix], eatType[pub], food[French], priceRange[moderate], customer rating[1 out of 5], area[city centre], familyFriendly[no], near[Crowne Plaza Hotel]	In the city centre, near Crowne Plaza Hotel, is a French pub called The Phoenix. It is not kid friendly and has a moderate price range.
name[The Phoenix], eatType[pub], food[French], priceRange[moderate], customer rating[1 out of 5], area[city centre], familyFriendly[yes], near[Crowne Plaza Hotel]	In the city centre, near Crowne Plaza Hotel, is a French pub called The Phoenix. It is kid friendly and has a moderate price range.
name[The Phoenix], eatType[pub], food[French], priceRange[moderate], customer rating[1 out of 5], area[riverside], familyFriendly[no], near[Crowne Plaza Hotel]	In the riverside area near Crowne Plaza Hotel, is a pub called The Phoenix. It serves French food and is not kid friendly.
name[The Phoenix], eatType[pub], food[French], priceRange[moderate], customer rating[1 out of 5], area[riverside], familyFriendly[yes], near[Crowne Plaza Hotel]	In the riverside area, near Crowne Plaza Hotel, is a kid friendly pub called The Phoenix. It serves French food and is moderately priced.
name[The Phoenix], eatType[pub], food[French], priceRange[more than £30], customer rating[5 out of 5], area[city centre], familyFriendly[no], near[Crowne Plaza Hotel]	In the city centre, near Crowne Plaza Hotel, is a French pub called The Phoenix. It is not child friendly and has a price range of more than £30.
name[The Phoenix], eatType[pub], food[French], priceRange[more than £30], customer rating[5 out of 5], area[city centre], familyFriendly[yes], near[Crowne Plaza Hotel]	In the city centre, near Crowne Plaza Hotel, is a French pub called The Phoenix. It is child friendly and has a price range of more than £30.
name[The Phoenix], eatType[pub], food[French], priceRange[more than £30], customer rating[5 out of 5], area[riverside], familyFriendly[no], near[Crowne Plaza Hotel]	In the riverside area near Crowne Plaza Hotel is a pub called The Phoenix. It serves French food and is not child friendly.
name[The Phoenix], eatType[pub], food[French], priceRange[more than £30], customer rating[5 out of 5], area[riverside], familyFriendly[yes], near[Crowne Plaza Hotel]	For a pub near Crowne Plaza Hotel, The Phoenix is a family friendly pub serving French food in the more than £30 price range.
name[The Phoenix], eatType[pub], food[French], priceRange[more than £30], customer rating[low], area[city centre], familyFriendly[no], near[Crowne Plaza Hotel]	In the city centre, near Crowne Plaza Hotel, is a French pub called The Phoenix. It is not child friendly and has a price range of more than £30.
name[The Phoenix], eatType[pub], food[French], priceRange[more than £30], customer rating[low], area[city centre], familyFriendly[yes], near[Crowne Plaza Hotel]	In the city centre, near Crowne Plaza Hotel, is a French pub called The Phoenix. It is child friendly and has a price range of more than £30.
name[The Phoenix], eatType[pub], food[French], priceRange[more than £30], customer rating[low], area[riverside], familyFriendly[no], near[Crowne Plaza Hotel]	In the riverside area near Crowne Plaza Hotel, is a pub called The Phoenix. It serves French food and is not child friendly.
name[The Phoenix], eatType[pub], food[French], priceRange[more than £30], customer rating[low], area[riverside], familyFriendly[yes], near[Crowne Plaza Hotel]	In the riverside area, near Crowne Plaza Hotel, is a child friendly pub called The Phoenix. It serves French food and costs more than £30.
name[The Phoenix], eatType[restaurant], food[Fast food], priceRange[cheap], area[riverside], familyFriendly[yes], near[Raja Indian Cuisine]	In the riverside area, The Phoenix is a cheap Fast food restaurant that is family friendly.
name[The Phoenix], eatType[restaurant], food[Fast food], priceRange[high], area[city centre], familyFriendly[no], near[Raja Indian Cuisine]	In the city centre, near Raja Indian Cuisine, is a high priced Fast food restaurant called The Phoenix.
name[The Phoenix], eatType[restaurant], food[Fast food], priceRange[high], area[city centre], familyFriendly[yes], near[Raja Indian Cuisine]	There is a high priced Fast food restaurant near Raja Indian Cuisine in the city centre called The Phoenix.
name[The Phoenix], eatType[restaurant], food[Fast food], priceRange[high], area[riverside], familyFriendly[no], near[Raja Indian Cuisine]	There is a high priced Fast food restaurant near Raja Indian Cuisine in the riverside area. It is not children friendly.
name[The Phoenix], eatType[restaurant], food[Fast food], priceRange[high], area[riverside], familyFriendly[yes], near[Raja Indian Cuisine]	There is a high priced restaurant that is family friendly, The Phoenix serves Fast food. It is located near Raja Indian Cuisine.
name[The Phoenix], eatType[restaurant], food[Fast food], priceRange[less than £20], area[city centre], familyFriendly[no], near[Raja Indian Cuisine]	In the city centre, near Raja Indian Cuisine, is a Fast food restaurant called The Phoenix. It is not family-friendly and has a price range of less than £20.
name[The Phoenix], eatType[restaurant], food[Fast food], priceRange[less than £20], area[city centre], familyFriendly[yes], near[Raja Indian Cuisine]	There is a family-friendly Fast food restaurant called The Phoenix. It is located near Raja Indian Cuisine in the city centre.
name[The Phoenix], eatType[restaurant], food[Fast food], priceRange[less than £20], area[riverside], familyFriendly[no], near[Raja Indian Cuisine]	Near the Raja Indian Cuisine, there is a Fast food restaurant called The Phoenix. It is not family-friendly and has a price range of less than £20.
name[The Phoenix], eatType[restaurant], food[Fast food], priceRange[less than £20], area[riverside], familyFriendly[yes], near[Raja Indian Cuisine]	Near the Raja Indian Cuisine, there is a family friendly restaurant called The Phoenix. It serves Fast food for less than £20.
name[The Phoenix], eatType[restaurant], food[Fast food], priceRange[moderate], area[city centre], familyFriendly[no], near[Raja Indian Cuisine]	In the city centre, near Raja Indian Cuisine, is a Fast food restaurant called The Phoenix. It is not kid friendly and has a moderate price range.
name[The Phoenix], eatType[restaurant], food[Fast food], priceRange[moderate], area[city centre], familyFriendly[yes], near[Raja Indian Cuisine]	In the city centre, near Raja Indian Cuisine, is a Fast food restaurant called The Phoenix. It is kid friendly and has a moderate price range.
name[The Phoenix], eatType[restaurant], food[Fast food], priceRange[moderate], area[riverside], familyFriendly[no], near[Raja Indian Cuisine]	Near the Raja Indian Cuisine, there is a moderately priced Fast food restaurant called The Phoenix. It is not kid friendly.
name[The Phoenix], eatType[restaurant], food[Fast food], priceRange[moderate], area[riverside], familyFriendly[yes], near[Raja Indian Cuisine]	There is a moderately priced restaurant that is family friendly, The Phoenix, serves Fast food. It is located near Raja Indian Cuisine in the riverside area.
name[The Phoenix], eatType[restaurant], food[Fast food], priceRange[more than £30], area[riverside], familyFriendly[yes], near[Raja Indian Cuisine]	In the riverside area, The Phoenix is a Fast food restaurant that is children friendly.
name[The Phoenix], eatType[restaurant], food[French], priceRange[£20-25], area[riverside], familyFriendly[yes], near[Raja Indian Cuisine]	In the riverside area, near Raja Indian Cuisine, is a kid friendly French restaurant called The Phoenix. It is in the £20-25 price range.
name[The Phoenix], eatType[restaurant], food[French], priceRange[cheap], area[riverside], familyFriendly[yes], near[Raja Indian Cuisine]	In the riverside area near Raja Indian Cuisine is a cheap French restaurant called The Phoenix. It is family friendly.
name[The Phoenix], eatType[restaurant], food[French], priceRange[high], area[riverside], familyFriendly[yes], near[Raja Indian Cuisine]	In the riverside area, there is a high priced French restaurant called The Phoenix. It is child friendly.
name[The Phoenix], eatType[restaurant], food[Indian], priceRange[£20-25], customer rating[high], area[city centre], familyFriendly[no], near[Crowne Plaza Hotel]	In the city centre, near Crowne Plaza Hotel, is a restaurant called The Phoenix. It serves Indian food in the £20-25 price range.
name[The Phoenix], eatType[restaurant], food[Indian], priceRange[£20-25], customer rating[high], area[city centre], familyFriendly[yes], near[Crowne Plaza Hotel]	In the city centre, near Crowne Plaza Hotel, is a kid friendly restaurant called The Phoenix. It serves Indian food in the £20-25 price range.
name[The Phoenix], eatType[restaurant], food[Indian], priceRange[£20-25], customer rating[high], area[riverside], familyFriendly[no], near[Crowne Plaza Hotel]	In the riverside area, The Phoenix is a restaurant that serves Indian food in the £20-25 price range. It is not kid friendly.
name[The Phoenix], eatType[restaurant], food[Indian], priceRange[£20-25], customer rating[high], area[riverside], familyFriendly[yes], near[Crowne Plaza Hotel]	For a kid friendly restaurant, The Phoenix is a restaurant that serves Indian food in the £20-25 price range. It is located in the riverside area near Crowne Plaza Hotel.
name[The Phoenix], eatType[restaurant], food[Indian], priceRange[cheap], customer rating[5 out of 5], area[city centre], familyFriendly[no], near[Crowne Plaza Hotel]	In the city centre, near Crowne Plaza Hotel, is a cheap Indian restaurant called The Phoenix. It is not family friendly.
name[The Phoenix], eatType[restaurant], food[Indian], priceRange[cheap], customer rating[5 out of 5], area[city centre], familyFriendly[yes], near[Crowne Plaza Hotel]	In the city centre, near Crowne Plaza Hotel, is a family friendly restaurant called The Phoenix. It serves Indian food and is cheap.
name[The Phoenix], eatType[restaurant], food[Indian], priceRange[cheap], customer rating[5 out of 5], area[riverside], familyFriendly[no], near[Crowne Plaza Hotel]	In the riverside area, near Crowne Plaza Hotel, is a cheap Indian restaurant called The Phoenix. It is not family friendly.
name[The Phoenix], eatType[restaurant], food[Indian], priceRange[cheap], customer rating[5 out of 5], area[riverside], familyFriendly[no], near[Express by Holiday Inn]	Near the Express by Holiday Inn, there is a cheap restaurant called The Phoenix. It serves Indian food and is not family friendly.
name[The Phoenix], eatType[restaurant], food[Indian], priceRange[cheap], customer rating[5 out of 5], area[riverside], familyFriendly[yes], near[Express by Holiday Inn]	In the riverside area, near Express by Holiday Inn, is a family friendly restaurant called The Phoenix. It serves Indian food and is cheap.
name[The Phoenix], eatType[restaurant], food[Indian], priceRange[cheap], customer rating[average], area[city centre], familyFriendly[no], near[Express by Holiday Inn]	In the city centre, near Express by Holiday Inn, is a cheap Indian restaurant called The Phoenix. It is not family friendly.
name[The Plough], eatType[pub], food[Chinese], priceRange[£20-25], area[riverside], familyFriendly[yes], near[Raja Indian Cuisine]	Near the Raja Indian Cuisine, there is a pub called The Plough. It serves Chinese food and is kid friendly and has a price range of £20-25.
name[The Plough], eatType[pub], food[Chinese], priceRange[cheap], area[riverside], familyFriendly[yes], near[Raja Indian Cuisine]	There is a cheap pub that serves Chinese food in the riverside area, near Raja Indian Cuisine, is family friendly.
name[The Plough], eatType[pub], food[Chinese], priceRange[high], area[city centre], familyFriendly[no], near[Raja Indian Cuisine]	In the city centre, near Raja Indian Cuisine, is a pub called The Plough. It serves Chinese food and is not child friendly.
name[The Plough], eatType[pub], food[Chinese], priceRange[high], area[city centre], familyFriendly[yes], near[Raja Indian Cuisine]	In the city centre, near Raja Indian Cuisine, is a high priced Chinese pub called The Plough. It is child friendly.
name[The Plough], eatType[pub], food[Chinese], priceRange[high], area[riverside], familyFriendly[no], near[Raja Indian Cuisine]	Near the Raja Indian Cuisine is a high priced pub that serves Chinese food. It is not children friendly.
name[The Plough], eatType[pub], food[Chinese], priceRange[high], area[riverside], familyFriendly[yes], near[Raja Indian Cuisine]	Near the Raja Indian Cuisine, there is a pub called The Plough. It serves Chinese food and is child friendly.
name[The Plough], eatType[pub], food[Chinese], priceRange[less than £20], area[city centre], familyFriendly[no], near[Raja Indian Cuisine]	In the city centre, near Raja Indian Cuisine, is a pub called The Plough. It serves Chinese food for less than £20. It is not family friendly.
name[The Plough], eatType[restaurant], food[Chinese], priceRange[£20-25], area[riverside], familyFriendly[yes], near[Raja Indian Cuisine]	There is a kid friendly Chinese restaurant called The Plough in riverside near Raja Indian Cuisine. It is in the £20-25 price range.
name[The Plough], eatType[restaurant], food[Chinese], priceRange[cheap], area[riverside], familyFriendly[yes], near[Raja Indian Cuisine]	Near Raja Indian Cuisine in the riverside area, is a cheap Chinese restaurant called The Plough. It is family friendly.
name[The Plough], eatType[restaurant], food[Chinese], priceRange[high], area[city centre], familyFriendly[no], near[Raja Indian Cuisine]	In the city centre, near Raja Indian Cuisine, there is a Chinese restaurant called The Plough. It is not child friendly and has a high price range.
name[The Plough], eatType[restaurant], food[Chinese], priceRange[high], area[city centre], familyFriendly[yes], near[Raja Indian Cuisine]	In the city centre, near Raja Indian Cuisine, is a high priced Chinese restaurant called The Plough. It is child friendly.
name[The Plough], eatType[restaurant], food[Chinese], priceRange[high], area[riverside], familyFriendly[no], near[Raja Indian Cuisine]	Near the Raja Indian Cuisine is a high priced Chinese restaurant called The Plough. It is not child friendly.
name[The Plough], eatType[restaurant], food[Chinese], priceRange[high], area[riverside], familyFriendly[yes], near[Raja Indian Cuisine]	There is a high priced Chinese restaurant called The Plough. It is located near Raja Indian Cuisine.
name[The Plough], eatType[restaurant], food[Chinese], priceRange[less than £20], area[city centre], familyFriendly[no], near[Raja Indian Cuisine]	In the city centre, near Raja Indian Cuisine, is a Chinese restaurant called The Plough. It is not family friendly and has a price range of less than £20.
name[The Punter], eatType[pub], food[Chinese], priceRange[less than £20], area[city centre], familyFriendly[yes], near[Raja Indian Cuisine]	There is a family friendly Chinese pub called The Punter, near Raja Indian Cuisine in the city centre. It is a pub that costs less than £20.
name[The Punter], eatType[pub], food[Chinese], priceRange[less than £20], area[riverside], familyFriendly[no], near[Raja Indian Cuisine]	Near the Raja Indian Cuisine, there is a pub called The Punter. It serves Chinese food for less than £20. It is not family friendly.
name[The Punter], eatType[pub], food[Chinese], priceRange[less than £20], area[riverside], familyFriendly[yes], near[Raja Indian Cuisine]	There is a family friendly pub that serves Chinese food at a less than £20 price range. It is located in the riverside area near Raja Indian Cuisine.
name[The Punter], eatType[pub], food[Chinese], priceRange[moderate], area[city centre], familyFriendly[no], near[Raja Indian Cuisine]	In the city centre, near Raja Indian Cuisine, is a pub called The Punter. It serves Chinese food and is not kid friendly.
name[The Punter], eatType[pub], food[Chinese], priceRange[moderate], area[city centre], familyFriendly[yes], near[Raja Indian Cuisine]	In the city centre, near Raja Indian Cuisine, is a pub called The Punter. It serves Chinese food and is kid friendly.
name[The Punter], eatType[pub], food[Chinese], priceRange[moderate], area[riverside], familyFriendly[no], near[Raja Indian Cuisine]	The Punter is a pub that serves Chinese food in the moderate price range. It is located in the riverside area near Raja Indian Cuisine.
name[The Punter], eatType[pub], food[Chinese], priceRange[moderate], area[riverside], familyFriendly[yes], near[Raja Indian Cuisine]	There is a pub called The Punter that serves Chinese food in the moderate price range. It is located in the riverside area near Raja Indian Cuisine.
name[The Punter], eatType[pub], food[Chinese], priceRange[more than £30], area[riverside], familyFriendly[yes], near[Raja Indian Cuisine]	Near Raja Indian Cuisine, is a pub that serves Chinese food at a price range of more than £30. It is children friendly and is near Raja Indian Cuisine.
name[The Punter], eatType[pub], food[English], priceRange[£20-25], area[riverside], familyFriendly[yes], near[Raja Indian Cuisine]	Near Raja Indian Cuisine, is a kid friendly pub that serves English food at a price range of £20-25.
name[The Punter], eatType[pub], food[English], priceRange[cheap], area[riverside], familyFriendly[yes], near[Raja Indian Cuisine]	Near Raja Indian Cuisine, is a family friendly pub that serves English food. It is called The Punter.
name[The Punter], eatType[pub], food[English], priceRange[high], area[city centre], familyFriendly[no], near[Raja Indian Cuisine]	In the city centre, near Raja Indian Cuisine, is a high priced English pub called The Punter. It is not child friendly.
name[The Punter], eatType[pub], food[English], priceRange[high], area[city centre], familyFriendly[yes], near[Raja Indian Cuisine]	In the city centre, near Raja Indian Cuisine, is a high priced pub called The Punter. It serves English food and is child friendly.
name[The Punter], eatType[pub], food[English], priceRange[high], area[riverside], familyFriendly[no], near[Raja Indian Cuisine]	In the riverside area near Raja Indian Cuisine is a high priced English pub called The Punter. It is not child friendly.
name[The Punter], eatType[pub], food[English], priceRange[high], area[riverside], familyFriendly[yes], near[Raja Indian Cuisine]	In the riverside area, near Raja Indian Cuisine, is a high priced pub that serves English food. It is child friendly.
name[The Punter], eatType[pub], food[Italian], priceRange[high], customer rating[average], area[city centre], familyFriendly[no], near[Rainbow Vegetarian Café]	In the city centre, near Rainbow Vegetarian Café, is a high priced Italian pub called The Punter. It is not child friendly.
name[The Punter], eatType[restaurant], food[Chinese], priceRange[less than £20], area[city centre], familyFriendly[yes], near[Raja Indian Cuisine]	There is a family friendly Chinese restaurant called The Punter, near Raja Indian Cuisine in the city centre. It is a family friendly restaurant.
name[The Punter], eatType[restaurant], food[Chinese], priceRange[less than £20], area[riverside], familyFriendly[no], near[Raja Indian Cuisine]	Near the Raja Indian Cuisine, there is a Chinese restaurant called The Punter. It is not family friendly and has a price range of less than £20.
name[The Punter], eatType[restaurant], food[Chinese], priceRange[less than £20], area[riverside], familyFriendly[yes], near[Raja Indian Cuisine]	There is a family friendly Chinese restaurant called The Punter. It is located near Raja Indian Cuisine.
name[The Punter], eatType[restaurant], food[Chinese], priceRange[moderate], area[city centre], familyFriendly[no], near[Raja Indian Cuisine]	There is a Chinese restaurant called The Punter in the city centre, near Raja Indian Cuisine, is not kid friendly and has a moderate price range.
name[The Punter], eatType[restaurant], food[Chinese], priceRange[moderate], area[city centre], familyFriendly[yes], near[Raja Indian Cuisine]	There is a kid friendly Chinese restaurant called The Punter in the city centre near Raja Indian Cuisine. It is moderately priced.
name[The Punter], eatType[restaurant], food[Chinese], priceRange[moderate], area[riverside], familyFriendly[no], near[Raja Indian Cuisine]	Near the Raja Indian Cuisine, there is a Chinese restaurant called The Punter. It is not kid friendly and has a moderate price range.
name[The Punter], eatType[restaurant], food[Chinese], priceRange[moderate], area[riverside], familyFriendly[yes], near[Raja Indian Cuisine]	There is a kid friendly Chinese restaurant called The Punter in riverside near Raja Indian Cuisine.
name[The Punter], eatType[restaurant], food[Chinese], priceRange[more than £30], area[riverside], familyFriendly[yes], near[Raja Indian Cuisine]	In the riverside area near Raja Indian Cuisine, The Punter is a Chinese restaurant that is child friendly and has a price range of more than £30.
name[The Punter], eatType[restaurant], food[English], priceRange[£20-25], area[riverside], familyFriendly[yes], near[Raja Indian Cuisine]	In the riverside area, near Raja Indian Cuisine, is a kid friendly restaurant called The Punter. It serves English food and has a price range of £20-25.
name[The Punter], eatType[restaurant], food[English], priceRange[cheap], area[riverside], familyFriendly[yes], near[Raja Indian Cuisine]	In the riverside area near Raja Indian Cuisine is a cheap family friendly restaurant called The Punter.
name[The Punter], eatType[restaurant], food[English], priceRange[high], area[city centre], familyFriendly[no], near[Raja Indian Cuisine]	In the city centre near Raja Indian Cuisine is a high priced English restaurant called The Punter. It is not child friendly.
name[The Punter], eatType[restaurant], food[English], priceRange[high], area[city centre], familyFriendly[yes], near[Raja Indian Cuisine]	In the city centre near Raja Indian Cuisine is a high priced restaurant called The Punter. It serves English food and is child friendly.
name[The Punter], eatType[restaurant], food[English], priceRange[high], area[riverside], familyFriendly[no], near[Raja Indian Cuisine]	In the riverside area near Raja Indian Cuisine is a high priced restaurant called The Punter. It serves English food and is not child friendly.
name[The Punter], eatType[restaurant], food[English], priceRange[high], area[riverside], familyFriendly[yes], near[Raja Indian Cuisine]	In the riverside area near Raja Indian Cuisine is a high priced restaurant that serves English food.
name[The Punter], eatType[restaurant], food[Indian], priceRange[cheap], customer rating[average], area[city centre], familyFriendly[yes], near[Express by Holiday Inn]	In the city centre, near Express by Holiday Inn, is a family friendly Indian restaurant called The Punter.
name[The Punter], eatType[restaurant], food[Indian], priceRange[cheap], customer rating[average], area[riverside], familyFriendly[no], near[Express by Holiday Inn]	In the riverside area, near Express by Holiday Inn, is a cheap Indian restaurant called The Punter. It is not family friendly.
name[The Punter], eatType[restaurant], food[Indian], priceRange[cheap], customer rating[average], area[riverside], familyFriendly[yes], near[Express by Holiday Inn]	In the riverside area, near Express by Holiday Inn, is a cheap Indian restaurant called The Punter. It is family friendly.
name[The Punter], eatType[restaurant], food[Indian], priceRange[high], customer rating[1 out of 5], area[city centre], familyFriendly[no], near[Express by Holiday Inn]	In the city centre, near Express by Holiday Inn, is a high priced Indian restaurant called The Punter. It is not child friendly.
name[The Punter], eatType[restaurant], food[Indian], priceRange[high], customer rating[1 out of 5], area[city centre], familyFriendly[yes], near[Express by Holiday Inn]	In the city centre, near Express by Holiday Inn, is a high priced Indian restaurant called The Punter.
name[The Punter], eatType[restaurant], food[Indian], priceRange[high], customer rating[1 out of 5], area[riverside], familyFriendly[no], near[Express by Holiday Inn]	In the riverside area, near Express by Holiday Inn, is a high priced Indian restaurant called The Punter. It is not child friendly.
name[The Punter], eatType[restaurant], food[Indian], priceRange[high], customer rating[1 out of 5], area[riverside], familyFriendly[yes], near[Express by Holiday Inn]	In the riverside area, The Punter is a high priced Indian restaurant. It is family friendly.
name[The Punter], eatType[restaurant], food[Indian], priceRange[high], customer rating[average], area[city centre], familyFriendly[no], near[Express by Holiday Inn]	In the city centre, near Express by Holiday Inn, is a high priced Indian restaurant called The Punter. It is not child friendly.
name[The Punter], eatType[restaurant], food[Indian], priceRange[high], customer rating[average], area[city centre], familyFriendly[yes], near[Express by Holiday Inn]	In the city centre, near Express by Holiday Inn, is a high priced Indian restaurant called The Punter. It is child friendly.
name[The Punter], eatType[restaurant], food[Indian], priceRange[high], customer rating[average], area[riverside], familyFriendly[no], near[Express by Holiday Inn]	In the riverside area, near Express by Holiday Inn, is a high priced Indian restaurant called The Punter. It is not child friendly.
name[The Punter], eatType[restaurant], food[Indian], priceRange[high], customer rating[average], area[riverside], familyFriendly[yes], near[Express by Holiday Inn]	In the riverside area, near Express by Holiday Inn, is a high priced Indian restaurant called The Punter.
name[The Punter], eatType[restaurant], food[Indian], priceRange[less than £20], customer rating[low], area[city centre], familyFriendly[no], near[Express by Holiday Inn]	In the city centre, near Express by Holiday Inn, is a non family friendly Indian restaurant called The Punter. It is not family friendly.
name[The Punter], eatType[restaurant], food[Indian], priceRange[less than £20], customer rating[low], area[city centre], familyFriendly[yes], near[Express by Holiday Inn]	In the city centre, near Express by Holiday Inn, is a family friendly restaurant called The Punter. It serves Indian food for less than £20.
name[The Punter], eatType[restaurant], food[Indian], priceRange[less than £20], customer rating[low], area[riverside], familyFriendly[no], near[Express by Holiday Inn]	In the riverside area near Express by Holiday Inn, is a non family friendly Indian restaurant called The Punter. It is not family friendly.
name[The Punter], eatType[restaurant], food[Indian], priceRange[less than £20], customer rating[low], area[riverside], familyFriendly[yes], near[Express by Holiday Inn]	For a family friendly Indian restaurant, The Punter, is located near Express by Holiday Inn.
name[The Punter], eatType[restaurant], food[Indian], priceRange[moderate], customer rating[1 out of 5], area[city centre], familyFriendly[no], near[Express by Holiday Inn]	In the city centre, near Express by Holiday Inn, is a restaurant called The Punter. It serves Indian food and is not kid friendly.
name[The Punter], eatType[restaurant], food[Indian], priceRange[moderate], customer rating[1 out of 5], area[city centre], familyFriendly[yes], near[Express by Holiday Inn]	In the city centre, near Express by Holiday Inn, is a kid friendly restaurant called The Punter. It serves Indian food and is moderately priced.
name[The Punter], eatType[restaurant], food[Indian], priceRange[moderate], customer rating[1 out of 5], area[riverside], familyFriendly[no], near[Express by Holiday Inn]	The Punter is a restaurant providing Indian food in the moderate price range. It is located in the riverside. It is near Express by Holiday Inn.
name[The Punter], eatType[restaurant], food[Indian], priceRange[moderate], customer rating[1 out of 5], area[riverside], familyFriendly[yes], near[Express by Holiday Inn]	In the riverside area, near Express by Holiday Inn, is a kid friendly restaurant called The Punter. It serves Indian food at a moderate price.
name[The Punter], eatType[restaurant], food[Indian], priceRange[moderate], customer rating[3 out of 5], area[city centre], familyFriendly[no], near[Express by Holiday Inn]	In the city centre, near Express by Holiday Inn, is a restaurant called The Punter. It serves Indian food and is not kid friendly.
name[The Punter], eatType[restaurant], food[Indian], priceRange[moderate], customer rating[3 out of 5], area[city centre], familyFriendly[yes], near[Express by Holiday Inn]	In the city centre, near Express by Holiday Inn, is a kid friendly restaurant called The Punter. It serves Indian food and is moderately priced.
name[The Punter], eatType[restaurant], food[Indian], priceRange[moderate], customer rating[3 out of 5], area[riverside], familyFriendly[no], near[Express by Holiday Inn]	In the riverside area, near Express by Holiday Inn, is a restaurant called The Punter. It serves Indian food and is not kid friendly.
name[The Punter], eatType[restaurant], food[Indian], priceRange[moderate], customer rating[3 out of 5], area[riverside], familyFriendly[yes], near[Express by Holiday Inn]	In the riverside area, near Express by Holiday Inn, is a kid friendly restaurant called The Punter. It serves Indian food at a moderate price.
name[The Punter], eatType[restaurant], food[Indian], priceRange[more than £30], customer rating[high], area[city centre], familyFriendly[no], near[Express by Holiday Inn]	In the city centre, near Express by Holiday Inn, is a restaurant called The Punter. It serves Indian food and is not child friendly.
name[The Punter], eatType[restaurant], food[Indian], priceRange[more than £30], customer rating[high], area[city centre], familyFriendly[yes], near[Express by Holiday Inn]	In the city centre, near Express by Holiday Inn, is a child friendly restaurant called The Punter. It serves Indian food at a price range of more than £30.
name[The Punter], eatType[restaurant], food[Indian], priceRange[more than £30], customer rating[high], area[riverside], familyFriendly[no], near[Express by Holiday Inn]	In the riverside area near Express by Holiday Inn, is a non friendly restaurant called The Punter. It serves Indian food at a price range of more than £30.
name[The Punter], eatType[restaurant], food[Indian], priceRange[more than £30], customer rating[high], area[riverside], familyFriendly[yes], near[Express by Holiday Inn]	In the riverside area, near Express by Holiday Inn, is a child friendly restaurant called The Punter. It serves Indian food at a price range of more than £30.
name[The Punter], eatType[restaurant], food[Italian], priceRange[£20-25], customer rating[high], area[city centre], familyFriendly[no], near[Express by Holiday Inn]	In the city centre, near Express by Holiday Inn, is a restaurant called The Punter. It serves Italian food and is not kid friendly and has a price range of £20-25.
name[The Punter], eatType[restaurant], food[Italian], priceRange[£20-25], customer rating[high], area[city centre], familyFriendly[yes], near[Express by Holiday Inn]	In the city centre near Express by Holiday Inn is a kid friendly Italian restaurant called The Punter. It is in the £20-25 price range.
name[The Punter], eatType[restaurant], food[Italian], priceRange[£20-25], customer rating[high], area[riverside], familyFriendly[no], near[Express by Holiday Inn]	In the riverside area, The Punter is a restaurant that serves Italian food in the £20-25 price range. It is not kid friendly.
name[The Punter], eatType[restaurant], food[Italian], priceRange[£20-25], customer rating[high], area[riverside], familyFriendly[yes], near[Express by Holiday Inn]	In the riverside area, The Punter is a kid friendly Italian restaurant with a price range of £20-25.
name[The Punter], eatType[restaurant], food[Italian], priceRange[cheap], customer rating[5 out of 5], area[city centre], familyFriendly[no], near[Express by Holiday Inn]	In the city centre, near Express by Holiday Inn, is a cheap Italian restaurant called The Punter. It is not family-friendly.
name[The Punter], eatType[restaurant], food[Italian], priceRange[cheap], customer rating[5 out of 5], area[city centre], familyFriendly[no], near[Rainbow Vegetarian Café]	In the city centre, near Rainbow Vegetarian Café, there is a cheap Italian restaurant called The Punter. It is not family-friendly.
name[The Punter], eatType[restaurant], food[Italian], priceRange[cheap], customer rating[5 out of 5], area[city centre], familyFriendly[yes], near[Rainbow Vegetarian Café]	In the city centre, near Rainbow Vegetarian Café, is a cheap Italian restaurant called The Punter. It is family-friendly.
name[The Punter], eatType[restaurant], food[Italian], priceRange[cheap], customer rating[5 out of 5], area[riverside], familyFriendly[no], near[Rainbow Vegetarian Café]	In the riverside area near Rainbow Vegetarian Café, is a cheap Italian restaurant called The Punter. It is not family-friendly.
name[The Punter], eatType[restaurant], food[Italian], priceRange[cheap], customer rating[5 out of 5], area[riverside], familyFriendly[yes], near[Rainbow Vegetarian Café]	For a cheap Italian restaurant, The Punter, is family friendly and is located near Rainbow Vegetarian Café.
name[The Punter], eatType[restaurant], food[Italian], priceRange[cheap], customer rating[average], area[city centre], familyFriendly[no], near[Rainbow Vegetarian Café]	In the city centre, near Rainbow Vegetarian Café, is a cheap Italian restaurant called The Punter. It is not family-friendly.
name[The Punter], eatType[restaurant], food[Italian], priceRange[cheap], customer rating[average], area[city centre], familyFriendly[yes], near[Rainbow Vegetarian Café]	In the city centre near Rainbow Vegetarian Café is a family-friendly Italian restaurant called The Punter. It is cheap and is family-friendly.
name[The Punter], eatType[restaurant], food[Italian], priceRange[cheap], customer rating[average], area[riverside], familyFriendly[no], near[Rainbow Vegetarian Café]	In the riverside area near Rainbow Vegetarian Café, is a cheap Italian restaurant called The Punter. It is not family-friendly.
name[The Punter], eatType[restaurant], food[Italian], priceRange[cheap], customer rating[average], area[riverside], familyFriendly[yes], near[Rainbow Vegetarian Café]	In the riverside area near Rainbow Vegetarian Café is a family friendly Italian restaurant called The Punter.
name[The Punter], eatType[restaurant], food[Italian], priceRange[high], customer rating[1 out of 5], area[city centre], familyFriendly[no], near[Rainbow Vegetarian Café]	In the city centre near Rainbow Vegetarian Café is a high priced Italian restaurant called The Punter. It is not child friendly.
name[The Punter], eatType[restaurant], food[Italian], priceRange[high], customer rating[1 out of 5], area[city centre], familyFriendly[yes], near[Rainbow Vegetarian Café]	In the city centre area, near Rainbow Vegetarian Café, is a high priced Italian restaurant called The Punter.
name[The Punter], eatType[restaurant], food[Italian], priceRange[high], customer rating[1 out of 5], area[riverside], familyFriendly[no], near[Rainbow Vegetarian Café]	In the riverside area near Rainbow Vegetarian Café is a high priced Italian restaurant called The Punter. It is not child friendly.
name[The Punter], eatType[restaurant], food[Italian], priceRange[high], customer rating[1 out of 5], area[riverside], familyFriendly[yes], near[Rainbow Vegetarian Café]	In the riverside area, near Rainbow Vegetarian Café, is a high priced restaurant called The Punter. It serves Italian food and is child friendly.
name[The Vaults], eatType[pub], food[French], priceRange[high], area[riverside], familyFriendly[yes], near[Raja Indian Cuisine]	In the riverside area, near Raja Indian Cuisine, is a high priced French pub called The Vaults. It is child friendly.
name[The Vaults], eatType[pub], food[French], priceRange[less than £20], area[city centre], familyFriendly[no], near[Raja Indian Cuisine]	In the city centre, near Raja Indian Cuisine, is a French pub called The Vaults. It is not family-friendly and has a price range of less than £20.
name[The Vaults], eatType[pub], food[French], priceRange[less than £20], area[city centre], familyFriendly[yes], near[Raja Indian Cuisine]	In the city centre, near Raja Indian Cuisine, is a family-friendly French pub called The Vaults. It is less than £20.
name[The Vaults], eatType[pub], food[French], priceRange[less than £20], area[riverside], familyFriendly[no], near[Raja Indian Cuisine]	For a pub serving French food in the less than £20 price range. It is located in the riverside area near Raja Indian Cuisine. It is not family-friendly.
name[The Vaults], eatType[pub], food[French], priceRange[less than £20], area[riverside], familyFriendly[yes], near[Raja Indian Cuisine]	For a family friendly pub serving French food at a £20 price range. It is located near Raja Indian Cuisine in the riverside area.
name[The Vaults], eatType[pub], food[French], priceRange[moderate], area[city centre], familyFriendly[no], near[Raja Indian Cuisine]	In the city centre, near Raja Indian Cuisine, is a French pub called The Vaults. It is not kid friendly and has a moderate price range.
name[The Vaults], eatType[pub], food[French], priceRange[moderate], area[city centre], familyFriendly[yes], near[Raja Indian Cuisine]	In the city centre, near Raja Indian Cuisine, is a pub called The Vaults. It serves French food and is kid friendly.
name[The Vaults], eatType[pub], food[French], priceRange[moderate], area[riverside], familyFriendly[no], near[Raja Indian Cuisine]	In the riverside area near Raja Indian Cuisine, is a pub called The Vaults. It serves French food and is not kid friendly.
name[The Vaults], eatType[pub], food[French], priceRange[moderate], area[riverside], familyFriendly[yes], near[Raja Indian Cuisine]	For a pub called The Vaults, is a family friendly pub that serves French food. It is located near Raja Indian Cuisine.
name[The Vaults], eatType[pub], food[French], priceRange[more than £30], area[city centre], familyFriendly[no], near[Raja Indian Cuisine]	In the city centre, near Raja Indian Cuisine, is a French pub called The Vaults. It is not child friendly and has a price range of more than £30.
name[The Vaults], eatType[pub], food[French], priceRange[more than £30], area[city centre], familyFriendly[yes], near[Raja Indian Cuisine]	In the city centre, near Raja Indian Cuisine, is a French pub called The Vaults. It is child friendly and has a price range of more than £30.
name[The Vaults], eatType[pub], food[French], priceRange[more than £30], area[riverside], familyFriendly[no], near[Raja Indian Cuisine]	In the riverside area near Raja Indian Cuisine, is a pub called The Vaults. It serves French food and is not child friendly.
name[The Vaults], eatType[pub], food[French], priceRange[more than £30], area[riverside], familyFriendly[yes], near[Raja Indian Cuisine]	In the riverside area, near Raja Indian Cuisine, is a child friendly pub called The Vaults. It serves French food and costs more than £30.
name[The Vaults], eatType[pub], food[Indian], priceRange[£20-25], area[riverside], familyFriendly[yes], near[Raja Indian Cuisine]	For a kid friendly pub, The Vaults is a pub that serves Indian food in the £20-25 price range. It is located in the riverside area near Raja Indian Cuisine.
name[The Vaults], eatType[pub], food[Indian], priceRange[cheap], area[riverside], familyFriendly[yes], near[Raja Indian Cuisine]	For a family friendly Indian pub, The Vaults, is located near Raja Indian Cuisine.
name[The Vaults], eatType[pub], food[Indian], priceRange[high], area[city centre], familyFriendly[no], near[Raja Indian Cuisine]	In the city centre, near Raja Indian Cuisine, is a high priced Indian pub called The Vaults. It is not child friendly.
name[The Vaults], eatType[pub], food[Indian], priceRange[high], area[city centre], familyFriendly[yes], near[Raja Indian Cuisine]	In the city centre, near Raja Indian Cuisine, is a high priced Indian pub called The Vaults. It is child friendly.
name[The Vaults], eatType[pub], food[Italian], priceRange[high], customer rating[average], area[city centre], familyFriendly[no], near[Rainbow Vegetarian Café]	In the city centre, near Rainbow Vegetarian Café, is a high priced Italian pub called The Vaults. It is not child friendly.
name[The Vaults], eatType[pub], food[Italian], priceRange[high], customer rating[average], area[city centre], familyFriendly[yes], near[Rainbow Vegetarian Café]	In the city centre, near Rainbow Vegetarian Café, is a high priced Italian pub called The Vaults. It is child friendly.
name[The Vaults], eatType[pub], food[Italian], priceRange[high], customer rating[average], area[riverside], familyFriendly[no], near[Rainbow Vegetarian Café]	In the riverside area near Rainbow Vegetarian Café, is a high priced Italian pub called The Vaults. It is not child friendly.
name[The Vaults], eatType[pub], food[Italian], priceRange[high], customer rating[average], area[riverside], familyFriendly[yes], near[Rainbow Vegetarian Café]	In the riverside area, there is a high priced, family friendly pub called The Vaults.
name[The Vaults], eatType[pub], food[Italian], priceRange[less than £20], customer rating[low], area[city centre], familyFriendly[no], near[Rainbow Vegetarian Café]	In the city centre, near Rainbow Vegetarian Café, is a pub called The Vaults. It serves Italian food for less than £20. It is not family-friendly.
name[The Vaults], eatType[pub], food[Italian], priceRange[less than £20], customer rating[low], area[city centre], familyFriendly[yes], near[Rainbow Vegetarian Café]	In the city centre, near Rainbow Vegetarian Café, is a family-friendly Italian pub called The Vaults. It is less than £20.
name[The Vaults], eatType[pub], food[Italian], priceRange[less than £20], customer rating[low], area[riverside], familyFriendly[no], near[Rainbow Vegetarian Café]	In the riverside area near Rainbow Vegetarian Café, is a pub called The Vaults. It serves Italian food for less than £20. It is not family-friendly.
name[The Vaults], eatType[pub], food[Italian], priceRange[less than £20], customer rating[low], area[riverside], familyFriendly[yes], near[Rainbow Vegetarian Café]	For a family friendly pub, The Vaults, is a family friendly pub that serves Italian food.
name[The Vaults], eatType[pub], food[Italian], priceRange[moderate], customer rating[1 out of 5], area[city centre], familyFriendly[no], near[Rainbow Vegetarian Café]	In the city centre, near Rainbow Vegetarian Café, is a pub called The Vaults. It serves Italian food and is not kid friendly.
name[The Vaults], eatType[pub], food[Italian], priceRange[moderate], customer rating[1 out of 5], area[city centre], familyFriendly[yes], near[Rainbow Vegetarian Café]	For a pub serving Italian food in the moderate price range. It is located in the city centre near Rainbow Vegetarian Café. It is kid friendly.
name[The Vaults], eatType[pub], food[Italian], priceRange[moderate], customer rating[1 out of 5], area[riverside], familyFriendly[no], near[Rainbow Vegetarian Café]	In the riverside area near Rainbow Vegetarian Café, is a pub called The Vaults. It serves Italian food and is not kid friendly.
name[The Vaults], eatType[pub], food[Italian], priceRange[moderate], customer rating[1 out of 5], area[riverside], familyFriendly[yes], near[Rainbow Vegetarian Café]	For a kid friendly pub serving Italian food at a moderate price range. It is located near Rainbow Vegetarian Café in the riverside area.
name[The Vaults], eatType[pub], food[Italian], priceRange[moderate], customer rating[3 out of 5], area[city centre], familyFriendly[no], near[Rainbow Vegetarian Café]	In the city centre, near Rainbow Vegetarian Café, is a pub called The Vaults. It serves Italian food and is not kid friendly.
name[The Vaults], eatType[pub], food[Italian], priceRange[moderate], customer rating[3 out of 5], area[city centre], familyFriendly[yes], near[Rainbow Vegetarian Café]	In the city centre, near Rainbow Vegetarian Café, is a kid friendly pub called The Vaults. It serves Italian food and is moderately priced.
name[The Vaults], eatType[pub], food[Italian], priceRange[moderate], customer rating[3 out of 5], area[riverside], familyFriendly[no], near[Rainbow Vegetarian Café]	In the riverside area near Rainbow Vegetarian Café, is a pub called The Vaults. It serves Italian food and is not kid friendly.
name[The Vaults], eatType[pub], food[Italian], priceRange[moderate], customer rating[3 out of 5], area[riverside], familyFriendly[yes], near[Rainbow Vegetarian Café]	For a kid friendly pub, The Vaults, is located near Rainbow Vegetarian Café.
name[The Vaults], eatType[pub], food[Italian], priceRange[more than £30], customer rating[high], area[city centre], familyFriendly[no], near[Rainbow Vegetarian Café]	In the city centre, near Rainbow Vegetarian Café, is a pub called The Vaults. It serves Italian food and is not child friendly.
name[The Vaults], eatType[pub], food[Italian], priceRange[more than £30], customer rating[high], area[city centre], familyFriendly[yes], near[Rainbow Vegetarian Café]	In the city centre, near Rainbow Vegetarian Café, is a pub called The Vaults. It serves Italian food and is child friendly.
name[The Vaults], eatType[pub], food[Italian], priceRange[more than £30], customer rating[high], area[riverside], familyFriendly[no], near[Rainbow Vegetarian Café]	In the riverside area near Rainbow Vegetarian Café, is a pub called The Vaults. It serves Italian food and is not child friendly.
name[The Vaults], eatType[pub], food[Italian], priceRange[more than £30], customer rating[high], area[riverside], familyFriendly[yes], near[Rainbow Vegetarian Café]	For a pub near Rainbow Vegetarian Café, The Vaults is a family friendly pub serving Italian food in the more than £30 price range.
name[The Vaults], eatType[pub], food[Japanese], priceRange[£20-25], customer rating[3 out of 5], area[city centre], familyFriendly[no], near[Rainbow Vegetarian Café]	In the city centre, near Rainbow Vegetarian Café, is a Japanese pub called The Vaults. It is not kid friendly and has a price range of £20-25.
name[The Vaults], eatType[pub], food[Japanese], priceRange[£20-25], customer rating[3 out of 5], area[city centre], familyFriendly[yes], near[Rainbow Vegetarian Café]	In the city centre, near Rainbow Vegetarian Café, is a Japanese pub called The Vaults. It is kid friendly and has a price range of £20-25.
name[The Vaults], eatType[pub], food[Japanese], priceRange[£20-25], customer rating[3 out of 5], area[riverside], familyFriendly[no], near[Rainbow Vegetarian Café]	In the riverside area near Rainbow Vegetarian Café, is a Japanese pub called The Vaults. It is not kid friendly and has a price range of £20-25.
name[The Vaults], eatType[pub], food[Japanese], priceRange[£20-25], customer rating[3 out of 5], area[riverside], familyFriendly[yes], near[Rainbow Vegetarian Café]	Near the Rainbow Vegetarian Café, is a kid friendly pub called The Vaults. It serves Japanese food and is in the £20-25 price range.
name[The Vaults], eatType[pub], food[Japanese], priceRange[£20-25], customer rating[high], area[city centre], familyFriendly[no], near[Rainbow Vegetarian Café]	In the city centre, near Rainbow Vegetarian Café, is a Japanese pub called The Vaults. It is not kid friendly and has a price range of £20-25.
name[The Vaults], eatType[pub], food[Japanese], priceRange[£20-25], customer rating[high], area[city centre], familyFriendly[yes], near[Rainbow Vegetarian Café]	In the city centre, near Rainbow Vegetarian Café, is a Japanese pub called The Vaults. It is kid friendly and has a price range of £20-25.
name[The Vaults], eatType[pub], food[Japanese], priceRange[£20-25], customer rating[high], area[riverside], familyFriendly[no], near[Rainbow Vegetarian Café]	Near the Rainbow Vegetarian Café, is a pub called The Vaults. It is not kid friendly and serves Japanese food and is between £20-25.
name[The Vaults], eatType[pub], food[Japanese], priceRange[£20-25], customer rating[high], area[riverside], familyFriendly[no], near[Raja Indian Cuisine]	Near the Raja Indian Cuisine, is a pub called The Vaults. It is not kid friendly and serves Japanese food and is between £20-25.
name[The Vaults], eatType[pub], food[Japanese], priceRange[£20-25], customer rating[high], area[riverside], familyFriendly[yes], near[Raja Indian Cuisine]	Near the Raja Indian Cuisine, is a kid friendly pub called The Vaults. It serves Japanese food and is in the £20-25 price range.
name[The Vaults], eatType[pub], food[Japanese], priceRange[cheap], customer rating[5 out of 5], area[city centre], familyFriendly[no], near[Raja Indian Cuisine]	In the city centre, near Raja Indian Cuisine, is a cheap Japanese pub called The Vaults. It is not family-friendly.
name[The Vaults], eatType[pub], food[Japanese], priceRange[cheap], customer rating[5 out of 5], area[city centre], familyFriendly[yes], near[Raja Indian Cuisine]	In the city centre, near Raja Indian Cuisine, is a cheap Japanese pub called The Vaults. It is family friendly.
name[The Vaults], eatType[pub], food[Japanese], priceRange[cheap], customer rating[5 out of 5], area[riverside], familyFriendly[no], near[Raja Indian Cuisine]	Near the Raja Indian Cuisine, is a cheap pub called The Vaults. It is not family friendly.
name[The Vaults], eatType[pub], food[Japanese], priceRange[cheap], customer rating[5 out of 5], area[riverside], familyFriendly[yes], near[Raja Indian Cuisine]	In the riverside area near Raja Indian Cuisine is a cheap Japanese pub called The Vaults. It is family friendly.
name[The Vaults], eatType[pub], food[Japanese], priceRange[high], customer rating[3 out of 5], area[city centre], familyFriendly[no], near[Raja Indian Cuisine]	In the city centre, near Raja Indian Cuisine, is a high priced Japanese pub called The Vaults. It is not child friendly.
name[The Vaults], eatType[pub], food[Japanese], priceRange[high], customer rating[3 out of 5], area[city centre], familyFriendly[yes], near[Raja Indian Cuisine]	In the city centre, near Raja Indian Cuisine, is a high priced pub called The Vaults. It serves Japanese food and is child friendly.
name[The Vaults], eatType[pub], food[Japanese], priceRange[high], customer rating[3 out of 5], area[riverside], familyFriendly[no], near[Raja Indian Cuisine]	Near the Raja Indian Cuisine is a high priced pub called The Vaults. It serves Japanese food and is not child friendly.
name[The Vaults], eatType[pub], food[Japanese], priceRange[high], customer rating[3 out of 5], area[riverside], familyFriendly[yes], near[Raja Indian Cuisine]	In the riverside area, near Raja Indian Cuisine, is a high priced pub called The Vaults. It serves Japanese food and is child friendly.
name[The Vaults], eatType[pub], food[Japanese], priceRange[less than £20], customer rating[average], area[city centre], familyFriendly[no], near[Raja Indian Cuisine]	In the city centre, near Raja Indian Cuisine, is a Japanese pub called The Vaults. It is not family-friendly and has a price range of less than £20.
name[The Vaults], eatType[pub], food[Japanese], priceRange[less than £20], customer rating[average], area[city centre], familyFriendly[yes], near[Raja Indian Cuisine]	In the city centre, near Raja Indian Cuisine, is a family-friendly pub called The Vaults. It serves Japanese food for less than £20.
name[The Vaults], eatType[pub], food[Japanese], priceRange[less than £20], customer rating[average], area[riverside], familyFriendly[no], near[Raja Indian Cuisine]	Near the Raja Indian Cuisine, there is a pub called The Vaults. It is a cheap Japanese food restaurant that is not family-friendly.
name[The Vaults], eatType[pub], food[Japanese], priceRange[less than £20], customer rating[average], area[riverside], familyFriendly[yes], near[Raja Indian Cuisine]	For a family friendly pub serving Japanese food at a £20 price range. It is located near Raja Indian Cuisine in the riverside area.
name[The Vaults], eatType[pub], food[Japanese], priceRange[less than £20], customer rating[low], area[city centre], familyFriendly[no], near[Raja Indian Cuisine]	In the city centre, near Raja Indian Cuisine, is a Japanese pub called The Vaults. It is not family-friendly and has a price range of less than £20.
name[The Vaults], eatType[pub], food[Japanese], priceRange[less than £20], customer rating[low], area[city centre], familyFriendly[yes], near[Raja Indian Cuisine]	In the city centre, near Raja Indian Cuisine, is a family-friendly pub called The Vaults. It serves Japanese food for less than £20.
name[The Vaults], eatType[pub], food[Japanese], priceRange[less than £20], customer rating[low], area[riverside], familyFriendly[no], near[Raja Indian Cuisine]	In the riverside area near Raja Indian Cuisine, is a Japanese pub called The Vaults. It is not family-friendly and has a price range of less than £20.
name[The Vaults], eatType[pub], food[Japanese], priceRange[less than £20], customer rating[low], area[riverside], familyFriendly[yes], near[Raja Indian Cuisine]	Near the Raja Indian Cuisine, is a family friendly pub that serves Japanese food at less than £20.
name[The Vaults], eatType[pub], food[Japanese], priceRange[moderate], customer rating[1 out of 5], area[city centre], familyFriendly[no], near[Raja Indian Cuisine]	In the city centre, near Raja Indian Cuisine, is a Japanese pub called The Vaults. It is not kid friendly and has a moderate price range.
name[The Vaults], eatType[pub], food[Japanese], priceRange[moderate], customer rating[1 out of 5], area[city centre], familyFriendly[yes], near[Raja Indian Cuisine]	In the city centre, near Raja Indian Cuisine, is a Japanese pub called The Vaults. It is kid friendly and has a moderate price range.
name[The Vaults], eatType[restaurant], food[French], priceRange[high], area[riverside], familyFriendly[yes], near[Raja Indian Cuisine]	In the riverside area, there is a high priced French restaurant called The Vaults. It is child friendly.
name[The Vaults], eatType[restaurant], food[French], priceRange[less than £20], area[city centre], familyFriendly[no], near[Raja Indian Cuisine]	In the city centre, near Raja Indian Cuisine, is a French restaurant called The Vaults. It is not family-friendly and has a price range of less than £20.
name[The Vaults], eatType[restaurant], food[French], priceRange[less than £20], area[city centre], familyFriendly[yes], near[Raja Indian Cuisine]	In the city centre, near Raja Indian Cuisine, is a French restaurant called The Vaults. It is family friendly and has a price range of less than £20.
name[The Vaults], eatType[restaurant], food[French], priceRange[less than £20], area[riverside], familyFriendly[no], near[Raja Indian Cuisine]	In the riverside area near Raja Indian Cuisine is a French restaurant called The Vaults. It is not family-friendly and has a price range of less than £20.
name[The Vaults], eatType[restaurant], food[French], priceRange[less than £20], area[riverside], familyFriendly[yes], near[Raja Indian Cuisine]	For a family friendly French restaurant, The Vaults, is located near Raja Indian Cuisine.
name[The Vaults], eatType[restaurant], food[French], priceRange[moderate], area[city centre], familyFriendly[no], near[Raja Indian Cuisine]	In the city centre, near Raja Indian Cuisine, is a French restaurant called The Vaults. It is not kid friendly and has a moderate price range.
name[The Vaults], eatType[restaurant], food[French], priceRange[moderate], area[city centre], familyFriendly[yes], near[Raja Indian Cuisine]	In the city centre, near Raja Indian Cuisine, is a French restaurant called The Vaults. It is kid friendly and has a moderate price range.
name[The Vaults], eatType[restaurant], food[French], priceRange[moderate], area[riverside], familyFriendly[no], near[Raja Indian Cuisine]	In the riverside area near Raja Indian Cuisine, is a French restaurant called The Vaults. It is not kid friendly and has a moderate price range.
name[The Vaults], eatType[restaurant], food[French], priceRange[moderate], area[riverside], familyFriendly[yes], near[Raja Indian Cuisine]	In the riverside area, near Raja Indian Cuisine, is a kid friendly French restaurant called The Vaults. It is moderately priced and is a restaurant.
name[The Vaults], eatType[restaurant], food[French], priceRange[more than £30], area[city centre], familyFriendly[no], near[Raja Indian Cuisine]	In the city centre, near Raja Indian Cuisine, is a French restaurant called The Vaults. It is not child friendly and has a price range of more than £30.
name[The Vaults], eatType[restaurant], food[French], priceRange[more than £30], area[city centre], familyFriendly[yes], near[Raja Indian Cuisine]	In the city centre, near Raja Indian Cuisine, is a French restaurant called The Vaults. It is child friendly and has a price range of more than £30.
name[The Vaults], eatType[restaurant], food[French], priceRange[more than £30], area[riverside], familyFriendly[no], near[Raja Indian Cuisine]	In the riverside area near Raja Indian Cuisine is a French restaurant called The Vaults. It is not child friendly and has a price range of more than £30.
name[The Vaults], eatType[restaurant], food[French], priceRange[more than £30], area[riverside], familyFriendly[yes], near[Raja Indian Cuisine]	In the riverside area near Raja Indian Cuisine is a child friendly French restaurant called The Vaults. It is in the higher price range.
name[The Vaults], eatType[restaurant], food[Indian], priceRange[£20-25], area[riverside], familyFriendly[yes], near[Raja Indian Cuisine]	In the riverside area, The Vaults is a kid friendly restaurant that serves Indian food in the £20-25 price range. It is located in the riverside area near Raja Indian Cuisine.
name[The Vaults], eatType[restaurant], food[Indian], priceRange[cheap], area[riverside], familyFriendly[yes], near[Raja Indian Cuisine]	In the riverside area, near Raja Indian Cuisine, is a family friendly restaurant called The Vaults. It serves Indian food and is cheap.
name[The Vaults], eatType[restaurant], food[Indian], priceRange[high], area[city centre], familyFriendly[no], near[Raja Indian Cuisine]	In the city centre, near Raja Indian Cuisine, is a high priced Indian restaurant called The Vaults. It is not child friendly.
name[The Vaults], eatType[restaurant], food[Indian], priceRange[high], area[city centre], familyFriendly[yes], near[Raja Indian Cuisine]	In the city centre, near Raja Indian Cuisine, is a high priced Indian restaurant called The Vaults.
name[The Waterman], eatType[pub], food[Indian], priceRange[high], area[city centre], familyFriendly[yes], near[Raja Indian Cuisine]	In the city centre, near Raja Indian Cuisine, is a high priced Indian pub called The Waterman. It is child friendly.
name[The Waterman], eatType[pub], food[Indian], priceRange[high], area[riverside], familyFriendly[no], near[Raja Indian Cuisine]	Near the Raja Indian Cuisine is a high priced Indian pub called The Waterman. It is not children friendly.
name[The Waterman], eatType[pub], food[Indian], priceRange[high], area[riverside], familyFriendly[yes], near[Raja Indian Cuisine]	In the riverside area, The Waterman is a pub that serves Indian food. It is child friendly and has a high price range.
name[The Waterman], eatType[pub], food[Indian], priceRange[less than £20], area[city centre], familyFriendly[no], near[Raja Indian Cuisine]	In the city centre, near Raja Indian Cuisine, is a pub called The Waterman. It serves Indian food for less than £20. It is not family friendly.
name[The Waterman], eatType[pub], food[Indian], priceRange[less than £20], area[city centre], familyFriendly[yes], near[Raja Indian Cuisine]	In the city centre, near Raja Indian Cuisine, is a family friendly pub that serves Indian food for less than £20.
name[The Waterman], eatType[pub], food[Indian], priceRange[less than £20], area[riverside], familyFriendly[no], near[Raja Indian Cuisine]	In the riverside area, near Raja Indian Cuisine, is a pub called The Waterman. It serves Indian food for less than £20. It is not family friendly.
name[The Waterman], eatType[pub], food[Indian], priceRange[less than £20], area[riverside], familyFriendly[yes], near[Raja Indian Cuisine]	For a family friendly pub that serves Indian food at less than £20 pounds. It is located near Raja Indian Cuisine in the riverside area.
name[The Waterman], eatType[pub], food[Indian], priceRange[moderate], area[city centre], familyFriendly[no], near[Raja Indian Cuisine]	In the city centre, near Raja Indian Cuisine, is a pub called The Waterman. It serves Indian food and is not kid friendly.
name[The Waterman], eatType[pub], food[Indian], priceRange[moderate], area[city centre], familyFriendly[yes], near[Raja Indian Cuisine]	There is a pub that serves Indian food in the moderate price range. It is located in the city centre near Raja Indian Cuisine.
name[The Waterman], eatType[pub], food[Indian], priceRange[moderate], area[riverside], familyFriendly[no], near[Raja Indian Cuisine]	In the riverside area, near Raja Indian Cuisine, is a pub called The Waterman. It serves Indian food and is not kid friendly.
name[The Waterman], eatType[pub], food[Indian], priceRange[moderate], area[riverside], familyFriendly[yes], near[Raja Indian Cuisine]	For a kid friendly pub serving Indian food in the riverside area, The Waterman is a pub. It is in the moderate price range. It is near Raja Indian Cuisine.
name[The Waterman], eatType[pub], food[Indian], priceRange[more than £30], area[riverside], familyFriendly[yes], near[Raja Indian Cuisine]	For a pub that serves Indian food at a price range of more than £30, it is child friendly, and is located near Raja Indian Cuisine in the riverside area.
name[The Waterman], eatType[pub], food[Italian], priceRange[£20-25], area[riverside], familyFriendly[yes], near[Raja Indian Cuisine]	For a pub called The Waterman, is a kid friendly pub that serves Italian food in the £20-25 price range. It is located in the riverside area near Raja Indian Cuisine.
name[The Waterman], eatType[pub], food[Italian], priceRange[cheap], area[riverside], familyFriendly[yes], near[Raja Indian Cuisine]	For a family friendly Italian pub, The Waterman, is located near Raja Indian Cuisine in the riverside area.
name[The Waterman], eatType[pub], food[Italian], priceRange[high], area[city centre], familyFriendly[no], near[Raja Indian Cuisine]	In the city centre, near Raja Indian Cuisine, is a high priced Italian pub called The Waterman. It is not child friendly.
name[The Waterman], eatType[pub], food[Italian], priceRange[high], area[city centre], familyFriendly[yes], near[Raja Indian Cuisine]	In the city centre, near Raja Indian Cuisine, is a high priced Italian pub called The Waterman. It is child friendly.
name[The Waterman], eatType[pub], food[Italian], priceRange[high], area[riverside], familyFriendly[no], near[Raja Indian Cuisine]	In the riverside area near Raja Indian Cuisine, is a high priced Italian pub called The Waterman. It is not child friendly.
name[The Waterman], eatType[pub], food[Italian], priceRange[high], area[riverside], familyFriendly[yes], near[Raja Indian Cuisine]	In the riverside area, near Raja Indian Cuisine, is a high priced Italian pub called The Waterman.
name[The Waterman], eatType[pub], food[Italian], priceRange[less than £20], area[city centre], familyFriendly[no], near[Raja Indian Cuisine]	In the city centre, near Raja Indian Cuisine, is a pub called The Waterman. It serves Italian food for less than £20. It is not family-friendly.
name[The Waterman], eatType[pub], food[Italian], priceRange[less than £20], area[city centre], familyFriendly[yes], near[Raja Indian Cuisine]	For a family-friendly pub serving Italian food at a £20 price range. It is located in the city centre near Raja Indian Cuisine.
name[The Waterman], eatType[pub], food[Italian], priceRange[less than £20], area[riverside], familyFriendly[no], near[Raja Indian Cuisine]	For a pub called The Waterman, is a cheap Italian pub near Raja Indian Cuisine. It is not family-friendly.
name[The Waterman], eatType[restaurant], food[Indian], priceRange[high], area[city centre], familyFriendly[yes], near[Raja Indian Cuisine]	In the city centre, near Raja Indian Cuisine, is a high priced Indian restaurant called The Waterman. It is child friendly.
name[The Waterman], eatType[restaurant], food[Indian], priceRange[high], area[riverside], familyFriendly[no], near[Raja Indian Cuisine]	In the riverside area, near Raja Indian Cuisine, is a high priced Indian restaurant called The Waterman. It is not child friendly.
name[The Waterman], eatType[restaurant], food[Indian], priceRange[high], area[riverside], familyFriendly[yes], near[Raja Indian Cuisine]	There is a high priced Indian restaurant in the riverside area, near Raja Indian Cuisine. It is called The Waterman.
name[The Waterman], eatType[restaurant], food[Indian], priceRange[less than £20], area[city centre], familyFriendly[no], near[Raja Indian Cuisine]	In the city centre, near Raja Indian Cuisine, is a non family friendly Indian restaurant called The Waterman. It is not family friendly.
name[The Waterman], eatType[restaurant], food[Indian], priceRange[less than £20], area[city centre], familyFriendly[yes], near[Raja Indian Cuisine]	In the city centre, near Raja Indian Cuisine, is a family friendly restaurant called The Waterman. It serves Indian food for less than £20.
name[The Waterman], eatType[restaurant], food[Indian], priceRange[less than £20], area[riverside], familyFriendly[no], near[Raja Indian Cuisine]	For a restaurant that serves Indian food at a price range of less than £20. It is located in the riverside area near Raja Indian Cuisine.
name[The Waterman], eatType[restaurant], food[Indian], priceRange[less than £20], area[riverside], familyFriendly[yes], near[Raja Indian Cuisine]	For a family friendly Indian restaurant, The Waterman, is located near Raja Indian Cuisine.
name[The Waterman], eatType[restaurant], food[Indian], priceRange[moderate], area[city centre], familyFriendly[no], near[Raja Indian Cuisine]	In the city centre, near Raja Indian Cuisine, is a restaurant called The Waterman. It serves Indian food and is not kid friendly.
name[The Waterman], eatType[restaurant], food[Indian], priceRange[moderate], area[city centre], familyFriendly[yes], near[Raja Indian Cuisine]	In the city centre, near Raja Indian Cuisine, is a kid friendly restaurant called The Waterman. It serves Indian food and is moderately priced.
name[The Waterman], eatType[restaurant], food[Indian], priceRange[moderate], area[riverside], familyFriendly[no], near[Raja Indian Cuisine]	In the riverside area, near Raja Indian Cuisine, is a restaurant called The Waterman. It serves Indian food and is not kid friendly.
name[The Waterman], eatType[restaurant], food[Indian], priceRange[moderate], area[riverside], familyFriendly[yes], near[Raja Indian Cuisine]	In the riverside area, near Raja Indian Cuisine, is a kid friendly restaurant called The Waterman. It serves Indian food at a moderate price.
name[The Waterman], eatType[restaurant], food[Indian], priceRange[more than £30], area[riverside], familyFriendly[yes], near[Raja Indian Cuisine]	In the riverside area, near Raja Indian Cuisine, is a child friendly restaurant called The Waterman. It serves Indian food at a price range of more than £30.
name[The Waterman], eatType[restaurant], food[Italian], priceRange[£20-25], area[riverside], familyFriendly[yes], near[Raja Indian Cuisine]	In the riverside area, The Waterman is a kid friendly Italian restaurant with a price range of £20-25.
name[The Waterman], eatType[restaurant], food[Italian], priceRange[cheap], area[riverside], familyFriendly[yes], near[Raja Indian Cuisine]	In the riverside area, near Raja Indian Cuisine, is a cheap Italian restaurant called The Waterman. It is family friendly.
name[The Waterman], eatType[restaurant], food[Italian], priceRange[high], area[city centre], familyFriendly[no], near[Raja Indian Cuisine]	In the city centre, near Raja Indian Cuisine, there is a high priced Italian restaurant called The Waterman. It is not family-friendly.
name[The Waterman], eatType[restaurant], food[Italian], priceRange[high], area[city centre], familyFriendly[yes], near[Raja Indian Cuisine]	In the city centre near Raja Indian Cuisine is a high priced Italian restaurant called The Waterman. It is child friendly.
name[The Waterman], eatType[restaurant], food[Italian], priceRange[high], area[riverside], familyFriendly[no], near[Raja Indian Cuisine]	In the riverside area near Raja Indian Cuisine is a high priced Italian restaurant called The Waterman. It is not child friendly.
name[The Waterman], eatType[restaurant], food[Italian], priceRange[high], area[riverside], familyFriendly[yes], near[Raja Indian Cuisine]	In the riverside area, there is a high priced restaurant called The Waterman. It is family friendly and serves Italian food.
name[The Waterman], eatType[restaurant], food[Italian], priceRange[less than £20], area[city centre], familyFriendly[no], near[Raja Indian Cuisine]	In the city centre, near Raja Indian Cuisine, is a non family-friendly Italian restaurant called The Waterman. It is not family-friendly.
name[The Waterman], eatType[restaurant], food[Italian], priceRange[less than £20], area[city centre], familyFriendly[yes], near[Raja Indian Cuisine]	In the city centre, near Raja Indian Cuisine, is a family-friendly Italian restaurant called The Waterman. It is less than £20.
name[The Waterman], eatType[restaurant], food[Italian], priceRange[less than £20], area[riverside], familyFriendly[no], near[Raja Indian Cuisine]	In the riverside area near Raja Indian Cuisine, is a non family-friendly Italian restaurant called The Waterman. It is not family-friendly.
name[The Wrestlers], eatType[pub], food[Italian], priceRange[less than £20], area[riverside], familyFriendly[no], near[Raja Indian Cuisine]	For a pub called The Wrestlers, is a cheap Italian pub near Raja Indian Cuisine. It is not family-friendly.
name[The Wrestlers], eatType[pub], food[Italian], priceRange[less than £20], area[riverside], familyFriendly[yes], near[Raja Indian Cuisine]	For a family friendly pub serving Italian food at a £20 price range. It is located near Raja Indian Cuisine in the riverside area.
name[The Wrestlers], eatType[pub], food[Italian], priceRange[moderate], area[city centre], familyFriendly[no], near[Raja Indian Cuisine]	In the city centre, near Raja Indian Cuisine, is a pub called The Wrestlers. It serves Italian food and is not kid friendly.
name[The Wrestlers], eatType[pub], food[Italian], priceRange[moderate], area[city centre], familyFriendly[yes], near[Raja Indian Cuisine]	In the city centre, near Raja Indian Cuisine, is a kid friendly pub called The Wrestlers. It serves Italian food and is moderately priced.
name[The Wrestlers], eatType[pub], food[Italian], priceRange[moderate], area[riverside], familyFriendly[no], near[Raja Indian Cuisine]	In the riverside area near Raja Indian Cuisine, is a pub called The Wrestlers. It serves Italian food and is not kid friendly.
name[The Wrestlers], eatType[pub], food[Italian], priceRange[moderate], area[riverside], familyFriendly[yes], near[Raja Indian Cuisine]	For a kid friendly pub, The Wrestlers, is located near Raja Indian Cuisine.
name[The Wrestlers], eatType[pub], food[Italian], priceRange[more than £30], area[riverside], familyFriendly[yes], near[Raja Indian Cuisine]	For a pub near Raja Indian Cuisine, The Wrestlers is a family friendly pub serving Italian food in the more than £30 price range.
name[The Wrestlers], eatType[pub], food[Japanese], priceRange[£20-25], area[riverside], familyFriendly[yes], near[Raja Indian Cuisine]	In the riverside area, near Raja Indian Cuisine, is a Japanese pub called The Wrestlers. It is kid friendly and has a price range of £20-25.
name[The Wrestlers], eatType[pub], food[Japanese], priceRange[cheap], area[riverside], familyFriendly[yes], near[Raja Indian Cuisine]	Near the Raja Indian Cuisine, is a cheap, family friendly pub called The Wrestlers.
name[The Wrestlers], eatType[pub], food[Japanese], priceRange[high], area[riverside], familyFriendly[yes], near[Raja Indian Cuisine]	There is a high priced pub that is family friendly, and serves Japanese food. It is located near Raja Indian Cuisine in the riverside area.
name[The Wrestlers], eatType[pub], food[Japanese], priceRange[less than £20], area[city centre], familyFriendly[no], near[Raja Indian Cuisine]	In the city centre, near Raja Indian Cuisine, is a Japanese pub called The Wrestlers. It is not family-friendly and has a price range of less than £20.
name[The Wrestlers], eatType[pub], food[Japanese], priceRange[less than £20], area[city centre], familyFriendly[yes], near[Raja Indian Cuisine]	In the city centre, near Raja Indian Cuisine, is a family-friendly pub called The Wrestlers. It serves Japanese food for less than £20.
name[The Wrestlers], eatType[pub], food[Japanese], priceRange[less than £20], area[riverside], familyFriendly[no], near[Raja Indian Cuisine]	Near the Raja Indian Cuisine, there is a pub called The Wrestlers. It is a cheap Japanese food restaurant that is not family-friendly.
name[The Wrestlers], eatType[pub], food[Japanese], priceRange[less than £20], area[riverside], familyFriendly[yes], near[Raja Indian Cuisine]	For a family friendly pub serving Japanese food at a £20 price range. It is located near Raja Indian Cuisine in the riverside area.
name[The Wrestlers], eatType[pub], food[Japanese], priceRange[moderate], area[city centre], familyFriendly[no], near[Raja Indian Cuisine]	In the city centre, near Raja Indian Cuisine, is a Japanese pub called The Wrestlers. It is not kid friendly and has a moderate price range.
name[The Wrestlers], eatType[pub], food[Japanese], priceRange[moderate], area[city centre], familyFriendly[yes], near[Raja Indian Cuisine]	In the city centre, near Raja Indian Cuisine, is a Japanese pub called The Wrestlers. It is kid friendly and has a moderate price range.
name[The Wrestlers], eatType[pub], food[Japanese], priceRange[moderate], area[riverside], familyFriendly[no], near[Raja Indian Cuisine]	Near the Raja Indian Cuisine, there is a pub called The Wrestlers. It is not kid friendly and serves Japanese food and is moderately priced.
name[The Wrestlers], eatType[pub], food[Japanese], priceRange[moderate], area[riverside], familyFriendly[yes], near[Raja Indian Cuisine]	In the riverside area, near Raja Indian Cuisine, is a kid friendly pub called The Wrestlers. It serves Japanese food and is moderately priced.
name[The Wrestlers], eatType[pub], food[Japanese], priceRange[moderate], customer rating[1 out of 5], area[city centre], familyFriendly[yes], near[Raja Indian Cuisine]	In the city centre, near Raja Indian Cuisine, is a Japanese pub called The Wrestlers. It is kid friendly and has a moderate price range.
name[The Wrestlers], eatType[pub], food[Japanese], priceRange[moderate], customer rating[1 out of 5], area[riverside], familyFriendly[no], near[Raja Indian Cuisine]	There is a pub called The Wrestlers, near Raja Indian Cuisine. It is not family friendly and serves Japanese food and is moderately priced.
name[The Wrestlers], eatType[pub], food[Japanese], priceRange[moderate], customer rating[1 out of 5], area[riverside], familyFriendly[yes], near[Raja Indian Cuisine]	Near the Raja Indian Cuisine, is a pub called The Wrestlers. It is a family friendly pub that serves Japanese food.
name[The Wrestlers], eatType[pub], food[Japanese], priceRange[more than £30], area[city centre], familyFriendly[no], near[Raja Indian Cuisine]	In the city centre, near Raja Indian Cuisine, is a Japanese pub called The Wrestlers. It is not child friendly and has a price range of more than £30.
name[The Wrestlers], eatType[pub], food[Japanese], priceRange[more than £30], area[city centre], familyFriendly[yes], near[Raja Indian Cuisine]	In the city centre, near Raja Indian Cuisine, is a Japanese pub called The Wrestlers. It is child friendly and costs more than £30.
name[The Wrestlers], eatType[pub], food[Japanese], priceRange[more than £30], area[riverside], familyFriendly[no], near[Raja Indian Cuisine]	In the riverside area near Raja Indian Cuisine, is a Japanese pub called The Wrestlers. It is not child friendly and has a price range of more than £30.
name[The Wrestlers], eatType[pub], food[Japanese], priceRange[more than £30], area[riverside], familyFriendly[yes], near[Raja Indian Cuisine]	Near the Raja Indian Cuisine, is a pub that serves Japanese food. It is a child friendly pub. It is called The Wrestlers.
name[The Wrestlers], eatType[pub], food[Japanese], priceRange[more than £30], customer rating[5 out of 5], area[city centre], familyFriendly[no], near[Raja Indian Cuisine]	In the city centre, near Raja Indian Cuisine, is a Japanese pub called The Wrestlers. It is not child friendly and has a price range of more than £30.
name[The Wrestlers], eatType[pub], food[Japanese], priceRange[more than £30], customer rating[5 out of 5], area[city centre], familyFriendly[yes], near[Raja Indian Cuisine]	In the city centre, near Raja Indian Cuisine, is a Japanese pub called The Wrestlers. It is child friendly and costs more than £30.
name[The Wrestlers], eatType[pub], food[Japanese], priceRange[more than £30], customer rating[5 out of 5], area[riverside], familyFriendly[no], near[Raja Indian Cuisine]	In the riverside area near Raja Indian Cuisine, is a Japanese pub called The Wrestlers. It is not child friendly and has a price range of more than £30.
name[The Wrestlers], eatType[pub], food[Japanese], priceRange[more than £30], customer rating[5 out of 5], area[riverside], familyFriendly[yes], near[Raja Indian Cuisine]	In the riverside area, near Raja Indian Cuisine, is a Japanese pub called The Wrestlers. It is child friendly and has a price range of more than £30.
name[The Wrestlers], eatType[pub], food[Japanese], priceRange[more than £30], customer rating[low], area[city centre], familyFriendly[no], near[Raja Indian Cuisine]	In the city centre, near Raja Indian Cuisine, is a Japanese pub called The Wrestlers. It is not child friendly and has a price range of more than £30.
name[The Wrestlers], eatType[pub], food[Japanese], priceRange[more than £30], customer rating[low], area[city centre], familyFriendly[yes], near[Raja Indian Cuisine]	In the city centre, near Raja Indian Cuisine, is a Japanese pub called The Wrestlers. It is child friendly and costs more than £30.
name[The Wrestlers], eatType[pub], food[Japanese], priceRange[more than £30], customer rating[low], area[riverside], familyFriendly[no], near[Raja Indian Cuisine]	Near the Raja Indian Cuisine, there is a pub called The Wrestlers. It is not child friendly and serves Japanese food at more than £30.
name[The Wrestlers], eatType[pub], food[Japanese], priceRange[more than £30], customer rating[low], area[riverside], familyFriendly[yes], near[Raja Indian Cuisine]	In the riverside area, near Raja Indian Cuisine, is a Japanese pub called The Wrestlers. It is child friendly and has a price range of more than £30.
name[The Wrestlers], eatType[restaurant], food[Italian], priceRange[less than £20], area[riverside], familyFriendly[no], near[Raja Indian Cuisine]	In the riverside area near Raja Indian Cuisine, is a non family-friendly Italian restaurant called The Wrestlers. It is not family-friendly.
name[The Wrestlers], eatType[restaurant], food[Italian], priceRange[less than £20], area[riverside], familyFriendly[yes], near[Raja Indian Cuisine]	For a family friendly Italian restaurant, The Wrestlers, is located near Raja Indian Cuisine.
name[The Wrestlers], eatType[restaurant], food[Italian], priceRange[moderate], area[city centre], familyFriendly[no], near[Raja Indian Cuisine]	In the city centre, near Raja Indian Cuisine, is a restaurant called The Wrestlers. It serves Italian food and is not kid friendly.
name[The Wrestlers], eatType[restaurant], food[Italian], priceRange[moderate], area[city centre], familyFriendly[yes], near[Raja Indian Cuisine]	In the city centre, near Raja Indian Cuisine, is a kid friendly Italian restaurant called The Wrestlers. It is moderately priced.
name[The Wrestlers], eatType[restaurant], food[Italian], priceRange[moderate], area[riverside], familyFriendly[no], near[Raja Indian Cuisine]	In the riverside area near Raja Indian Cuisine, is a moderately priced Italian restaurant called The Wrestlers. It is not kid friendly.
name[The Wrestlers], eatType[restaurant], food[Italian], priceRange[moderate], area[riverside], familyFriendly[yes], near[Raja Indian Cuisine]	For a kid friendly Italian restaurant, The Wrestlers, is located near Raja Indian Cuisine in the riverside area.
name[The Wrestlers], eatType[restaurant], food[Italian], priceRange[more than £30], area[riverside], familyFriendly[yes], near[Raja Indian Cuisine]	In the riverside area near Raja Indian Cuisine is a child friendly restaurant called The Wrestlers. It serves Italian food at a price range of more than £30.
name[The Wrestlers], eatType[restaurant], food[Japanese], priceRange[£20-25], area[riverside], familyFriendly[yes], near[Raja Indian Cuisine]	In the riverside area, near Raja Indian Cuisine, is a Japanese restaurant called The Wrestlers. It is kid friendly and has a price range of £20-25.
name[The Wrestlers], eatType[restaurant], food[Japanese], priceRange[cheap], area[riverside], familyFriendly[yes], near[Raja Indian Cuisine]	In the riverside area near Raja Indian Cuisine is a cheap Japanese restaurant called The Wrestlers. It is family friendly.
name[The Wrestlers], eatType[restaurant], food[Japanese], priceRange[high], area[riverside], familyFriendly[yes], near[Raja Indian Cuisine]	In the riverside area, there is a high priced restaurant called The Wrestlers. It is a Japanese restaurant that is child friendly.
name[The Wrestlers], eatType[restaurant], food[Japanese], priceRange[less than £20], area[city centre], familyFriendly[no], near[Raja Indian Cuisine]	In the city centre, near Raja Indian Cuisine, is a Japanese restaurant called The Wrestlers. It is not family-friendly and has a price range of less than £20.
name[The Wrestlers], eatType[restaurant], food[Japanese], priceRange[less than £20], area[city centre], familyFriendly[yes], near[Raja Indian Cuisine]	In the city centre, near Raja Indian Cuisine, is a Japanese restaurant called The Wrestlers. It is family friendly and has a price range of less than £20.
name[The Wrestlers], eatType[restaurant], food[Japanese], priceRange[less than £20], area[riverside], familyFriendly[no], near[Raja Indian Cuisine]	In the riverside area near Raja Indian Cuisine, is a Japanese restaurant called The Wrestlers. It is not family-friendly and has a price range of less than £20.
name[The Wrestlers], eatType[restaurant], food[Japanese], priceRange[less than £20], area[riverside], familyFriendly[yes], near[Raja Indian Cuisine]	There is a family friendly restaurant called The Wrestlers. It is located near Raja Indian Cuisine.
name[The Wrestlers], eatType[restaurant], food[Japanese], priceRange[moderate], area[city centre], familyFriendly[no], near[Raja Indian Cuisine]	In the city centre, near Raja Indian Cuisine, is a Japanese restaurant called The Wrestlers. It is not kid friendly and has a moderate price range.
name[The Wrestlers], eatType[restaurant], food[Japanese], priceRange[moderate], area[city centre], familyFriendly[yes], near[Raja Indian Cuisine]	In the city centre, near Raja Indian Cuisine, is a Japanese restaurant called The Wrestlers. It is kid friendly and has a moderate price range.
name[The Wrestlers], eatType[restaurant], food[Japanese], priceRange[moderate], area[riverside], familyFriendly[no], near[Raja Indian Cuisine]	In the riverside area near Raja Indian Cuisine, is a Japanese restaurant called The Wrestlers. It is not kid friendly and has a moderate price range.
name[The Wrestlers], eatType[restaurant], food[Japanese], priceRange[moderate], area[riverside], familyFriendly[yes], near[Raja Indian Cuisine]	In the riverside area, near Raja Indian Cuisine, is a Japanese restaurant called The Wrestlers. It is kid friendly and has a moderate price range.
name[The Wrestlers], eatType[restaurant], food[Japanese], priceRange[more than £30], area[city centre], familyFriendly[no], near[Raja Indian Cuisine]	In the city centre, near Raja Indian Cuisine, there is a Japanese restaurant called The Wrestlers. It is not child friendly and has a price range of more than £30.
name[The Wrestlers], eatType[restaurant], food[Japanese], priceRange[more than £30], area[city centre], familyFriendly[yes], near[Raja Indian Cuisine]	In the city centre, near Raja Indian Cuisine, is a Japanese restaurant called The Wrestlers. It is a child friendly restaurant with a price range of more than £30.
name[The Wrestlers], eatType[restaurant], food[Japanese], priceRange[more than £30], area[riverside], familyFriendly[no], near[Raja Indian Cuisine]	In the riverside area near Raja Indian Cuisine, is a Japanese restaurant called The Wrestlers. It is not child friendly and has a price range of more than £30.
name[The Wrestlers], eatType[restaurant], food[Japanese], priceRange[more than £30], area[riverside], familyFriendly[yes], near[Raja Indian Cuisine]	In the riverside area near Raja Indian Cuisine is a Japanese restaurant called The Wrestlers. It is child friendly and costs more than £30.
name[Wildwood], eatType[coffee shop], area[riverside]	In riverside is a coffee shop called Wildwood.
name[Wildwood], eatType[pub], area[riverside]	For a pub in the riverside area, Wildwood is a pub.
name[Wildwood], eatType[pub], food[French], area[riverside], familyFriendly[yes], near[Raja Indian Cuisine]	For a family friendly pub serving French food, Wildwood is located near Raja Indian Cuisine.
name[Wildwood], eatType[pub], food[Indian], area[city centre], familyFriendly[no], near[Raja Indian Cuisine]	In the city centre, near Raja Indian Cuisine, is a pub called Wildwood. It serves Indian food and is not family friendly.
name[Wildwood], eatType[pub], food[Indian], area[city centre], familyFriendly[yes], near[Raja Indian Cuisine]	In the city centre, near Raja Indian Cuisine, is a family friendly pub called Wildwood.
name[Wildwood], eatType[pub], food[Indian], area[riverside], familyFriendly[no], near[Raja Indian Cuisine]	In the riverside area, near Raja Indian Cuisine, is a pub called Wildwood. It serves Indian food and is not family friendly.
name[Wildwood], eatType[pub], food[Indian], area[riverside], familyFriendly[yes], near[Raja Indian Cuisine]	In the riverside area, near Raja Indian Cuisine, is a family friendly pub called Wildwood.
name[Wildwood], eatType[pub], food[Italian], area[city centre], familyFriendly[no], near[Raja Indian Cuisine]	In the city centre, near Raja Indian Cuisine, is a pub called Wildwood. It serves Italian food and is not family-friendly.
name[Wildwood], eatType[pub], food[Italian], area[city centre], familyFriendly[yes], near[Raja Indian Cuisine]	In the city centre, near Raja Indian Cuisine, is a family-friendly Italian pub called Wildwood.
name[Wildwood], eatType[pub], food[Italian], area[riverside], familyFriendly[no], near[Raja Indian Cuisine]	In the riverside area, near Raja Indian Cuisine, is a pub called Wildwood. It serves Italian food and is not family-friendly.
name[Wildwood], eatType[pub], food[Italian], area[riverside], familyFriendly[yes], near[Raja Indian Cuisine]	For a family friendly pub serving Italian food, Wildwood is located near Raja Indian Cuisine.
name[Wildwood], eatType[restaurant], food[French], area[riverside], familyFriendly[yes], near[Raja Indian Cuisine]	In the riverside area, near Raja Indian Cuisine, is a French restaurant called Wildwood. It is family friendly.
name[Wildwood], eatType[restaurant], food[Indian], area[city centre], familyFriendly[no], near[Raja Indian Cuisine]	In the city centre, near Raja Indian Cuisine, there is a restaurant called Wildwood. It serves Indian food and is not family friendly.
name[Wildwood], eatType[restaurant], food[Indian], area[city centre], familyFriendly[yes], near[Raja Indian Cuisine]	In the city centre, near Raja Indian Cuisine, is a family friendly restaurant called Wildwood.
name[Wildwood], eatType[restaurant], food[Indian], area[riverside], familyFriendly[no], near[Raja Indian Cuisine]	In the riverside area, near Raja Indian Cuisine, is a restaurant called Wildwood. It serves Indian food and is not family friendly.
name[Wildwood], eatType[restaurant], food[Indian], area[riverside], familyFriendly[yes], near[Raja Indian Cuisine]	In the riverside area, near Raja Indian Cuisine, is a family friendly restaurant called Wildwood.
name[Wildwood], eatType[restaurant], food[Italian], area[city centre], familyFriendly[no], near[Raja Indian Cuisine]	In the city centre, near Raja Indian Cuisine, there is a restaurant called Wildwood. It serves Italian food and is not family-friendly.
name[Wildwood], eatType[restaurant], food[Italian], area[city centre], familyFriendly[yes], near[Raja Indian Cuisine]	In the city centre, near Raja Indian Cuisine, is a family-friendly Italian restaurant called Wildwood.
name[Wildwood], eatType[restaurant], food[Italian], area[riverside], familyFriendly[no], near[Raja Indian Cuisine]	In the riverside area, near Raja Indian Cuisine, is a non family-friendly Italian restaurant called Wildwood.
name[Wildwood], eatType[restaurant], food[Italian], area[riverside], familyFriendly[yes], near[Raja Indian Cuisine]	In the riverside area, near Raja Indian Cuisine, is a family friendly restaurant called Wildwood.
name[Zizzi], eatType[coffee shop], area[riverside]	In riverside is a coffee shop called Zizzi.
name[Zizzi], eatType[coffee shop], customer rating[average], near[Burger King]	For a coffee shop near Burger King is Zizzi.
name[Zizzi], eatType[coffee shop], customer rating[high], near[Burger King]	For a coffee shop near Burger King is Zizzi.
name[Zizzi], eatType[coffee shop], near[The Sorrento]	For a coffee shop near The Sorrento is Zizzi.
name[Zizzi], eatType[pub], area[riverside]	In riverside is a pub called Zizzi.
name[Zizzi], eatType[pub], customer rating[average], near[Burger King]	For a pub near Burger King, Zizzi is a pub.
name[Zizzi], eatType[pub], customer rating[high], near[Burger King]	For a pub near Burger King, Zizzi is a pub.
name[Zizzi], eatType[pub], near[The Sorrento]	For a pub near The Sorrento, Zizzi is a pub.