name[Blue Spice], eatType[coffee shop], area[city centre]	Blue Spice is a coffee shop located in the city centre.
name[Blue Spice], eatType[coffee shop], area[riverside]	Blue Spice is a coffee shop located in the riverside area.
name[Blue Spice], eatType[coffee shop], customer rating[5 out of 5], near[Crowne Plaza Hotel]	Blue Spice near Crowne Plaza Hotel is a coffee shop with a customer rating of 5 out of 5.
name[Blue Spice], eatType[coffee shop], customer rating[average], near[Burger King]	Blue Spice is an average rated coffee shop near Burger King.
name[Blue Spice], eatType[coffee shop], customer rating[average], near[Crowne Plaza Hotel]	Blue Spice is an average rated coffee shop near Crowne Plaza Hotel.
name[Blue Spice], eatType[pub], area[city centre]	Blue Spice pub located in the city centre.
name[Blue Spice], eatType[pub], area[riverside]	Blue Spice pub located in the riverside area.
name[Blue Spice], eatType[pub], customer rating[5 out of 5], near[Crowne Plaza Hotel]	Blue Spice pub near Crowne Plaza Hotel has a customer rating of 5 out of 5.
name[Blue Spice], eatType[pub], customer rating[average], near[Burger King]	Blue Spice pub near Burger King has an average customer rating.
name[Blue Spice], eatType[pub], customer rating[average], near[Crowne Plaza Hotel]	Blue Spice pub near Crowne Plaza Hotel has an average customer rating.
name[Blue Spice], eatType[pub], food[Chinese], area[city centre], familyFriendly[no], near[Rainbow Vegetarian Café]	Blue Spice is a Chinese pub located in the city centre near Rainbow Vegetarian Café it is not family friendly.
name[Blue Spice], eatType[pub], food[Chinese], area[city centre], familyFriendly[yes], near[Rainbow Vegetarian Café]	Blue Spice is a Chinese pub in the city centre near Rainbow Vegetarian Café it is family friendly.
name[Blue Spice], eatType[pub], food[Chinese], area[riverside], familyFriendly[no], near[Rainbow Vegetarian Café]	Blue Spice is a Chinese pub located in the riverside near Rainbow Vegetarian Café it is not family friendly.
name[Blue Spice], eatType[pub], food[Chinese], area[riverside], familyFriendly[yes], near[Rainbow Vegetarian Café]	Blue Spice is a Chinese pub in riverside near Rainbow Vegetarian Café it is family friendly.
name[Blue Spice], eatType[pub], food[English], area[city centre], familyFriendly[no], near[Rainbow Vegetarian Café]	Blue Spice is an English pub located in the city centre near Rainbow Vegetarian Café it is not family friendly.
name[Blue Spice], eatType[pub], food[English], area[city centre], familyFriendly[yes], near[Rainbow Vegetarian Café]	Blue Spice is a family friendly pub serving English food near Rainbow Vegetarian Café in the city centre.
name[Blue Spice], eatType[pub], food[English], area[riverside], familyFriendly[no], near[Rainbow Vegetarian Café]	Blue Spice is an English pub located in the riverside near Rainbow Vegetarian Café it is not family friendly.
name[Blue Spice], eatType[pub], food[English], area[riverside], familyFriendly[yes], near[Rainbow Vegetarian Café]	Blue Spice is a family friendly pub serving English food near Rainbow Vegetarian Café in riverside.
name[Blue Spice], eatType[restaurant], food[Chinese], area[city centre], familyFriendly[no], near[Rainbow Vegetarian Café]	Blue Spice is a Chinese restaurant in the city centre near Rainbow Vegetarian Café it is not family friendly.
name[Blue Spice], eatType[restaurant], food[Chinese], area[city centre], familyFriendly[yes], near[Rainbow Vegetarian Café]	Blue Spice is a Chinese restaurant in the city centre near Rainbow Vegetarian Café it is family friendly.
name[Blue Spice], eatType[restaurant], food[Chinese], area[riverside], familyFriendly[no], near[Rainbow Vegetarian Café]	Blue Spice is a Chinese restaurant in riverside near Rainbow Vegetarian Café it is not family friendly.
name[Blue Spice], eatType[restaurant], food[Chinese], area[riverside], familyFriendly[yes], near[Rainbow Vegetarian Café]	Blue Spice is a Chinese restaurant in riverside near Rainbow Vegetarian Café it is family friendly.
name[Blue Spice], eatType[restaurant], food[English], area[city centre], familyFriendly[no], near[Rainbow Vegetarian Café]	Blue Spice is an English restaurant in the city centre near Rainbow Vegetarian Café it is not family friendly.
name[Blue Spice], eatType[restaurant], food[English], area[city centre], familyFriendly[yes], near[Rainbow Vegetarian Café]	Blue Spice is an English restaurant in the city centre near Rainbow Vegetarian Café it is family friendly.
name[Blue Spice], eatType[restaurant], food[English], area[riverside], familyFriendly[no], near[Rainbow Vegetarian Café]	Blue Spice is an English restaurant located in riverside near Rainbow Vegetarian Café it is not family friendly.
name[Blue Spice], eatType[restaurant], food[English], area[riverside], familyFriendly[yes], near[Rainbow Vegetarian Café]	Blue Spice is an English restaurant in riverside near Rainbow Vegetarian Café is a family friendly.
name[Clowns], eatType[coffee shop], customer rating[3 out of 5], near[All Bar One]	Clowns near All Bar One is a coffee shop with a customer rating of 3 out of 5.
name[Clowns], eatType[coffee shop], customer rating[5 out of 5], near[Crowne Plaza Hotel]	Clowns near Crowne Plaza Hotel is a coffee shop with a customer rating of 5 out of 5.
name[Clowns], eatType[coffee shop], near[The Sorrento]	Clowns near The Sorrento is a coffee shop.
name[Clowns], eatType[pub], customer rating[3 out of 5], near[All Bar One]	Clowns pub near All Bar One with a customer rating of 3 out of 5.
name[Clowns], eatType[pub], customer rating[5 out of 5], near[Crowne Plaza Hotel]	Clowns pub near Crowne Plaza Hotel has a customer rating of 5 out of 5.
name[Clowns], eatType[pub], near[The Sorrento]	Clowns pub near The Sorrento.
name[Cocum], eatType[coffee shop], customer rating[high], near[Burger King]	Cocum is a high rated coffee shop near Burger King.
name[Cocum], eatType[coffee shop], customer rating[high], near[Café Sicilia]	Cocum is a high rated coffee shop near Café Sicilia.
name[Cocum], eatType[coffee shop], customer rating[low], near[Café Sicilia]	Cocum is a coffee shop near Café Sicilia it has a low customer rating.
name[Cocum], eatType[coffee shop], customer rating[low], near[Express by Holiday Inn]	Cocum is a coffee shop near Express by Holiday Inn it has a low customer rating.
name[Cocum], eatType[coffee shop], near[The Rice Boat]	Cocum near The Rice Boat is a coffee shop.
name[Cocum], eatType[coffee shop], near[The Sorrento]	Cocum near The Sorrento is a coffee shop.
name[Cocum], eatType[pub], customer rating[high], near[Burger King]	Cocum pub near Burger King has a high customer rating.
name[Cocum], eatType[pub], customer rating[high], near[Café Sicilia]	Cocum pub near Café Sicilia has a high customer rating.
name[Cocum], eatType[pub], customer rating[low], near[Café Sicilia]	Cocum pub near Café Sicilia with a low customer rating.
name[Cocum], eatType[pub], customer rating[low], near[Express by Holiday Inn]	Cocum pub near Express by Holiday Inn with a low customer rating.
name[Cocum], eatType[pub], near[The Rice Boat]	Cocum pub near The Rice Boat.
name[Cocum], eatType[pub], near[The Sorrento]	Cocum pub near The Sorrento.
name[Cotto], eatType[coffee shop], near[The Bakers]	Cotto near The Bakers is a coffee shop.
name[Cotto], eatType[pub], near[The Bakers]	Cotto pub near The Bakers.
name[Giraffe], eatType[coffee shop], near[The Bakers]	Giraffe near The Bakers is a coffee shop.
name[Giraffe], eatType[coffee shop], near[The Rice Boat]	Giraffe near The Rice Boat is a coffee shop.
name[Giraffe], eatType[pub], food[English], area[riverside], familyFriendly[yes], near[Rainbow Vegetarian Café]	Giraffe is a family friendly pub serving English food near Rainbow Vegetarian Café in riverside.
name[Giraffe], eatType[pub], food[Fast food], area[city centre], familyFriendly[no], near[Rainbow Vegetarian Café]	Giraffe is a Fast food pub located in the city centre near Rainbow Vegetarian Café it is not family friendly.
name[Giraffe], eatType[pub], food[Fast food], area[city centre], familyFriendly[yes], near[Rainbow Vegetarian Café]	Giraffe is a family friendly pub serving Fast food in the city centre near Rainbow Vegetarian Café.
name[Giraffe], eatType[pub], food[Fast food], area[riverside], familyFriendly[no], near[Rainbow Vegetarian Café]	Giraffe is a Fast food pub located in riverside near Rainbow Vegetarian Café it is not family friendly.
name[Giraffe], eatType[pub], food[Fast food], area[riverside], familyFriendly[yes], near[Rainbow Vegetarian Café]	Giraffe is a family friendly pub serving Fast food in the riverside near Rainbow Vegetarian Café.
name[Giraffe], eatType[pub], food[Fast food], area[riverside], familyFriendly[yes], near[Raja Indian Cuisine]	Giraffe is a family friendly pub serving Fast food in the riverside near Raja Indian Cuisine.
name[Giraffe], eatType[pub], food[French], area[city centre], familyFriendly[no], near[Raja Indian Cuisine]	Giraffe is a French pub located in the city centre near Raja Indian Cuisine it is not family friendly.
name[Giraffe], eatType[pub], food[French], area[city centre], familyFriendly[yes], near[Raja Indian Cuisine]	Giraffe is a family friendly pub serving French food located in the city centre near Raja Indian Cuisine.
name[Giraffe], eatType[pub], food[French], area[riverside], familyFriendly[no], near[Raja Indian Cuisine]	Giraffe is a French pub located in the riverside near Raja Indian Cuisine it is not family friendly.
name[Giraffe], eatType[pub], food[French], area[riverside], familyFriendly[yes], near[Raja Indian Cuisine]	Giraffe is a family friendly pub serving French food located in the riverside near Raja Indian Cuisine.
name[Giraffe], eatType[pub], near[The Bakers]	Giraffe pub near The Bakers.
name[Giraffe], eatType[pub], near[The Rice Boat]	Giraffe pub near The Rice Boat.
name[Giraffe], eatType[restaurant], food[English], area[riverside], familyFriendly[yes], near[Rainbow Vegetarian Café]	Giraffe is an English restaurant in riverside near Rainbow Vegetarian Café is a family friendly.
name[Giraffe], eatType[restaurant], food[Fast food], area[city centre], familyFriendly[no], near[Rainbow Vegetarian Café]	Giraffe is a Fast food restaurant located in the city centre near Rainbow Vegetarian Café it is not family friendly.
name[Giraffe], eatType[restaurant], food[Fast food], area[city centre], familyFriendly[yes], near[Rainbow Vegetarian Café]	Giraffe is a Fast food restaurant in the city centre near Rainbow Vegetarian Café it is family friendly.
name[Giraffe], eatType[restaurant], food[Fast food], area[riverside], familyFriendly[no], near[Rainbow Vegetarian Café]	Giraffe is a Fast food restaurant located in riverside near Rainbow Vegetarian Café it is not family friendly.
name[Giraffe], eatType[restaurant], food[Fast food], area[riverside], familyFriendly[yes], near[Rainbow Vegetarian Café]	Giraffe is a Fast food restaurant in riverside near Rainbow Vegetarian Café it is family friendly.
name[Giraffe], eatType[restaurant], food[Fast food], area[riverside], familyFriendly[yes], near[Raja Indian Cuisine]	Giraffe is a Fast food restaurant in riverside near Raja Indian Cuisine it is family friendly.
name[Giraffe], eatType[restaurant], food[French], area[city centre], familyFriendly[no], near[Raja Indian Cuisine]	Giraffe is a French restaurant in the city centre near Raja Indian Cuisine it is not family friendly.
name[Giraffe], eatType[restaurant], food[French], area[city centre], familyFriendly[yes], near[Raja Indian Cuisine]	Giraffe is a French restaurant in the city centre near Raja Indian Cuisine it is family friendly.
name[Giraffe], eatType[restaurant], food[French], area[riverside], familyFriendly[no], near[Raja Indian Cuisine]	Giraffe is a French restaurant located in the riverside near Raja Indian Cuisine it is not family friendly.
name[Giraffe], eatType[restaurant], food[French], area[riverside], familyFriendly[yes], near[Raja Indian Cuisine]	Giraffe is a French restaurant in riverside near Raja Indian Cuisine it is family friendly.
name[Green Man], eatType[coffee shop], customer rating[1 out of 5], near[All Bar One]	Green Man is a coffee shop near All Bar One it has a customer rating of 1 out of 5.
name[Green Man], eatType[coffee shop], customer rating[3 out of 5], near[All Bar One]	Green Man near All Bar One is a coffee shop with a customer rating of 3 out of 5.
name[Green Man], eatType[pub], customer rating[1 out of 5], near[All Bar One]	Green Man pub near All Bar One with a customer rating of 1 out of 5.
name[Green Man], eatType[pub], customer rating[3 out of 5], near[All Bar One]	Green Man pub near All Bar One with a customer rating of 3 out of 5.
name[Green Man], eatType[pub], food[Italian], area[riverside], familyFriendly[yes], near[Express by Holiday Inn]	Green Man is a family friendly pub Italian located in the riverside near Express by Holiday Inn.
name[Green Man], eatType[pub], food[Italian], area[riverside], familyFriendly[yes], near[Raja Indian Cuisine]	Green Man is a family friendly pub Italian located in the riverside near Raja Indian Cuisine.
name[Green Man], eatType[pub], food[Japanese], area[city centre], familyFriendly[no], near[Express by Holiday Inn]	Green Man is a Japanese pub located in the city centre near Express by Holiday Inn it is not family friendly.
name[Green Man], eatType[pub], food[Japanese], area[city centre], familyFriendly[yes], near[Express by Holiday Inn]	Green Man is a family friendly pub serving Japanese food located in the city centre near Express by Holiday Inn.
name[Green Man], eatType[pub], food[Japanese], area[riverside], familyFriendly[no], near[Express by Holiday Inn]	Green Man is a Japanese pub located in riverside near Express by Holiday Inn it is not family friendly.
name[Green Man], eatType[pub], food[Japanese], area[riverside], familyFriendly[yes], near[Express by Holiday Inn]	Green Man is a family friendly pub serving Japanese food in the riverside near Express by Holiday Inn.
name[Green Man], eatType[restaurant], food[Italian], area[riverside], familyFriendly[yes], near[Express by Holiday Inn]	Green Man is an Italian restaurant in riverside near Express by Holiday Inn is a family friendly.
name[Green Man], eatType[restaurant], food[Italian], area[riverside], familyFriendly[yes], near[Raja Indian Cuisine]	Green Man is an Italian restaurant in riverside near Raja Indian Cuisine is a family friendly.
name[Green Man], eatType[restaurant], food[Japanese], area[city centre], familyFriendly[no], near[Express by Holiday Inn]	Green Man is a Japanese restaurant in the city centre near Express by Holiday Inn it is not family friendly.
name[Green Man], eatType[restaurant], food[Japanese], area[city centre], familyFriendly[yes], near[Express by Holiday Inn]	Green Man is a Japanese restaurant that is family friendly it is located in the city centre near Express by Holiday Inn.
name[Green Man], eatType[restaurant], food[Japanese], area[riverside], familyFriendly[no], near[Express by Holiday Inn]	Green Man is a Japanese restaurant located in riverside near Express by Holiday Inn it is not family friendly.
name[Green Man], eatType[restaurant], food[Japanese], area[riverside], familyFriendly[yes], near[Express by Holiday Inn]	Green Man is a Japanese restaurant in riverside near Express by Holiday Inn is a family friendly.
name[Loch Fyne], eatType[coffee shop], area[riverside]	Loch Fyne is a coffee shop located in the riverside area.
name[Loch Fyne], eatType[pub], area[riverside]	Loch Fyne pub located in the riverside area.
name[Strada], eatType[coffee shop], area[city centre]	Strada is a coffee shop located in the city centre.
name[Strada], eatType[coffee shop], customer rating[1 out of 5], near[All Bar One]	Strada is a coffee shop near All Bar One it has a customer rating of 1 out of 5.
name[Strada], eatType[coffee shop], customer rating[1 out of 5], near[Rainbow Vegetarian Café]	Strada is a coffee shop near Rainbow Vegetarian Café it has a customer rating of 1 out of 5.
name[Strada], eatType[coffee shop], customer rating[low], near[Express by Holiday Inn]	Strada is a coffee shop near Express by Holiday Inn it has a low customer rating.
name[Strada], eatType[pub], area[city centre]	Strada pub located in the city centre.
name[Strada], eatType[pub], customer rating[1 out of 5], near[All Bar One]	Strada pub near All Bar One with a customer rating of 1 out of 5.
name[Strada], eatType[pub], customer rating[1 out of 5], near[Rainbow Vegetarian Café]	Strada pub near Rainbow Vegetarian Café with a customer rating of 1 out of 5.
name[Strada], eatType[pub], customer rating[low], near[Express by Holiday Inn]	Strada pub near Express by Holiday Inn with a low customer rating.
name[The Cricketers], eatType[coffee shop], customer rating[1 out of 5], familyFriendly[yes], near[Avalon]	The Cricketers is a family friendly coffee shop near Avalon with a customer rating of 1 out of 5.
name[The Cricketers], eatType[coffee shop], customer rating[3 out of 5], familyFriendly[yes], near[Avalon]	The Cricketers is a family friendly coffee shop near Avalon with a customer rating of 3 out of 5.
name[The Cricketers], eatType[coffee shop], customer rating[3 out of 5], familyFriendly[yes], near[Crowne Plaza Hotel]	The Cricketers is a family friendly coffee shop near Crowne Plaza Hotel with a customer rating of 3 out of 5.
name[The Cricketers], eatType[coffee shop], customer rating[5 out of 5], familyFriendly[no], near[Crowne Plaza Hotel]	The Cricketers near Crowne Plaza Hotel is a coffee shop that is not family friendly and has a customer rating of 5 out of 5.
name[The Cricketers], eatType[coffee shop], customer rating[5 out of 5], familyFriendly[yes], near[Crowne Plaza Hotel]	The Cricketers is a family friendly coffee shop near Crowne Plaza Hotel with a customer rating of 5 out of 5.
name[The Cricketers], eatType[coffee shop], customer rating[average], familyFriendly[no], near[Café Sicilia]	The Cricketers is an average coffee shop near Café Sicilia it is not family friendly.
name[The Cricketers], eatType[coffee shop], customer rating[average], familyFriendly[no], near[Crowne Plaza Hotel]	The Cricketers is an average coffee shop near Crowne Plaza Hotel it is not family friendly.
name[The Cricketers], eatType[coffee shop], customer rating[average], familyFriendly[yes], near[Café Sicilia]	The Cricketers near Café Sicilia and has a customer rating is a family friendly coffee shop.
name[The Cricketers], eatType[coffee shop], customer rating[high], familyFriendly[yes], near[Café Sicilia]	The Cricketers is a family friendly coffee shop near Café Sicilia with a high customer rating.
name[The Cricketers], eatType[coffee shop], customer rating[high], familyFriendly[yes], near[Express by Holiday Inn]	The Cricketers is a family friendly coffee shop near Express by Holiday Inn with a high customer rating.
name[The Cricketers], eatType[coffee shop], customer rating[low], familyFriendly[no], near[Express by Holiday Inn]	The Cricketers near Express by Holiday Inn is a coffee shop with a low customer rating it is not family friendly.
name[The Cricketers], eatType[coffee shop], customer rating[low], familyFriendly[no], near[Ranch]	The Cricketers near Ranch is a coffee shop with a low customer rating it is not family friendly.
name[The Cricketers], eatType[coffee shop], customer rating[low], familyFriendly[yes], near[Ranch]	The Cricketers is a family friendly coffee shop near Ranch with a low customer rating.
name[The Cricketers], eatType[restaurant], customer rating[1 out of 5], familyFriendly[yes], near[Avalon]	The Cricketers is a family friendly restaurant near Avalon with a customer rating of 1 out of 5.
name[The Cricketers], eatType[restaurant], customer rating[3 out of 5], familyFriendly[yes], near[Avalon]	The Cricketers is a family friendly restaurant near Avalon with a customer rating of 3 out of 5.
name[The Cricketers], eatType[restaurant], customer rating[3 out of 5], familyFriendly[yes], near[Crowne Plaza Hotel]	The Cricketers is a family friendly restaurant near Crowne Plaza Hotel with a customer rating of 3 out of 5.
name[The Cricketers], eatType[restaurant], customer rating[5 out of 5], familyFriendly[no], near[Crowne Plaza Hotel]	The Cricketers near Crowne Plaza Hotel is a restaurant with a customer rating of 5 out of 5 and is not family friendly.
name[The Cricketers], eatType[restaurant], customer rating[5 out of 5], familyFriendly[yes], near[Crowne Plaza Hotel]	The Cricketers is a family friendly restaurant near Crowne Plaza Hotel has a customer rating of 5 out of 5.
name[The Cricketers], eatType[restaurant], customer rating[average], familyFriendly[no], near[Café Sicilia]	The Cricketers near Café Sicilia has an average customer rating it is not family friendly restaurant.
name[The Cricketers], eatType[restaurant], customer rating[average], familyFriendly[no], near[Crowne Plaza Hotel]	The Cricketers near Crowne Plaza Hotel has an average customer rating it is not family friendly restaurant.
name[The Cricketers], eatType[restaurant], customer rating[average], familyFriendly[yes], near[Café Sicilia]	The Cricketers near Café Sicilia is a family friendly restaurant with an average customer rating.
name[The Cricketers], eatType[restaurant], customer rating[high], familyFriendly[yes], near[Café Sicilia]	The Cricketers is a family friendly restaurant near Café Sicilia has a high customer rating.
name[The Cricketers], eatType[restaurant], customer rating[high], familyFriendly[yes], near[Express by Holiday Inn]	The Cricketers is a family friendly restaurant near Express by Holiday Inn has a high customer rating.
name[The Cricketers], eatType[restaurant], customer rating[low], familyFriendly[no], near[Express by Holiday Inn]	The Cricketers near Express by Holiday Inn is a restaurant with a low customer rating it is not family friendly.
name[The Cricketers], eatType[restaurant], customer rating[low], familyFriendly[no], near[Ranch]	The Cricketers near Ranch is a restaurant with a low customer rating it is not family friendly.
name[The Cricketers], eatType[restaurant], customer rating[low], familyFriendly[yes], near[Ranch]	The Cricketers is a family friendly restaurant near Ranch with a low customer rating.
name[The Cricketers], eatType[restaurant], food[Chinese], priceRange[£20-25], customer rating[high], area[city centre], familyFriendly[no], near[All Bar One]	The Cricketers is a Chinese restaurant with a price range of more than £30 and has a high customer rating it is located in the city centre near All Bar One it is not kid friendly.
name[The Cricketers], eatType[restaurant], food[Chinese], priceRange[£20-25], customer rating[high], area[city centre], familyFriendly[yes], near[All Bar One]	The Cricketers is a Chinese restaurant with a price range of more than £30 and has a high customer rating it is kid friendly near All Bar One in the city centre.
name[The Cricketers], eatType[restaurant], food[Chinese], priceRange[£20-25], customer rating[high], area[riverside], familyFriendly[no], near[All Bar One]	The Cricketers is a Chinese restaurant with a price range of more than £30 and has a high customer rating it is located in the riverside near All Bar One it is not kid friendly.
name[The Cricketers], eatType[restaurant], food[Chinese], priceRange[£20-25], customer rating[high], area[riverside], familyFriendly[yes], near[All Bar One]	The Cricketers is a Chinese restaurant with a price range of more than £30 and has a high customer rating it is kid friendly located in the riverside near All Bar One.
name[The Cricketers], eatType[restaurant], food[Chinese], priceRange[cheap], customer rating[5 out of 5], area[city centre], familyFriendly[no], near[All Bar One]	The Cricketers is a cheap Chinese restaurant in the city centre near All Bar One it has a customer rating of 5 out of 5 is not family friendly.
name[The Cricketers], eatType[restaurant], food[Chinese], priceRange[cheap], customer rating[5 out of 5], area[city centre], familyFriendly[yes], near[All Bar One]	The Cricketers is a cheap family friendly Chinese restaurant in the city centre near All Bar One it has a customer rating of 5 out of 5.
name[The Cricketers], eatType[restaurant], food[Chinese], priceRange[cheap], customer rating[5 out of 5], area[riverside], familyFriendly[no], near[All Bar One]	The Cricketers is a cheap Chinese restaurant in riverside near All Bar One it has a customer rating of 5 out of 5 is not family friendly.
name[The Cricketers], eatType[restaurant], food[Chinese], priceRange[cheap], customer rating[5 out of 5], area[riverside], familyFriendly[yes], near[All Bar One]	The Cricketers is a cheap family friendly Chinese restaurant in riverside near All Bar One and has a customer rating of 5 out of 5.
name[The Cricketers], eatType[restaurant], food[Chinese], priceRange[cheap], customer rating[average], area[city centre], familyFriendly[no], near[All Bar One]	The Cricketers is a cheap Chinese restaurant in the city centre near All Bar One it has an average customer rating it is not family friendly.
name[The Cricketers], eatType[restaurant], food[Chinese], priceRange[cheap], customer rating[average], area[city centre], familyFriendly[yes], near[All Bar One]	The Cricketers is a cheap family friendly Chinese restaurant in the city centre near All Bar One it has an average customer rating.
name[The Cricketers], eatType[restaurant], food[Chinese], priceRange[cheap], customer rating[average], area[riverside], familyFriendly[no], near[All Bar One]	The Cricketers is a cheap Chinese restaurant in riverside near All Bar One it has an average customer rating it is not family friendly.
name[The Cricketers], eatType[restaurant], food[Chinese], priceRange[cheap], customer rating[average], area[riverside], familyFriendly[yes], near[All Bar One]	The Cricketers is a cheap family friendly Chinese restaurant in riverside near All Bar One and has an average customer rating.
name[The Cricketers], eatType[restaurant], food[Chinese], priceRange[high], customer rating[1 out of 5], area[city centre], familyFriendly[no], near[All Bar One]	The Cricketers is a Chinese restaurant with a high price range it is located in the city centre near All Bar One it has a customer rating of 1 out of 5 and is not children friendly.
name[The Cricketers], eatType[restaurant], food[Chinese], priceRange[high], customer rating[1 out of 5], area[city centre], familyFriendly[yes], near[All Bar One]	The Cricketers serves Chinese food in the high price range it is located in the city centre near All Bar One it is a children friendly restaurant with a customer rating of 1 out of 5.
name[The Cricketers], eatType[restaurant], food[Chinese], priceRange[high], customer rating[1 out of 5], area[riverside], familyFriendly[no], near[All Bar One]	The Cricketers is a Chinese restaurant with a high price range it is located in the riverside near All Bar One it has a customer rating of 1 out of 5 is not children friendly.
name[The Cricketers], eatType[restaurant], food[Chinese], priceRange[high], customer rating[1 out of 5], area[riverside], familyFriendly[yes], near[All Bar One]	The Cricketers serves Chinese food in the high price range it is located in the riverside near All Bar One it has a customer rating of 1 out of 5 a children friendly restaurant.
name[The Cricketers], eatType[restaurant], food[Chinese], priceRange[high], customer rating[average], area[city centre], familyFriendly[no], near[All Bar One]	The Cricketers is a Chinese food in the high price range it is located in the city centre near All Bar One it has an average customer rating it is not children friendly.
name[The Cricketers], eatType[restaurant], food[Chinese], priceRange[high], customer rating[average], area[city centre], familyFriendly[yes], near[All Bar One]	The Cricketers is a Chinese food in the high price range it is located in the city centre near All Bar One it has an average customer rating it is a family friendly restaurant.
name[The Cricketers], eatType[restaurant], food[Chinese], priceRange[high], customer rating[average], area[riverside], familyFriendly[no], near[All Bar One]	The Cricketers is a Chinese restaurant with a high price range it has an average customer rating it is located in the riverside near All Bar One it is not children friendly.
name[The Cricketers], eatType[restaurant], food[Chinese], priceRange[high], customer rating[average], area[riverside], familyFriendly[yes], near[All Bar One]	The Cricketers serves Chinese food in the high price range it is located in the riverside near All Bar One and has an average customer rating it is a children friendly restaurant.
name[The Cricketers], eatType[restaurant], food[Chinese], priceRange[less than £20], customer rating[low], area[city centre], familyFriendly[no], near[All Bar One]	The Cricketers is a Chinese restaurant with a price range of less than £20 it is located in the city centre near All Bar One it has a low customer rating it is not family friendly.
name[The Cricketers], eatType[restaurant], food[Chinese], priceRange[less than £20], customer rating[low], area[city centre], familyFriendly[yes], near[All Bar One]	The Cricketers is a Chinese restaurant with a price range of less than £20 it has a low customer rating it is family friendly it is located in the city centre near All Bar One.
name[The Cricketers], eatType[restaurant], food[Chinese], priceRange[less than £20], customer rating[low], area[riverside], familyFriendly[no], near[All Bar One]	The Cricketers is a Chinese restaurant with a price range of less than £20 it has a low customer rating located in riverside near All Bar One it is not family friendly.
name[The Cricketers], eatType[restaurant], food[Chinese], priceRange[less than £20], customer rating[low], area[riverside], familyFriendly[yes], near[All Bar One]	The Cricketers is a Chinese restaurant with a price range of less than £20 it has a low customer rating located in riverside near All Bar One is family friendly.
name[The Cricketers], eatType[restaurant], food[Chinese], priceRange[moderate], customer rating[1 out of 5], area[city centre], familyFriendly[no], near[All Bar One]	The Cricketers is a Chinese restaurant with a moderate price range it is located in the city centre near All Bar One it has a customer rating of 1 out of 5 it is not kid friendly.
name[The Cricketers], eatType[restaurant], food[Chinese], priceRange[moderate], customer rating[1 out of 5], area[city centre], familyFriendly[yes], near[All Bar One]	The Cricketers is a moderately priced Chinese restaurant in the city centre near All Bar One it is kid friendly but has a customer rating of 1 out of 5.
name[The Cricketers], eatType[restaurant], food[Chinese], priceRange[moderate], customer rating[1 out of 5], area[riverside], familyFriendly[no], near[All Bar One]	The Cricketers serves Chinese food in the moderate price range it is located in the riverside near All Bar One it has a customer rating of 1 out of 5 it is not kid friendly.
name[The Cricketers], eatType[restaurant], food[Chinese], priceRange[moderate], customer rating[1 out of 5], area[riverside], familyFriendly[yes], near[All Bar One]	The Cricketers is a moderately priced Chinese restaurant in riverside near All Bar One has a customer rating of 1 out of 5 friendly.
name[The Cricketers], eatType[restaurant], food[Chinese], priceRange[moderate], customer rating[3 out of 5], area[city centre], familyFriendly[no], near[All Bar One]	The Cricketers is a moderately priced Chinese restaurant in the city centre near All Bar One it has a customer rating of 3 out of 5 and is not kid friendly.
name[The Cricketers], eatType[restaurant], food[Chinese], priceRange[moderate], customer rating[3 out of 5], area[city centre], familyFriendly[yes], near[All Bar One]	The Cricketers is a moderately priced Chinese restaurant in the city centre near All Bar One it is kid friendly with a customer rating of 3 out of 5.
name[The Cricketers], eatType[restaurant], food[Chinese], priceRange[moderate], customer rating[3 out of 5], area[riverside], familyFriendly[no], near[All Bar One]	The Cricketers is a moderately priced Chinese restaurant in riverside near All Bar One it has a customer rating of 3 out of 5 and is not kid friendly.
name[The Cricketers], eatType[restaurant], food[Chinese], priceRange[moderate], customer rating[3 out of 5], area[riverside], familyFriendly[yes], near[All Bar One]	The Cricketers is a moderately priced Chinese restaurant in riverside near All Bar One has a customer rating of 3 out of 5 friendly.
name[The Cricketers], eatType[restaurant], food[Chinese], priceRange[more than £30], customer rating[high], area[city centre], familyFriendly[no], near[All Bar One]	The Cricketers is a Chinese restaurant with a price range of more than £30 and a high customer rating it is not child friendly it is located in the city centre near All Bar One.
name[The Cricketers], eatType[restaurant], food[Chinese], priceRange[more than £30], customer rating[high], area[city centre], familyFriendly[yes], near[All Bar One]	The Cricketers is a Chinese restaurant with a price range of more than £30 and has a high customer rating it is children friendly located in the city centre near All Bar One.
name[The Cricketers], eatType[restaurant], food[Chinese], priceRange[more than £30], customer rating[high], area[riverside], familyFriendly[no], near[All Bar One]	The Cricketers is a Chinese restaurant with a price range of more than £30 and has a high customer rating it is located in the riverside near All Bar One it is not children friendly.
name[The Cricketers], eatType[restaurant], food[Chinese], priceRange[more than £30], customer rating[high], area[riverside], familyFriendly[yes], near[All Bar One]	The Cricketers is a Chinese restaurant with a price range of more than £30 and has a high customer rating it is children friendly located in the riverside near All Bar One.
name[The Cricketers], eatType[restaurant], food[English], priceRange[£20-25], customer rating[high], area[city centre], familyFriendly[no], near[All Bar One]	The Cricketers is an English restaurant in the city centre near All Bar One it has a price range of 20-25 and has a high customer rating it is not kid friendly.
name[The Cricketers], eatType[restaurant], food[English], priceRange[£20-25], customer rating[high], area[city centre], familyFriendly[yes], near[All Bar One]	The Cricketers is an English restaurant in the city centre near All Bar One it has a price range of more than £30 and has a high customer rating is kid friendly.
name[The Cricketers], eatType[restaurant], food[English], priceRange[£20-25], customer rating[high], area[riverside], familyFriendly[no], near[All Bar One]	The Cricketers is an English restaurant in the riverside near All Bar One it has a price range of 20-25 and has a high customer rating it is not kid friendly.
name[The Cricketers], eatType[restaurant], food[English], priceRange[£20-25], customer rating[high], area[riverside], familyFriendly[yes], near[All Bar One]	The Cricketers is an English restaurant in the riverside near All Bar One it has a price range of 20-25 and has a high customer rating is kid friendly.
name[The Cricketers], eatType[restaurant], food[English], priceRange[cheap], customer rating[5 out of 5], area[city centre], familyFriendly[no], near[Café Rouge]	The Cricketers is a cheap English restaurant located near Café Rouge in the city centre it is not family friendly and has a customer rating of 5 out of 5.
name[The Cricketers], eatType[restaurant], food[English], priceRange[cheap], customer rating[5 out of 5], area[city centre], familyFriendly[yes], near[Café Rouge]	The Cricketers is a cheap family friendly English restaurant in the city centre near Café Rouge it has a customer rating of 5 out of 5.
name[The Cricketers], eatType[restaurant], food[English], priceRange[cheap], customer rating[5 out of 5], area[riverside], familyFriendly[no], near[Café Rouge]	The Cricketers is a cheap English restaurant in riverside near Café Rouge it has a customer rating of 5 out of 5 is not family friendly.
name[The Cricketers], eatType[restaurant], food[English], priceRange[cheap], customer rating[5 out of 5], area[riverside], familyFriendly[yes], near[Café Rouge]	The Cricketers is a cheap family friendly English restaurant in riverside near Café Rouge and has a customer rating of 5 out of 5.
name[The Cricketers], eatType[restaurant], food[English], priceRange[cheap], customer rating[average], area[city centre], familyFriendly[no], near[Café Rouge]	The Cricketers is a cheap English restaurant located near Café Rouge in the city centre it has an average customer rating and is not family friendly.
name[The Cricketers], eatType[restaurant], food[English], priceRange[cheap], customer rating[average], area[city centre], familyFriendly[yes], near[Café Rouge]	The Cricketers is a cheap family friendly English restaurant in the city centre near Café Rouge it has an average customer rating.
name[The Cricketers], eatType[restaurant], food[English], priceRange[cheap], customer rating[average], area[riverside], familyFriendly[no], near[Café Rouge]	The Cricketers is a cheap English restaurant in riverside near Café Rouge it has an average customer rating and is not family friendly.
name[The Cricketers], eatType[restaurant], food[English], priceRange[cheap], customer rating[average], area[riverside], familyFriendly[yes], near[Café Rouge]	The Cricketers is a cheap family friendly English restaurant in riverside near Café Rouge and has an average customer rating.
name[The Cricketers], eatType[restaurant], food[English], priceRange[high], customer rating[1 out of 5], area[city centre], familyFriendly[no], near[Café Rouge]	The Cricketers is an English restaurant in the city centre near Café Rouge it has a high price range, a 1 out of 5 and is not children friendly.
name[The Cricketers], eatType[restaurant], food[English], priceRange[high], customer rating[1 out of 5], area[city centre], familyFriendly[yes], near[Café Rouge]	The Cricketers is an English restaurant in the city centre near Café Rouge it has a high price range, is children friendly and has a customer rating of 1 out of 5.
name[The Cricketers], eatType[restaurant], food[English], priceRange[high], customer rating[1 out of 5], area[riverside], familyFriendly[no], near[Café Rouge]	The Cricketers is an English restaurant in the riverside near Café Rouge it has a high price range and a 1 out of 5 is not children friendly.
name[The Cricketers], eatType[restaurant], food[English], priceRange[high], customer rating[1 out of 5], area[riverside], familyFriendly[yes], near[Café Rouge]	The Cricketers is an English restaurant in the riverside near Café Rouge it has a high price range and a 1 out of 5 is children friendly.
name[The Cricketers], eatType[restaurant], food[English], priceRange[high], customer rating[average], area[city centre], familyFriendly[no], near[Café Rouge]	The Cricketers is an English restaurant in the city centre near Café Rouge it has a high price range, has an average customer rating and is not children friendly.
name[The Cricketers], eatType[restaurant], food[English], priceRange[high], customer rating[average], area[city centre], familyFriendly[yes], near[Café Rouge]	The Cricketers is an English restaurant with a high price range it is near Café Rouge in the city centre it is children friendly and has an average customer rating.
name[The Cricketers], eatType[restaurant], food[English], priceRange[high], customer rating[average], area[riverside], familyFriendly[no], near[Café Rouge]	The Cricketers is an English restaurant in riverside near Café Rouge it has a high price range and has an average customer rating it is not children friendly.
name[The Mill], eatType[pub], food[English], priceRange[high], area[riverside], familyFriendly[yes], near[Raja Indian Cuisine]	The Mill is a high priced English pub located in riverside near Raja Indian Cuisine it is kid friendly.
name[The Mill], eatType[pub], food[English], priceRange[less than £20], area[city centre], familyFriendly[no], near[Raja Indian Cuisine]	The Mill is a low priced English pub located in the city centre near Raja Indian Cuisine it is not family friendly.
name[The Mill], eatType[pub], food[English], priceRange[less than £20], area[city centre], familyFriendly[yes], near[Raja Indian Cuisine]	The Mill is a low priced English pub near Raja Indian Cuisine in the city centre it is family friendly.
name[The Mill], eatType[pub], food[English], priceRange[less than £20], area[riverside], familyFriendly[no], near[Raja Indian Cuisine]	The Mill is a low priced English pub located in riverside near Raja Indian Cuisine it is not family friendly.
name[The Mill], eatType[pub], food[English], priceRange[less than £20], area[riverside], familyFriendly[yes], near[Raja Indian Cuisine]	The Mill is a low priced English pub near Raja Indian Cuisine in riverside is family friendly.
name[The Mill], eatType[pub], food[English], priceRange[moderate], area[city centre], familyFriendly[no], near[Raja Indian Cuisine]	The Mill is a moderately priced English pub near Raja Indian Cuisine in the city centre it is not kid friendly.
name[The Mill], eatType[pub], food[English], priceRange[moderate], area[city centre], familyFriendly[yes], near[Raja Indian Cuisine]	The Mill is a moderately priced pub near Raja Indian Cuisine in the city centre it is a family friendly English food.
name[The Mill], eatType[pub], food[English], priceRange[moderate], area[riverside], familyFriendly[no], near[Raja Indian Cuisine]	The Mill is a moderately priced pub near Raja Indian Cuisine in riverside it is not family friendly English food.
name[The Mill], eatType[pub], food[English], priceRange[moderate], area[riverside], familyFriendly[yes], near[Raja Indian Cuisine]	The Mill is a moderately priced pub near Raja Indian Cuisine in riverside it is family friendly English food.
name[The Mill], eatType[pub], food[English], priceRange[more than £30], area[riverside], familyFriendly[yes], near[Raja Indian Cuisine]	The Mill is a low priced children friendly pub located in the riverside near Raja Indian Cuisine serves English food.
name[The Mill], eatType[pub], food[Fast food], priceRange[£20-25], area[riverside], familyFriendly[yes], near[Raja Indian Cuisine]	The Mill is a low priced pub near Raja Indian Cuisine in riverside is family friendly Fast food.
name[The Mill], eatType[pub], food[Fast food], priceRange[£20-25], customer rating[high], area[city centre], familyFriendly[no], near[Café Rouge]	The Mill is a Fast food pub in the city centre near Café Rouge it has a price range of 20-25 and has a high customer rating it is not kid friendly.
name[The Mill], eatType[pub], food[Fast food], priceRange[£20-25], customer rating[high], area[city centre], familyFriendly[yes], near[Café Rouge]	The Mill is a low priced pub serving Fast food in the city centre near Café Rouge it has a high customer rating it is kid friendly.
name[The Mill], eatType[pub], food[Fast food], priceRange[£20-25], customer rating[high], area[riverside], familyFriendly[no], near[Café Rouge]	The Mill is a Fast food pub in the riverside near Café Rouge it has a price range of 20-25 and has a high customer rating it is not kid friendly.
name[The Mill], eatType[pub], food[Fast food], priceRange[£20-25], customer rating[high], area[riverside], familyFriendly[yes], near[Café Rouge]	The Mill is a low priced pub that serves Fast food in riverside near Café Rouge and has a high customer rating it is kid friendly.
name[The Mill], eatType[pub], food[Fast food], priceRange[£20-25], customer rating[high], area[riverside], familyFriendly[yes], near[Café Sicilia]	The Mill is a low priced pub that serves Fast food in riverside near Café Sicilia and has a high customer rating it is kid friendly.
name[The Mill], eatType[pub], food[Fast food], priceRange[cheap], area[riverside], familyFriendly[yes], near[Raja Indian Cuisine]	The Mill is a cheap family friendly Fast food pub located in the riverside near Raja Indian Cuisine.
name[The Mill], eatType[pub], food[Fast food], priceRange[cheap], customer rating[5 out of 5], area[city centre], familyFriendly[no], near[Café Sicilia]	The Mill is a cheap family friendly Fast food pub located in the city centre near Café Sicilia it has a customer rating of 5 out of 5.
name[The Mill], eatType[pub], food[Fast food], priceRange[cheap], customer rating[5 out of 5], area[city centre], familyFriendly[yes], near[Café Sicilia]	The Mill is a cheap family friendly Fast food pub located in the city centre near Café Sicilia with a customer rating of 5 out of 5.
name[The Mill], eatType[pub], food[Fast food], priceRange[cheap], customer rating[5 out of 5], area[riverside], familyFriendly[no], near[Café Sicilia]	The Mill is a cheap Fast food pub located in riverside near Café Sicilia it has a customer rating of 5 out of 5 and is not family friendly.
name[The Mill], eatType[pub], food[Fast food], priceRange[cheap], customer rating[5 out of 5], area[riverside], familyFriendly[yes], near[Café Sicilia]	The Mill is a cheap family friendly Fast food pub located in the riverside near Café Sicilia and has a customer rating of 5 out of 5.
name[The Mill], eatType[pub], food[Fast food], priceRange[cheap], customer rating[average], area[city centre], familyFriendly[no], near[Café Sicilia]	The Mill is a cheap Fast food pub located in the city centre with an average customer rating it is not family friendly and is near Café Sicilia.
name[The Mill], eatType[pub], food[Fast food], priceRange[cheap], customer rating[average], area[city centre], familyFriendly[yes], near[Café Sicilia]	The Mill is a cheap family friendly Fast food pub located in the city centre near Café Sicilia with an average customer rating.
name[The Mill], eatType[pub], food[Fast food], priceRange[cheap], customer rating[average], area[riverside], familyFriendly[no], near[Café Sicilia]	The Mill is a cheap Fast food pub located in riverside near Café Sicilia it has an average customer rating it is not family friendly.
name[The Mill], eatType[pub], food[Fast food], priceRange[cheap], customer rating[average], area[riverside], familyFriendly[yes], near[Café Sicilia]	The Mill is a cheap family friendly Fast food pub located in riverside near Café Sicilia and has an average customer rating.
name[The Mill], eatType[pub], food[Fast food], priceRange[high], customer rating[1 out of 5], area[city centre], familyFriendly[no], near[Café Sicilia]	The Mill is a Fast food pub in the city centre near Café Sicilia it has a high price range and a 1 out of 5 it is not children friendly.
name[The Mill], eatType[pub], food[Fast food], priceRange[high], customer rating[1 out of 5], area[city centre], familyFriendly[yes], near[Café Sicilia]	The Mill is a high priced Fast food pub located in the city centre near Café Sicilia it has a customer rating of 1 out of 5 and is kid friendly.
name[The Mill], eatType[pub], food[Fast food], priceRange[high], customer rating[1 out of 5], area[riverside], familyFriendly[no], near[Café Sicilia]	The Mill is a Fast food pub in the riverside near Café Sicilia it has a high price range and a 1 out of 5 it is not children friendly.
name[The Mill], eatType[pub], food[Fast food], priceRange[high], customer rating[1 out of 5], area[riverside], familyFriendly[yes], near[Café Sicilia]	The Mill is a high priced Fast food pub located in the riverside near Café Sicilia has a customer rating of 1 out of 5 it is kid friendly.
name[The Mill], eatType[pub], food[Fast food], priceRange[high], customer rating[average], area[city centre], familyFriendly[no], near[Café Sicilia]	The Mill is a Fast food pub in the city centre near Café Sicilia it has a high price range and has an average customer rating it is not children friendly.
name[The Mill], eatType[pub], food[Fast food], priceRange[high], customer rating[average], area[city centre], familyFriendly[yes], near[Café Sicilia]	The Mill is a high priced Fast food pub located in the city centre near Café Sicilia with an average customer rating it is children friendly.
name[The Mill], eatType[pub], food[Fast food], priceRange[high], customer rating[average], area[riverside], familyFriendly[no], near[Café Sicilia]	The Mill is a Fast food pub in riverside near Café Sicilia it has a high price range and has an average customer rating it is not children friendly.
name[The Mill], eatType[pub], food[Fast food], priceRange[high], customer rating[average], area[riverside], familyFriendly[yes], near[Café Sicilia]	The Mill is a high priced Fast food pub located in riverside near Café Sicilia has an average customer rating it is children friendly and.
name[The Mill], eatType[pub], food[Fast food], priceRange[less than £20], customer rating[low], area[city centre], familyFriendly[no], near[Café Sicilia]	The Mill is a Fast food pub in the city centre near Café Sicilia it has a price range less than £20 and has a low customer rating it is not family friendly.
name[The Mill], eatType[pub], food[Fast food], priceRange[less than £20], customer rating[low], area[city centre], familyFriendly[yes], near[Café Sicilia]	The Mill is a low priced Fast food pub located in the city centre near Café Sicilia it has a low customer rating it is family friendly.
name[The Mill], eatType[pub], food[Fast food], priceRange[less than £20], customer rating[low], area[riverside], familyFriendly[no], near[Café Sicilia]	The Mill is a Fast food pub in the riverside near Café Sicilia it has a price range of less than £20 and has a low customer rating it is not family friendly.
name[The Mill], eatType[pub], food[Fast food], priceRange[less than £20], customer rating[low], area[riverside], familyFriendly[yes], near[Café Sicilia]	The Mill is a low priced Fast food pub located in the riverside near Café Sicilia it has a low customer rating it is family friendly.
name[The Mill], eatType[pub], food[Fast food], priceRange[moderate], customer rating[1 out of 5], area[city centre], familyFriendly[no], near[Café Sicilia]	The Mill is a moderately priced Fast food pub located in the city centre near Café Sicilia it has a customer rating of 1 out of 5 and is not kid friendly.
name[The Mill], eatType[pub], food[Fast food], priceRange[moderate], customer rating[1 out of 5], area[city centre], familyFriendly[yes], near[Café Sicilia]	The Mill is a moderately priced Fast food pub located in the city centre near Café Sicilia with a customer rating of 1 out of 5 it is kid friendly.
name[The Mill], eatType[pub], food[Fast food], priceRange[moderate], customer rating[1 out of 5], area[riverside], familyFriendly[no], near[Café Sicilia]	The Mill is a moderately priced Fast food pub located in the riverside near Café Sicilia it has a customer rating of 1 out of 5 and is not kid friendly.
name[The Mill], eatType[pub], food[Fast food], priceRange[moderate], customer rating[1 out of 5], area[riverside], familyFriendly[yes], near[Café Sicilia]	The Mill is a moderately priced Fast food pub located in the riverside near Café Sicilia with a customer rating of 1 out of 5 it is kid friendly.
name[The Mill], eatType[pub], food[Fast food], priceRange[moderate], customer rating[3 out of 5], area[city centre], familyFriendly[no], near[Café Sicilia]	The Mill is a moderately priced Fast food pub located in the city centre near Café Sicilia it has a customer rating of 3 out of 5 and is not kid friendly.
name[The Mill], eatType[pub], food[Fast food], priceRange[moderate], customer rating[3 out of 5], area[city centre], familyFriendly[yes], near[Café Sicilia]	The Mill is a moderately priced Fast food pub located in the city centre near Café Sicilia with a customer rating of 3 out of 5 and is kid friendly.
name[The Mill], eatType[pub], food[Fast food], priceRange[moderate], customer rating[3 out of 5], area[riverside], familyFriendly[no], near[Café Sicilia]	The Mill is a moderately priced Fast food pub located in the riverside near Café Sicilia it has a customer rating of 3 out of 5 and is not kid friendly.
name[The Mill], eatType[pub], food[Fast food], priceRange[moderate], customer rating[3 out of 5], area[riverside], familyFriendly[yes], near[Café Sicilia]	The Mill is a moderately priced pub serving Fast food in riverside near Café Sicilia with a customer rating of 3 out of 5 and is kid friendly.
name[The Mill], eatType[restaurant], food[English], priceRange[high], area[riverside], familyFriendly[yes], near[Raja Indian Cuisine]	The Mill is a high priced English restaurant near Raja Indian Cuisine in riverside is children friendly.
name[The Mill], eatType[restaurant], food[English], priceRange[high], customer rating[average], area[riverside], familyFriendly[yes], near[Café Rouge]	The Mill is an English restaurant in the riverside near Café Rouge it has a high price range, has an average customer rating and is children friendly.
name[The Mill], eatType[restaurant], food[English], priceRange[less than £20], area[city centre], familyFriendly[no], near[Raja Indian Cuisine]	The Mill is an English restaurant with a price range of less than £20 is located near Raja Indian Cuisine in the city centre it is not family friendly.
name[The Mill], eatType[restaurant], food[English], priceRange[less than £20], area[city centre], familyFriendly[yes], near[Raja Indian Cuisine]	The Mill is a low priced English restaurant near Raja Indian Cuisine in the city centre it is family friendly.
name[The Mill], eatType[restaurant], food[English], priceRange[less than £20], area[riverside], familyFriendly[no], near[Raja Indian Cuisine]	The Mill is an English restaurant with a price range of less than £20 is located near Raja Indian Cuisine in riverside it is not family friendly.
name[The Mill], eatType[restaurant], food[English], priceRange[less than £20], area[riverside], familyFriendly[yes], near[Raja Indian Cuisine]	The Mill is a low priced English restaurant near Raja Indian Cuisine in riverside is family friendly.
name[The Mill], eatType[restaurant], food[English], priceRange[less than £20], customer rating[low], area[city centre], familyFriendly[no], near[Café Rouge]	The Mill is an English restaurant with a price range of less than £20 located near Café Rouge in the city centre it is not family friendly but has a low customer rating.
name[The Mill], eatType[restaurant], food[English], priceRange[less than £20], customer rating[low], area[city centre], familyFriendly[yes], near[Café Rouge]	The Mill is a chinese restaurant with a price range of less than £20 it is family friendly but has a low customer rating is located in the city centre near Café Rouge.
name[The Mill], eatType[restaurant], food[English], priceRange[less than £20], customer rating[low], area[riverside], familyFriendly[no], near[Café Rouge]	The Mill is an English restaurant in the riverside near Café Rouge it has a price range of less than £20 and has a low customer rating it is not family friendly.
name[The Mill], eatType[restaurant], food[English], priceRange[less than £20], customer rating[low], area[riverside], familyFriendly[yes], near[Café Rouge]	The Mill is an English restaurant with a price range of less than £20 is located near Café Rouge in riverside it is family friendly and has a low customer rating.
name[The Mill], eatType[restaurant], food[English], priceRange[moderate], area[city centre], familyFriendly[no], near[Raja Indian Cuisine]	The Mill is a moderately priced English restaurant near Raja Indian Cuisine in the city centre it is not kid friendly.
name[The Mill], eatType[restaurant], food[English], priceRange[moderate], area[city centre], familyFriendly[yes], near[Raja Indian Cuisine]	The Mill is a moderately priced English restaurant near Raja Indian Cuisine in the city centre it is kid friendly.
name[The Mill], eatType[restaurant], food[English], priceRange[moderate], area[riverside], familyFriendly[no], near[Raja Indian Cuisine]	The Mill is a moderately priced English restaurant near Raja Indian Cuisine in riverside it is not kid friendly.
name[The Mill], eatType[restaurant], food[English], priceRange[moderate], area[riverside], familyFriendly[yes], near[Raja Indian Cuisine]	The Mill is a moderately priced English restaurant near Raja Indian Cuisine in riverside is kid friendly.
name[The Mill], eatType[restaurant], food[English], priceRange[moderate], customer rating[1 out of 5], area[city centre], familyFriendly[no], near[Café Rouge]	The Mill is an English restaurant with a moderate price range it is located in the city centre near Café Rouge it has a customer rating of 1 out of 5 and is not kid friendly.
name[The Mill], eatType[restaurant], food[English], priceRange[moderate], customer rating[1 out of 5], area[city centre], familyFriendly[yes], near[Café Rouge]	The Mill is a moderately priced English restaurant near Café Rouge in the city centre it is kid friendly and has a customer rating of 1 out of 5.
name[The Mill], eatType[restaurant], food[English], priceRange[moderate], customer rating[1 out of 5], area[riverside], familyFriendly[no], near[Café Rouge]	The Mill is an English restaurant in the riverside near Café Rouge it has a moderate price range it is not kid friendly and has a customer rating of 1 out of 5.
name[The Mill], eatType[restaurant], food[English], priceRange[moderate], customer rating[1 out of 5], area[riverside], familyFriendly[yes], near[Café Rouge]	The Mill is a moderately priced English restaurant near Café Rouge in riverside it is kid friendly and has a customer rating of 1 out of 5.
name[The Mill], eatType[restaurant], food[English], priceRange[moderate], customer rating[3 out of 5], area[city centre], familyFriendly[no], near[Café Rouge]	The Mill is a moderately priced English restaurant near Café Rouge in the city centre it is not kid friendly and has a customer rating of 3 out of 5.
name[The Mill], eatType[restaurant], food[English], priceRange[moderate], customer rating[3 out of 5], area[city centre], familyFriendly[yes], near[Café Rouge]	The Mill is a moderately priced English restaurant near Café Rouge in the city centre it is kid friendly and has a customer rating of 3 out of 5.
name[The Mill], eatType[restaurant], food[English], priceRange[moderate], customer rating[3 out of 5], area[riverside], familyFriendly[no], near[Café Rouge]	The Mill is a moderately priced English restaurant near Café Rouge in riverside is not kid friendly and has a customer rating of 3 out of 5.
name[The Mill], eatType[restaurant], food[English], priceRange[moderate], customer rating[3 out of 5], area[riverside], familyFriendly[yes], near[Café Rouge]	The Mill is a moderately priced English restaurant near Café Rouge in riverside is kid friendly and has a customer rating of 3 out of 5.
name[The Mill], eatType[restaurant], food[English], priceRange[more than £30], area[riverside], familyFriendly[yes], near[Raja Indian Cuisine]	The Mill is a low priced kid friendly English restaurant in riverside near Raja Indian Cuisine.
name[The Mill], eatType[restaurant], food[English], priceRange[more than £30], customer rating[high], area[city centre], familyFriendly[no], near[Café Rouge]	The Mill is an English restaurant in the city centre near Café Rouge it has a price range of more than £30 and a high customer rating it is not children friendly.
name[The Mill], eatType[restaurant], food[English], priceRange[more than £30], customer rating[high], area[city centre], familyFriendly[yes], near[Café Rouge]	The Mill is an English restaurant in the city centre near Café Rouge it has a price range of more than £30 and has a high customer rating it is children friendly.
name[The Mill], eatType[restaurant], food[English], priceRange[more than £30], customer rating[high], area[riverside], familyFriendly[no], near[Café Rouge]	The Mill is an English restaurant in the riverside near Café Rouge it has a price range of more than £30 and has a high customer rating it is not children friendly.
name[The Mill], eatType[restaurant], food[English], priceRange[more than £30], customer rating[high], area[riverside], familyFriendly[yes], near[Café Rouge]	The Mill is an English restaurant in the riverside near Café Rouge it has a price range of more than £30 and has a high customer rating it is children friendly.
name[The Mill], eatType[restaurant], food[Fast food], priceRange[£20-25], area[riverside], familyFriendly[yes], near[Raja Indian Cuisine]	The Mill is a low priced Fast food restaurant in riverside near Raja Indian Cuisine is kid friendly.
name[The Mill], eatType[restaurant], food[Fast food], priceRange[cheap], area[riverside], familyFriendly[yes], near[Raja Indian Cuisine]	The Mill is a cheap family friendly Fast food restaurant in riverside near Raja Indian Cuisine.
name[The Phoenix], eatType[pub], food[Fast food], priceRange[cheap], area[riverside], familyFriendly[yes], near[Raja Indian Cuisine]	The Phoenix is a cheap family friendly Fast food pub located in the riverside near Raja Indian Cuisine.
name[The Phoenix], eatType[pub], food[Fast food], priceRange[high], area[city centre], familyFriendly[no], near[Raja Indian Cuisine]	The Phoenix is a high priced Fast food pub located in the city centre near Raja Indian Cuisine it is not children friendly.
name[The Phoenix], eatType[pub], food[Fast food], priceRange[high], area[city centre], familyFriendly[yes], near[Raja Indian Cuisine]	The Phoenix is a high priced Fast food pub located in the city centre near Raja Indian Cuisine it is kid friendly.
name[The Phoenix], eatType[pub], food[Fast food], priceRange[high], area[riverside], familyFriendly[no], near[Raja Indian Cuisine]	The Phoenix is a high priced Fast food pub located in riverside near Raja Indian Cuisine it is not kid friendly.
name[The Phoenix], eatType[pub], food[Fast food], priceRange[high], area[riverside], familyFriendly[yes], near[Raja Indian Cuisine]	The Phoenix is a high priced Fast food pub located in riverside near Raja Indian Cuisine it is kid friendly.
name[The Phoenix], eatType[pub], food[Fast food], priceRange[less than £20], area[city centre], familyFriendly[no], near[Raja Indian Cuisine]	The Phoenix is a low priced Fast food pub located in the city centre near Raja Indian Cuisine it is not family friendly.
name[The Phoenix], eatType[pub], food[Fast food], priceRange[less than £20], area[city centre], familyFriendly[yes], near[Raja Indian Cuisine]	The Phoenix is a low priced Fast food pub located in the city centre near Raja Indian Cuisine it is family friendly.
name[The Phoenix], eatType[pub], food[Fast food], priceRange[less than £20], area[riverside], familyFriendly[no], near[Raja Indian Cuisine]	The Phoenix is a low priced Fast food pub located in riverside near Raja Indian Cuisine it is not family friendly.
name[The Phoenix], eatType[pub], food[Fast food], priceRange[less than £20], area[riverside], familyFriendly[yes], near[Raja Indian Cuisine]	The Phoenix is a low priced Fast food pub located in riverside near Raja Indian Cuisine it is family friendly.
name[The Phoenix], eatType[pub], food[Fast food], priceRange[moderate], area[city centre], familyFriendly[no], near[Raja Indian Cuisine]	The Phoenix is a moderately priced Fast food pub located in the city centre near Raja Indian Cuisine it is not kid friendly.
name[The Phoenix], eatType[pub], food[Fast food], priceRange[moderate], area[city centre], familyFriendly[yes], near[Raja Indian Cuisine]	The Phoenix is a moderately priced Fast food pub located in the city centre near Raja Indian Cuisine it is kid friendly.
name[The Phoenix], eatType[pub], food[Fast food], priceRange[moderate], area[riverside], familyFriendly[no], near[Raja Indian Cuisine]	The Phoenix is a moderately priced Fast food pub located in riverside near Raja Indian Cuisine it is not kid friendly.
name[The Phoenix], eatType[pub], food[Fast food], priceRange[moderate], area[riverside], familyFriendly[yes], near[Raja Indian Cuisine]	The Phoenix is a moderately priced Fast food pub located in riverside near Raja Indian Cuisine it is kid friendly.
name[The Phoenix], eatType[pub], food[Fast food], priceRange[moderate], customer rating[3 out of 5], area[riverside], familyFriendly[yes], near[Café Sicilia]	The Phoenix is a moderately priced pub serving Fast food in riverside near Café Sicilia with a customer rating of 3 out of 5 and is kid friendly.
name[The Phoenix], eatType[pub], food[Fast food], priceRange[more than £30], area[riverside], familyFriendly[yes], near[Raja Indian Cuisine]	The Phoenix is a low priced children friendly pub serving Fast food in riverside near Raja Indian Cuisine.
name[The Phoenix], eatType[pub], food[Fast food], priceRange[more than £30], customer rating[high], area[city centre], familyFriendly[no], near[Café Sicilia]	The Phoenix is a Fast food pub in the city centre near Café Sicilia it has a price range of more than £30 and has a high customer rating it is not children friendly.
name[The Phoenix], eatType[pub], food[Fast food], priceRange[more than £30], customer rating[high], area[city centre], familyFriendly[yes], near[Café Sicilia]	The Phoenix is a low priced child friendly pub serving Fast food in the city centre near Café Sicilia with a high customer rating.
name[The Phoenix], eatType[pub], food[Fast food], priceRange[more than £30], customer rating[high], area[riverside], familyFriendly[no], near[Café Sicilia]	The Phoenix is a Fast food pub in the riverside near Café Sicilia it has a price range of more than £30 and has a high customer rating it is not children friendly.
name[The Phoenix], eatType[pub], food[Fast food], priceRange[more than £30], customer rating[high], area[riverside], familyFriendly[yes], near[Café Sicilia]	The Phoenix is a low priced children friendly pub serving Fast food in the riverside area with a high customer rating near Café Sicilia.
name[The Phoenix], eatType[pub], food[French], priceRange[£20-25], area[riverside], familyFriendly[yes], near[Raja Indian Cuisine]	The Phoenix is a low priced pub near Raja Indian Cuisine in riverside is family friendly food.
name[The Phoenix], eatType[pub], food[French], priceRange[£20-25], customer rating[3 out of 5], area[city centre], familyFriendly[no], near[Café Sicilia]	The Phoenix is a French pub in the city centre near Café Sicilia it has a price range of 3 out of 5 and is not kid friendly.
name[The Phoenix], eatType[pub], food[French], priceRange[£20-25], customer rating[3 out of 5], area[city centre], familyFriendly[yes], near[Café Sicilia]	The Phoenix is a low priced pub near Café Sicilia in the city centre it is kid friendly has a 3 out of 5 serves French food.
name[The Phoenix], eatType[pub], food[French], priceRange[£20-25], customer rating[3 out of 5], area[riverside], familyFriendly[no], near[Café Sicilia]	The Phoenix is a French pub in the riverside near Café Sicilia it has a price range of 3 out of 5 and is not kid friendly.
name[The Phoenix], eatType[pub], food[French], priceRange[£20-25], customer rating[3 out of 5], area[riverside], familyFriendly[yes], near[Café Sicilia]	The Phoenix is a low priced pub near Café Sicilia in riverside is kid friendly has a 3 out of 5 serves French food.
name[The Phoenix], eatType[pub], food[French], priceRange[£20-25], customer rating[3 out of 5], area[riverside], familyFriendly[yes], near[Crowne Plaza Hotel]	The Phoenix is a low priced pub near Crowne Plaza Hotel in riverside is kid friendly has a 3 out of 5 serves French food.
name[The Phoenix], eatType[pub], food[French], priceRange[£20-25], customer rating[high], area[city centre], familyFriendly[no], near[Crowne Plaza Hotel]	The Phoenix is a French pub in the city centre near Crowne Plaza Hotel it has a price range of 20-25 and has a high customer rating it is not kid friendly.
name[The Phoenix], eatType[pub], food[French], priceRange[£20-25], customer rating[high], area[city centre], familyFriendly[yes], near[Crowne Plaza Hotel]	The Phoenix is a low priced pub serving French food in the city centre near Crowne Plaza Hotel it has a high customer rating it is kid friendly.
name[The Phoenix], eatType[pub], food[French], priceRange[£20-25], customer rating[high], area[riverside], familyFriendly[no], near[Crowne Plaza Hotel]	The Phoenix is a French pub in the riverside near Crowne Plaza Hotel it has a price range of 20-25 and has a high customer rating it is not kid friendly.
name[The Phoenix], eatType[pub], food[French], priceRange[£20-25], customer rating[high], area[riverside], familyFriendly[yes], near[Crowne Plaza Hotel]	The Phoenix is a low priced pub near Crowne Plaza Hotel in riverside it has a high customer rating rated French food and is kid friendly.
name[The Phoenix], eatType[pub], food[French], priceRange[cheap], area[riverside], familyFriendly[yes], near[Raja Indian Cuisine]	The Phoenix is a cheap family friendly French pub in riverside near Raja Indian Cuisine.
name[The Phoenix], eatType[pub], food[French], priceRange[cheap], customer rating[5 out of 5], area[city centre], familyFriendly[no], near[Crowne Plaza Hotel]	The Phoenix is a cheap French pub located in the city centre near Crowne Plaza Hotel it has a customer rating of 5 out of 5 and is not family friendly.
name[The Phoenix], eatType[pub], food[French], priceRange[cheap], customer rating[5 out of 5], area[city centre], familyFriendly[yes], near[Crowne Plaza Hotel]	The Phoenix is a cheap family friendly French pub located in the city centre near Crowne Plaza Hotel with a customer rating of 5 out of 5.
name[The Phoenix], eatType[pub], food[French], priceRange[cheap], customer rating[5 out of 5], area[riverside], familyFriendly[no], near[Crowne Plaza Hotel]	The Phoenix is a cheap French pub located in the riverside near Crowne Plaza Hotel it has a customer rating of 5 out of 5 is not family friendly.
name[The Phoenix], eatType[pub], food[French], priceRange[cheap], customer rating[5 out of 5], area[riverside], familyFriendly[yes], near[Crowne Plaza Hotel]	The Phoenix is a cheap family friendly French pub located in the riverside near Crowne Plaza Hotel has a customer rating of 5 out of 5.
name[The Phoenix], eatType[pub], food[French], priceRange[high], area[riverside], familyFriendly[yes], near[Raja Indian Cuisine]	The Phoenix is a high priced French pub located in riverside near Raja Indian Cuisine it is kid friendly.
name[The Phoenix], eatType[pub], food[French], priceRange[high], customer rating[3 out of 5], area[city centre], familyFriendly[no], near[Crowne Plaza Hotel]	The Phoenix is a high priced French pub located in the city centre near Crowne Plaza Hotel it has a customer rating of 3 out of 5 and is not child friendly.
name[The Phoenix], eatType[pub], food[French], priceRange[high], customer rating[3 out of 5], area[city centre], familyFriendly[yes], near[Crowne Plaza Hotel]	The Phoenix is a high priced French pub located in the city centre near Crowne Plaza Hotel it is kid friendly has a customer rating of 3 out of 5.
name[The Phoenix], eatType[pub], food[French], priceRange[high], customer rating[3 out of 5], area[riverside], familyFriendly[no], near[Crowne Plaza Hotel]	The Phoenix is a high priced French pub located in the riverside near Crowne Plaza Hotel it has a customer rating of 3 out of 5 is not child friendly.
name[The Phoenix], eatType[pub], food[French], priceRange[high], customer rating[3 out of 5], area[riverside], familyFriendly[yes], near[Crowne Plaza Hotel]	The Phoenix is a high priced French pub located in the riverside near Crowne Plaza Hotel it has a 3 out of 5 is kid friendly.
name[The Phoenix], eatType[pub], food[French], priceRange[less than £20], customer rating[average], area[city centre], familyFriendly[no], near[Crowne Plaza Hotel]	The Phoenix is a French pub in the city centre near Crowne Plaza Hotel it has a price range less than £20 and has an average customer rating it is not family friendly.
name[The Phoenix], eatType[pub], food[French], priceRange[less than £20], customer rating[average], area[city centre], familyFriendly[yes], near[Crowne Plaza Hotel]	The Phoenix is a low priced French pub located in the city centre near Crowne Plaza Hotel it has an average customer rating and is family friendly.
name[The Phoenix], eatType[pub], food[French], priceRange[less than £20], customer rating[average], area[riverside], familyFriendly[no], near[Crowne Plaza Hotel]	The Phoenix is a French pub in the riverside near Crowne Plaza Hotel it has a price range less than £20 and has an average customer rating it is not family friendly.
name[The Phoenix], eatType[pub], food[French], priceRange[less than £20], customer rating[average], area[riverside], familyFriendly[yes], near[Crowne Plaza Hotel]	The Phoenix is a low priced French pub located in the riverside near Crowne Plaza Hotel has an average customer rating it is family friendly.
name[The Phoenix], eatType[pub], food[French], priceRange[less than £20], customer rating[low], area[city centre], familyFriendly[no], near[Crowne Plaza Hotel]	The Phoenix is a French pub in the city centre near Crowne Plaza Hotel it has a price range less than £20 and has a low customer rating it is not family friendly.
name[The Phoenix], eatType[pub], food[French], priceRange[less than £20], customer rating[low], area[city centre], familyFriendly[yes], near[Crowne Plaza Hotel]	The Phoenix is a low priced French pub located in the city centre near Crowne Plaza Hotel it is family friendly but has a low customer rating.
name[The Phoenix], eatType[pub], food[French], priceRange[less than £20], customer rating[low], area[riverside], familyFriendly[no], near[Crowne Plaza Hotel]	The Phoenix is a French pub in the riverside near Crowne Plaza Hotel it has a price range less than £20 and has a low customer rating it is not family friendly.
name[The Phoenix], eatType[pub], food[French], priceRange[less than £20], customer rating[low], area[riverside], familyFriendly[yes], near[Crowne Plaza Hotel]	The Phoenix is a low priced French pub located in the riverside near Crowne Plaza Hotel it has a low customer rating it is family friendly.
name[The Phoenix], eatType[pub], food[French], priceRange[moderate], customer rating[1 out of 5], area[city centre], familyFriendly[no], near[Crowne Plaza Hotel]	The Phoenix is a moderately priced French pub located in the city centre near Crowne Plaza Hotel it has a customer rating of 1 out of 5 it is not kid friendly and.
name[The Phoenix], eatType[pub], food[French], priceRange[moderate], customer rating[1 out of 5], area[city centre], familyFriendly[yes], near[Crowne Plaza Hotel]	The Phoenix is a moderately priced French pub located in the city centre near Crowne Plaza Hotel it is kid friendly but has a customer rating of 1 out of 5.
name[The Phoenix], eatType[pub], food[French], priceRange[moderate], customer rating[1 out of 5], area[riverside], familyFriendly[no], near[Crowne Plaza Hotel]	The Phoenix is a moderately priced French pub located in the riverside near Crowne Plaza Hotel it has a customer rating of 1 out of 5 it is not kid friendly and.
name[The Phoenix], eatType[pub], food[French], priceRange[moderate], customer rating[1 out of 5], area[riverside], familyFriendly[yes], near[Crowne Plaza Hotel]	The Phoenix is a moderately priced French pub located in the riverside near Crowne Plaza Hotel has a customer rating of 1 out of 5 it is kid friendly.
name[The Phoenix], eatType[pub], food[French], priceRange[more than £30], customer rating[5 out of 5], area[city centre], familyFriendly[no], near[Crowne Plaza Hotel]	The Phoenix is a French pub in the city centre near Crowne Plaza Hotel it has a price range of more than £30, has a customer rating of 5 out of 5 and is not children friendly.
name[The Phoenix], eatType[pub], food[French], priceRange[more than £30], customer rating[5 out of 5], area[city centre], familyFriendly[yes], near[Crowne Plaza Hotel]	The Phoenix is a low priced family friendly pub serving French food located in the city centre near Crowne Plaza Hotel and has a customer rating of 5 out of 5.
name[The Phoenix], eatType[pub], food[French], priceRange[more than £30], customer rating[5 out of 5], area[riverside], familyFriendly[no], near[Crowne Plaza Hotel]	The Phoenix is a French pub in the riverside near Crowne Plaza Hotel it has a price range of more than £30, has a customer rating 5 out of 5 and is not children friendly.
name[The Phoenix], eatType[pub], food[French], priceRange[more than £30], customer rating[5 out of 5], area[riverside], familyFriendly[yes], near[Crowne Plaza Hotel]	The Phoenix is a low priced children friendly pub located in the riverside near Crowne Plaza Hotel serves French food and has a customer rating of 5 out of 5.
name[The Phoenix], eatType[pub], food[French], priceRange[more than £30], customer rating[low], area[city centre], familyFriendly[no], near[Crowne Plaza Hotel]	The Phoenix is a French pub in the city centre near Crowne Plaza Hotel it has a price range of more than £30, has a low customer rating it is not children friendly and.
name[The Phoenix], eatType[pub], food[French], priceRange[more than £30], customer rating[low], area[city centre], familyFriendly[yes], near[Crowne Plaza Hotel]	The Phoenix is a low priced family friendly pub serving French food located in the city centre near Crowne Plaza Hotel it has a low customer rating.
name[The Phoenix], eatType[pub], food[French], priceRange[more than £30], customer rating[low], area[riverside], familyFriendly[no], near[Crowne Plaza Hotel]	The Phoenix is a French pub in the riverside near Crowne Plaza Hotel it has a price range of more than £30, has a low customer rating it is not children friendly and.
name[The Phoenix], eatType[pub], food[French], priceRange[more than £30], customer rating[low], area[riverside], familyFriendly[yes], near[Crowne Plaza Hotel]	The Phoenix is a low priced family friendly pub serving French food located in the riverside near Crowne Plaza Hotel it has a low customer rating.
name[The Phoenix], eatType[restaurant], food[Fast food], priceRange[cheap], area[riverside], familyFriendly[yes], near[Raja Indian Cuisine]	The Phoenix is a cheap family friendly Fast food restaurant in riverside near Raja Indian Cuisine.
name[The Phoenix], eatType[restaurant], food[Fast food], priceRange[high], area[city centre], familyFriendly[no], near[Raja Indian Cuisine]	The Phoenix is a Fast food restaurant in the city centre near Raja Indian Cuisine it has a high price range and is not children friendly.
name[The Phoenix], eatType[restaurant], food[Fast food], priceRange[high], area[city centre], familyFriendly[yes], near[Raja Indian Cuisine]	The Phoenix is a high priced Fast food restaurant in the city centre near Raja Indian Cuisine it is children friendly.
name[The Phoenix], eatType[restaurant], food[Fast food], priceRange[high], area[riverside], familyFriendly[no], near[Raja Indian Cuisine]	The Phoenix is a Fast food restaurant in riverside near Raja Indian Cuisine it has a high price range and is not children friendly.
name[The Phoenix], eatType[restaurant], food[Fast food], priceRange[high], area[riverside], familyFriendly[yes], near[Raja Indian Cuisine]	The Phoenix is a high priced Fast food restaurant in riverside near Raja Indian Cuisine is a children friendly.
name[The Phoenix], eatType[restaurant], food[Fast food], priceRange[less than £20], area[city centre], familyFriendly[no], near[Raja Indian Cuisine]	The Phoenix is a Fast food restaurant with a price range of less than £20 it is located in the city centre near Raja Indian Cuisine it is not family friendly.
name[The Phoenix], eatType[restaurant], food[Fast food], priceRange[less than £20], area[city centre], familyFriendly[yes], near[Raja Indian Cuisine]	The Phoenix is a low priced Fast food restaurant in the city centre near Raja Indian Cuisine it is family friendly.
name[The Phoenix], eatType[restaurant], food[Fast food], priceRange[less than £20], area[riverside], familyFriendly[no], near[Raja Indian Cuisine]	The Phoenix is a Fast food restaurant in the riverside near Raja Indian Cuisine it has a price range of less than £20 it is not family friendly.
name[The Phoenix], eatType[restaurant], food[Fast food], priceRange[less than £20], area[riverside], familyFriendly[yes], near[Raja Indian Cuisine]	The Phoenix is a low priced Fast food restaurant in riverside near Raja Indian Cuisine it is family friendly.
name[The Phoenix], eatType[restaurant], food[Fast food], priceRange[moderate], area[city centre], familyFriendly[no], near[Raja Indian Cuisine]	The Phoenix is a moderately priced Fast food restaurant located in the city centre near Raja Indian Cuisine it is not kid friendly.
name[The Phoenix], eatType[restaurant], food[Fast food], priceRange[moderate], area[city centre], familyFriendly[yes], near[Raja Indian Cuisine]	The Phoenix is a moderately priced Fast food restaurant located in the city centre near Raja Indian Cuisine it is kid friendly.
name[The Phoenix], eatType[restaurant], food[Fast food], priceRange[moderate], area[riverside], familyFriendly[no], near[Raja Indian Cuisine]	The Phoenix is a moderately priced Fast food restaurant located in riverside near Raja Indian Cuisine it is not kid friendly.
name[The Phoenix], eatType[restaurant], food[Fast food], priceRange[moderate], area[riverside], familyFriendly[yes], near[Raja Indian Cuisine]	The Phoenix is a moderately priced Fast food restaurant located in riverside near Raja Indian Cuisine it is kid friendly.
name[The Phoenix], eatType[restaurant], food[Fast food], priceRange[more than £30], area[riverside], familyFriendly[yes], near[Raja Indian Cuisine]	The Phoenix is a high priced Fast food restaurant located in riverside near Raja Indian Cuisine it is kid friendly.
name[The Phoenix], eatType[restaurant], food[French], priceRange[£20-25], area[riverside], familyFriendly[yes], near[Raja Indian Cuisine]	The Phoenix is a low priced French restaurant near Raja Indian Cuisine in riverside is kid friendly.
name[The Phoenix], eatType[restaurant], food[French], priceRange[cheap], area[riverside], familyFriendly[yes], near[Raja Indian Cuisine]	The Phoenix is a cheap family friendly French restaurant in riverside near Raja Indian Cuisine.
name[The Phoenix], eatType[restaurant], food[French], priceRange[high], area[riverside], familyFriendly[yes], near[Raja Indian Cuisine]	The Phoenix is a high priced French restaurant in riverside near Raja Indian Cuisine is a children friendly.
name[The Phoenix], eatType[restaurant], food[Indian], priceRange[£20-25], customer rating[high], area[city centre], familyFriendly[no], near[Crowne Plaza Hotel]	The Phoenix is a restaurant in the city centre near Crowne Plaza Hotel it has a price range of more than £30 and has a high customer rating it is not kid friendly.
name[The Phoenix], eatType[restaurant], food[Indian], priceRange[£20-25], customer rating[high], area[city centre], familyFriendly[yes], near[Crowne Plaza Hotel]	The Phoenix is a restaurant in the city centre near Crowne Plaza Hotel it has a price range and a high customer rating is kid friendly.
name[The Phoenix], eatType[restaurant], food[Indian], priceRange[£20-25], customer rating[high], area[riverside], familyFriendly[no], near[Crowne Plaza Hotel]	The Phoenix is a restaurant in the riverside near Crowne Plaza Hotel it has a price range of 20-25 and has a high customer rating it is not kid friendly.
name[The Phoenix], eatType[restaurant], food[Indian], priceRange[£20-25], customer rating[high], area[riverside], familyFriendly[yes], near[Crowne Plaza Hotel]	The Phoenix is a restaurant in the riverside near Crowne Plaza Hotel it has a price range and a high customer rating is kid friendly.
name[The Phoenix], eatType[restaurant], food[Indian], priceRange[cheap], customer rating[5 out of 5], area[city centre], familyFriendly[no], near[Crowne Plaza Hotel]	The Phoenix is a cheap Indian restaurant located in the city centre near Crowne Plaza Hotel it has a customer rating of 5 out of 5 and is not family friendly.
name[The Phoenix], eatType[restaurant], food[Indian], priceRange[cheap], customer rating[5 out of 5], area[city centre], familyFriendly[yes], near[Crowne Plaza Hotel]	The Phoenix is a cheap family friendly Indian restaurant in the city centre near Crowne Plaza Hotel it has a customer rating of 5 out of 5.
name[The Phoenix], eatType[restaurant], food[Indian], priceRange[cheap], customer rating[5 out of 5], area[riverside], familyFriendly[no], near[Crowne Plaza Hotel]	The Phoenix is a cheap Indian restaurant located in riverside near Crowne Plaza Hotel it has a customer rating of 5 out of 5 is not family friendly.
name[The Phoenix], eatType[restaurant], food[Indian], priceRange[cheap], customer rating[5 out of 5], area[riverside], familyFriendly[no], near[Express by Holiday Inn]	The Phoenix is a cheap Indian restaurant located in riverside near Express by Holiday Inn it has a customer rating of 5 out of 5 is not family friendly.
name[The Phoenix], eatType[restaurant], food[Indian], priceRange[cheap], customer rating[5 out of 5], area[riverside], familyFriendly[yes], near[Express by Holiday Inn]	The Phoenix is a cheap family friendly Indian restaurant in riverside near Express by Holiday Inn and has a customer rating of 5 out of 5.
name[The Phoenix], eatType[restaurant], food[Indian], priceRange[cheap], customer rating[average], area[city centre], familyFriendly[no], near[Express by Holiday Inn]	The Phoenix is a cheap Indian restaurant in the city centre near Express by Holiday Inn it has an average customer rating and is not family friendly.
name[The Plough], eatType[pub], food[Chinese], priceRange[£20-25], area[riverside], familyFriendly[yes], near[Raja Indian Cuisine]	The Plough is a low priced pub serving Chinese food in the riverside near Raja Indian Cuisine.
name[The Plough], eatType[pub], food[Chinese], priceRange[cheap], area[riverside], familyFriendly[yes], near[Raja Indian Cuisine]	The Plough is a cheap family friendly Chinese pub in riverside near Raja Indian Cuisine.
name[The Plough], eatType[pub], food[Chinese], priceRange[high], area[city centre], familyFriendly[no], near[Raja Indian Cuisine]	The Plough is a Chinese food in the high price range pub located in the city centre near Raja Indian Cuisine it is not children friendly.
name[The Plough], eatType[pub], food[Chinese], priceRange[high], area[city centre], familyFriendly[yes], near[Raja Indian Cuisine]	The Plough is a high priced Chinese pub located in the city centre near Raja Indian Cuisine it is kid friendly.
name[The Plough], eatType[pub], food[Chinese], priceRange[high], area[riverside], familyFriendly[no], near[Raja Indian Cuisine]	The Plough is a high priced Chinese pub located in riverside near Raja Indian Cuisine it is not children friendly.
name[The Plough], eatType[pub], food[Chinese], priceRange[high], area[riverside], familyFriendly[yes], near[Raja Indian Cuisine]	The Plough is a high priced Chinese pub located in riverside near Raja Indian Cuisine it is kid friendly.
name[The Plough], eatType[pub], food[Chinese], priceRange[less than £20], area[city centre], familyFriendly[no], near[Raja Indian Cuisine]	The Plough is a low priced Chinese pub located in the city centre near Raja Indian Cuisine it is not family friendly.
name[The Plough], eatType[restaurant], food[Chinese], priceRange[£20-25], area[riverside], familyFriendly[yes], near[Raja Indian Cuisine]	The Plough is a Chinese food in the average price range restaurant near Raja Indian Cuisine in riverside is kid friendly.
name[The Plough], eatType[restaurant], food[Chinese], priceRange[cheap], area[riverside], familyFriendly[yes], near[Raja Indian Cuisine]	The Plough is a cheap family friendly Chinese restaurant in riverside near Raja Indian Cuisine.
name[The Plough], eatType[restaurant], food[Chinese], priceRange[high], area[city centre], familyFriendly[no], near[Raja Indian Cuisine]	The Plough is a Chinese restaurant with a high price range it is located in the city centre near Raja Indian Cuisine it is not a family friendly restaurant.
name[The Plough], eatType[restaurant], food[Chinese], priceRange[high], area[city centre], familyFriendly[yes], near[Raja Indian Cuisine]	The Plough is a high priced Chinese restaurant in the city centre near Raja Indian Cuisine it is children friendly.
name[The Plough], eatType[restaurant], food[Chinese], priceRange[high], area[riverside], familyFriendly[no], near[Raja Indian Cuisine]	The Plough is a Chinese food in the high price range it is located in the riverside near Raja Indian Cuisine it is not a family friendly restaurant.
name[The Plough], eatType[restaurant], food[Chinese], priceRange[high], area[riverside], familyFriendly[yes], near[Raja Indian Cuisine]	The Plough is a high priced Chinese restaurant in riverside near Raja Indian Cuisine it is kid friendly.
name[The Plough], eatType[restaurant], food[Chinese], priceRange[less than £20], area[city centre], familyFriendly[no], near[Raja Indian Cuisine]	The Plough is a Chinese restaurant with a price range of less than £20 it is located in the city centre near Raja Indian Cuisine it is not family friendly.
name[The Punter], eatType[pub], food[Chinese], priceRange[less than £20], area[city centre], familyFriendly[yes], near[Raja Indian Cuisine]	The Punter is a low priced Chinese pub located in the city centre near Raja Indian Cuisine it is family friendly.
name[The Punter], eatType[pub], food[Chinese], priceRange[less than £20], area[riverside], familyFriendly[no], near[Raja Indian Cuisine]	The Punter is a low priced Chinese pub located in riverside near Raja Indian Cuisine it is not family friendly.
name[The Punter], eatType[pub], food[Chinese], priceRange[less than £20], area[riverside], familyFriendly[yes], near[Raja Indian Cuisine]	The Punter is a low priced Chinese pub located in riverside near Raja Indian Cuisine it is family friendly.
name[The Punter], eatType[pub], food[Chinese], priceRange[moderate], area[city centre], familyFriendly[no], near[Raja Indian Cuisine]	The Punter is a moderately priced Chinese pub located in the city centre near Raja Indian Cuisine it is not kid friendly.
name[The Punter], eatType[pub], food[Chinese], priceRange[moderate], area[city centre], familyFriendly[yes], near[Raja Indian Cuisine]	The Punter is a moderately priced Chinese pub located in the city centre near Raja Indian Cuisine it is kid friendly.
name[The Punter], eatType[pub], food[Chinese], priceRange[moderate], area[riverside], familyFriendly[no], near[Raja Indian Cuisine]	The Punter is a moderately priced Chinese pub located in riverside near Raja Indian Cuisine it is not kid friendly.
name[The Punter], eatType[pub], food[Chinese], priceRange[moderate], area[riverside], familyFriendly[yes], near[Raja Indian Cuisine]	The Punter is a moderately priced pub serving Chinese food in riverside near Raja Indian Cuisine it is kid friendly.
name[The Punter], eatType[pub], food[Chinese], priceRange[more than £30], area[riverside], familyFriendly[yes], near[Raja Indian Cuisine]	The Punter is a low priced children friendly pub serving Chinese food in riverside near Raja Indian Cuisine.
name[The Punter], eatType[pub], food[English], priceRange[£20-25], area[riverside], familyFriendly[yes], near[Raja Indian Cuisine]	The Punter is a low priced pub near Raja Indian Cuisine in riverside is a family friendly English food.
name[The Punter], eatType[pub], food[English], priceRange[cheap], area[riverside], familyFriendly[yes], near[Raja Indian Cuisine]	The Punter is a cheap family friendly English pub located in the riverside near Raja Indian Cuisine.
name[The Punter], eatType[pub], food[English], priceRange[high], area[city centre], familyFriendly[no], near[Raja Indian Cuisine]	The Punter is a high priced English pub located in the city centre near Raja Indian Cuisine it is not children friendly.
name[The Punter], eatType[pub], food[English], priceRange[high], area[city centre], familyFriendly[yes], near[Raja Indian Cuisine]	The Punter is a high priced English pub located in the city centre near Raja Indian Cuisine it is kid friendly.
name[The Punter], eatType[pub], food[English], priceRange[high], area[riverside], familyFriendly[no], near[Raja Indian Cuisine]	The Punter is a high priced English pub located in riverside near Raja Indian Cuisine it is not children friendly.
name[The Punter], eatType[pub], food[English], priceRange[high], area[riverside], familyFriendly[yes], near[Raja Indian Cuisine]	The Punter is a high priced English pub located in riverside near Raja Indian Cuisine it is kid friendly.
name[The Punter], eatType[pub], food[Italian], priceRange[high], customer rating[average], area[city centre], familyFriendly[no], near[Rainbow Vegetarian Café]	The Punter is an Italian pub located in the city centre near Rainbow Vegetarian Café it has a high price range and has an average customer rating it is not children friendly.
name[The Punter], eatType[restaurant], food[Chinese], priceRange[less than £20], area[city centre], familyFriendly[yes], near[Raja Indian Cuisine]	The Punter is a low priced Chinese restaurant in the city centre near Raja Indian Cuisine it is family friendly.
name[The Punter], eatType[restaurant], food[Chinese], priceRange[less than £20], area[riverside], familyFriendly[no], near[Raja Indian Cuisine]	The Punter is a Chinese restaurant with a price range of less than £20 it is located in the riverside near Raja Indian Cuisine it is not family friendly.
name[The Punter], eatType[restaurant], food[Chinese], priceRange[less than £20], area[riverside], familyFriendly[yes], near[Raja Indian Cuisine]	The Punter is a low priced Chinese restaurant in riverside near Raja Indian Cuisine it is family friendly.
name[The Punter], eatType[restaurant], food[Chinese], priceRange[moderate], area[city centre], familyFriendly[no], near[Raja Indian Cuisine]	The Punter is a moderately priced Chinese restaurant in the city centre near Raja Indian Cuisine it is not kid friendly.
name[The Punter], eatType[restaurant], food[Chinese], priceRange[moderate], area[city centre], familyFriendly[yes], near[Raja Indian Cuisine]	The Punter is a moderately priced Chinese restaurant near Raja Indian Cuisine in the city centre it is kid friendly.
name[The Punter], eatType[restaurant], food[Chinese], priceRange[moderate], area[riverside], familyFriendly[no], near[Raja Indian Cuisine]	The Punter is a moderately priced Chinese restaurant in riverside near Raja Indian Cuisine it is not kid friendly.
name[The Punter], eatType[restaurant], food[Chinese], priceRange[moderate], area[riverside], familyFriendly[yes], near[Raja Indian Cuisine]	The Punter is a moderately priced Chinese restaurant near Raja Indian Cuisine in riverside is kid friendly.
name[The Punter], eatType[restaurant], food[Chinese], priceRange[more than £30], area[riverside], familyFriendly[yes], near[Raja Indian Cuisine]	The Punter serves Chinese food for more than £30 it is a children friendly restaurant in riverside near Raja Indian Cuisine.
name[The Punter], eatType[restaurant], food[English], priceRange[£20-25], area[riverside], familyFriendly[yes], near[Raja Indian Cuisine]	The Punter is an English restaurant with a price range of £20-25 is near Raja Indian Cuisine in riverside is kid friendly.
name[The Punter], eatType[restaurant], food[English], priceRange[cheap], area[riverside], familyFriendly[yes], near[Raja Indian Cuisine]	The Punter is a cheap family friendly English restaurant in riverside near Raja Indian Cuisine.
name[The Punter], eatType[restaurant], food[English], priceRange[high], area[city centre], familyFriendly[no], near[Raja Indian Cuisine]	The Punter is an English restaurant with a high price range it is near Raja Indian Cuisine in the city centre it is not children friendly.
name[The Punter], eatType[restaurant], food[English], priceRange[high], area[city centre], familyFriendly[yes], near[Raja Indian Cuisine]	The Punter is a high priced English restaurant near Raja Indian Cuisine in the city centre it is children friendly.
name[The Punter], eatType[restaurant], food[English], priceRange[high], area[riverside], familyFriendly[no], near[Raja Indian Cuisine]	The Punter is an English restaurant in riverside near Raja Indian Cuisine it has a high price range and is not children friendly.
name[The Punter], eatType[restaurant], food[English], priceRange[high], area[riverside], familyFriendly[yes], near[Raja Indian Cuisine]	The Punter is a high priced English restaurant near Raja Indian Cuisine in riverside is children friendly.
name[The Punter], eatType[restaurant], food[Indian], priceRange[cheap], customer rating[average], area[city centre], familyFriendly[yes], near[Express by Holiday Inn]	The Punter is a cheap Indian restaurant in the city centre near Express by Holiday Inn it has an average customer rating and is family friendly.
name[The Punter], eatType[restaurant], food[Indian], priceRange[cheap], customer rating[average], area[riverside], familyFriendly[no], near[Express by Holiday Inn]	The Punter is a cheap Indian restaurant in riverside near Express by Holiday Inn it has an average customer rating and is not family friendly.
name[The Punter], eatType[restaurant], food[Indian], priceRange[cheap], customer rating[average], area[riverside], familyFriendly[yes], near[Express by Holiday Inn]	The Punter is a cheap Indian restaurant in riverside near Express by Holiday Inn and has an average customer rating it is family friendly.
name[The Punter], eatType[restaurant], food[Indian], priceRange[high], customer rating[1 out of 5], area[city centre], familyFriendly[no], near[Express by Holiday Inn]	The Punter is a restaurant in the city centre near Express by Holiday Inn it has a high price range, a 1 out of 5 and is not children friendly.
name[The Punter], eatType[restaurant], food[Indian], priceRange[high], customer rating[1 out of 5], area[city centre], familyFriendly[yes], near[Express by Holiday Inn]	The Punter is a restaurant in the city centre near Express by Holiday Inn it has a high price range and has a customer rating of 1 out of 5 is children friendly.
name[The Punter], eatType[restaurant], food[Indian], priceRange[high], customer rating[1 out of 5], area[riverside], familyFriendly[no], near[Express by Holiday Inn]	The Punter is a restaurant in the riverside near Express by Holiday Inn it has a high price range and a 1 out of 5 is not children friendly.
name[The Punter], eatType[restaurant], food[Indian], priceRange[high], customer rating[1 out of 5], area[riverside], familyFriendly[yes], near[Express by Holiday Inn]	The Punter is a restaurant in the riverside near Express by Holiday Inn it has a high price range and has a customer rating of 1 out of 5 is children friendly.
name[The Punter], eatType[restaurant], food[Indian], priceRange[high], customer rating[average], area[city centre], familyFriendly[no], near[Express by Holiday Inn]	The Punter is a Indian restaurant in the city centre near Express by Holiday Inn it has a high price range, has an average customer rating and is not children friendly.
name[The Punter], eatType[restaurant], food[Indian], priceRange[high], customer rating[average], area[city centre], familyFriendly[yes], near[Express by Holiday Inn]	The Punter is a restaurant with a high price range it is located in the city centre near Express by Holiday Inn it has an average customer rating and is children friendly.
name[The Punter], eatType[restaurant], food[Indian], priceRange[high], customer rating[average], area[riverside], familyFriendly[no], near[Express by Holiday Inn]	The Punter is a restaurant in the riverside near Express by Holiday Inn it has a high price range, has an average customer rating and is not children friendly.
name[The Punter], eatType[restaurant], food[Indian], priceRange[high], customer rating[average], area[riverside], familyFriendly[yes], near[Express by Holiday Inn]	The Punter is a restaurant in the riverside near Express by Holiday Inn it has a high price range, an average customer rating and is children friendly.
name[The Punter], eatType[restaurant], food[Indian], priceRange[less than £20], customer rating[low], area[city centre], familyFriendly[no], near[Express by Holiday Inn]	The Punter is a restaurant with a price range of less than £20 it is located in the city centre near Express by Holiday Inn it has a low customer rating it is not family friendly.
name[The Punter], eatType[restaurant], food[Indian], priceRange[less than £20], customer rating[low], area[city centre], familyFriendly[yes], near[Express by Holiday Inn]	The Punter is a restaurant with a price range of less than £20 it is located in the city centre near Express by Holiday Inn it has a low customer rating and is family friendly.
name[The Punter], eatType[restaurant], food[Indian], priceRange[less than £20], customer rating[low], area[riverside], familyFriendly[no], near[Express by Holiday Inn]	The Punter is a restaurant in the riverside near Express by Holiday Inn it has a price range of less than £20 and has a low customer rating it is not family friendly.
name[The Punter], eatType[restaurant], food[Indian], priceRange[less than £20], customer rating[low], area[riverside], familyFriendly[yes], near[Express by Holiday Inn]	The Punter is a restaurant with a low price range it is located in the riverside near Express by Holiday Inn and has a low customer rating is family friendly.
name[The Punter], eatType[restaurant], food[Indian], priceRange[moderate], customer rating[1 out of 5], area[city centre], familyFriendly[no], near[Express by Holiday Inn]	The Punter is a moderate price range it is located in the city centre near Express by Holiday Inn it has a customer rating of 1 out of 5 is not a kid friendly restaurant.
name[The Punter], eatType[restaurant], food[Indian], priceRange[moderate], customer rating[1 out of 5], area[city centre], familyFriendly[yes], near[Express by Holiday Inn]	The Punter is a moderately priced Indian restaurant in the city centre near Express by Holiday Inn it is kid friendly but has a customer rating of 1 out of 5.
name[The Punter], eatType[restaurant], food[Indian], priceRange[moderate], customer rating[1 out of 5], area[riverside], familyFriendly[no], near[Express by Holiday Inn]	The Punter serves Indian food in the moderate price range it is located in the riverside near Express by Holiday Inn it has a customer rating of 1 out of 5 is not kid friendly and.
name[The Punter], eatType[restaurant], food[Indian], priceRange[moderate], customer rating[1 out of 5], area[riverside], familyFriendly[yes], near[Express by Holiday Inn]	The Punter is a moderately priced Indian restaurant in riverside near Express by Holiday Inn has a customer rating of 1 out of 5 friendly.
name[The Punter], eatType[restaurant], food[Indian], priceRange[moderate], customer rating[3 out of 5], area[city centre], familyFriendly[no], near[Express by Holiday Inn]	The Punter is a moderately priced Indian restaurant in the city centre near Express by Holiday Inn it has a customer rating of 3 out of 5 and is not kid friendly.
name[The Punter], eatType[restaurant], food[Indian], priceRange[moderate], customer rating[3 out of 5], area[city centre], familyFriendly[yes], near[Express by Holiday Inn]	The Punter is a moderately priced Indian restaurant located in the city centre near Express by Holiday Inn it is kid friendly has a customer rating of 3 out of 5.
name[The Punter], eatType[restaurant], food[Indian], priceRange[moderate], customer rating[3 out of 5], area[riverside], familyFriendly[no], near[Express by Holiday Inn]	The Punter is a moderately priced Indian restaurant in riverside near Express by Holiday Inn it has a customer rating of 3 out of 5 and is not kid friendly.
name[The Punter], eatType[restaurant], food[Indian], priceRange[moderate], customer rating[3 out of 5], area[riverside], familyFriendly[yes], near[Express by Holiday Inn]	The Punter is a moderately priced Indian restaurant in riverside near Express by Holiday Inn is kid friendly it has a customer rating of 3 out of 5.
name[The Punter], eatType[restaurant], food[Indian], priceRange[more than £30], customer rating[high], area[city centre], familyFriendly[no], near[Express by Holiday Inn]	The Punter is a Indian restaurant in the city centre near Express by Holiday Inn it has a price range of more than £30 and has a high customer rating it is not children friendly.
name[The Punter], eatType[restaurant], food[Indian], priceRange[more than £30], customer rating[high], area[city centre], familyFriendly[yes], near[Express by Holiday Inn]	The Punter is a restaurant in the city centre near Express by Holiday Inn it has a price range of more than £30 and has a high customer rating it is children friendly.
name[The Punter], eatType[restaurant], food[Indian], priceRange[more than £30], customer rating[high], area[riverside], familyFriendly[no], near[Express by Holiday Inn]	The Punter is a restaurant in the riverside near Express by Holiday Inn it has a price range of more than £30 and has a high customer rating it is not children friendly.
name[The Punter], eatType[restaurant], food[Indian], priceRange[more than £30], customer rating[high], area[riverside], familyFriendly[yes], near[Express by Holiday Inn]	The Punter is a restaurant in the riverside near Express by Holiday Inn it has a price range of more than £30 and has a high customer rating it is children friendly.
name[The Punter], eatType[restaurant], food[Italian], priceRange[£20-25], customer rating[high], area[city centre], familyFriendly[no], near[Express by Holiday Inn]	The Punter is an Italian restaurant in the city centre near Express by Holiday Inn it has a price range of more than £30 and has a high customer rating it is not kid friendly.
name[The Punter], eatType[restaurant], food[Italian], priceRange[£20-25], customer rating[high], area[city centre], familyFriendly[yes], near[Express by Holiday Inn]	The Punter is a Italian restaurant in the city centre near Express by Holiday Inn it has a price range and a high customer rating is kid friendly.
name[The Punter], eatType[restaurant], food[Italian], priceRange[£20-25], customer rating[high], area[riverside], familyFriendly[no], near[Express by Holiday Inn]	The Punter is an Italian restaurant in the riverside near Express by Holiday Inn it has a price range of 20-25 and has a high customer rating it is not kid friendly.
name[The Punter], eatType[restaurant], food[Italian], priceRange[£20-25], customer rating[high], area[riverside], familyFriendly[yes], near[Express by Holiday Inn]	The Punter is an Italian restaurant in the riverside near Express by Holiday Inn it has a price range and a high customer rating is kid friendly.
name[The Punter], eatType[restaurant], food[Italian], priceRange[cheap], customer rating[5 out of 5], area[city centre], familyFriendly[no], near[Express by Holiday Inn]	The Punter is a cheap Italian restaurant located in the city centre near Express by Holiday Inn it has a customer rating of 5 out of 5 and is not family friendly.
name[The Punter], eatType[restaurant], food[Italian], priceRange[cheap], customer rating[5 out of 5], area[city centre], familyFriendly[no], near[Rainbow Vegetarian Café]	The Punter is a cheap Italian restaurant located in the city centre near Rainbow Vegetarian Café it has a customer rating of 5 out of 5 and is not family friendly.
name[The Punter], eatType[restaurant], food[Italian], priceRange[cheap], customer rating[5 out of 5], area[city centre], familyFriendly[yes], near[Rainbow Vegetarian Café]	The Punter is a cheap family friendly Italian restaurant in the city centre near Rainbow Vegetarian Café it has a customer rating of 5 out of 5.
name[The Punter], eatType[restaurant], food[Italian], priceRange[cheap], customer rating[5 out of 5], area[riverside], familyFriendly[no], near[Rainbow Vegetarian Café]	The Punter is a cheap Italian coffee restaurant in riverside near Rainbow Vegetarian Café it has a customer rating of 5 out of 5 is not family friendly.
name[The Punter], eatType[restaurant], food[Italian], priceRange[cheap], customer rating[5 out of 5], area[riverside], familyFriendly[yes], near[Rainbow Vegetarian Café]	The Punter is a cheap family friendly Italian restaurant in riverside near Rainbow Vegetarian Café and has a customer rating of 5 out of 5.
name[The Punter], eatType[restaurant], food[Italian], priceRange[cheap], customer rating[average], area[city centre], familyFriendly[no], near[Rainbow Vegetarian Café]	The Punter is a cheap Italian restaurant located in the city centre near Rainbow Vegetarian Café it has an average customer rating and is not family friendly.
name[The Punter], eatType[restaurant], food[Italian], priceRange[cheap], customer rating[average], area[city centre], familyFriendly[yes], near[Rainbow Vegetarian Café]	The Punter is a cheap family friendly Italian restaurant in the city centre near Rainbow Vegetarian Café it has an average customer rating.
name[The Punter], eatType[restaurant], food[Italian], priceRange[cheap], customer rating[average], area[riverside], familyFriendly[no], near[Rainbow Vegetarian Café]	The Punter is a cheap Italian coffee restaurant in riverside near Rainbow Vegetarian Café it has an average customer rating and is not family friendly.
name[The Punter], eatType[restaurant], food[Italian], priceRange[cheap], customer rating[average], area[riverside], familyFriendly[yes], near[Rainbow Vegetarian Café]	The Punter is a cheap family friendly Italian restaurant in riverside near Rainbow Vegetarian Café and has an average customer rating.
name[The Punter], eatType[restaurant], food[Italian], priceRange[high], customer rating[1 out of 5], area[city centre], familyFriendly[no], near[Rainbow Vegetarian Café]	The Punter is an Italian restaurant in the city centre near Rainbow Vegetarian Café it has a high price range, a 1 out of 5 and is not children friendly.
name[The Punter], eatType[restaurant], food[Italian], priceRange[high], customer rating[1 out of 5], area[city centre], familyFriendly[yes], near[Rainbow Vegetarian Café]	The Punter is an Italian restaurant in the city centre near Rainbow Vegetarian Café it has a high price range and has a customer rating of 1 out of 5 is children friendly.
name[The Punter], eatType[restaurant], food[Italian], priceRange[high], customer rating[1 out of 5], area[riverside], familyFriendly[no], near[Rainbow Vegetarian Café]	The Punter is an Italian restaurant in the riverside near Rainbow Vegetarian Café it has a high price range and a 1 out of 5 is not children friendly.
name[The Punter], eatType[restaurant], food[Italian], priceRange[high], customer rating[1 out of 5], area[riverside], familyFriendly[yes], near[Rainbow Vegetarian Café]	The Punter is an Italian restaurant in the riverside near Rainbow Vegetarian Café it has a high price range and a 1 out of 5 is children friendly.
name[The Vaults], eatType[pub], food[French], priceRange[high], area[riverside], familyFriendly[yes], near[Raja Indian Cuisine]	The Vaults is a high priced French pub located in riverside near Raja Indian Cuisine it is kid friendly.
name[The Vaults], eatType[pub], food[French], priceRange[less than £20], area[city centre], familyFriendly[no], near[Raja Indian Cuisine]	The Vaults is a low priced French pub located in the city centre near Raja Indian Cuisine it is not family friendly.
name[The Vaults], eatType[pub], food[French], priceRange[less than £20], area[city centre], familyFriendly[yes], near[Raja Indian Cuisine]	The Vaults is a low priced French pub located in the city centre near Raja Indian Cuisine it is family friendly.
name[The Vaults], eatType[pub], food[French], priceRange[less than £20], area[riverside], familyFriendly[no], near[Raja Indian Cuisine]	The Vaults is a low priced French pub located in the riverside near Raja Indian Cuisine it is not family friendly.
name[The Vaults], eatType[pub], food[French], priceRange[less than £20], area[riverside], familyFriendly[yes], near[Raja Indian Cuisine]	The Vaults is a low priced French pub located in riverside near Raja Indian Cuisine it is family friendly.
name[The Vaults], eatType[pub], food[French], priceRange[moderate], area[city centre], familyFriendly[no], near[Raja Indian Cuisine]	The Vaults is a moderately priced French pub located in the city centre near Raja Indian Cuisine it is not kid friendly.
name[The Vaults], eatType[pub], food[French], priceRange[moderate], area[city centre], familyFriendly[yes], near[Raja Indian Cuisine]	The Vaults is a moderately priced French pub near Raja Indian Cuisine in the city centre it is kid friendly.
name[The Vaults], eatType[pub], food[French], priceRange[moderate], area[riverside], familyFriendly[no], near[Raja Indian Cuisine]	The Vaults is a moderately priced French pub located in the riverside near Raja Indian Cuisine it is not kid friendly and.
name[The Vaults], eatType[pub], food[French], priceRange[moderate], area[riverside], familyFriendly[yes], near[Raja Indian Cuisine]	The Vaults is a moderately priced French pub near Raja Indian Cuisine in riverside it is kid friendly.
name[The Vaults], eatType[pub], food[French], priceRange[more than £30], area[city centre], familyFriendly[no], near[Raja Indian Cuisine]	The Vaults is a high priced French pub located in the city centre near Raja Indian Cuisine it is not children friendly.
name[The Vaults], eatType[pub], food[French], priceRange[more than £30], area[city centre], familyFriendly[yes], near[Raja Indian Cuisine]	The Vaults is a low priced children friendly pub serving French food located in the city centre near Raja Indian Cuisine.
name[The Vaults], eatType[pub], food[French], priceRange[more than £30], area[riverside], familyFriendly[no], near[Raja Indian Cuisine]	The Vaults is a low priced French pub located in riverside near Raja Indian Cuisine it is not children friendly.
name[The Vaults], eatType[pub], food[French], priceRange[more than £30], area[riverside], familyFriendly[yes], near[Raja Indian Cuisine]	The Vaults is a low priced children friendly pub located in the riverside near Raja Indian Cuisine serves French food.
name[The Vaults], eatType[pub], food[Indian], priceRange[£20-25], area[riverside], familyFriendly[yes], near[Raja Indian Cuisine]	The Vaults is a low priced pub serving Indian food in riverside near Raja Indian Cuisine it is kid friendly.
name[The Vaults], eatType[pub], food[Indian], priceRange[cheap], area[riverside], familyFriendly[yes], near[Raja Indian Cuisine]	The Vaults is a cheap family friendly Indian pub in riverside near Raja Indian Cuisine.
name[The Vaults], eatType[pub], food[Indian], priceRange[high], area[city centre], familyFriendly[no], near[Raja Indian Cuisine]	The Vaults is an Indian pub with a high price range it is located in the city centre near Raja Indian Cuisine it is not children friendly.
name[The Vaults], eatType[pub], food[Indian], priceRange[high], area[city centre], familyFriendly[yes], near[Raja Indian Cuisine]	The Vaults is a high priced Indian pub located in the city centre near Raja Indian Cuisine it is kid friendly.
name[The Vaults], eatType[pub], food[Italian], priceRange[high], customer rating[average], area[city centre], familyFriendly[no], near[Rainbow Vegetarian Café]	The Vaults is an Italian pub located in the city centre near Rainbow Vegetarian Café it has a high price range and has an average customer rating it is not children friendly.
name[The Vaults], eatType[pub], food[Italian], priceRange[high], customer rating[average], area[city centre], familyFriendly[yes], near[Rainbow Vegetarian Café]	The Vaults is a high priced Italian pub located in the city centre near Rainbow Vegetarian Café it has an average customer rating and is child friendly.
name[The Vaults], eatType[pub], food[Italian], priceRange[high], customer rating[average], area[riverside], familyFriendly[no], near[Rainbow Vegetarian Café]	The Vaults is an Italian pub in the riverside near Rainbow Vegetarian Café it has a high price range and has an average customer rating it is not children friendly.
name[The Vaults], eatType[pub], food[Italian], priceRange[high], customer rating[average], area[riverside], familyFriendly[yes], near[Rainbow Vegetarian Café]	The Vaults is a high priced Italian pub located in riverside near Rainbow Vegetarian Café it has an average customer rating and is child friendly.
name[The Vaults], eatType[pub], food[Italian], priceRange[less than £20], customer rating[low], area[city centre], familyFriendly[no], near[Rainbow Vegetarian Café]	The Vaults is a Italian pub located in the city centre near Rainbow Vegetarian Café it has a price range less than £20 and has a low customer rating it is not family friendly.
name[The Vaults], eatType[pub], food[Italian], priceRange[less than £20], customer rating[low], area[city centre], familyFriendly[yes], near[Rainbow Vegetarian Café]	The Vaults is a low priced Italian pub located in the city centre near Rainbow Vegetarian Café it has a low customer rating and is family friendly.
name[The Vaults], eatType[pub], food[Italian], priceRange[less than £20], customer rating[low], area[riverside], familyFriendly[no], near[Rainbow Vegetarian Café]	The Vaults is a Italian pub located in the riverside near Rainbow Vegetarian Café it has a price range of less than £20 and has a low customer rating it is not family friendly.
name[The Vaults], eatType[pub], food[Italian], priceRange[less than £20], customer rating[low], area[riverside], familyFriendly[yes], near[Rainbow Vegetarian Café]	The Vaults is a low priced Italian pub located in the riverside near Rainbow Vegetarian Café it has a low customer rating and is family friendly.
name[The Vaults], eatType[pub], food[Italian], priceRange[moderate], customer rating[1 out of 5], area[city centre], familyFriendly[no], near[Rainbow Vegetarian Café]	The Vaults is a moderately priced Italian pub located in the city centre near Rainbow Vegetarian Café it has a customer rating of 1 out of 5 and is not kid friendly.
name[The Vaults], eatType[pub], food[Italian], priceRange[moderate], customer rating[1 out of 5], area[city centre], familyFriendly[yes], near[Rainbow Vegetarian Café]	The Vaults is a moderately priced Italian pub located in the city centre near Rainbow Vegetarian Café it has a customer rating of 1 out of 5 and is kid friendly.
name[The Vaults], eatType[pub], food[Italian], priceRange[moderate], customer rating[1 out of 5], area[riverside], familyFriendly[no], near[Rainbow Vegetarian Café]	The Vaults is a moderately priced Italian pub located in the riverside near Rainbow Vegetarian Café it has a customer rating of 1 out of 5 and is not kid friendly.
name[The Vaults], eatType[pub], food[Italian], priceRange[moderate], customer rating[1 out of 5], area[riverside], familyFriendly[yes], near[Rainbow Vegetarian Café]	The Vaults is a moderately priced Italian pub located in the riverside near Rainbow Vegetarian Café has a customer rating of 1 out of 5 kid friendly.
name[The Vaults], eatType[pub], food[Italian], priceRange[moderate], customer rating[3 out of 5], area[city centre], familyFriendly[no], near[Rainbow Vegetarian Café]	The Vaults is a moderately priced Italian pub located in the city centre near Rainbow Vegetarian Café it has a customer rating of 3 out of 5 and is not kid friendly.
name[The Vaults], eatType[pub], food[Italian], priceRange[moderate], customer rating[3 out of 5], area[city centre], familyFriendly[yes], near[Rainbow Vegetarian Café]	The Vaults is a moderately priced Italian pub located in the city centre near Rainbow Vegetarian Café it is kid friendly with a customer rating of 3 out of 5.
name[The Vaults], eatType[pub], food[Italian], priceRange[moderate], customer rating[3 out of 5], area[riverside], familyFriendly[no], near[Rainbow Vegetarian Café]	The Vaults is a moderately priced Italian pub located in the riverside near Rainbow Vegetarian Café it has a customer rating of 3 out of 5 and is not kid friendly.
name[The Vaults], eatType[pub], food[Italian], priceRange[moderate], customer rating[3 out of 5], area[riverside], familyFriendly[yes], near[Rainbow Vegetarian Café]	The Vaults is a moderately priced Italian pub located in the riverside near Rainbow Vegetarian Café has a customer rating of 3 out of 5 is kid friendly.
name[The Vaults], eatType[pub], food[Italian], priceRange[more than £30], customer rating[high], area[city centre], familyFriendly[no], near[Rainbow Vegetarian Café]	The Vaults is an Italian pub located in the city centre near Rainbow Vegetarian Café it has a price range of more than £30 and has a high customer rating it is not children friendly.
name[The Vaults], eatType[pub], food[Italian], priceRange[more than £30], customer rating[high], area[city centre], familyFriendly[yes], near[Rainbow Vegetarian Café]	The Vaults is a low priced children friendly pub serving Italian located in the city centre near Rainbow Vegetarian Café it has a high customer rating.
name[The Vaults], eatType[pub], food[Italian], priceRange[more than £30], customer rating[high], area[riverside], familyFriendly[no], near[Rainbow Vegetarian Café]	The Vaults is an Italian pub located in the riverside near Rainbow Vegetarian Café it has a price range of more than £30 and has a high customer rating it is not children friendly.
name[The Vaults], eatType[pub], food[Italian], priceRange[more than £30], customer rating[high], area[riverside], familyFriendly[yes], near[Rainbow Vegetarian Café]	The Vaults is a low priced children friendly pub located in the riverside near Rainbow Vegetarian Café has a high customer rating Italian food.
name[The Vaults], eatType[pub], food[Japanese], priceRange[£20-25], customer rating[3 out of 5], area[city centre], familyFriendly[no], near[Rainbow Vegetarian Café]	The Vaults is a Japanese pub located in the city centre near Rainbow Vegetarian Café it has a price range of £20-25 and has a customer rating of 3 out of 5 is not kid friendly.
name[The Vaults], eatType[pub], food[Japanese], priceRange[£20-25], customer rating[3 out of 5], area[city centre], familyFriendly[yes], near[Rainbow Vegetarian Café]	The Vaults is a low priced pub near Rainbow Vegetarian Café in the city centre is a kid friendly and has a customer rating of 3 out of 5 Japanese food.
name[The Vaults], eatType[pub], food[Japanese], priceRange[£20-25], customer rating[3 out of 5], area[riverside], familyFriendly[no], near[Rainbow Vegetarian Café]	The Vaults is a Japanese pub in the riverside near Rainbow Vegetarian Café it has a price range of £20-25 and has a customer rating of 3 out of 5 is not kid friendly.
name[The Vaults], eatType[pub], food[Japanese], priceRange[£20-25], customer rating[3 out of 5], area[riverside], familyFriendly[yes], near[Rainbow Vegetarian Café]	The Vaults is a low priced pub near Rainbow Vegetarian Café in riverside is kid friendly and has a customer rating of 3 out of 5 Japanese food.
name[The Vaults], eatType[pub], food[Japanese], priceRange[£20-25], customer rating[high], area[city centre], familyFriendly[no], near[Rainbow Vegetarian Café]	The Vaults is a Japanese pub in the city centre near Rainbow Vegetarian Café it has a price range of more than £30 and has a high customer rating it is not kid friendly.
name[The Vaults], eatType[pub], food[Japanese], priceRange[£20-25], customer rating[high], area[city centre], familyFriendly[yes], near[Rainbow Vegetarian Café]	The Vaults is a low priced pub Japanese food in the city centre near Rainbow Vegetarian Café it has a high customer rating it is kid friendly.
name[The Vaults], eatType[pub], food[Japanese], priceRange[£20-25], customer rating[high], area[riverside], familyFriendly[no], near[Rainbow Vegetarian Café]	The Vaults is a Japanese pub in the riverside near Rainbow Vegetarian Café the price range is £20-25 and has a high customer rating it is not kid friendly.
name[The Vaults], eatType[pub], food[Japanese], priceRange[£20-25], customer rating[high], area[riverside], familyFriendly[no], near[Raja Indian Cuisine]	The Vaults is a Japanese pub in the riverside near Raja Indian Cuisine the price range is £20-25 and has a high customer rating it is not kid friendly.
name[The Vaults], eatType[pub], food[Japanese], priceRange[£20-25], customer rating[high], area[riverside], familyFriendly[yes], near[Raja Indian Cuisine]	The Vaults is a low priced pub Japanese food in the riverside near Raja Indian Cuisine it has a high customer rating it is kid friendly.
name[The Vaults], eatType[pub], food[Japanese], priceRange[cheap], customer rating[5 out of 5], area[city centre], familyFriendly[no], near[Raja Indian Cuisine]	The Vaults is a cheap family friendly Japanese pub located in the city centre near Raja Indian Cuisine it has a customer rating of 5 out of 5.
name[The Vaults], eatType[pub], food[Japanese], priceRange[cheap], customer rating[5 out of 5], area[city centre], familyFriendly[yes], near[Raja Indian Cuisine]	The Vaults is a cheap family friendly Japanese pub located in the city centre near Raja Indian Cuisine it has a customer rating of 5 out of 5.
name[The Vaults], eatType[pub], food[Japanese], priceRange[cheap], customer rating[5 out of 5], area[riverside], familyFriendly[no], near[Raja Indian Cuisine]	The Vaults is a cheap family friendly Japanese pub located in the riverside near Raja Indian Cuisine and has a customer rating of 5 out of 5.
name[The Vaults], eatType[pub], food[Japanese], priceRange[cheap], customer rating[5 out of 5], area[riverside], familyFriendly[yes], near[Raja Indian Cuisine]	The Vaults is a cheap family friendly Japanese pub located in the riverside near Raja Indian Cuisine and has a customer rating of 5 out of 5.
name[The Vaults], eatType[pub], food[Japanese], priceRange[high], customer rating[3 out of 5], area[city centre], familyFriendly[no], near[Raja Indian Cuisine]	The Vaults is a Japanese pub located in the city centre near Raja Indian Cuisine it has a high price range, a customer rating of 3 out of 5 and is not kid friendly.
name[The Vaults], eatType[pub], food[Japanese], priceRange[high], customer rating[3 out of 5], area[city centre], familyFriendly[yes], near[Raja Indian Cuisine]	The Vaults is a high priced Japanese pub located in the city centre near Raja Indian Cuisine it is kid friendly and has a customer rating of 3 out of 5.
name[The Vaults], eatType[pub], food[Japanese], priceRange[high], customer rating[3 out of 5], area[riverside], familyFriendly[no], near[Raja Indian Cuisine]	The Vaults is a Japanese pub in riverside near Raja Indian Cuisine it has a high price range and a customer rating of 3 out of 5 is not kid friendly.
name[The Vaults], eatType[pub], food[Japanese], priceRange[high], customer rating[3 out of 5], area[riverside], familyFriendly[yes], near[Raja Indian Cuisine]	The Vaults is a high priced Japanese pub located in riverside near Raja Indian Cuisine it has a 3 out of 5 and is kid friendly.
name[The Vaults], eatType[pub], food[Japanese], priceRange[less than £20], customer rating[average], area[city centre], familyFriendly[no], near[Raja Indian Cuisine]	The Vaults is a Japanese pub located in the city centre near Raja Indian Cuisine it has a price range less than £20 and has an average customer rating it is not family friendly.
name[The Vaults], eatType[pub], food[Japanese], priceRange[less than £20], customer rating[average], area[city centre], familyFriendly[yes], near[Raja Indian Cuisine]	The Vaults is a low priced Japanese pub in the city centre near Raja Indian Cuisine it has an average customer rating and is family friendly.
name[The Vaults], eatType[pub], food[Japanese], priceRange[less than £20], customer rating[average], area[riverside], familyFriendly[no], near[Raja Indian Cuisine]	The Vaults is a Japanese pub in the riverside near Raja Indian Cuisine it has a price range of less than £20 and has an average customer rating it is not family friendly.
name[The Vaults], eatType[pub], food[Japanese], priceRange[less than £20], customer rating[average], area[riverside], familyFriendly[yes], near[Raja Indian Cuisine]	The Vaults is a low priced Japanese pub in riverside near Raja Indian Cuisine it has an average customer rating and is family friendly.
name[The Vaults], eatType[pub], food[Japanese], priceRange[less than £20], customer rating[low], area[city centre], familyFriendly[no], near[Raja Indian Cuisine]	The Vaults is a Japanese pub located in the city centre near Raja Indian Cuisine it has a price range less than £20 and has a low customer rating it is not family friendly.
name[The Vaults], eatType[pub], food[Japanese], priceRange[less than £20], customer rating[low], area[city centre], familyFriendly[yes], near[Raja Indian Cuisine]	The Vaults is a low priced Japanese pub in the city centre near Raja Indian Cuisine it has a low customer rating it is family friendly.
name[The Vaults], eatType[pub], food[Japanese], priceRange[less than £20], customer rating[low], area[riverside], familyFriendly[no], near[Raja Indian Cuisine]	The Vaults is a Japanese pub in the riverside near Raja Indian Cuisine it has a price range of less than £20 and has a low customer rating it is not family friendly.
name[The Vaults], eatType[pub], food[Japanese], priceRange[less than £20], customer rating[low], area[riverside], familyFriendly[yes], near[Raja Indian Cuisine]	The Vaults is a low priced Japanese pub in riverside near Raja Indian Cuisine it has a low customer rating it is family friendly.
name[The Vaults], eatType[pub], food[Japanese], priceRange[moderate], customer rating[1 out of 5], area[city centre], familyFriendly[no], near[Raja Indian Cuisine]	The Vaults is a moderately priced Japanese pub in the city centre near Raja Indian Cuisine it has a customer rating of 1 out of 5 and is not kid friendly.
name[The Vaults], eatType[pub], food[Japanese], priceRange[moderate], customer rating[1 out of 5], area[city centre], familyFriendly[yes], near[Raja Indian Cuisine]	The Vaults is a moderately priced Japanese pub located in the city centre near Raja Indian Cuisine it is kid friendly with a customer rating of 1 out of 5.
name[The Vaults], eatType[restaurant], food[French], priceRange[high], area[riverside], familyFriendly[yes], near[Raja Indian Cuisine]	The Vaults is a high priced French restaurant in riverside near Raja Indian Cuisine is a children friendly.
name[The Vaults], eatType[restaurant], food[French], priceRange[less than £20], area[city centre], familyFriendly[no], near[Raja Indian Cuisine]	The Vaults is a French restaurant with a price range of less than £20 is near Raja Indian Cuisine in the city centre it is not family friendly.
name[The Vaults], eatType[restaurant], food[French], priceRange[less than £20], area[city centre], familyFriendly[yes], near[Raja Indian Cuisine]	The Vaults is a low priced French restaurant near Raja Indian Cuisine in the city centre it is family friendly.
name[The Vaults], eatType[restaurant], food[French], priceRange[less than £20], area[riverside], familyFriendly[no], near[Raja Indian Cuisine]	The Vaults is a French restaurant with a price range of less than £20 it is located in the riverside near Raja Indian Cuisine it is not family friendly.
name[The Vaults], eatType[restaurant], food[French], priceRange[less than £20], area[riverside], familyFriendly[yes], near[Raja Indian Cuisine]	The Vaults is a low priced French restaurant near Raja Indian Cuisine in riverside is family friendly.
name[The Vaults], eatType[restaurant], food[French], priceRange[moderate], area[city centre], familyFriendly[no], near[Raja Indian Cuisine]	The Vaults is a moderately priced French restaurant near Raja Indian Cuisine in the city centre it is not kid friendly.
name[The Vaults], eatType[restaurant], food[French], priceRange[moderate], area[city centre], familyFriendly[yes], near[Raja Indian Cuisine]	The Vaults is a moderately priced French restaurant near Raja Indian Cuisine in the city centre it is kid friendly.
name[The Vaults], eatType[restaurant], food[French], priceRange[moderate], area[riverside], familyFriendly[no], near[Raja Indian Cuisine]	The Vaults is a moderately priced French restaurant near Raja Indian Cuisine in riverside it is not kid friendly.
name[The Vaults], eatType[restaurant], food[French], priceRange[moderate], area[riverside], familyFriendly[yes], near[Raja Indian Cuisine]	The Vaults is a moderately priced French restaurant near Raja Indian Cuisine in riverside is kid friendly.
name[The Vaults], eatType[restaurant], food[French], priceRange[more than £30], area[city centre], familyFriendly[no], near[Raja Indian Cuisine]	The Vaults is a French restaurant with a price range it is located in the city centre near Raja Indian Cuisine it is not children friendly.
name[The Vaults], eatType[restaurant], food[French], priceRange[more than £30], area[city centre], familyFriendly[yes], near[Raja Indian Cuisine]	The Vaults is a high priced French restaurant near Raja Indian Cuisine in the city centre it is children friendly.
name[The Vaults], eatType[restaurant], food[French], priceRange[more than £30], area[riverside], familyFriendly[no], near[Raja Indian Cuisine]	The Vaults is a French restaurant in the riverside near Raja Indian Cuisine it has a price range and is not children friendly.
name[The Vaults], eatType[restaurant], food[French], priceRange[more than £30], area[riverside], familyFriendly[yes], near[Raja Indian Cuisine]	The Vaults is a high priced French restaurant in riverside near Raja Indian Cuisine it is family friendly.
name[The Vaults], eatType[restaurant], food[Indian], priceRange[£20-25], area[riverside], familyFriendly[yes], near[Raja Indian Cuisine]	The Vaults is a restaurant with a price range of £20-25 is near Raja Indian Cuisine in riverside is kid friendly.
name[The Vaults], eatType[restaurant], food[Indian], priceRange[cheap], area[riverside], familyFriendly[yes], near[Raja Indian Cuisine]	The Vaults is a cheap family friendly Indian restaurant in riverside near Raja Indian Cuisine.
name[The Vaults], eatType[restaurant], food[Indian], priceRange[high], area[city centre], familyFriendly[no], near[Raja Indian Cuisine]	The Vaults is an Indian restaurant with a high price range it is located in the city centre near Raja Indian Cuisine it is not children friendly.
name[The Vaults], eatType[restaurant], food[Indian], priceRange[high], area[city centre], familyFriendly[yes], near[Raja Indian Cuisine]	The Vaults is a Indian food in the high price range it is children friendly restaurant located in the city centre near Raja Indian Cuisine.
name[The Waterman], eatType[pub], food[Indian], priceRange[high], area[city centre], familyFriendly[yes], near[Raja Indian Cuisine]	The Waterman is a high priced Indian pub located in the city centre near Raja Indian Cuisine it is kid friendly.
name[The Waterman], eatType[pub], food[Indian], priceRange[high], area[riverside], familyFriendly[no], near[Raja Indian Cuisine]	The Waterman is an Indian pub with a high price range it is located in the riverside near Raja Indian Cuisine it is not children friendly.
name[The Waterman], eatType[pub], food[Indian], priceRange[high], area[riverside], familyFriendly[yes], near[Raja Indian Cuisine]	The Waterman is a high priced Indian pub located in riverside near Raja Indian Cuisine it is kid friendly.
name[The Waterman], eatType[pub], food[Indian], priceRange[less than £20], area[city centre], familyFriendly[no], near[Raja Indian Cuisine]	The Waterman is a pub with a price range of less than £20 it is located in the city centre near Raja Indian Cuisine it is not family friendly.
name[The Waterman], eatType[pub], food[Indian], priceRange[less than £20], area[city centre], familyFriendly[yes], near[Raja Indian Cuisine]	The Waterman is a low priced Indian pub located in the city centre near Raja Indian Cuisine it is family friendly.
name[The Waterman], eatType[pub], food[Indian], priceRange[less than £20], area[riverside], familyFriendly[no], near[Raja Indian Cuisine]	The Waterman is a pub with a price range of less than £20 it is located in the riverside near Raja Indian Cuisine it is not family friendly.
name[The Waterman], eatType[pub], food[Indian], priceRange[less than £20], area[riverside], familyFriendly[yes], near[Raja Indian Cuisine]	The Waterman is a low priced Indian pub located in riverside near Raja Indian Cuisine it is family friendly.
name[The Waterman], eatType[pub], food[Indian], priceRange[moderate], area[city centre], familyFriendly[no], near[Raja Indian Cuisine]	The Waterman is a moderately priced Indian pub located in the city centre near Raja Indian Cuisine it is not kid friendly and.
name[The Waterman], eatType[pub], food[Indian], priceRange[moderate], area[city centre], familyFriendly[yes], near[Raja Indian Cuisine]	The Waterman is a moderately priced Indian pub located in the city centre near Raja Indian Cuisine it is kid friendly.
name[The Waterman], eatType[pub], food[Indian], priceRange[moderate], area[riverside], familyFriendly[no], near[Raja Indian Cuisine]	The Waterman is a moderately priced Indian pub located in the riverside near Raja Indian Cuisine it is not kid friendly and.
name[The Waterman], eatType[pub], food[Indian], priceRange[moderate], area[riverside], familyFriendly[yes], near[Raja Indian Cuisine]	The Waterman is a moderately priced pub serving Indian food in riverside near Raja Indian Cuisine it is kid friendly.
name[The Waterman], eatType[pub], food[Indian], priceRange[more than £30], area[riverside], familyFriendly[yes], near[Raja Indian Cuisine]	The Waterman is a high priced Indian pub located in riverside near Raja Indian Cuisine it is kid friendly.
name[The Waterman], eatType[pub], food[Italian], priceRange[£20-25], area[riverside], familyFriendly[yes], near[Raja Indian Cuisine]	The Waterman is a low priced pub near Raja Indian Cuisine in riverside is a family friendly Italian food.
name[The Waterman], eatType[pub], food[Italian], priceRange[cheap], area[riverside], familyFriendly[yes], near[Raja Indian Cuisine]	The Waterman is a cheap family friendly Italian pub located in the riverside near Raja Indian Cuisine.
name[The Waterman], eatType[pub], food[Italian], priceRange[high], area[city centre], familyFriendly[no], near[Raja Indian Cuisine]	The Waterman is a high priced Italian pub located in the city centre near Raja Indian Cuisine it is not children friendly.
name[The Waterman], eatType[pub], food[Italian], priceRange[high], area[city centre], familyFriendly[yes], near[Raja Indian Cuisine]	The Waterman is a high priced Italian pub located in the city centre near Raja Indian Cuisine it is kid friendly.
name[The Waterman], eatType[pub], food[Italian], priceRange[high], area[riverside], familyFriendly[no], near[Raja Indian Cuisine]	The Waterman is a high priced Italian pub located in riverside near Raja Indian Cuisine it is not children friendly.
name[The Waterman], eatType[pub], food[Italian], priceRange[high], area[riverside], familyFriendly[yes], near[Raja Indian Cuisine]	The Waterman is a high priced Italian pub located in riverside near Raja Indian Cuisine it is kid friendly.
name[The Waterman], eatType[pub], food[Italian], priceRange[less than £20], area[city centre], familyFriendly[no], near[Raja Indian Cuisine]	The Waterman is a low priced Italian pub located in the city centre near Raja Indian Cuisine it is not family friendly.
name[The Waterman], eatType[pub], food[Italian], priceRange[less than £20], area[city centre], familyFriendly[yes], near[Raja Indian Cuisine]	The Waterman is a low priced Italian pub located in the city centre near Raja Indian Cuisine it is family friendly.
name[The Waterman], eatType[pub], food[Italian], priceRange[less than £20], area[riverside], familyFriendly[no], near[Raja Indian Cuisine]	The Waterman is a low priced Italian pub located in riverside near Raja Indian Cuisine it is not family friendly.
name[The Waterman], eatType[restaurant], food[Indian], priceRange[high], area[city centre], familyFriendly[yes], near[Raja Indian Cuisine]	The Waterman is a Indian food in the high price range it is children friendly restaurant located in the city centre near Raja Indian Cuisine.
name[The Waterman], eatType[restaurant], food[Indian], priceRange[high], area[riverside], familyFriendly[no], near[Raja Indian Cuisine]	The Waterman is an Indian restaurant in riverside near Raja Indian Cuisine it has a high price range and is not children friendly.
name[The Waterman], eatType[restaurant], food[Indian], priceRange[high], area[riverside], familyFriendly[yes], near[Raja Indian Cuisine]	The Waterman serves Indian food in the high price range it is located in the riverside near Raja Indian Cuisine is a family friendly restaurant.
name[The Waterman], eatType[restaurant], food[Indian], priceRange[less than £20], area[city centre], familyFriendly[no], near[Raja Indian Cuisine]	The Waterman is a restaurant with a price range of less than £20 it is located in the city centre near Raja Indian Cuisine it is not family friendly.
name[The Waterman], eatType[restaurant], food[Indian], priceRange[less than £20], area[city centre], familyFriendly[yes], near[Raja Indian Cuisine]	The Waterman is a restaurant with a price range of less than £20 it is located in the city centre near Raja Indian Cuisine it is family friendly.
name[The Waterman], eatType[restaurant], food[Indian], priceRange[less than £20], area[riverside], familyFriendly[no], near[Raja Indian Cuisine]	The Waterman is a restaurant with a low price range it is located in the riverside near Raja Indian Cuisine is not family friendly.
name[The Waterman], eatType[restaurant], food[Indian], priceRange[less than £20], area[riverside], familyFriendly[yes], near[Raja Indian Cuisine]	The Waterman is a restaurant with a low price range it is located in the riverside near Raja Indian Cuisine is family friendly.
name[The Waterman], eatType[restaurant], food[Indian], priceRange[moderate], area[city centre], familyFriendly[no], near[Raja Indian Cuisine]	The Waterman is a moderately priced Indian restaurant located in the city centre near Raja Indian Cuisine it is not kid friendly.
name[The Waterman], eatType[restaurant], food[Indian], priceRange[moderate], area[city centre], familyFriendly[yes], near[Raja Indian Cuisine]	The Waterman is a moderately priced Indian restaurant in the city centre near Raja Indian Cuisine it is kid friendly.
name[The Waterman], eatType[restaurant], food[Indian], priceRange[moderate], area[riverside], familyFriendly[no], near[Raja Indian Cuisine]	The Waterman is a moderately priced Indian restaurant located in riverside near Raja Indian Cuisine it is not kid friendly and.
name[The Waterman], eatType[restaurant], food[Indian], priceRange[moderate], area[riverside], familyFriendly[yes], near[Raja Indian Cuisine]	The Waterman is a moderately priced Indian restaurant in riverside near Raja Indian Cuisine is kid friendly.
name[The Waterman], eatType[restaurant], food[Indian], priceRange[more than £30], area[riverside], familyFriendly[yes], near[Raja Indian Cuisine]	The Waterman is a restaurant in the riverside near Raja Indian Cuisine is children friendly.
name[The Waterman], eatType[restaurant], food[Italian], priceRange[£20-25], area[riverside], familyFriendly[yes], near[Raja Indian Cuisine]	The Waterman is an Italian restaurant in the riverside near Raja Indian Cuisine it has a price range of £20-25 and is kid friendly.
name[The Waterman], eatType[restaurant], food[Italian], priceRange[cheap], area[riverside], familyFriendly[yes], near[Raja Indian Cuisine]	The Waterman is a cheap family friendly Italian restaurant in riverside near Raja Indian Cuisine.
name[The Waterman], eatType[restaurant], food[Italian], priceRange[high], area[city centre], familyFriendly[no], near[Raja Indian Cuisine]	The Waterman is an Italian restaurant in the city centre near Raja Indian Cuisine it has a high price range and is not children friendly.
name[The Waterman], eatType[restaurant], food[Italian], priceRange[high], area[city centre], familyFriendly[yes], near[Raja Indian Cuisine]	The Waterman is a high priced Italian restaurant in the city centre near Raja Indian Cuisine it is children friendly.
name[The Waterman], eatType[restaurant], food[Italian], priceRange[high], area[riverside], familyFriendly[no], near[Raja Indian Cuisine]	The Waterman is an Italian restaurant in the riverside near Raja Indian Cuisine it has a high price range and is not children friendly.
name[The Waterman], eatType[restaurant], food[Italian], priceRange[high], area[riverside], familyFriendly[yes], near[Raja Indian Cuisine]	The Waterman is a high priced Italian restaurant in riverside near Raja Indian Cuisine is children friendly.
name[The Waterman], eatType[restaurant], food[Italian], priceRange[less than £20], area[city centre], familyFriendly[no], near[Raja Indian Cuisine]	The Waterman is a Italian restaurant in the city centre near Raja Indian Cuisine it has a price range of less than £20 it is not family friendly.
name[The Waterman], eatType[restaurant], food[Italian], priceRange[less than £20], area[city centre], familyFriendly[yes], near[Raja Indian Cuisine]	The Waterman is a low priced Italian restaurant in the city centre near Raja Indian Cuisine it is family friendly.
name[The Waterman], eatType[restaurant], food[Italian], priceRange[less than £20], area[riverside], familyFriendly[no], near[Raja Indian Cuisine]	The Waterman is a Italian restaurant in the riverside near Raja Indian Cuisine it has a price range of less than £20 it is not family friendly.
name[The Wrestlers], eatType[pub], food[Italian], priceRange[less than £20], area[riverside], familyFriendly[no], near[Raja Indian Cuisine]	The Wrestlers is a low priced Italian pub located in riverside near Raja Indian Cuisine it is not family friendly.
name[The Wrestlers], eatType[pub], food[Italian], priceRange[less than £20], area[riverside], familyFriendly[yes], near[Raja Indian Cuisine]	The Wrestlers is a low priced Italian pub located in riverside near Raja Indian Cuisine it is family friendly.
name[The Wrestlers], eatType[pub], food[Italian], priceRange[moderate], area[city centre], familyFriendly[no], near[Raja Indian Cuisine]	The Wrestlers is a moderately priced Italian pub located in the city centre near Raja Indian Cuisine it is not kid friendly.
name[The Wrestlers], eatType[pub], food[Italian], priceRange[moderate], area[city centre], familyFriendly[yes], near[Raja Indian Cuisine]	The Wrestlers is a moderately priced Italian pub located in the city centre near Raja Indian Cuisine it is kid friendly.
name[The Wrestlers], eatType[pub], food[Italian], priceRange[moderate], area[riverside], familyFriendly[no], near[Raja Indian Cuisine]	The Wrestlers is a moderately priced Italian pub located in the riverside near Raja Indian Cuisine it is not kid friendly and.
name[The Wrestlers], eatType[pub], food[Italian], priceRange[moderate], area[riverside], familyFriendly[yes], near[Raja Indian Cuisine]	The Wrestlers is a moderately priced Italian pub located in the riverside near Raja Indian Cuisine it is kid friendly.
name[The Wrestlers], eatType[pub], food[Italian], priceRange[more than £30], area[riverside], familyFriendly[yes], near[Raja Indian Cuisine]	The Wrestlers is a low priced children friendly Italian pub located in the riverside near Raja Indian Cuisine.
name[The Wrestlers], eatType[pub], food[Japanese], priceRange[£20-25], area[riverside], familyFriendly[yes], near[Raja Indian Cuisine]	The Wrestlers is a low priced pub near Raja Indian Cuisine in riverside is a family friendly Japanese food.
name[The Wrestlers], eatType[pub], food[Japanese], priceRange[cheap], area[riverside], familyFriendly[yes], near[Raja Indian Cuisine]	The Wrestlers is a cheap family friendly Japanese pub in riverside near Raja Indian Cuisine.
name[The Wrestlers], eatType[pub], food[Japanese], priceRange[high], area[riverside], familyFriendly[yes], near[Raja Indian Cuisine]	The Wrestlers is a high priced Japanese pub located in riverside near Raja Indian Cuisine it is kid friendly.
name[The Wrestlers], eatType[pub], food[Japanese], priceRange[less than £20], area[city centre], familyFriendly[no], near[Raja Indian Cuisine]	The Wrestlers is a Japanese pub in the city centre near Raja Indian Cuisine it has a price range of less than £20 it is not family friendly.
name[The Wrestlers], eatType[pub], food[Japanese], priceRange[less than £20], area[city centre], familyFriendly[yes], near[Raja Indian Cuisine]	The Wrestlers is a low priced Japanese pub located in the city centre near Raja Indian Cuisine it is family friendly.
name[The Wrestlers], eatType[pub], food[Japanese], priceRange[less than £20], area[riverside], familyFriendly[no], near[Raja Indian Cuisine]	The Wrestlers is a Japanese pub in the riverside near Raja Indian Cuisine it has a price range of less than £20 it is not family friendly.
name[The Wrestlers], eatType[pub], food[Japanese], priceRange[less than £20], area[riverside], familyFriendly[yes], near[Raja Indian Cuisine]	The Wrestlers is a low priced Japanese pub located in riverside near Raja Indian Cuisine it is family friendly.
name[The Wrestlers], eatType[pub], food[Japanese], priceRange[moderate], area[city centre], familyFriendly[no], near[Raja Indian Cuisine]	The Wrestlers is a moderately priced Japanese pub located in the city centre near Raja Indian Cuisine it is not kid friendly.
name[The Wrestlers], eatType[pub], food[Japanese], priceRange[moderate], area[city centre], familyFriendly[yes], near[Raja Indian Cuisine]	The Wrestlers is a moderately priced Japanese pub near Raja Indian Cuisine in the city centre it is kid friendly.
name[The Wrestlers], eatType[pub], food[Japanese], priceRange[moderate], area[riverside], familyFriendly[no], near[Raja Indian Cuisine]	The Wrestlers is a moderately priced Japanese pub located in riverside near Raja Indian Cuisine it is not kid friendly.
name[The Wrestlers], eatType[pub], food[Japanese], priceRange[moderate], area[riverside], familyFriendly[yes], near[Raja Indian Cuisine]	The Wrestlers is a moderately priced Japanese pub located in riverside near Raja Indian Cuisine it is kid friendly.
name[The Wrestlers], eatType[pub], food[Japanese], priceRange[moderate], customer rating[1 out of 5], area[city centre], familyFriendly[yes], near[Raja Indian Cuisine]	The Wrestlers is a moderately priced Japanese pub located in the city centre near Raja Indian Cuisine it is kid friendly with a customer rating of 1 out of 5.
name[The Wrestlers], eatType[pub], food[Japanese], priceRange[moderate], customer rating[1 out of 5], area[riverside], familyFriendly[no], near[Raja Indian Cuisine]	The Wrestlers is a moderately priced Japanese pub in riverside near Raja Indian Cuisine it has a customer rating of 1 out of 5 and is not kid friendly.
name[The Wrestlers], eatType[pub], food[Japanese], priceRange[moderate], customer rating[1 out of 5], area[riverside], familyFriendly[yes], near[Raja Indian Cuisine]	The Wrestlers is a moderately priced Japanese pub located in the riverside near Raja Indian Cuisine has a customer rating of 1 out of 5 kid friendly.
name[The Wrestlers], eatType[pub], food[Japanese], priceRange[more than £30], area[city centre], familyFriendly[no], near[Raja Indian Cuisine]	The Wrestlers is a Japanese pub in the city centre near Raja Indian Cuisine it has a price range it is not children friendly.
name[The Wrestlers], eatType[pub], food[Japanese], priceRange[more than £30], area[city centre], familyFriendly[yes], near[Raja Indian Cuisine]	The Wrestlers is a low priced children friendly Japanese pub located in the city centre near Raja Indian Cuisine.
name[The Wrestlers], eatType[pub], food[Japanese], priceRange[more than £30], area[riverside], familyFriendly[no], near[Raja Indian Cuisine]	The Wrestlers is a Japanese pub in riverside near Raja Indian Cuisine it has a price range it is not children friendly.
name[The Wrestlers], eatType[pub], food[Japanese], priceRange[more than £30], area[riverside], familyFriendly[yes], near[Raja Indian Cuisine]	The Wrestlers is a low priced children friendly Japanese pub located in the riverside near Raja Indian Cuisine.
name[The Wrestlers], eatType[pub], food[Japanese], priceRange[more than £30], customer rating[5 out of 5], area[city centre], familyFriendly[no], near[Raja Indian Cuisine]	The Wrestlers is a Japanese pub located in the city centre near Raja Indian Cuisine it has a price range of more than £30, has a customer rating 5 out of 5 and is not family friendly.
name[The Wrestlers], eatType[pub], food[Japanese], priceRange[more than £30], customer rating[5 out of 5], area[city centre], familyFriendly[yes], near[Raja Indian Cuisine]	The Wrestlers is a low priced children friendly Japanese pub located in the city centre near Raja Indian Cuisine it has a customer rating of 5 out of 5.
name[The Wrestlers], eatType[pub], food[Japanese], priceRange[more than £30], customer rating[5 out of 5], area[riverside], familyFriendly[no], near[Raja Indian Cuisine]	The Wrestlers is a Japanese pub in riverside near Raja Indian Cuisine it has a price range of more than £30, has a customer rating 5 out of 5 and is not family friendly.
name[The Wrestlers], eatType[pub], food[Japanese], priceRange[more than £30], customer rating[5 out of 5], area[riverside], familyFriendly[yes], near[Raja Indian Cuisine]	The Wrestlers is a low priced family friendly pub serving Japanese food in the riverside near Raja Indian Cuisine and has a customer rating of 5 out of 5.
name[The Wrestlers], eatType[pub], food[Japanese], priceRange[more than £30], customer rating[low], area[city centre], familyFriendly[no], near[Raja Indian Cuisine]	The Wrestlers is a Japanese pub in the city centre near Raja Indian Cuisine it has a price range of more than £30 and a low customer rating it is not children friendly.
name[The Wrestlers], eatType[pub], food[Japanese], priceRange[more than £30], customer rating[low], area[city centre], familyFriendly[yes], near[Raja Indian Cuisine]	The Wrestlers is a Japanese pub in the city centre near Raja Indian Cuisine it has a price range of more than £30, has a low customer rating it is children friendly and.
name[The Wrestlers], eatType[pub], food[Japanese], priceRange[more than £30], customer rating[low], area[riverside], familyFriendly[no], near[Raja Indian Cuisine]	The Wrestlers is a Japanese pub in the riverside near Raja Indian Cuisine it has a price range of more than £30 and a low customer rating it is not children friendly.
name[The Wrestlers], eatType[pub], food[Japanese], priceRange[more than £30], customer rating[low], area[riverside], familyFriendly[yes], near[Raja Indian Cuisine]	The Wrestlers is a Japanese pub in the riverside near Raja Indian Cuisine it has a price range of more than £30, has a low customer rating it is children friendly and.
name[The Wrestlers], eatType[restaurant], food[Italian], priceRange[less than £20], area[riverside], familyFriendly[no], near[Raja Indian Cuisine]	The Wrestlers is a Italian restaurant in the riverside near Raja Indian Cuisine it has a price range of less than £20 it is not family friendly.
name[The Wrestlers], eatType[restaurant], food[Italian], priceRange[less than £20], area[riverside], familyFriendly[yes], near[Raja Indian Cuisine]	The Wrestlers is a low priced Italian restaurant in riverside near Raja Indian Cuisine is family friendly.
name[The Wrestlers], eatType[restaurant], food[Italian], priceRange[moderate], area[city centre], familyFriendly[no], near[Raja Indian Cuisine]	The Wrestlers is a moderately priced Italian restaurant located in the city centre near Raja Indian Cuisine it is not kid friendly.
name[The Wrestlers], eatType[restaurant], food[Italian], priceRange[moderate], area[city centre], familyFriendly[yes], near[Raja Indian Cuisine]	The Wrestlers is a moderately priced Italian restaurant in the city centre near Raja Indian Cuisine it is kid friendly.
name[The Wrestlers], eatType[restaurant], food[Italian], priceRange[moderate], area[riverside], familyFriendly[no], near[Raja Indian Cuisine]	The Wrestlers is a moderately priced Italian restaurant located in riverside near Raja Indian Cuisine it is not kid friendly.
name[The Wrestlers], eatType[restaurant], food[Italian], priceRange[moderate], area[riverside], familyFriendly[yes], near[Raja Indian Cuisine]	The Wrestlers is a moderately priced Italian restaurant in riverside near Raja Indian Cuisine it is kid friendly.
name[The Wrestlers], eatType[restaurant], food[Italian], priceRange[more than £30], area[riverside], familyFriendly[yes], near[Raja Indian Cuisine]	The Wrestlers is a high priced Italian restaurant located in riverside near Raja Indian Cuisine it is kid friendly.
name[The Wrestlers], eatType[restaurant], food[Japanese], priceRange[£20-25], area[riverside], familyFriendly[yes], near[Raja Indian Cuisine]	The Wrestlers is a Japanese restaurant in riverside near Raja Indian Cuisine the price range is £20-25 and is kid friendly.
name[The Wrestlers], eatType[restaurant], food[Japanese], priceRange[cheap], area[riverside], familyFriendly[yes], near[Raja Indian Cuisine]	The Wrestlers is a cheap family friendly Japanese restaurant in riverside near Raja Indian Cuisine.
name[The Wrestlers], eatType[restaurant], food[Japanese], priceRange[high], area[riverside], familyFriendly[yes], near[Raja Indian Cuisine]	The Wrestlers is a Japanese restaurant with a high price range it is located in riverside near Raja Indian Cuisine is a family friendly.
name[The Wrestlers], eatType[restaurant], food[Japanese], priceRange[less than £20], area[city centre], familyFriendly[no], near[Raja Indian Cuisine]	The Wrestlers is a Japanese restaurant in the city centre near Raja Indian Cuisine it has a price range of less than £20 it is not family friendly.
name[The Wrestlers], eatType[restaurant], food[Japanese], priceRange[less than £20], area[city centre], familyFriendly[yes], near[Raja Indian Cuisine]	The Wrestlers is a Japanese restaurant is family friendly the price range is less than £20 located near Raja Indian Cuisine in the city centre.
name[The Wrestlers], eatType[restaurant], food[Japanese], priceRange[less than £20], area[riverside], familyFriendly[no], near[Raja Indian Cuisine]	The Wrestlers is a Japanese restaurant in riverside near Raja Indian Cuisine the price range is less than £20 it is not family friendly.
name[The Wrestlers], eatType[restaurant], food[Japanese], priceRange[less than £20], area[riverside], familyFriendly[yes], near[Raja Indian Cuisine]	The Wrestlers is a Japanese restaurant is family friendly the price range is less than £20 located near Raja Indian Cuisine in riverside.
name[The Wrestlers], eatType[restaurant], food[Japanese], priceRange[moderate], area[city centre], familyFriendly[no], near[Raja Indian Cuisine]	The Wrestlers is a moderately priced Japanese restaurant near Raja Indian Cuisine in the city centre it is not kid friendly.
name[The Wrestlers], eatType[restaurant], food[Japanese], priceRange[moderate], area[city centre], familyFriendly[yes], near[Raja Indian Cuisine]	The Wrestlers is a moderately priced Japanese restaurant near Raja Indian Cuisine in the city centre it is kid friendly.
name[The Wrestlers], eatType[restaurant], food[Japanese], priceRange[moderate], area[riverside], familyFriendly[no], near[Raja Indian Cuisine]	The Wrestlers is a moderately priced Japanese restaurant near Raja Indian Cuisine in riverside it is not kid friendly.
name[The Wrestlers], eatType[restaurant], food[Japanese], priceRange[moderate], area[riverside], familyFriendly[yes], near[Raja Indian Cuisine]	The Wrestlers is a moderately priced Japanese restaurant near Raja Indian Cuisine in riverside is kid friendly.
name[The Wrestlers], eatType[restaurant], food[Japanese], priceRange[more than £30], area[city centre], familyFriendly[no], near[Raja Indian Cuisine]	The Wrestlers is a Japanese restaurant in the city centre near Raja Indian Cuisine it has a price range and is not children friendly.
name[The Wrestlers], eatType[restaurant], food[Japanese], priceRange[more than £30], area[city centre], familyFriendly[yes], near[Raja Indian Cuisine]	The Wrestlers is a Japanese restaurant with a price range it is children friendly and near Raja Indian Cuisine in the city centre.
name[The Wrestlers], eatType[restaurant], food[Japanese], priceRange[more than £30], area[riverside], familyFriendly[no], near[Raja Indian Cuisine]	The Wrestlers is a Japanese restaurant in riverside near Raja Indian Cuisine the price range is more than £30 it is not children friendly.
name[The Wrestlers], eatType[restaurant], food[Japanese], priceRange[more than £30], area[riverside], familyFriendly[yes], near[Raja Indian Cuisine]	The Wrestlers is a Japanese restaurant in riverside near Raja Indian Cuisine the price range is more than £30 it is children friendly.
name[Wildwood], eatType[coffee shop], area[riverside]	Wildwood is a coffee shop located in the riverside area.
name[Wildwood], eatType[pub], area[riverside]	Wildwood pub located in the riverside area.
name[Wildwood], eatType[pub], food[French], area[riverside], familyFriendly[yes], near[Raja Indian Cuisine]	Wildwood is a family friendly pub serving French food located in the riverside near Raja Indian Cuisine.
name[Wildwood], eatType[pub], food[Indian], area[city centre], familyFriendly[no], near[Raja Indian Cuisine]	Wildwood is an Indian pub located in the city centre near Raja Indian Cuisine it is not family friendly.
name[Wildwood], eatType[pub], food[Indian], area[city centre], familyFriendly[yes], near[Raja Indian Cuisine]	Wildwood is a Indian pub located in the city centre near Raja Indian Cuisine it is family friendly.
name[Wildwood], eatType[pub], food[Indian], area[riverside], familyFriendly[no], near[Raja Indian Cuisine]	Wildwood is an Indian pub located in the riverside near Raja Indian Cuisine it is not family friendly.
name[Wildwood], eatType[pub], food[Indian], area[riverside], familyFriendly[yes], near[Raja Indian Cuisine]	Wildwood is a pub in riverside near Raja Indian Cuisine it is family friendly.
name[Wildwood], eatType[pub], food[Italian], area[city centre], familyFriendly[no], near[Raja Indian Cuisine]	Wildwood is an Italian pub located in the city centre near Raja Indian Cuisine it is not family friendly.
name[Wildwood], eatType[pub], food[Italian], area[city centre], familyFriendly[yes], near[Raja Indian Cuisine]	Wildwood is a family friendly pub serving Italian located in the city centre near Raja Indian Cuisine.
name[Wildwood], eatType[pub], food[Italian], area[riverside], familyFriendly[no], near[Raja Indian Cuisine]	Wildwood is an Italian pub located in the riverside near Raja Indian Cuisine it is not family friendly.
name[Wildwood], eatType[pub], food[Italian], area[riverside], familyFriendly[yes], near[Raja Indian Cuisine]	Wildwood is a family friendly pub Italian located in the riverside near Raja Indian Cuisine.
name[Wildwood], eatType[restaurant], food[French], area[riverside], familyFriendly[yes], near[Raja Indian Cuisine]	Wildwood is a French restaurant in riverside near Raja Indian Cuisine it is family friendly.
name[Wildwood], eatType[restaurant], food[Indian], area[city centre], familyFriendly[no], near[Raja Indian Cuisine]	Wildwood is a Indian restaurant located in the city centre near Raja Indian Cuisine it is not family friendly.
name[Wildwood], eatType[restaurant], food[Indian], area[city centre], familyFriendly[yes], near[Raja Indian Cuisine]	Wildwood is a restaurant in the city centre near Raja Indian Cuisine it is family friendly.
name[Wildwood], eatType[restaurant], food[Indian], area[riverside], familyFriendly[no], near[Raja Indian Cuisine]	Wildwood is an Indian restaurant located in riverside near Raja Indian Cuisine it is not family friendly.
name[Wildwood], eatType[restaurant], food[Indian], area[riverside], familyFriendly[yes], near[Raja Indian Cuisine]	Wildwood is a restaurant in riverside near Raja Indian Cuisine is family friendly.
name[Wildwood], eatType[restaurant], food[Italian], area[city centre], familyFriendly[no], near[Raja Indian Cuisine]	Wildwood is an Italian restaurant located in the city centre near Raja Indian Cuisine it is not family friendly.
name[Wildwood], eatType[restaurant], food[Italian], area[city centre], familyFriendly[yes], near[Raja Indian Cuisine]	Wildwood is an Italian restaurant in the city centre near Raja Indian Cuisine it is family friendly.
name[Wildwood], eatType[restaurant], food[Italian], area[riverside], familyFriendly[no], near[Raja Indian Cuisine]	Wildwood is an Italian restaurant located in riverside near Raja Indian Cuisine it is not family friendly.
name[Wildwood], eatType[restaurant], food[Italian], area[riverside], familyFriendly[yes], near[Raja Indian Cuisine]	Wildwood is an Italian restaurant in riverside near Raja Indian Cuisine is a family friendly.
name[Zizzi], eatType[coffee shop], area[riverside]	Zizzi is a coffee shop located in the riverside area.
name[Zizzi], eatType[coffee shop], customer rating[average], near[Burger King]	Zizzi is an average rated coffee shop near Burger King.
name[Zizzi], eatType[coffee shop], customer rating[high], near[Burger King]	Zizzi is a high rated coffee shop near Burger King.
name[Zizzi], eatType[coffee shop], near[The Sorrento]	Zizzi near The Sorrento is a coffee shop.
name[Zizzi], eatType[pub], area[riverside]	Zizzi pub located in the riverside area.
name[Zizzi], eatType[pub], customer rating[average], near[Burger King]	Zizzi pub near Burger King has an average customer rating.
name[Zizzi], eatType[pub], customer rating[high], near[Burger King]	Zizzi pub near Burger King has a high customer rating.
name[Zizzi], eatType[pub], near[The Sorrento]	Zizzi pub near The Sorrento.