MR	output
"name[Blue Spice], eatType[coffee shop], area[city centre]"	"Located in the city centre, Blue Spice is a coffee shop with a moderate price range."
"name[Blue Spice], eatType[coffee shop], area[riverside]"	"By the riverside, there is a coffee shop called Blue Spice."
"name[Blue Spice], eatType[coffee shop], customer rating[5 out of 5], near[Crowne Plaza Hotel]"	"Located near Crowne Plaza Hotel, Blue Spice is a coffee shop with a 5 out of 5 customer rating."
"name[Blue Spice], eatType[coffee shop], customer rating[average], near[Burger King]"	"Located near Burger King, Blue Spice is a coffee shop with an average customer rating."
"name[Blue Spice], eatType[coffee shop], customer rating[average], near[Crowne Plaza Hotel]"	"Located near Crowne Plaza Hotel, Blue Spice is a coffee shop with an average customer rating."
"name[Blue Spice], eatType[pub], area[city centre]"	"In the city centre, there is a pub called Blue Spice."
"name[Blue Spice], eatType[pub], area[riverside]"	"By the riverside, there is a pub called Blue Spice."
"name[Blue Spice], eatType[pub], customer rating[5 out of 5], near[Crowne Plaza Hotel]"	"Near Crowne Plaza Hotel, Blue Spice is a pub with a customer rating of 5 out of 5."
"name[Blue Spice], eatType[pub], customer rating[average], near[Burger King]"	"Located near Burger King, Blue Spice is a pub with an average customer rating."
"name[Blue Spice], eatType[pub], customer rating[average], near[Crowne Plaza Hotel]"	"Located near Crowne Plaza Hotel, Blue Spice is a pub with an average customer rating."
"name[Blue Spice], eatType[pub], food[Chinese], area[city centre], familyFriendly[no], near[Rainbow Vegetarian Café]"	In the city centre near Rainbow Vegetarian Café is a Chinese pub called the Blue Spice. It is not family-friendly.
"name[Blue Spice], eatType[pub], food[Chinese], area[city centre], familyFriendly[yes], near[Rainbow Vegetarian Café]"	Blue Spice is a family-friendly pub serving Chinese food in the city centre near Rainbow Vegetarian Café
"name[Blue Spice], eatType[pub], food[Chinese], area[riverside], familyFriendly[no], near[Rainbow Vegetarian Café]"	"Blue Spice is a pub that offers Chinese food, it is located in the riverside near Rainbow Vegetarian Café and is not family friendly."
"name[Blue Spice], eatType[pub], food[Chinese], area[riverside], familyFriendly[yes], near[Rainbow Vegetarian Café]"	"Blue Spice is a pub that serves Chinese food, is kid friendly, and is near Rainbow Vegetarian Café in the riverside area."
"name[Blue Spice], eatType[pub], food[English], area[city centre], familyFriendly[no], near[Rainbow Vegetarian Café]"	"Located in the city centre near the Rainbow Vegetarian Café, Blue Spice is an English pub that is not family-friendly."
"name[Blue Spice], eatType[pub], food[English], area[city centre], familyFriendly[yes], near[Rainbow Vegetarian Café]"	Blue Spice is a family-friendly pub serving English food in the city centre near Rainbow Vegetarian Café
"name[Blue Spice], eatType[pub], food[English], area[riverside], familyFriendly[no], near[Rainbow Vegetarian Café]"	Blue Spice is a pub that serves English food and is located in the riverside area near Rainbow Vegetarian Café and is not family friendly.
"name[Blue Spice], eatType[pub], food[English], area[riverside], familyFriendly[yes], near[Rainbow Vegetarian Café]"	Blue Spice is a family friendly pub located in riverside near Rainbow Vegetarian Café
"name[Blue Spice], eatType[restaurant], food[Chinese], area[city centre], familyFriendly[no], near[Rainbow Vegetarian Café]"	"In the city centre near Rainbow Vegetarian Café, there is a Chinese restaurant called Blue Spice. It is not family friendly."
"name[Blue Spice], eatType[restaurant], food[Chinese], area[city centre], familyFriendly[yes], near[Rainbow Vegetarian Café]"	"Near Rainbow Vegetarian Café in the city centre, Blue Spice is a family-friendly Chinese restaurant."
"name[Blue Spice], eatType[restaurant], food[Chinese], area[riverside], familyFriendly[no], near[Rainbow Vegetarian Café]"	"Blue Spice, located near Rainbow Vegetarian Café in riverside, is a Chinese restaurant that is not family friendly."
"name[Blue Spice], eatType[restaurant], food[Chinese], area[riverside], familyFriendly[yes], near[Rainbow Vegetarian Café]"	A family friendly Chinese restaurant in the riverside area near the Rainbow Vegetarian Café is Blue Spice.
"name[Blue Spice], eatType[restaurant], food[English], area[city centre], familyFriendly[no], near[Rainbow Vegetarian Café]"	"Located in the city centre near Rainbow Vegetarian Café, Blue Spice is an English restaurant that is not family-friendly."
"name[Blue Spice], eatType[restaurant], food[English], area[city centre], familyFriendly[yes], near[Rainbow Vegetarian Café]"	"Located in the city centre near Rainbow Vegetarian Café, Blue Spice is a family-friendly family friendly English restaurant."
"name[Blue Spice], eatType[restaurant], food[English], area[riverside], familyFriendly[no], near[Rainbow Vegetarian Café]"	"In the riverside area, near Rainbow Vegetarian Café, Blue Spice is an English restaurant that is not family friendly."
"name[Blue Spice], eatType[restaurant], food[English], area[riverside], familyFriendly[yes], near[Rainbow Vegetarian Café]"	"Blue Spice, located near Rainbow Vegetarian Café in the riverside area, is a family friendly pub that serves English food."
"name[Clowns], eatType[coffee shop], customer rating[3 out of 5], near[All Bar One]"	"Located near All Bar One, Clowns is a coffee shop with a customer rating of 3 out of 5."
"name[Clowns], eatType[coffee shop], customer rating[5 out of 5], near[Crowne Plaza Hotel]"	"Located near Crowne Plaza Hotel, Clowns is a coffee shop with a 5 out of 5 customer rating."
"name[Clowns], eatType[coffee shop], near[The Sorrento]"	Clowns is a coffee shop and is located near The Sorrento
"name[Clowns], eatType[pub], customer rating[3 out of 5], near[All Bar One]"	"With a customer rating of 3 out of 5, the Clowns pub is near the All Bar One"
"name[Clowns], eatType[pub], customer rating[5 out of 5], near[Crowne Plaza Hotel]"	"Near Crowne Plaza Hotel, Clowns is a pub with a customer rating of 5 out of 5."
"name[Clowns], eatType[pub], near[The Sorrento]"	"Near The Sorrento, there is a pub called Clowns."
"name[Cocum], eatType[coffee shop], customer rating[high], near[Burger King]"	"Near Burger King is Cocum, a highly rated coffee shop"
"name[Cocum], eatType[coffee shop], customer rating[high], near[Café Sicilia]"	"Near Café Sicilia is Cocum, a highly rated coffee shop"
"name[Cocum], eatType[coffee shop], customer rating[low], near[Café Sicilia]"	"Located near Café Sicilia, Cocum is a coffee shop with a low customer rating."
"name[Cocum], eatType[coffee shop], customer rating[low], near[Express by Holiday Inn]"	"Located near Express by Holiday Inn, Cocum is a coffee shop with a low customer rating."
"name[Cocum], eatType[coffee shop], near[The Rice Boat]"	Cocum is a coffee shop and is located near The Rice Boat
"name[Cocum], eatType[coffee shop], near[The Sorrento]"	Cocum is a coffee shop and is located near The Sorrento
"name[Cocum], eatType[pub], customer rating[high], near[Burger King]"	"Located near Burger King, Cocum is a pub with a high customer rating."
"name[Cocum], eatType[pub], customer rating[high], near[Café Sicilia]"	"Located near Café Sicilia, Cocum is a pub with a high customer rating."
"name[Cocum], eatType[pub], customer rating[low], near[Café Sicilia]"	"Located near Café Sicilia, Cocum is a pub with a low customer rating."
"name[Cocum], eatType[pub], customer rating[low], near[Express by Holiday Inn]"	"With a low customer rating, Cocum is a pub near the Express by Holiday Inn."
"name[Cocum], eatType[pub], near[The Rice Boat]"	"Near The Rice Boat, there is a pub called Cocum."
"name[Cocum], eatType[pub], near[The Sorrento]"	"Near The Sorrento, there is a pub called Cocum."
"name[Cotto], eatType[coffee shop], near[The Bakers]"	Cotto is a coffee shop and is located near The Bakers
"name[Cotto], eatType[pub], near[The Bakers]"	"Near The Bakers, there is a pub called Cotto."
"name[Giraffe], eatType[coffee shop], near[The Bakers]"	Giraffe is a coffee shop and is located near The Bakers
"name[Giraffe], eatType[coffee shop], near[The Rice Boat]"	Giraffe is a coffee shop and is located near The Rice Boat
"name[Giraffe], eatType[pub], food[English], area[riverside], familyFriendly[yes], near[Rainbow Vegetarian Café]"	Giraffe is a family friendly pub located in riverside near Rainbow Vegetarian Café
"name[Giraffe], eatType[pub], food[Fast food], area[city centre], familyFriendly[no], near[Rainbow Vegetarian Café]"	"In the city centre near Rainbow Vegetarian Café, there is a Fast food pub called Giraffe. It is not family-friendly."
"name[Giraffe], eatType[pub], food[Fast food], area[city centre], familyFriendly[yes], near[Rainbow Vegetarian Café]"	"Near Rainbow Vegetarian Café, in the city centre, Giraffe is a family-friendly pub serving Fast food."
"name[Giraffe], eatType[pub], food[Fast food], area[riverside], familyFriendly[no], near[Rainbow Vegetarian Café]"	Near the Rainbow Vegetarian Café in the riverside area is a Fast food pub called Giraffe. It is not family-friendly.
"name[Giraffe], eatType[pub], food[Fast food], area[riverside], familyFriendly[yes], near[Rainbow Vegetarian Café]"	"Giraffe is a family friendly, Fast food pub, near Rainbow Vegetarian Café, in the riverside area."
"name[Giraffe], eatType[pub], food[Fast food], area[riverside], familyFriendly[yes], near[Raja Indian Cuisine]"	"Giraffe is a family friendly, Fast food pub, near Raja Indian Cuisine, in the riverside area."
"name[Giraffe], eatType[pub], food[French], area[city centre], familyFriendly[no], near[Raja Indian Cuisine]"	In the city centre near Raja Indian Cuisine is a French pub called the Giraffe. It is not family-friendly.
"name[Giraffe], eatType[pub], food[French], area[city centre], familyFriendly[yes], near[Raja Indian Cuisine]"	Giraffe is a family-friendly pub serving French food in the city centre near Raja Indian Cuisine
"name[Giraffe], eatType[pub], food[French], area[riverside], familyFriendly[no], near[Raja Indian Cuisine]"	"Giraffe is a pub that offers French food, it is located in the riverside near Raja Indian Cuisine and is not family friendly."
"name[Giraffe], eatType[pub], food[French], area[riverside], familyFriendly[yes], near[Raja Indian Cuisine]"	"Giraffe is a pub that serves French food, is kid friendly, and is near Raja Indian Cuisine in the riverside area."
"name[Giraffe], eatType[pub], near[The Bakers]"	"Near The Bakers, there is a pub called Giraffe."
"name[Giraffe], eatType[pub], near[The Rice Boat]"	"Near The Rice Boat, there is a pub called Giraffe."
"name[Giraffe], eatType[restaurant], food[English], area[riverside], familyFriendly[yes], near[Rainbow Vegetarian Café]"	"Giraffe, located near Rainbow Vegetarian Café in the riverside area, is a family friendly pub that serves English food."
"name[Giraffe], eatType[restaurant], food[Fast food], area[city centre], familyFriendly[no], near[Rainbow Vegetarian Café]"	"Located near Rainbow Vegetarian Café in the city centre, Giraffe is a non family-friendly Fast food restaurant."
"name[Giraffe], eatType[restaurant], food[Fast food], area[city centre], familyFriendly[yes], near[Rainbow Vegetarian Café]"	"Near Rainbow Vegetarian Café in the city centre, Giraffe is a family-friendly Fast food restaurant."
"name[Giraffe], eatType[restaurant], food[Fast food], area[riverside], familyFriendly[no], near[Rainbow Vegetarian Café]"	"Giraffe, near Rainbow Vegetarian Café in the riverside area, is a Fast food restaurant that is not family-friendly."
"name[Giraffe], eatType[restaurant], food[Fast food], area[riverside], familyFriendly[yes], near[Rainbow Vegetarian Café]"	"Giraffe, located near Rainbow Vegetarian Café in the riverside area, is a family friendly Fast food restaurant."
"name[Giraffe], eatType[restaurant], food[Fast food], area[riverside], familyFriendly[yes], near[Raja Indian Cuisine]"	"Giraffe, located near Raja Indian Cuisine in the riverside area, is a family friendly Fast food restaurant."
"name[Giraffe], eatType[restaurant], food[French], area[city centre], familyFriendly[no], near[Raja Indian Cuisine]"	"In the city centre near Raja Indian Cuisine, there is a French restaurant called Giraffe. It is not family friendly."
"name[Giraffe], eatType[restaurant], food[French], area[city centre], familyFriendly[yes], near[Raja Indian Cuisine]"	"Near Raja Indian Cuisine in the city centre, Giraffe is a family-friendly French restaurant."
"name[Giraffe], eatType[restaurant], food[French], area[riverside], familyFriendly[no], near[Raja Indian Cuisine]"	"Giraffe, located near Raja Indian Cuisine in riverside, is a French restaurant that is not family friendly."
"name[Giraffe], eatType[restaurant], food[French], area[riverside], familyFriendly[yes], near[Raja Indian Cuisine]"	A family friendly French restaurant in the riverside area near the Raja Indian Cuisine is Giraffe.
"name[Green Man], eatType[coffee shop], customer rating[1 out of 5], near[All Bar One]"	"Located near All Bar One, Green Man is a coffee shop with a customer rating of 1 out of 5."
"name[Green Man], eatType[coffee shop], customer rating[3 out of 5], near[All Bar One]"	"Located near All Bar One, Green Man is a coffee shop with a customer rating of 3 out of 5."
"name[Green Man], eatType[pub], customer rating[1 out of 5], near[All Bar One]"	"Located near All Bar One, Green Man is a pub with a customer rating of 1 out of 5."
"name[Green Man], eatType[pub], customer rating[3 out of 5], near[All Bar One]"	"With a customer rating of 3 out of 5, the Green Man pub is near the All Bar One"
"name[Green Man], eatType[pub], food[Italian], area[riverside], familyFriendly[yes], near[Express by Holiday Inn]"	Near the Express by Holiday Inn in the riverside area is a family friendly pub called Green Man that serves Italian food
"name[Green Man], eatType[pub], food[Italian], area[riverside], familyFriendly[yes], near[Raja Indian Cuisine]"	Green Man is a family friendly pub located in riverside near Raja Indian Cuisine
"name[Green Man], eatType[pub], food[Japanese], area[city centre], familyFriendly[no], near[Express by Holiday Inn]"	"The Japanese pub, Green Man, is located in the city centre near Express by Holiday Inn and is not family-friendly."
"name[Green Man], eatType[pub], food[Japanese], area[city centre], familyFriendly[yes], near[Express by Holiday Inn]"	"Located in the city centre near the Express by Holiday Inn, Green Man is a family-friendly Japanese pub."
"name[Green Man], eatType[pub], food[Japanese], area[riverside], familyFriendly[no], near[Express by Holiday Inn]"	"Green Man is a pub in the riverside area, near the Express by Holiday Inn. It serves Japanese food, but is not family friendly."
"name[Green Man], eatType[pub], food[Japanese], area[riverside], familyFriendly[yes], near[Express by Holiday Inn]"	A family friendly Japanese pub in the riverside area near the Express by Holiday Inn is Green Man.
"name[Green Man], eatType[restaurant], food[Italian], area[riverside], familyFriendly[yes], near[Express by Holiday Inn]"	"Green Man, near Express by Holiday Inn in the riverside area, is a family friendly Italian restaurant."
"name[Green Man], eatType[restaurant], food[Italian], area[riverside], familyFriendly[yes], near[Raja Indian Cuisine]"	"Green Man, located near Raja Indian Cuisine in the riverside area, is a family friendly pub that serves Italian food."
"name[Green Man], eatType[restaurant], food[Japanese], area[city centre], familyFriendly[no], near[Express by Holiday Inn]"	"Located in the city centre near Express by Holiday Inn, Green Man is a non family-friendly Japanese restaurant."
"name[Green Man], eatType[restaurant], food[Japanese], area[city centre], familyFriendly[yes], near[Express by Holiday Inn]"	"Near Express by Holiday Inn in the city centre, Green Man is a family-friendly Japanese restaurant."
"name[Green Man], eatType[restaurant], food[Japanese], area[riverside], familyFriendly[no], near[Express by Holiday Inn]"	"Located near Express by Holiday Inn in the riverside area, Green Man is a Japanese restaurant that is not kid friendly."
"name[Green Man], eatType[restaurant], food[Japanese], area[riverside], familyFriendly[yes], near[Express by Holiday Inn]"	"Green Man is a Japanese restaurant in the riverside area, near Express by Holiday Inn."
"name[Loch Fyne], eatType[coffee shop], area[riverside]"	"By the riverside, there is a coffee shop called Loch Fyne."
"name[Loch Fyne], eatType[pub], area[riverside]"	"By the riverside, there is a pub called Loch Fyne."
"name[Strada], eatType[coffee shop], area[city centre]"	"Located in the city centre, Strada is a coffee shop with a moderate price range."
"name[Strada], eatType[coffee shop], customer rating[1 out of 5], near[All Bar One]"	"Located near All Bar One, Strada is a coffee shop with a customer rating of 1 out of 5."
"name[Strada], eatType[coffee shop], customer rating[1 out of 5], near[Rainbow Vegetarian Café]"	"Near Rainbow Vegetarian Café, Strada is a coffee shop with a customer rating of 1 out of 5."
"name[Strada], eatType[coffee shop], customer rating[low], near[Express by Holiday Inn]"	"Located near Express by Holiday Inn, Strada is a coffee shop with a low customer rating."
"name[Strada], eatType[pub], area[city centre]"	"In the city centre, there is a pub called Strada."
"name[Strada], eatType[pub], customer rating[1 out of 5], near[All Bar One]"	"Located near All Bar One, Strada is a pub with a customer rating of 1 out of 5."
"name[Strada], eatType[pub], customer rating[1 out of 5], near[Rainbow Vegetarian Café]"	"Located near Rainbow Vegetarian Café, Strada is a pub with a customer rating of 1 out of 5."
"name[Strada], eatType[pub], customer rating[low], near[Express by Holiday Inn]"	"With a low customer rating, Strada is a pub near the Express by Holiday Inn."
"name[The Cricketers], eatType[coffee shop], customer rating[1 out of 5], familyFriendly[yes], near[Avalon]"	"Located near Avalon, The Cricketers is a kid friendly coffee shop with a customer rating of 1 out of 5."
"name[The Cricketers], eatType[coffee shop], customer rating[3 out of 5], familyFriendly[yes], near[Avalon]"	"Located near the Avalon, The Cricketers is a kid friendly coffee shop with a customer rating of 3 out of 5."
"name[The Cricketers], eatType[coffee shop], customer rating[3 out of 5], familyFriendly[yes], near[Crowne Plaza Hotel]"	The Cricketers is a kid friendly coffee shop near Crowne Plaza Hotel with a customer rating of 3 out of 5.
"name[The Cricketers], eatType[coffee shop], customer rating[5 out of 5], familyFriendly[no], near[Crowne Plaza Hotel]"	The Cricketers is a coffee shop near Crowne Plaza Hotel with a 5 out of 5 customer rating and is not family-friendly.
"name[The Cricketers], eatType[coffee shop], customer rating[5 out of 5], familyFriendly[yes], near[Crowne Plaza Hotel]"	"Located near Crowne Plaza Hotel, The Cricketers is a family-friendly coffee shop with a 5 out of 5 customer rating."
"name[The Cricketers], eatType[coffee shop], customer rating[average], familyFriendly[no], near[Café Sicilia]"	"Located near Café Sicilia, The Cricketers is a coffee shop with an average customer rating and is not family-friendly."
"name[The Cricketers], eatType[coffee shop], customer rating[average], familyFriendly[no], near[Crowne Plaza Hotel]"	"Located near Crowne Plaza Hotel, The Cricketers is a coffee shop with an average customer rating and is not family-friendly."
"name[The Cricketers], eatType[coffee shop], customer rating[average], familyFriendly[yes], near[Café Sicilia]"	"Located near Café Sicilia, The Cricketers is a family friendly coffee shop with an average customer rating."
"name[The Cricketers], eatType[coffee shop], customer rating[high], familyFriendly[yes], near[Café Sicilia]"	"Located near Café Sicilia, The Cricketers is a kid friendly coffee shop with a high customer rating."
"name[The Cricketers], eatType[coffee shop], customer rating[high], familyFriendly[yes], near[Express by Holiday Inn]"	"Located near Express by Holiday Inn, The Cricketers is a kid friendly coffee shop with a high customer rating."
"name[The Cricketers], eatType[coffee shop], customer rating[low], familyFriendly[no], near[Express by Holiday Inn]"	"Located near Express by Holiday Inn, The Cricketers is a coffee shop with a low customer rating and is not family-friendly."
"name[The Cricketers], eatType[coffee shop], customer rating[low], familyFriendly[no], near[Ranch]"	"Located near Ranch, The Cricketers is a coffee shop with a low customer rating and is not family-friendly."
"name[The Cricketers], eatType[coffee shop], customer rating[low], familyFriendly[yes], near[Ranch]"	A family friendly coffee shop near Ranch called The Cricketers has a low customer rating.
"name[The Cricketers], eatType[restaurant], customer rating[1 out of 5], familyFriendly[yes], near[Avalon]"	The Cricketers is a kid friendly restaurant near the Avalon with a customer rating of 1 out of 5.
"name[The Cricketers], eatType[restaurant], customer rating[3 out of 5], familyFriendly[yes], near[Avalon]"	The Cricketers is a kid friendly restaurant near the Avalon with a customer rating of 3 out of 5.
"name[The Cricketers], eatType[restaurant], customer rating[3 out of 5], familyFriendly[yes], near[Crowne Plaza Hotel]"	"Located near Crowne Plaza Hotel, The Cricketers is a kid friendly restaurant with a customer rating of 3 out of 5."
"name[The Cricketers], eatType[restaurant], customer rating[5 out of 5], familyFriendly[no], near[Crowne Plaza Hotel]"	"Near Crowne Plaza Hotel, The Cricketers is a family-friendly restaurant with a customer rating of 5 out of 5 and is not family-friendly."
"name[The Cricketers], eatType[restaurant], customer rating[5 out of 5], familyFriendly[yes], near[Crowne Plaza Hotel]"	"Located near Crowne Plaza Hotel, The Cricketers is a family friendly restaurant with a 5 out of 5 customer rating."
"name[The Cricketers], eatType[restaurant], customer rating[average], familyFriendly[no], near[Café Sicilia]"	The Cricketers is a restaurant near Café Sicilia with an average customer rating and is not family-friendly.
"name[The Cricketers], eatType[restaurant], customer rating[average], familyFriendly[no], near[Crowne Plaza Hotel]"	The Cricketers is a restaurant near Crowne Plaza Hotel with an average customer rating and is not family-friendly.
"name[The Cricketers], eatType[restaurant], customer rating[average], familyFriendly[yes], near[Café Sicilia]"	"Located near Café Sicilia, The Cricketers is a family friendly restaurant with an average customer rating."
"name[The Cricketers], eatType[restaurant], customer rating[high], familyFriendly[yes], near[Café Sicilia]"	"Located near Café Sicilia, The Cricketers is a kid friendly restaurant with a high customer rating."
"name[The Cricketers], eatType[restaurant], customer rating[high], familyFriendly[yes], near[Express by Holiday Inn]"	"Located near the Express by Holiday Inn, The Cricketers is a child friendly restaurant with a high customer rating."
"name[The Cricketers], eatType[restaurant], customer rating[low], familyFriendly[no], near[Express by Holiday Inn]"	The Cricketers is a restaurant near Express by Holiday Inn with a low customer rating and is not family-friendly.
"name[The Cricketers], eatType[restaurant], customer rating[low], familyFriendly[no], near[Ranch]"	"Located near Ranch, The Cricketers is a family-friendly restaurant that is not family-friendly and has a low customer rating."
"name[The Cricketers], eatType[restaurant], customer rating[low], familyFriendly[yes], near[Ranch]"	"Located near Ranch, The Cricketers is a family friendly restaurant with a low customer rating."
"name[The Cricketers], eatType[restaurant], food[Chinese], priceRange[£20-25], customer rating[high], area[city centre], familyFriendly[no], near[All Bar One]"	"The Cricketers is a Chinese restaurant in the city centre near All Bar One. It has a high customer rating, is not kid friendly, and has a price range of £20-25."
"name[The Cricketers], eatType[restaurant], food[Chinese], priceRange[£20-25], customer rating[high], area[city centre], familyFriendly[yes], near[All Bar One]"	The Cricketers is a kid friendly Chinese restaurant in the city centre near All Bar One with a high customer rating and a price range of £20-25.
"name[The Cricketers], eatType[restaurant], food[Chinese], priceRange[£20-25], customer rating[high], area[riverside], familyFriendly[no], near[All Bar One]"	"The Cricketers is a Chinese restaurant in riverside near All Bar One. It has a high customer rating, is not kid friendly, and has a price range of £20-25."
"name[The Cricketers], eatType[restaurant], food[Chinese], priceRange[£20-25], customer rating[high], area[riverside], familyFriendly[yes], near[All Bar One]"	The Cricketers is a family friendly Chinese restaurant in the riverside area near All Bar One. It has a high customer rating and a price range of £20-25.
"name[The Cricketers], eatType[restaurant], food[Chinese], priceRange[cheap], customer rating[5 out of 5], area[city centre], familyFriendly[no], near[All Bar One]"	"Located in the city centre near All Bar One, The Cricketers is a non family-friendly Chinese food restaurant with a customer rating of 5 out of 5 and a cheap price range."
"name[The Cricketers], eatType[restaurant], food[Chinese], priceRange[cheap], customer rating[5 out of 5], area[city centre], familyFriendly[yes], near[All Bar One]"	The Cricketers is a cheap Chinese restaurant with a 5 out of 5 customer rating. It is located in the city centre near All Bar One and is family friendly.
"name[The Cricketers], eatType[restaurant], food[Chinese], priceRange[cheap], customer rating[5 out of 5], area[riverside], familyFriendly[no], near[All Bar One]"	The Cricketers is a cheap Chinese restaurant located in riverside near the All Bar One. It has a customer rating of 5 out of 5 and is not family-friendly.
"name[The Cricketers], eatType[restaurant], food[Chinese], priceRange[cheap], customer rating[5 out of 5], area[riverside], familyFriendly[yes], near[All Bar One]"	"The Cricketers is a cheap, family friendly, Chinese restaurant near All Bar One in the riverside area with a customer rating of 5 out of 5."
"name[The Cricketers], eatType[restaurant], food[Chinese], priceRange[cheap], customer rating[average], area[city centre], familyFriendly[no], near[All Bar One]"	"Located in the city centre near All Bar One, The Cricketers is a cheap Chinese restaurant with an average customer rating and is not family-friendly."
"name[The Cricketers], eatType[restaurant], food[Chinese], priceRange[cheap], customer rating[average], area[city centre], familyFriendly[yes], near[All Bar One]"	"Located near All Bar One in the city centre, The Cricketers is a family-friendly Chinese restaurant with an average customer rating and a price range of less than £20."
"name[The Cricketers], eatType[restaurant], food[Chinese], priceRange[cheap], customer rating[average], area[riverside], familyFriendly[no], near[All Bar One]"	"The Cricketers is a cheap Chinese restaurant near All Bar One in the riverside area, but it has an average customer rating and is not family friendly."
"name[The Cricketers], eatType[restaurant], food[Chinese], priceRange[cheap], customer rating[average], area[riverside], familyFriendly[yes], near[All Bar One]"	"The Cricketers is a Chinese restaurant near All Bar One in the riverside area. It is family friendly, has an average customer rating, and has a cheap price range."
"name[The Cricketers], eatType[restaurant], food[Chinese], priceRange[high], customer rating[1 out of 5], area[city centre], familyFriendly[no], near[All Bar One]"	The Cricketers is a Chinese restaurant in the high price range with a customer rating of 1 out of 5. it is located in the city centre near All Bar One and is not child friendly.
"name[The Cricketers], eatType[restaurant], food[Chinese], priceRange[high], customer rating[1 out of 5], area[city centre], familyFriendly[yes], near[All Bar One]"	"Located near All Bar One in the city centre, The Cricketers is a child friendly Chinese restaurant with a high price range and a customer rating of 1 out of 5."
"name[The Cricketers], eatType[restaurant], food[Chinese], priceRange[high], customer rating[1 out of 5], area[riverside], familyFriendly[no], near[All Bar One]"	"The Cricketers is a Chinese restaurant near All Bar One in the riverside area. It is not child friendly, has a high price range and has a customer rating of 1 out of 5."
"name[The Cricketers], eatType[restaurant], food[Chinese], priceRange[high], customer rating[1 out of 5], area[riverside], familyFriendly[yes], near[All Bar One]"	The Cricketers is a family friendly Chinese restaurant in the riverside area near All Bar One. It has a customer rating of 1 out of 5 and is high priced.
"name[The Cricketers], eatType[restaurant], food[Chinese], priceRange[high], customer rating[average], area[city centre], familyFriendly[no], near[All Bar One]"	"The Cricketers is a Chinese restaurant near the All Bar One in the city centre. It is not child friendly, has a high price range and an average customer rating."
"name[The Cricketers], eatType[restaurant], food[Chinese], priceRange[high], customer rating[average], area[city centre], familyFriendly[yes], near[All Bar One]"	"Located near All Bar One in the city centre, The Cricketers is a child friendly Chinese restaurant with a high price range and average customer rating."
"name[The Cricketers], eatType[restaurant], food[Chinese], priceRange[high], customer rating[average], area[riverside], familyFriendly[no], near[All Bar One]"	"Located near All Bar One in the riverside area, The Cricketers is a Chinese restaurant with a high price range and an average customer rating. It is not child friendly."
"name[The Cricketers], eatType[restaurant], food[Chinese], priceRange[high], customer rating[average], area[riverside], familyFriendly[yes], near[All Bar One]"	"The Cricketers is a Chinese restaurant near All Bar One in the riverside area. It is child friendly, has a high price range and an average customer rating."
"name[The Cricketers], eatType[restaurant], food[Chinese], priceRange[less than £20], customer rating[low], area[city centre], familyFriendly[no], near[All Bar One]"	The Cricketers is a Chinese restaurant located near All Bar One in the city centre. It has a low customer rating and a price range of less than £20 and is not family-friendly.
"name[The Cricketers], eatType[restaurant], food[Chinese], priceRange[less than £20], customer rating[low], area[city centre], familyFriendly[yes], near[All Bar One]"	The Cricketers is a family-friendly Chinese restaurant with a price range less than £20 near All Bar One in the city centre with a low customer rating.
"name[The Cricketers], eatType[restaurant], food[Chinese], priceRange[less than £20], customer rating[low], area[riverside], familyFriendly[no], near[All Bar One]"	"Located near All Bar One in the riverside area, The Cricketers is a Chinese restaurant with a price range of less than £20 and has a low customer rating. It is not family friendly."
"name[The Cricketers], eatType[restaurant], food[Chinese], priceRange[less than £20], customer rating[low], area[riverside], familyFriendly[yes], near[All Bar One]"	"Located near All Bar One in the riverside area, The Cricketers is a family friendly Chinese restaurant with a price range of less than £20 and a low customer rating."
"name[The Cricketers], eatType[restaurant], food[Chinese], priceRange[moderate], customer rating[1 out of 5], area[city centre], familyFriendly[no], near[All Bar One]"	"The Cricketers, located near All Bar One in the city centre, is a moderately priced Chinese restaurant with a customer rating of 1 out of 5. it is not kid friendly."
"name[The Cricketers], eatType[restaurant], food[Chinese], priceRange[moderate], customer rating[1 out of 5], area[city centre], familyFriendly[yes], near[All Bar One]"	"Located near All Bar One in the city centre, The Cricketers is a kid friendly Chinese food restaurant with a moderate price range and a customer rating of 1 out of 5."
"name[The Cricketers], eatType[restaurant], food[Chinese], priceRange[moderate], customer rating[1 out of 5], area[riverside], familyFriendly[no], near[All Bar One]"	"Located near All Bar One in the riverside area, The Cricketers is a moderately priced Chinese restaurant with a customer rating of 1 out of 5."
"name[The Cricketers], eatType[restaurant], food[Chinese], priceRange[moderate], customer rating[1 out of 5], area[riverside], familyFriendly[yes], near[All Bar One]"	"The Cricketers is a moderately priced, kid friendly, Chinese restaurant near All Bar One in the riverside area with a customer rating of 1 out of 5."
"name[The Cricketers], eatType[restaurant], food[Chinese], priceRange[moderate], customer rating[3 out of 5], area[city centre], familyFriendly[no], near[All Bar One]"	The Cricketers is a Chinese restaurant in the city centre near All Bar One. It has a moderate price range and a customer rating of 3 out of 5 and is not kid friendly.
"name[The Cricketers], eatType[restaurant], food[Chinese], priceRange[moderate], customer rating[3 out of 5], area[city centre], familyFriendly[yes], near[All Bar One]"	The Cricketers is a Chinese restaurant in the city centre near All Bar One. It has a customer rating of 3 out of 5 and is kid friendly.
"name[The Cricketers], eatType[restaurant], food[Chinese], priceRange[moderate], customer rating[3 out of 5], area[riverside], familyFriendly[no], near[All Bar One]"	"The Cricketers is a Chinese restaurant in the riverside area, near All Bar One. It is not kid friendly, has a moderate price range, and has a customer rating of 3 out of 5."
"name[The Cricketers], eatType[restaurant], food[Chinese], priceRange[moderate], customer rating[3 out of 5], area[riverside], familyFriendly[yes], near[All Bar One]"	"The Cricketers is a Chinese restaurant near All Bar One in the riverside area. It is kid friendly, has a moderate price range, and has a customer rating of 3 out of 5."
"name[The Cricketers], eatType[restaurant], food[Chinese], priceRange[more than £30], customer rating[high], area[city centre], familyFriendly[no], near[All Bar One]"	"The Cricketers is a Chinese restaurant in the city centre near All Bar One. It has a high customer rating, is not child friendly, and has a price range of more than £30."
"name[The Cricketers], eatType[restaurant], food[Chinese], priceRange[more than £30], customer rating[high], area[city centre], familyFriendly[yes], near[All Bar One]"	"The Cricketers is a Chinese restaurant near the All Bar One in the city centre. It is child friendly, has a high customer rating, and has a price range of more than £30."
"name[The Cricketers], eatType[restaurant], food[Chinese], priceRange[more than £30], customer rating[high], area[riverside], familyFriendly[no], near[All Bar One]"	"The Cricketers is a Chinese restaurant near All Bar One in the riverside area. It has a high customer rating, is not child friendly, and has a price range of more than £30."
"name[The Cricketers], eatType[restaurant], food[Chinese], priceRange[more than £30], customer rating[high], area[riverside], familyFriendly[yes], near[All Bar One]"	"The Cricketers is a Chinese restaurant near All Bar One in the riverside area. It is child friendly, has a price range of more than £30, and has a high customer rating."
"name[The Cricketers], eatType[restaurant], food[English], priceRange[£20-25], customer rating[high], area[city centre], familyFriendly[no], near[All Bar One]"	"The Cricketers is an English restaurant in the city centre near All Bar One. It has a high customer rating, is not kid friendly, and has a price range of £20-25."
"name[The Cricketers], eatType[restaurant], food[English], priceRange[£20-25], customer rating[high], area[city centre], familyFriendly[yes], near[All Bar One]"	The Cricketers is a family-friendly English restaurant in the city centre near All Bar One with a high customer rating and a price range of £20-25.
"name[The Cricketers], eatType[restaurant], food[English], priceRange[£20-25], customer rating[high], area[riverside], familyFriendly[no], near[All Bar One]"	"The Cricketers is an English restaurant near All Bar One in the riverside area. It has a high customer rating, is not kid friendly, and has a price range of £20-25."
"name[The Cricketers], eatType[restaurant], food[English], priceRange[£20-25], customer rating[high], area[riverside], familyFriendly[yes], near[All Bar One]"	The Cricketers is a family friendly English restaurant in the riverside area near All Bar One. It has a high customer rating and a price range of £20-25.
"name[The Cricketers], eatType[restaurant], food[English], priceRange[cheap], customer rating[5 out of 5], area[city centre], familyFriendly[no], near[Café Rouge]"	"Located in the city centre near Café Rouge, The Cricketers is a cheap English restaurant with a 5 out of 5 customer rating. It is not family-friendly."
"name[The Cricketers], eatType[restaurant], food[English], priceRange[cheap], customer rating[5 out of 5], area[city centre], familyFriendly[yes], near[Café Rouge]"	"Located in the city centre near Café Rouge, The Cricketers is a family-friendly English restaurant with a customer rating of 5 out of 5 and a cheap price range."
"name[The Cricketers], eatType[restaurant], food[English], priceRange[cheap], customer rating[5 out of 5], area[riverside], familyFriendly[no], near[Café Rouge]"	"Located near Café Rouge in riverside, The Cricketers is a cheap English restaurant with a 5 out of 5 customer rating. It is not family friendly."
"name[The Cricketers], eatType[restaurant], food[English], priceRange[cheap], customer rating[5 out of 5], area[riverside], familyFriendly[yes], near[Café Rouge]"	In the riverside area near the Café Rouge is a cheap family friendly restaurant called The Cricketers which serves English food with a customer rating of 5 out of 5.
"name[The Cricketers], eatType[restaurant], food[English], priceRange[cheap], customer rating[average], area[city centre], familyFriendly[no], near[Café Rouge]"	"Located in the city centre near Café Rouge, The Cricketers is a cheap English restaurant with an average customer rating."
"name[The Cricketers], eatType[restaurant], food[English], priceRange[cheap], customer rating[average], area[city centre], familyFriendly[yes], near[Café Rouge]"	"Located in the city centre near Café Rouge, The Cricketers is a family-friendly English restaurant with an average customer rating, and a cheap price range."
"name[The Cricketers], eatType[restaurant], food[English], priceRange[cheap], customer rating[average], area[riverside], familyFriendly[no], near[Café Rouge]"	"The Cricketers is an English restaurant near Café Rouge in riverside. It has an average customer rating, is not family-friendly, and has a cheap price range."
"name[The Cricketers], eatType[restaurant], food[English], priceRange[cheap], customer rating[average], area[riverside], familyFriendly[yes], near[Café Rouge]"	"Located near Café Rouge in riverside, The Cricketers is a family friendly English restaurant with an average customer rating."
"name[The Cricketers], eatType[restaurant], food[English], priceRange[high], customer rating[1 out of 5], area[city centre], familyFriendly[no], near[Café Rouge]"	"Located near Café Rouge in the city centre, The Cricketers is a high priced English restaurant with a 1 out of 5 customer rating and is not child friendly."
"name[The Cricketers], eatType[restaurant], food[English], priceRange[high], customer rating[1 out of 5], area[city centre], familyFriendly[yes], near[Café Rouge]"	"Located in the city centre near Café Rouge, The Cricketers is a child friendly English restaurant with a high price range and a customer rating of 1 out of 5."
"name[The Cricketers], eatType[restaurant], food[English], priceRange[high], customer rating[1 out of 5], area[riverside], familyFriendly[no], near[Café Rouge]"	"Located near Café Rouge in the riverside area, The Cricketers is a high priced English restaurant with a 1 out of 5 customer rating. It is not child friendly."
"name[The Cricketers], eatType[restaurant], food[English], priceRange[high], customer rating[1 out of 5], area[riverside], familyFriendly[yes], near[Café Rouge]"	"Located in the riverside area near the Café Rouge, The Cricketers is a family friendly English restaurant with a high price range and a customer rating of 1 out of 5."
"name[The Cricketers], eatType[restaurant], food[English], priceRange[high], customer rating[average], area[city centre], familyFriendly[no], near[Café Rouge]"	"Located near Café Rouge in the city centre, The Cricketers is an English restaurant with a high price range and an average customer rating and is not child friendly."
"name[The Cricketers], eatType[restaurant], food[English], priceRange[high], customer rating[average], area[city centre], familyFriendly[yes], near[Café Rouge]"	"Located near Café Rouge in the city centre, The Cricketers is an English restaurant with a high price range and an average customer rating and is child friendly."
"name[The Cricketers], eatType[restaurant], food[English], priceRange[high], customer rating[average], area[riverside], familyFriendly[no], near[Café Rouge]"	The Cricketers is an English restaurant in the riverside area near the Café Rouge. It has a high price range and an average customer rating and is not child friendly.
"name[The Mill], eatType[pub], food[English], priceRange[high], area[riverside], familyFriendly[yes], near[Raja Indian Cuisine]"	"Located near Raja Indian Cuisine in riverside, The Mill is a child friendly pub with a high price range."
"name[The Mill], eatType[pub], food[English], priceRange[less than £20], area[city centre], familyFriendly[no], near[Raja Indian Cuisine]"	"Located near Raja Indian Cuisine in the city centre, The Mill is a non family-friendly pub with a price range of less than £20."
"name[The Mill], eatType[pub], food[English], priceRange[less than £20], area[city centre], familyFriendly[yes], near[Raja Indian Cuisine]"	"Located in the city centre near Raja Indian Cuisine, The Mill is a family-friendly pub serving English food at a price range of less than £20."
"name[The Mill], eatType[pub], food[English], priceRange[less than £20], area[riverside], familyFriendly[no], near[Raja Indian Cuisine]"	"Located near Raja Indian Cuisine in the riverside area, The Mill is an English pub with a price range of less than £20 and is not family friendly."
"name[The Mill], eatType[pub], food[English], priceRange[less than £20], area[riverside], familyFriendly[yes], near[Raja Indian Cuisine]"	Near Raja Indian Cuisine in the riverside area is a pub called The Mill that serves English food for less than £20 and is family friendly
"name[The Mill], eatType[pub], food[English], priceRange[moderate], area[city centre], familyFriendly[no], near[Raja Indian Cuisine]"	"Located near Raja Indian Cuisine in the city centre, The Mill is an English pub that is not kid friendly with a moderate price range."
"name[The Mill], eatType[pub], food[English], priceRange[moderate], area[city centre], familyFriendly[yes], near[Raja Indian Cuisine]"	"Located near Raja Indian Cuisine in the city centre, The Mill is a kid friendly English pub with a moderate price range."
"name[The Mill], eatType[pub], food[English], priceRange[moderate], area[riverside], familyFriendly[no], near[Raja Indian Cuisine]"	The Mill is a moderately priced English pub located in riverside near Raja Indian Cuisine.
"name[The Mill], eatType[pub], food[English], priceRange[moderate], area[riverside], familyFriendly[yes], near[Raja Indian Cuisine]"	"Located near Raja Indian Cuisine, The Mill is a kid friendly pub that serves English food at a moderate price. It is located in the riverside area."
"name[The Mill], eatType[pub], food[English], priceRange[more than £30], area[riverside], familyFriendly[yes], near[Raja Indian Cuisine]"	The Mill is a child friendly English pub in riverside near Raja Indian Cuisine
"name[The Mill], eatType[pub], food[Fast food], priceRange[£20-25], area[riverside], familyFriendly[yes], near[Raja Indian Cuisine]"	"In the riverside area, near Raja Indian Cuisine, The Mill is a kid friendly Fast food pub with a price range of £20-25."
"name[The Mill], eatType[pub], food[Fast food], priceRange[£20-25], customer rating[high], area[city centre], familyFriendly[no], near[Café Rouge]"	"Located near Café Rouge in the city centre, The Mill is a Fast food restaurant that is not kid friendly with a high customer rating and a price range of £20-25."
"name[The Mill], eatType[pub], food[Fast food], priceRange[£20-25], customer rating[high], area[city centre], familyFriendly[yes], near[Café Rouge]"	The Mill is a kid friendly Fast food restaurant in the city centre near Café Rouge with a high customer rating and a price range of £20-25.
"name[The Mill], eatType[pub], food[Fast food], priceRange[£20-25], customer rating[high], area[riverside], familyFriendly[no], near[Café Rouge]"	"Located near Café Rouge in the riverside area, The Mill is a Fast food restaurant that is not kid friendly with a high customer rating and a price range of £20-25."
"name[The Mill], eatType[pub], food[Fast food], priceRange[£20-25], customer rating[high], area[riverside], familyFriendly[yes], near[Café Rouge]"	Near the Café Rouge in the riverside area is a Fast food pub called The Mill. It is kid friendly and has a high customer rating and a price range of £20-25.
"name[The Mill], eatType[pub], food[Fast food], priceRange[£20-25], customer rating[high], area[riverside], familyFriendly[yes], near[Café Sicilia]"	Near the Café Sicilia in the riverside area is a Fast food pub called The Mill. It is kid friendly and has a high customer rating and a price range of £20-25.
"name[The Mill], eatType[pub], food[Fast food], priceRange[cheap], area[riverside], familyFriendly[yes], near[Raja Indian Cuisine]"	"The Mill is a cheap, family friendly, Fast food pub near Raja Indian Cuisine in the riverside area."
"name[The Mill], eatType[pub], food[Fast food], priceRange[cheap], customer rating[5 out of 5], area[city centre], familyFriendly[no], near[Café Sicilia]"	In the city centre near Café Sicilia there is a cheap Fast food restaurant called The Mill. It has a customer rating of 5 out of 5 and is not family-friendly.
"name[The Mill], eatType[pub], food[Fast food], priceRange[cheap], customer rating[5 out of 5], area[city centre], familyFriendly[yes], near[Café Sicilia]"	The Mill is a family-friendly Fast food restaurant in the city centre near Café Sicilia with a customer rating of 5 out of 5 and has a cheap price range.
"name[The Mill], eatType[pub], food[Fast food], priceRange[cheap], customer rating[5 out of 5], area[riverside], familyFriendly[no], near[Café Sicilia]"	A cheap Fast food restaurant in riverside near Café Sicilia is The Mill. It has a customer rating of 5 out of 5 and is not family-friendly.
"name[The Mill], eatType[pub], food[Fast food], priceRange[cheap], customer rating[5 out of 5], area[riverside], familyFriendly[yes], near[Café Sicilia]"	"Located near Café Sicilia in riverside, The Mill is a family-friendly Fast food pub with a customer rating of 5 out of 5 and a cheap price range."
"name[The Mill], eatType[pub], food[Fast food], priceRange[cheap], customer rating[average], area[city centre], familyFriendly[no], near[Café Sicilia]"	"Located near Café Sicilia in the city centre, The Mill is a cheap Fast food pub with an average customer rating and is not family-friendly."
"name[The Mill], eatType[pub], food[Fast food], priceRange[cheap], customer rating[average], area[city centre], familyFriendly[yes], near[Café Sicilia]"	"Located near Café Sicilia in the city centre, The Mill is a family-friendly Fast food pub with a cheap price range and average customer rating."
"name[The Mill], eatType[pub], food[Fast food], priceRange[cheap], customer rating[average], area[riverside], familyFriendly[no], near[Café Sicilia]"	"Near Café Sicilia, in the riverside area, is a cheap Fast food pub called The Mill. It has an average customer rating and is not family-friendly."
"name[The Mill], eatType[pub], food[Fast food], priceRange[cheap], customer rating[average], area[riverside], familyFriendly[yes], near[Café Sicilia]"	In the riverside area near Café Sicilia is a cheap family friendly pub called The Mill. It has an average customer rating.
"name[The Mill], eatType[pub], food[Fast food], priceRange[high], customer rating[1 out of 5], area[city centre], familyFriendly[no], near[Café Sicilia]"	In the city centre near the Café Sicilia is a high priced Fast food pub called The Mill. It has a customer rating of 1 out of 5 and is not child friendly.
"name[The Mill], eatType[pub], food[Fast food], priceRange[high], customer rating[1 out of 5], area[city centre], familyFriendly[yes], near[Café Sicilia]"	The Mill is a children friendly Fast food pub near Café Sicilia in the city centre with a high price range and a customer rating of 1 out of 5.
"name[The Mill], eatType[pub], food[Fast food], priceRange[high], customer rating[1 out of 5], area[riverside], familyFriendly[no], near[Café Sicilia]"	"The Mill is a Fast food restaurant near Café Sicilia, in the riverside area. It is not child friendly, has a high price range and has a customer rating of 1 out of 5."
"name[The Mill], eatType[pub], food[Fast food], priceRange[high], customer rating[1 out of 5], area[riverside], familyFriendly[yes], near[Café Sicilia]"	"Located near Café Sicilia in the riverside area, The Mill is a children friendly Fast food pub with a high price range and a customer rating of 1 out of 5."
"name[The Mill], eatType[pub], food[Fast food], priceRange[high], customer rating[average], area[city centre], familyFriendly[no], near[Café Sicilia]"	"Located near Café Sicilia in the city centre, The Mill is a Fast food pub with a high price range and an average customer rating and is not child friendly."
"name[The Mill], eatType[pub], food[Fast food], priceRange[high], customer rating[average], area[city centre], familyFriendly[yes], near[Café Sicilia]"	"Located near Café Sicilia in the city centre, The Mill is a child friendly Fast food pub with a high price range and average customer rating."
"name[The Mill], eatType[pub], food[Fast food], priceRange[high], customer rating[average], area[riverside], familyFriendly[no], near[Café Sicilia]"	Near the Café Sicilia in the riverside area is a high priced Fast food pub called The Mill. It has an average customer rating and is not child friendly.
"name[The Mill], eatType[pub], food[Fast food], priceRange[high], customer rating[average], area[riverside], familyFriendly[yes], near[Café Sicilia]"	"Located in the riverside area near Café Sicilia, The Mill is a child friendly Fast food pub with a high price range and an average customer rating."
"name[The Mill], eatType[pub], food[Fast food], priceRange[less than £20], customer rating[low], area[city centre], familyFriendly[no], near[Café Sicilia]"	"The Mill is a Fast food restaurant located near Café Sicilia in the city centre. It has a low customer rating and a price range of less than £20, but it is not family-friendly."
"name[The Mill], eatType[pub], food[Fast food], priceRange[less than £20], customer rating[low], area[city centre], familyFriendly[yes], near[Café Sicilia]"	The Mill is a family-friendly Fast food pub in the city centre near Café Sicilia with a price range less than £20 and has a low customer rating.
"name[The Mill], eatType[pub], food[Fast food], priceRange[less than £20], customer rating[low], area[riverside], familyFriendly[no], near[Café Sicilia]"	"The Mill is a Fast food restaurant near Café Sicilia in the riverside area. It is not family-friendly, has a low customer rating and has a price range of less than £20."
"name[The Mill], eatType[pub], food[Fast food], priceRange[less than £20], customer rating[low], area[riverside], familyFriendly[yes], near[Café Sicilia]"	The Mill is a family friendly Fast food restaurant with a price range less than £20 located near Café Sicilia in the riverside area with a low customer rating.
"name[The Mill], eatType[pub], food[Fast food], priceRange[moderate], customer rating[1 out of 5], area[city centre], familyFriendly[no], near[Café Sicilia]"	"Located near Café Sicilia in the city centre, The Mill is a kid friendly Fast food restaurant with a moderate price range and a customer rating of 1 out of 5."
"name[The Mill], eatType[pub], food[Fast food], priceRange[moderate], customer rating[1 out of 5], area[city centre], familyFriendly[yes], near[Café Sicilia]"	The Mill is a kid friendly pub near Café Sicilia in the city centre with a moderate price range and a customer rating of 1 out of 5.
"name[The Mill], eatType[pub], food[Fast food], priceRange[moderate], customer rating[1 out of 5], area[riverside], familyFriendly[no], near[Café Sicilia]"	"The Mill is a Fast food restaurant near Café Sicilia in the riverside area. It is not kid friendly, has a moderate price range and has a customer rating of 1 out of 5."
"name[The Mill], eatType[pub], food[Fast food], priceRange[moderate], customer rating[1 out of 5], area[riverside], familyFriendly[yes], near[Café Sicilia]"	"The Mill, located near Café Sicilia in the riverside area, is a moderately priced, kid friendly pub with a customer rating of 1 out of 5."
"name[The Mill], eatType[pub], food[Fast food], priceRange[moderate], customer rating[3 out of 5], area[city centre], familyFriendly[no], near[Café Sicilia]"	The Mill is a Fast food restaurant near Café Sicilia in the city centre with a moderate price range and a customer rating of 3 out of 5.
"name[The Mill], eatType[pub], food[Fast food], priceRange[moderate], customer rating[3 out of 5], area[city centre], familyFriendly[yes], near[Café Sicilia]"	"Located near Café Sicilia in the city centre, The Mill is a kid friendly Fast food restaurant with a moderate price range and a customer rating of 3 out of 5."
"name[The Mill], eatType[pub], food[Fast food], priceRange[moderate], customer rating[3 out of 5], area[riverside], familyFriendly[no], near[Café Sicilia]"	"Located near Café Sicilia in the riverside area, The Mill is a Fast food restaurant with a moderate price range and a customer rating of 3 out of 5 and is not kid friendly."
"name[The Mill], eatType[pub], food[Fast food], priceRange[moderate], customer rating[3 out of 5], area[riverside], familyFriendly[yes], near[Café Sicilia]"	"In the riverside area, near Café Sicilia, The Mill is a kid friendly Fast food restaurant with a moderate price range and a customer rating of 3 out of 5."
"name[The Mill], eatType[restaurant], food[English], priceRange[high], area[riverside], familyFriendly[yes], near[Raja Indian Cuisine]"	"Located in the riverside area near Raja Indian Cuisine, The Mill is a child friendly English restaurant with a high price range."
"name[The Mill], eatType[restaurant], food[English], priceRange[high], customer rating[average], area[riverside], familyFriendly[yes], near[Café Rouge]"	"Located near Café Rouge in the riverside area, The Mill is a child friendly English restaurant with a high price range and an average customer rating."
"name[The Mill], eatType[restaurant], food[English], priceRange[less than £20], area[city centre], familyFriendly[no], near[Raja Indian Cuisine]"	"The Mill is an English restaurant located near Raja Indian Cuisine in the city centre. It is not family-friendly, but has a price range of less than £20."
"name[The Mill], eatType[restaurant], food[English], priceRange[less than £20], area[city centre], familyFriendly[yes], near[Raja Indian Cuisine]"	"In the city centre near Raja Indian Cuisine, there is a family friendly restaurant called The Mill that serves English food at less than £20."
"name[The Mill], eatType[restaurant], food[English], priceRange[less than £20], area[riverside], familyFriendly[no], near[Raja Indian Cuisine]"	"The Mill is an English restaurant near Raja Indian Cuisine in riverside. It is not family-friendly, but has a price range of less than £20."
"name[The Mill], eatType[restaurant], food[English], priceRange[less than £20], area[riverside], familyFriendly[yes], near[Raja Indian Cuisine]"	"Located near Raja Indian Cuisine in riverside, The Mill is a family friendly English restaurant with a price range of less than £20."
"name[The Mill], eatType[restaurant], food[English], priceRange[less than £20], customer rating[low], area[city centre], familyFriendly[no], near[Café Rouge]"	"The Mill is an English restaurant near Café Rouge in the city centre. It is not family-friendly, has a price range of less than £20 and has a low customer rating."
"name[The Mill], eatType[restaurant], food[English], priceRange[less than £20], customer rating[low], area[city centre], familyFriendly[yes], near[Café Rouge]"	"Located in the city centre near Café Rouge, The Mill is a family-friendly English restaurant with a low customer rating and a price range of less than £20."
"name[The Mill], eatType[restaurant], food[English], priceRange[less than £20], customer rating[low], area[riverside], familyFriendly[no], near[Café Rouge]"	"Located near Café Rouge in riverside, The Mill is an English restaurant with a low customer rating and a price range of less than £20. It is not family friendly."
"name[The Mill], eatType[restaurant], food[English], priceRange[less than £20], customer rating[low], area[riverside], familyFriendly[yes], near[Café Rouge]"	The Mill is a family friendly English restaurant with a price range less than £20 near Café Rouge in the riverside area with a low customer rating.
"name[The Mill], eatType[restaurant], food[English], priceRange[moderate], area[city centre], familyFriendly[no], near[Raja Indian Cuisine]"	"Located near Raja Indian Cuisine in the city centre, The Mill is an English restaurant that is not kid friendly with a moderate price range."
"name[The Mill], eatType[restaurant], food[English], priceRange[moderate], area[city centre], familyFriendly[yes], near[Raja Indian Cuisine]"	"The Mill is a moderately priced, kid friendly, English restaurant near Raja Indian Cuisine in the city centre."
"name[The Mill], eatType[restaurant], food[English], priceRange[moderate], area[riverside], familyFriendly[no], near[Raja Indian Cuisine]"	"The Mill is a moderately priced English restaurant, not kid friendly, located near Raja Indian Cuisine in the riverside area."
"name[The Mill], eatType[restaurant], food[English], priceRange[moderate], area[riverside], familyFriendly[yes], near[Raja Indian Cuisine]"	"Located in the riverside area near Raja Indian Cuisine, The Mill is a kid friendly English restaurant with a moderate price range."
"name[The Mill], eatType[restaurant], food[English], priceRange[moderate], customer rating[1 out of 5], area[city centre], familyFriendly[no], near[Café Rouge]"	"The Mill, located near Café Rouge in the city centre, is a moderately priced English restaurant with a customer rating of 1 out of 5. it is not kid friendly."
"name[The Mill], eatType[restaurant], food[English], priceRange[moderate], customer rating[1 out of 5], area[city centre], familyFriendly[yes], near[Café Rouge]"	"Located near Café Rouge in the city centre, The Mill is a kid friendly English food restaurant with a moderate price range and a customer rating of 1 out of 5."
"name[The Mill], eatType[restaurant], food[English], priceRange[moderate], customer rating[1 out of 5], area[riverside], familyFriendly[no], near[Café Rouge]"	"The Mill is an English restaurant near Café Rouge in the riverside area. It is not kid friendly, has a moderate price range and has a customer rating of 1 out of 5."
"name[The Mill], eatType[restaurant], food[English], priceRange[moderate], customer rating[1 out of 5], area[riverside], familyFriendly[yes], near[Café Rouge]"	"Located in the riverside area near the Café Rouge, The Mill is a kid friendly restaurant with a moderate price range and a customer rating of 1 out of 5."
"name[The Mill], eatType[restaurant], food[English], priceRange[moderate], customer rating[3 out of 5], area[city centre], familyFriendly[no], near[Café Rouge]"	The Mill is a moderately priced English restaurant located in the city centre near Café Rouge. It is not kid friendly and is rated 3 out of 5.
"name[The Mill], eatType[restaurant], food[English], priceRange[moderate], customer rating[3 out of 5], area[city centre], familyFriendly[yes], near[Café Rouge]"	"Located near Café Rouge in the city centre, The Mill is a moderately priced English restaurant with a customer rating of 3 out of 5."
"name[The Mill], eatType[restaurant], food[English], priceRange[moderate], customer rating[3 out of 5], area[riverside], familyFriendly[no], near[Café Rouge]"	"In the riverside area, near Café Rouge, there is a moderately priced English restaurant called The Mill. It is not kid friendly and has a customer rating of 3 out of 5."
"name[The Mill], eatType[restaurant], food[English], priceRange[moderate], customer rating[3 out of 5], area[riverside], familyFriendly[yes], near[Café Rouge]"	"Located in riverside near Café Rouge, The Mill is a kid friendly restaurant with a moderate price range and a customer rating of 3 out of 5."
"name[The Mill], eatType[restaurant], food[English], priceRange[more than £30], area[riverside], familyFriendly[yes], near[Raja Indian Cuisine]"	"Located near Raja Indian Cuisine in riverside, The Mill is a child friendly English restaurant with a price range of more than £30."
"name[The Mill], eatType[restaurant], food[English], priceRange[more than £30], customer rating[high], area[city centre], familyFriendly[no], near[Café Rouge]"	"Located in the city centre near Café Rouge, The Mill is an English restaurant with a price range of more than £30, and a high customer rating. It is not child friendly."
"name[The Mill], eatType[restaurant], food[English], priceRange[more than £30], customer rating[high], area[city centre], familyFriendly[yes], near[Café Rouge]"	"The Mill, near Café Rouge in the city centre, is a high priced English restaurant with a high customer rating."
"name[The Mill], eatType[restaurant], food[English], priceRange[more than £30], customer rating[high], area[riverside], familyFriendly[no], near[Café Rouge]"	"The Mill is an English restaurant near Café Rouge in the riverside area. It has a high customer rating, is not child friendly, and has a price range of more than £30."
"name[The Mill], eatType[restaurant], food[English], priceRange[more than £30], customer rating[high], area[riverside], familyFriendly[yes], near[Café Rouge]"	"Located near Café Rouge in the riverside area, The Mill is a child friendly English restaurant with a high customer rating and a price range of more than £30."
"name[The Mill], eatType[restaurant], food[Fast food], priceRange[£20-25], area[riverside], familyFriendly[yes], near[Raja Indian Cuisine]"	"In the riverside area, near Raja Indian Cuisine, there is a Fast food restaurant called The Mill. It is kid friendly and has a price range of £20-25."
"name[The Mill], eatType[restaurant], food[Fast food], priceRange[cheap], area[riverside], familyFriendly[yes], near[Raja Indian Cuisine]"	"The Mill is a cheap, family friendly, Fast food restaurant near Raja Indian Cuisine in the riverside area."
"name[The Phoenix], eatType[pub], food[Fast food], priceRange[cheap], area[riverside], familyFriendly[yes], near[Raja Indian Cuisine]"	"The Phoenix is a cheap, family friendly, Fast food pub near Raja Indian Cuisine in the riverside area."
"name[The Phoenix], eatType[pub], food[Fast food], priceRange[high], area[city centre], familyFriendly[no], near[Raja Indian Cuisine]"	"Located near Raja Indian Cuisine in the city centre, The Phoenix is a Fast food pub that has a high price range. It is not child friendly."
"name[The Phoenix], eatType[pub], food[Fast food], priceRange[high], area[city centre], familyFriendly[yes], near[Raja Indian Cuisine]"	"Located near Raja Indian Cuisine in the city centre, The Phoenix is a child friendly Fast food pub with a high price range."
"name[The Phoenix], eatType[pub], food[Fast food], priceRange[high], area[riverside], familyFriendly[no], near[Raja Indian Cuisine]"	"In the riverside area, near Raja Indian Cuisine, there is a high priced Fast food pub called The Phoenix."
"name[The Phoenix], eatType[pub], food[Fast food], priceRange[high], area[riverside], familyFriendly[yes], near[Raja Indian Cuisine]"	Located near Raja Indian Cuisine in the riverside area is a Fast food pub called The Phoenix that is child friendly and has a high price range.
"name[The Phoenix], eatType[pub], food[Fast food], priceRange[less than £20], area[city centre], familyFriendly[no], near[Raja Indian Cuisine]"	"Located near Raja Indian Cuisine in the city centre, The Phoenix is a non family-friendly Fast food pub with a price range of less than £20."
"name[The Phoenix], eatType[pub], food[Fast food], priceRange[less than £20], area[city centre], familyFriendly[yes], near[Raja Indian Cuisine]"	"Located near Raja Indian Cuisine in the city centre, The Phoenix is a family-friendly Fast food pub with a price range of less than £20."
"name[The Phoenix], eatType[pub], food[Fast food], priceRange[less than £20], area[riverside], familyFriendly[no], near[Raja Indian Cuisine]"	Near the Raja Indian Cuisine is a Fast food pub called The Phoenix. It has a price range of less than £20 and is not family-friendly.
"name[The Phoenix], eatType[pub], food[Fast food], priceRange[less than £20], area[riverside], familyFriendly[yes], near[Raja Indian Cuisine]"	The Phoenix is a family friendly pub located near Raja Indian Cuisine in the riverside area with a price range of less than £20
"name[The Phoenix], eatType[pub], food[Fast food], priceRange[moderate], area[city centre], familyFriendly[no], near[Raja Indian Cuisine]"	"In the city centre, near Raja Indian Cuisine, there is a Fast food pub called The Phoenix. It is not kid friendly and has a moderate price range."
"name[The Phoenix], eatType[pub], food[Fast food], priceRange[moderate], area[city centre], familyFriendly[yes], near[Raja Indian Cuisine]"	"Near Raja Indian Cuisine in the city centre, The Phoenix is a kid friendly Fast food pub with a moderate price range."
"name[The Phoenix], eatType[pub], food[Fast food], priceRange[moderate], area[riverside], familyFriendly[no], near[Raja Indian Cuisine]"	"The Phoenix is a moderately priced Fast food pub, not kid friendly, located near Raja Indian Cuisine in the riverside area."
"name[The Phoenix], eatType[pub], food[Fast food], priceRange[moderate], area[riverside], familyFriendly[yes], near[Raja Indian Cuisine]"	"Located near Raja Indian Cuisine on the riverside, The Phoenix is a kid friendly Fast food pub with a moderate price range."
"name[The Phoenix], eatType[pub], food[Fast food], priceRange[moderate], customer rating[3 out of 5], area[riverside], familyFriendly[yes], near[Café Sicilia]"	"In the riverside area, near Café Sicilia, The Phoenix is a kid friendly Fast food restaurant with a moderate price range and a customer rating of 3 out of 5."
"name[The Phoenix], eatType[pub], food[Fast food], priceRange[more than £30], area[riverside], familyFriendly[yes], near[Raja Indian Cuisine]"	The Phoenix is a children friendly Fast food pub with a price range of more than £30 near Raja Indian Cuisine in the riverside area.
"name[The Phoenix], eatType[pub], food[Fast food], priceRange[more than £30], customer rating[high], area[city centre], familyFriendly[no], near[Café Sicilia]"	The Phoenix is a Fast food restaurant near Café Sicilia in the city centre with a high customer rating and is not children friendly.
"name[The Phoenix], eatType[pub], food[Fast food], priceRange[more than £30], customer rating[high], area[city centre], familyFriendly[yes], near[Café Sicilia]"	The Phoenix is a children friendly Fast food pub in the city centre near Café Sicilia with a high customer rating and a price range of more than £30.
"name[The Phoenix], eatType[pub], food[Fast food], priceRange[more than £30], customer rating[high], area[riverside], familyFriendly[no], near[Café Sicilia]"	"Located in the riverside area, near Café Sicilia, The Phoenix is a Fast food pub that has a high customer rating and a price range of more than £30. It is not child friendly."
"name[The Phoenix], eatType[pub], food[Fast food], priceRange[more than £30], customer rating[high], area[riverside], familyFriendly[yes], near[Café Sicilia]"	"Located near the Café Sicilia in the riverside area, The Phoenix is a child friendly Fast food pub with a high price range."
"name[The Phoenix], eatType[pub], food[French], priceRange[£20-25], area[riverside], familyFriendly[yes], near[Raja Indian Cuisine]"	In the riverside area near Raja Indian Cuisine is a French pub called The Phoenix that is kid friendly and has a price range of £20-25
"name[The Phoenix], eatType[pub], food[French], priceRange[£20-25], customer rating[3 out of 5], area[city centre], familyFriendly[no], near[Café Sicilia]"	"In the city centre near Café Sicilia, there is a French restaurant called The Phoenix. It is not kid friendly and has a price range of £20-25 and a customer rating of 3 out of 5."
"name[The Phoenix], eatType[pub], food[French], priceRange[£20-25], customer rating[3 out of 5], area[city centre], familyFriendly[yes], near[Café Sicilia]"	"Located near Café Sicilia in the city centre, The Phoenix is a kid friendly French restaurant with a price range of £20-25 and a customer rating of 3 out of 5."
"name[The Phoenix], eatType[pub], food[French], priceRange[£20-25], customer rating[3 out of 5], area[riverside], familyFriendly[no], near[Café Sicilia]"	"In the riverside area near Café Sicilia is a French restaurant called The Phoenix. It has a moderate price range and a customer rating of 3 out of 5, and is not kid friendly."
"name[The Phoenix], eatType[pub], food[French], priceRange[£20-25], customer rating[3 out of 5], area[riverside], familyFriendly[yes], near[Café Sicilia]"	In the riverside area near Café Sicilia is a kid friendly French restaurant called The Phoenix. It has a customer rating of 3 out of 5 and a price range of £20-25.
"name[The Phoenix], eatType[pub], food[French], priceRange[£20-25], customer rating[3 out of 5], area[riverside], familyFriendly[yes], near[Crowne Plaza Hotel]"	In the riverside area near Crowne Plaza Hotel is a kid friendly French restaurant called The Phoenix. It has a customer rating of 3 out of 5 and a price range of £20-25.
"name[The Phoenix], eatType[pub], food[French], priceRange[£20-25], customer rating[high], area[city centre], familyFriendly[no], near[Crowne Plaza Hotel]"	"The Phoenix is a French restaurant near the Crowne Plaza Hotel in the city centre. It is not kid friendly, has a high customer rating and is in the price range of £20-25."
"name[The Phoenix], eatType[pub], food[French], priceRange[£20-25], customer rating[high], area[city centre], familyFriendly[yes], near[Crowne Plaza Hotel]"	"Located near Crowne Plaza Hotel in the city centre, The Phoenix is a child friendly French restaurant with a price range of £20-25 and a high customer rating."
"name[The Phoenix], eatType[pub], food[French], priceRange[£20-25], customer rating[high], area[riverside], familyFriendly[no], near[Crowne Plaza Hotel]"	Near the Crowne Plaza Hotel in the riverside area is a French restaurant called The Phoenix. It is not kid friendly and has a high customer rating and a price range of £20-25.
"name[The Phoenix], eatType[pub], food[French], priceRange[£20-25], customer rating[high], area[riverside], familyFriendly[yes], near[Crowne Plaza Hotel]"	Near the Crowne Plaza Hotel in the riverside area is a kid friendly pub called The Phoenix that serves French food and has a high customer rating and a price range of £20-25.
"name[The Phoenix], eatType[pub], food[French], priceRange[cheap], area[riverside], familyFriendly[yes], near[Raja Indian Cuisine]"	"The Phoenix is a cheap, family friendly, French pub near Raja Indian Cuisine in the riverside area."
"name[The Phoenix], eatType[pub], food[French], priceRange[cheap], customer rating[5 out of 5], area[city centre], familyFriendly[no], near[Crowne Plaza Hotel]"	"The Phoenix is a French restaurant in the city centre near Crowne Plaza Hotel. It is not family-friendly, has a customer rating of 5 out of 5 and has a cheap price range."
"name[The Phoenix], eatType[pub], food[French], priceRange[cheap], customer rating[5 out of 5], area[city centre], familyFriendly[yes], near[Crowne Plaza Hotel]"	"Located in the city centre near Crowne Plaza Hotel, The Phoenix is a family-friendly French restaurant with a customer rating of 5 out of 5."
"name[The Phoenix], eatType[pub], food[French], priceRange[cheap], customer rating[5 out of 5], area[riverside], familyFriendly[no], near[Crowne Plaza Hotel]"	A cheap French restaurant in riverside near Crowne Plaza Hotel is The Phoenix. It has a customer rating of 5 out of 5 and is not family-friendly.
"name[The Phoenix], eatType[pub], food[French], priceRange[cheap], customer rating[5 out of 5], area[riverside], familyFriendly[yes], near[Crowne Plaza Hotel]"	A cheap French food place in the riverside area near the Crowne Plaza Hotel is The Phoenix. It has a customer rating of 5 out of 5 and is family friendly.
"name[The Phoenix], eatType[pub], food[French], priceRange[high], area[riverside], familyFriendly[yes], near[Raja Indian Cuisine]"	"The Phoenix is a high priced, child friendly, French pub near Raja Indian Cuisine in the riverside area."
"name[The Phoenix], eatType[pub], food[French], priceRange[high], customer rating[3 out of 5], area[city centre], familyFriendly[no], near[Crowne Plaza Hotel]"	"The Phoenix, located near Crowne Plaza Hotel in the city centre, is a French pub with a high price range and a customer rating of 3 out of 5. it is not children friendly."
"name[The Phoenix], eatType[pub], food[French], priceRange[high], customer rating[3 out of 5], area[city centre], familyFriendly[yes], near[Crowne Plaza Hotel]"	"Located near Crowne Plaza Hotel in the city centre, The Phoenix is a child friendly French pub with a high price range and a customer rating of 3 out of 5."
"name[The Phoenix], eatType[pub], food[French], priceRange[high], customer rating[3 out of 5], area[riverside], familyFriendly[no], near[Crowne Plaza Hotel]"	The Phoenix is a French restaurant in the riverside area near Crowne Plaza Hotel. It has a high price range and a customer rating of 3 out of 5 and is not child friendly.
"name[The Phoenix], eatType[pub], food[French], priceRange[high], customer rating[3 out of 5], area[riverside], familyFriendly[yes], near[Crowne Plaza Hotel]"	Near the Crowne Plaza Hotel in the riverside area is a child friendly pub called The Phoenix that serves French food in the high price range and has a customer rating of 3 out of 5
"name[The Phoenix], eatType[pub], food[French], priceRange[less than £20], customer rating[average], area[city centre], familyFriendly[no], near[Crowne Plaza Hotel]"	"Located in the city centre near Crowne Plaza Hotel, The Phoenix is a French pub with a price range of less than £20 and has an average customer rating."
"name[The Phoenix], eatType[pub], food[French], priceRange[less than £20], customer rating[average], area[city centre], familyFriendly[yes], near[Crowne Plaza Hotel]"	"Located near Crowne Plaza Hotel in the city centre, The Phoenix is a family-friendly French pub with a price range of less than £20 and has an average customer rating."
"name[The Phoenix], eatType[pub], food[French], priceRange[less than £20], customer rating[average], area[riverside], familyFriendly[no], near[Crowne Plaza Hotel]"	"Located near Crowne Plaza Hotel in the riverside area, The Phoenix is a French pub with an average customer rating and a price range of less than £20, but is not family-friendly."
"name[The Phoenix], eatType[pub], food[French], priceRange[less than £20], customer rating[average], area[riverside], familyFriendly[yes], near[Crowne Plaza Hotel]"	Near the Crowne Plaza Hotel in the riverside area is a family friendly pub called the The Phoenix which has a price range of less than £20 and an average customer rating.
"name[The Phoenix], eatType[pub], food[French], priceRange[less than £20], customer rating[low], area[city centre], familyFriendly[no], near[Crowne Plaza Hotel]"	The The Phoenix is a French pub in the city centre near Crowne Plaza Hotel with a low customer rating but a price range of less than £20.
"name[The Phoenix], eatType[pub], food[French], priceRange[less than £20], customer rating[low], area[city centre], familyFriendly[yes], near[Crowne Plaza Hotel]"	"The Phoenix is a French pub located near the Crowne Plaza Hotel in the city centre. It has a low customer rating and is family-friendly, but the price range is less than £20."
"name[The Phoenix], eatType[pub], food[French], priceRange[less than £20], customer rating[low], area[riverside], familyFriendly[no], near[Crowne Plaza Hotel]"	In the riverside area near Crowne Plaza Hotel is a French pub called The Phoenix. It is not family-friendly and has a low customer rating and a price range of less than £20.
"name[The Phoenix], eatType[pub], food[French], priceRange[less than £20], customer rating[low], area[riverside], familyFriendly[yes], near[Crowne Plaza Hotel]"	"In the riverside area, near the Crowne Plaza Hotel, is a low priced pub called The Phoenix."
"name[The Phoenix], eatType[pub], food[French], priceRange[moderate], customer rating[1 out of 5], area[city centre], familyFriendly[no], near[Crowne Plaza Hotel]"	"The Phoenix, located near the Crowne Plaza Hotel in the city centre, is a moderately priced French pub with a customer rating of 1 out of 5. it is not kid friendly."
"name[The Phoenix], eatType[pub], food[French], priceRange[moderate], customer rating[1 out of 5], area[city centre], familyFriendly[yes], near[Crowne Plaza Hotel]"	"Located near Crowne Plaza Hotel in the city centre, The Phoenix is a kid friendly French pub with a moderate price range and a customer rating of 1 out of 5."
"name[The Phoenix], eatType[pub], food[French], priceRange[moderate], customer rating[1 out of 5], area[riverside], familyFriendly[no], near[Crowne Plaza Hotel]"	"The Phoenix is a French pub near Crowne Plaza Hotel in the riverside area. It is not kid friendly, has a moderate price range and has a customer rating of 1 out of 5."
"name[The Phoenix], eatType[pub], food[French], priceRange[moderate], customer rating[1 out of 5], area[riverside], familyFriendly[yes], near[Crowne Plaza Hotel]"	"The Phoenix is a French pub near Crowne Plaza Hotel in the riverside area. It is kid friendly, has a moderate price range and a customer rating of 1 out of 5."
"name[The Phoenix], eatType[pub], food[French], priceRange[more than £30], customer rating[5 out of 5], area[city centre], familyFriendly[no], near[Crowne Plaza Hotel]"	"The Phoenix is a French pub near the Crowne Plaza Hotel in the city centre. It is not child friendly, has a customer rating of 5 out of 5 and has a price range of more than £30."
"name[The Phoenix], eatType[pub], food[French], priceRange[more than £30], customer rating[5 out of 5], area[city centre], familyFriendly[yes], near[Crowne Plaza Hotel]"	"The Phoenix is a French pub near the Crowne Plaza Hotel in the city centre. It is children friendly, has a customer rating of 5 out of 5 and has a price range of more than £30."
"name[The Phoenix], eatType[pub], food[French], priceRange[more than £30], customer rating[5 out of 5], area[riverside], familyFriendly[no], near[Crowne Plaza Hotel]"	"Located in the riverside area, near Crowne Plaza Hotel, The Phoenix is a highly priced French restaurant. It has a customer rating of 5 out of 5 and is not child friendly."
"name[The Phoenix], eatType[pub], food[French], priceRange[more than £30], customer rating[5 out of 5], area[riverside], familyFriendly[yes], near[Crowne Plaza Hotel]"	"Located in riverside near Crowne Plaza Hotel, The Phoenix is a highly priced French pub with a customer rating of 5 out of 5."
"name[The Phoenix], eatType[pub], food[French], priceRange[more than £30], customer rating[low], area[city centre], familyFriendly[no], near[Crowne Plaza Hotel]"	"Located near Crowne Plaza Hotel in the city centre, The Phoenix is a French pub with a low customer rating and a price range of more than £30. It is not child friendly."
"name[The Phoenix], eatType[pub], food[French], priceRange[more than £30], customer rating[low], area[city centre], familyFriendly[yes], near[Crowne Plaza Hotel]"	"The Phoenix is a French pub near the Crowne Plaza Hotel in the city centre. It is children friendly, has a low customer rating and a price range of more than £30."
"name[The Phoenix], eatType[pub], food[French], priceRange[more than £30], customer rating[low], area[riverside], familyFriendly[no], near[Crowne Plaza Hotel]"	"Near the Crowne Plaza Hotel is a French pub called the The Phoenix. It is in the riverside area, has a low customer rating and is in the price range of more than £30. It is not children friendly."
"name[The Phoenix], eatType[pub], food[French], priceRange[more than £30], customer rating[low], area[riverside], familyFriendly[yes], near[Crowne Plaza Hotel]"	"In the riverside area, near the Crowne Plaza Hotel is a French pub called The Phoenix. It is child friendly and has a low customer rating."
"name[The Phoenix], eatType[restaurant], food[Fast food], priceRange[cheap], area[riverside], familyFriendly[yes], near[Raja Indian Cuisine]"	"The Phoenix is a cheap, family friendly, Fast food restaurant near Raja Indian Cuisine in the riverside area."
"name[The Phoenix], eatType[restaurant], food[Fast food], priceRange[high], area[city centre], familyFriendly[no], near[Raja Indian Cuisine]"	The Phoenix is a Fast food restaurant near Raja Indian Cuisine in the city centre with a high price range and is not child friendly.
"name[The Phoenix], eatType[restaurant], food[Fast food], priceRange[high], area[city centre], familyFriendly[yes], near[Raja Indian Cuisine]"	"Located near Raja Indian Cuisine in the city centre, The Phoenix is a child friendly Fast food restaurant with a high price range."
"name[The Phoenix], eatType[restaurant], food[Fast food], priceRange[high], area[riverside], familyFriendly[no], near[Raja Indian Cuisine]"	"Located near Raja Indian Cuisine in the riverside area, The Phoenix is a Fast food restaurant with a high price range and is not child friendly."
"name[The Phoenix], eatType[restaurant], food[Fast food], priceRange[high], area[riverside], familyFriendly[yes], near[Raja Indian Cuisine]"	"Located in the riverside area near Raja Indian Cuisine, The Phoenix is a child friendly Fast food restaurant with a high price range."
"name[The Phoenix], eatType[restaurant], food[Fast food], priceRange[less than £20], area[city centre], familyFriendly[no], near[Raja Indian Cuisine]"	"Located near Raja Indian Cuisine in the city centre, The Phoenix is a non family-friendly Fast food restaurant with a price range of less than £20."
"name[The Phoenix], eatType[restaurant], food[Fast food], priceRange[less than £20], area[city centre], familyFriendly[yes], near[Raja Indian Cuisine]"	"Located near Raja Indian Cuisine in the city centre, The Phoenix is a family-friendly Fast food restaurant with a price range less than £20."
"name[The Phoenix], eatType[restaurant], food[Fast food], priceRange[less than £20], area[riverside], familyFriendly[no], near[Raja Indian Cuisine]"	"The Phoenix is a Fast food restaurant in the riverside area, near Raja Indian Cuisine. It is not family-friendly, has a price range of less than £20."
"name[The Phoenix], eatType[restaurant], food[Fast food], priceRange[less than £20], area[riverside], familyFriendly[yes], near[Raja Indian Cuisine]"	The Phoenix is a family friendly Fast food restaurant with a price range of less than £20 near Raja Indian Cuisine in the riverside area.
"name[The Phoenix], eatType[restaurant], food[Fast food], priceRange[moderate], area[city centre], familyFriendly[no], near[Raja Indian Cuisine]"	"Located near Raja Indian Cuisine in the city centre, The Phoenix is a Fast food restaurant that is not kid friendly with a moderate price range."
"name[The Phoenix], eatType[restaurant], food[Fast food], priceRange[moderate], area[city centre], familyFriendly[yes], near[Raja Indian Cuisine]"	"Located near Raja Indian Cuisine in the city centre, The Phoenix is a kid friendly Fast food restaurant with a moderate price range."
"name[The Phoenix], eatType[restaurant], food[Fast food], priceRange[moderate], area[riverside], familyFriendly[no], near[Raja Indian Cuisine]"	"The Phoenix is a moderately priced Fast food restaurant, not kid friendly, located near Raja Indian Cuisine in the riverside area."
"name[The Phoenix], eatType[restaurant], food[Fast food], priceRange[moderate], area[riverside], familyFriendly[yes], near[Raja Indian Cuisine]"	"The Phoenix is a moderately priced, kid friendly, Fast food restaurant near Raja Indian Cuisine in the riverside area."
"name[The Phoenix], eatType[restaurant], food[Fast food], priceRange[more than £30], area[riverside], familyFriendly[yes], near[Raja Indian Cuisine]"	"Located near Raja Indian Cuisine in riverside, The Phoenix is a child friendly Fast food restaurant with a price range of more than £30."
"name[The Phoenix], eatType[restaurant], food[French], priceRange[£20-25], area[riverside], familyFriendly[yes], near[Raja Indian Cuisine]"	"Located near Raja Indian Cuisine in riverside, The Phoenix is a kid friendly French restaurant with a price range of £20-25."
"name[The Phoenix], eatType[restaurant], food[French], priceRange[cheap], area[riverside], familyFriendly[yes], near[Raja Indian Cuisine]"	"The Phoenix is a cheap, family friendly, French restaurant near Raja Indian Cuisine in the riverside area."
"name[The Phoenix], eatType[restaurant], food[French], priceRange[high], area[riverside], familyFriendly[yes], near[Raja Indian Cuisine]"	"Located in riverside, near Raja Indian Cuisine, The Phoenix is a child friendly French restaurant with a high price range."
"name[The Phoenix], eatType[restaurant], food[Indian], priceRange[£20-25], customer rating[high], area[city centre], familyFriendly[no], near[Crowne Plaza Hotel]"	The Phoenix is an Indian restaurant near Crowne Plaza Hotel in the city centre with a high customer rating and a price range of £20-25. It is not kid friendly.
"name[The Phoenix], eatType[restaurant], food[Indian], priceRange[£20-25], customer rating[high], area[city centre], familyFriendly[yes], near[Crowne Plaza Hotel]"	"Located near Crowne Plaza Hotel in the city centre, The Phoenix is an Indian restaurant with a price range of £20-25 and a high customer rating. It is kid friendly."
"name[The Phoenix], eatType[restaurant], food[Indian], priceRange[£20-25], customer rating[high], area[riverside], familyFriendly[no], near[Crowne Plaza Hotel]"	"Located near Crowne Plaza Hotel in the riverside area, The Phoenix is an Indian restaurant that is not kid friendly with a high customer rating and a price range of £20-25."
"name[The Phoenix], eatType[restaurant], food[Indian], priceRange[£20-25], customer rating[high], area[riverside], familyFriendly[yes], near[Crowne Plaza Hotel]"	"The Phoenix is an Indian restaurant near Crowne Plaza Hotel in the riverside area. It has a high customer rating, is kid friendly, and has a price range of £20-25."
"name[The Phoenix], eatType[restaurant], food[Indian], priceRange[cheap], customer rating[5 out of 5], area[city centre], familyFriendly[no], near[Crowne Plaza Hotel]"	"Located in the city centre near Crowne Plaza Hotel, The Phoenix is a cheap Indian restaurant with a 5 out of 5 customer rating. It is not family-friendly."
"name[The Phoenix], eatType[restaurant], food[Indian], priceRange[cheap], customer rating[5 out of 5], area[city centre], familyFriendly[yes], near[Crowne Plaza Hotel]"	"Located in the city centre near Crowne Plaza Hotel, The Phoenix is a family-friendly Indian restaurant with a customer rating of 5 out of 5 and a cheap price range."
"name[The Phoenix], eatType[restaurant], food[Indian], priceRange[cheap], customer rating[5 out of 5], area[riverside], familyFriendly[no], near[Crowne Plaza Hotel]"	"Located near Crowne Plaza Hotel in riverside, The Phoenix is a cheap Indian restaurant with a 5 out of 5 customer rating. It is not family friendly."
"name[The Phoenix], eatType[restaurant], food[Indian], priceRange[cheap], customer rating[5 out of 5], area[riverside], familyFriendly[no], near[Express by Holiday Inn]"	The Phoenix is a cheap Indian restaurant with a 5 out of 5 customer rating. It is located in the riverside area near Express by Holiday Inn and is not family friendly.
"name[The Phoenix], eatType[restaurant], food[Indian], priceRange[cheap], customer rating[5 out of 5], area[riverside], familyFriendly[yes], near[Express by Holiday Inn]"	"The Phoenix is a cheap, family friendly, Indian restaurant in the riverside area near Express by Holiday Inn. It has a customer rating of 5 out of 5."
"name[The Phoenix], eatType[restaurant], food[Indian], priceRange[cheap], customer rating[average], area[city centre], familyFriendly[no], near[Express by Holiday Inn]"	"Located in the city centre near Express by Holiday Inn, The Phoenix is a cheap Indian restaurant with an average customer rating and is not family friendly."
"name[The Plough], eatType[pub], food[Chinese], priceRange[£20-25], area[riverside], familyFriendly[yes], near[Raja Indian Cuisine]"	In the riverside area near Raja Indian Cuisine is a Chinese pub called The Plough that is kid friendly and has a price range of £20-25
"name[The Plough], eatType[pub], food[Chinese], priceRange[cheap], area[riverside], familyFriendly[yes], near[Raja Indian Cuisine]"	"The Plough is a cheap, family friendly, Chinese pub near Raja Indian Cuisine in the riverside area."
"name[The Plough], eatType[pub], food[Chinese], priceRange[high], area[city centre], familyFriendly[no], near[Raja Indian Cuisine]"	In the city centre near Raja Indian Cuisine is a Chinese pub called The Plough. It is not child friendly and has a high price range.
"name[The Plough], eatType[pub], food[Chinese], priceRange[high], area[city centre], familyFriendly[yes], near[Raja Indian Cuisine]"	"Located near Raja Indian Cuisine in the city centre, The Plough is a child friendly Chinese pub with a high price range."
"name[The Plough], eatType[pub], food[Chinese], priceRange[high], area[riverside], familyFriendly[no], near[Raja Indian Cuisine]"	"The Plough, located near Raja Indian Cuisine in the riverside area, is a Chinese pub with a high price range. It is not child friendly."
"name[The Plough], eatType[pub], food[Chinese], priceRange[high], area[riverside], familyFriendly[yes], near[Raja Indian Cuisine]"	"The Plough is a high priced, child friendly, Chinese pub near Raja Indian Cuisine in the riverside area."
"name[The Plough], eatType[pub], food[Chinese], priceRange[less than £20], area[city centre], familyFriendly[no], near[Raja Indian Cuisine]"	"Located near Raja Indian Cuisine in the city centre, The Plough is a non family-friendly pub with a price range of less than £20."
"name[The Plough], eatType[restaurant], food[Chinese], priceRange[£20-25], area[riverside], familyFriendly[yes], near[Raja Indian Cuisine]"	"Located near Raja Indian Cuisine in riverside, The Plough is a kid friendly Chinese restaurant with a price range of £20-25."
"name[The Plough], eatType[restaurant], food[Chinese], priceRange[cheap], area[riverside], familyFriendly[yes], near[Raja Indian Cuisine]"	"The Plough is a cheap, family friendly, Chinese restaurant near Raja Indian Cuisine in the riverside area."
"name[The Plough], eatType[restaurant], food[Chinese], priceRange[high], area[city centre], familyFriendly[no], near[Raja Indian Cuisine]"	"Located near Raja Indian Cuisine in the city centre, The Plough is a Chinese restaurant that is not child friendly with a high price range."
"name[The Plough], eatType[restaurant], food[Chinese], priceRange[high], area[city centre], familyFriendly[yes], near[Raja Indian Cuisine]"	"The Plough, located near Raja Indian Cuisine in the city centre, is a child friendly Chinese pub with a high price range."
"name[The Plough], eatType[restaurant], food[Chinese], priceRange[high], area[riverside], familyFriendly[no], near[Raja Indian Cuisine]"	"The Plough, located near Raja Indian Cuisine in the riverside area, is a Chinese restaurant with a high price range. It is not child friendly."
"name[The Plough], eatType[restaurant], food[Chinese], priceRange[high], area[riverside], familyFriendly[yes], near[Raja Indian Cuisine]"	"Located in riverside, near Raja Indian Cuisine, The Plough is a child friendly Chinese restaurant with a high price range."
"name[The Plough], eatType[restaurant], food[Chinese], priceRange[less than £20], area[city centre], familyFriendly[no], near[Raja Indian Cuisine]"	"The Plough, located near Raja Indian Cuisine in the city centre, is a Chinese restaurant with a price range of less than £20. It is not family-friendly."
"name[The Punter], eatType[pub], food[Chinese], priceRange[less than £20], area[city centre], familyFriendly[yes], near[Raja Indian Cuisine]"	"The Punter, a family-friendly pub near Raja Indian Cuisine in the city centre, serves Chinese food for less than £20."
"name[The Punter], eatType[pub], food[Chinese], priceRange[less than £20], area[riverside], familyFriendly[no], near[Raja Indian Cuisine]"	"In the riverside area, near Raja Indian Cuisine, is a cheap pub called The Punter. It serves Chinese food and is not family friendly."
"name[The Punter], eatType[pub], food[Chinese], priceRange[less than £20], area[riverside], familyFriendly[yes], near[Raja Indian Cuisine]"	The Punter is a family friendly pub that serves Chinese food for less than £20 near Raja Indian Cuisine in the riverside area.
"name[The Punter], eatType[pub], food[Chinese], priceRange[moderate], area[city centre], familyFriendly[no], near[Raja Indian Cuisine]"	"In the city centre, near Raja Indian Cuisine, there is a Chinese pub called The Punter. It is not kid friendly and has a moderate price range."
"name[The Punter], eatType[pub], food[Chinese], priceRange[moderate], area[city centre], familyFriendly[yes], near[Raja Indian Cuisine]"	"Located near Raja Indian Cuisine in the city centre, The Punter is a kid friendly Chinese pub with a moderate price range."
"name[The Punter], eatType[pub], food[Chinese], priceRange[moderate], area[riverside], familyFriendly[no], near[Raja Indian Cuisine]"	"The Punter, located near Raja Indian Cuisine in the riverside area, is a moderately priced pub that serves Chinese food. It is not kid friendly."
"name[The Punter], eatType[pub], food[Chinese], priceRange[moderate], area[riverside], familyFriendly[yes], near[Raja Indian Cuisine]"	"A kid friendly pub located near Raja Indian Cuisine in the riverside area, The Punter serves Chinese food and has a moderate price range."
"name[The Punter], eatType[pub], food[Chinese], priceRange[more than £30], area[riverside], familyFriendly[yes], near[Raja Indian Cuisine]"	Located near Raja Indian Cuisine in the riverside area is a child friendly pub called The Punter that serves Chinese food and has a price range of more than £30.
"name[The Punter], eatType[pub], food[English], priceRange[£20-25], area[riverside], familyFriendly[yes], near[Raja Indian Cuisine]"	The Punter is a pub that serves English food in the riverside area near Raja Indian Cuisine. It is kid friendly and has a price range of £20-25.
"name[The Punter], eatType[pub], food[English], priceRange[cheap], area[riverside], familyFriendly[yes], near[Raja Indian Cuisine]"	"The Punter is a cheap, family friendly, English pub near Raja Indian Cuisine in the riverside area."
"name[The Punter], eatType[pub], food[English], priceRange[high], area[city centre], familyFriendly[no], near[Raja Indian Cuisine]"	"Located near Raja Indian Cuisine in the city centre, The Punter is an English pub with a high price range and is not child friendly."
"name[The Punter], eatType[pub], food[English], priceRange[high], area[city centre], familyFriendly[yes], near[Raja Indian Cuisine]"	"Located near Raja Indian Cuisine in the city centre, The Punter is a child friendly English pub with a high price range."
"name[The Punter], eatType[pub], food[English], priceRange[high], area[riverside], familyFriendly[no], near[Raja Indian Cuisine]"	The Punter is a pub that serves English food in the high price range. It is located in the riverside area near Raja Indian Cuisine and is not children friendly.
"name[The Punter], eatType[pub], food[English], priceRange[high], area[riverside], familyFriendly[yes], near[Raja Indian Cuisine]"	"Located near Raja Indian Cuisine in riverside, The Punter is a child friendly pub with a high price range."
"name[The Punter], eatType[pub], food[Italian], priceRange[high], customer rating[average], area[city centre], familyFriendly[no], near[Rainbow Vegetarian Café]"	"Located near Rainbow Vegetarian Café in the city centre, The Punter is an Italian pub with a high price range and an average customer rating and is not child friendly."
"name[The Punter], eatType[restaurant], food[Chinese], priceRange[less than £20], area[city centre], familyFriendly[yes], near[Raja Indian Cuisine]"	The Punter is a family-friendly Chinese restaurant with a price range less than £20 near Raja Indian Cuisine in the city centre.
"name[The Punter], eatType[restaurant], food[Chinese], priceRange[less than £20], area[riverside], familyFriendly[no], near[Raja Indian Cuisine]"	"Located near Raja Indian Cuisine, in the riverside area, The Punter is a non family-friendly Chinese restaurant with a price range of less than £20."
"name[The Punter], eatType[restaurant], food[Chinese], priceRange[less than £20], area[riverside], familyFriendly[yes], near[Raja Indian Cuisine]"	"Located near Raja Indian Cuisine in riverside, The Punter is a family friendly Chinese restaurant with a price range less than £20."
"name[The Punter], eatType[restaurant], food[Chinese], priceRange[moderate], area[city centre], familyFriendly[no], near[Raja Indian Cuisine]"	"In the city centre, near Raja Indian Cuisine, there is a Chinese restaurant called The Punter. It is not kid friendly and has a moderate price range."
"name[The Punter], eatType[restaurant], food[Chinese], priceRange[moderate], area[city centre], familyFriendly[yes], near[Raja Indian Cuisine]"	"Located near Raja Indian Cuisine in the city centre, The Punter is a kid friendly Chinese restaurant with a moderate price range."
"name[The Punter], eatType[restaurant], food[Chinese], priceRange[moderate], area[riverside], familyFriendly[no], near[Raja Indian Cuisine]"	"Near Raja Indian Cuisine, in the riverside area is a Chinese restaurant called The Punter. It has a moderate price range and is not kid friendly."
"name[The Punter], eatType[restaurant], food[Chinese], priceRange[moderate], area[riverside], familyFriendly[yes], near[Raja Indian Cuisine]"	"The Punter, located near Raja Indian Cuisine in riverside, is a family friendly Chinese restaurant with a moderate price range."
"name[The Punter], eatType[restaurant], food[Chinese], priceRange[more than £30], area[riverside], familyFriendly[yes], near[Raja Indian Cuisine]"	"The Punter, located near Raja Indian Cuisine in the riverside area, is a child friendly Chinese restaurant with a price range of more than £30."
"name[The Punter], eatType[restaurant], food[English], priceRange[£20-25], area[riverside], familyFriendly[yes], near[Raja Indian Cuisine]"	Near Raja Indian Cuisine in the riverside area is a kid friendly restaurant called The Punter that serves English food and has a price range of £20-25.
"name[The Punter], eatType[restaurant], food[English], priceRange[cheap], area[riverside], familyFriendly[yes], near[Raja Indian Cuisine]"	Near Raja Indian Cuisine in the riverside area is a cheap family friendly English restaurant called The Punter
"name[The Punter], eatType[restaurant], food[English], priceRange[high], area[city centre], familyFriendly[no], near[Raja Indian Cuisine]"	"Near Raja Indian Cuisine, in the city centre, is an English restaurant called The Punter. It has a high price range and is not child friendly."
"name[The Punter], eatType[restaurant], food[English], priceRange[high], area[city centre], familyFriendly[yes], near[Raja Indian Cuisine]"	"Located near Raja Indian Cuisine in the city centre, The Punter is a child friendly English restaurant with a high price range."
"name[The Punter], eatType[restaurant], food[English], priceRange[high], area[riverside], familyFriendly[no], near[Raja Indian Cuisine]"	"Located near Raja Indian Cuisine, The Punter is an English restaurant with a high price range. It is not child friendly and is in the riverside area."
"name[The Punter], eatType[restaurant], food[English], priceRange[high], area[riverside], familyFriendly[yes], near[Raja Indian Cuisine]"	"Located in the riverside area near Raja Indian Cuisine, The Punter is a child friendly English restaurant with a high price range."
"name[The Punter], eatType[restaurant], food[Indian], priceRange[cheap], customer rating[average], area[city centre], familyFriendly[yes], near[Express by Holiday Inn]"	"The Punter is a cheap, family-friendly Indian restaurant in the city centre near Express by Holiday Inn with an average customer rating."
"name[The Punter], eatType[restaurant], food[Indian], priceRange[cheap], customer rating[average], area[riverside], familyFriendly[no], near[Express by Holiday Inn]"	"The Punter is an Indian restaurant near Express by Holiday Inn in the riverside area. It has an average customer rating, is not family-friendly, and has a cheap price range."
"name[The Punter], eatType[restaurant], food[Indian], priceRange[cheap], customer rating[average], area[riverside], familyFriendly[yes], near[Express by Holiday Inn]"	"The Punter is an Indian restaurant near Express by Holiday Inn in the riverside area. It is cheap and family friendly, has an average customer rating."
"name[The Punter], eatType[restaurant], food[Indian], priceRange[high], customer rating[1 out of 5], area[city centre], familyFriendly[no], near[Express by Holiday Inn]"	"Located in the city centre near Express by Holiday Inn, The Punter is a non child friendly Indian restaurant with a high price range and a customer rating of 1 out of 5."
"name[The Punter], eatType[restaurant], food[Indian], priceRange[high], customer rating[1 out of 5], area[city centre], familyFriendly[yes], near[Express by Holiday Inn]"	The Punter is a child friendly Indian restaurant in the city centre near Express by Holiday Inn with a high price range and a customer rating of 1 out of 5.
"name[The Punter], eatType[restaurant], food[Indian], priceRange[high], customer rating[1 out of 5], area[riverside], familyFriendly[no], near[Express by Holiday Inn]"	"The Punter is an Indian restaurant near Express by Holiday Inn in the riverside area. It is not child friendly, has a high price range and has a customer rating of 1 out of 5."
"name[The Punter], eatType[restaurant], food[Indian], priceRange[high], customer rating[1 out of 5], area[riverside], familyFriendly[yes], near[Express by Holiday Inn]"	"The Punter is a family friendly Indian restaurant near Express by Holiday Inn in the riverside area, with a high price range and a customer rating of 1 out of 5."
"name[The Punter], eatType[restaurant], food[Indian], priceRange[high], customer rating[average], area[city centre], familyFriendly[no], near[Express by Holiday Inn]"	"Located in the city centre near Express by Holiday Inn, The Punter is an Indian restaurant with a high price range and an average customer rating and is not child friendly."
"name[The Punter], eatType[restaurant], food[Indian], priceRange[high], customer rating[average], area[city centre], familyFriendly[yes], near[Express by Holiday Inn]"	The Punter is a high priced Indian restaurant in the city centre near Express by Holiday Inn with an average customer rating and is children friendly.
"name[The Punter], eatType[restaurant], food[Indian], priceRange[high], customer rating[average], area[riverside], familyFriendly[no], near[Express by Holiday Inn]"	The Punter is an Indian restaurant in the riverside area near the Express by Holiday Inn. It has a high price range and an average customer rating and is not child friendly.
"name[The Punter], eatType[restaurant], food[Indian], priceRange[high], customer rating[average], area[riverside], familyFriendly[yes], near[Express by Holiday Inn]"	"Located near Express by Holiday Inn in the riverside area, The Punter is a child friendly Indian restaurant with a high price range and an average customer rating."
"name[The Punter], eatType[restaurant], food[Indian], priceRange[less than £20], customer rating[low], area[city centre], familyFriendly[no], near[Express by Holiday Inn]"	"The Punter is an Indian restaurant near Express by Holiday Inn in the city centre. It is not family-friendly, has a price range of less than £20 and has a low customer rating."
"name[The Punter], eatType[restaurant], food[Indian], priceRange[less than £20], customer rating[low], area[city centre], familyFriendly[yes], near[Express by Holiday Inn]"	The Punter is a family friendly Indian restaurant in the city centre near Express by Holiday Inn with a price range of less than £20 with a low customer rating.
"name[The Punter], eatType[restaurant], food[Indian], priceRange[less than £20], customer rating[low], area[riverside], familyFriendly[no], near[Express by Holiday Inn]"	"The Punter is an Indian restaurant near the Express by Holiday Inn in the riverside area. It is not family-friendly, has a low customer rating, and has a price range of less than £20."
"name[The Punter], eatType[restaurant], food[Indian], priceRange[less than £20], customer rating[low], area[riverside], familyFriendly[yes], near[Express by Holiday Inn]"	"Located near Express by Holiday Inn in the riverside area, The Punter is an Indian restaurant with a price range of less than £20 and a low customer rating. It is family friendly."
"name[The Punter], eatType[restaurant], food[Indian], priceRange[moderate], customer rating[1 out of 5], area[city centre], familyFriendly[no], near[Express by Holiday Inn]"	The Punter is a moderately priced Indian restaurant located in the city centre near Express by Holiday Inn. It is not kid friendly and is rated 1 out of 5.
"name[The Punter], eatType[restaurant], food[Indian], priceRange[moderate], customer rating[1 out of 5], area[city centre], familyFriendly[yes], near[Express by Holiday Inn]"	"Located in the city centre near Express by Holiday Inn, The Punter is a kid friendly Indian restaurant with a moderate price range and a customer rating of 1 out of 5."
"name[The Punter], eatType[restaurant], food[Indian], priceRange[moderate], customer rating[1 out of 5], area[riverside], familyFriendly[no], near[Express by Holiday Inn]"	"The Punter is an Indian restaurant near Express by Holiday Inn in the riverside area. It is not kid friendly, has a moderate price range and has a customer rating of 1 out of 5."
"name[The Punter], eatType[restaurant], food[Indian], priceRange[moderate], customer rating[1 out of 5], area[riverside], familyFriendly[yes], near[Express by Holiday Inn]"	"The Punter is a moderately priced, family friendly, Indian restaurant near Express by Holiday Inn in the riverside area. It has a customer rating of 1 out of 5."
"name[The Punter], eatType[restaurant], food[Indian], priceRange[moderate], customer rating[3 out of 5], area[city centre], familyFriendly[no], near[Express by Holiday Inn]"	The Punter is a moderately priced Indian restaurant in the city centre near Express by Holiday Inn. It is not kid friendly and is rated 3 out of 5.
"name[The Punter], eatType[restaurant], food[Indian], priceRange[moderate], customer rating[3 out of 5], area[city centre], familyFriendly[yes], near[Express by Holiday Inn]"	The Punter is a moderately priced Indian restaurant located in the city centre near Express by Holiday Inn. It is kid friendly and has a rating of 3 out of 5.
"name[The Punter], eatType[restaurant], food[Indian], priceRange[moderate], customer rating[3 out of 5], area[riverside], familyFriendly[no], near[Express by Holiday Inn]"	The Punter is an Indian restaurant in the riverside area near Express by Holiday Inn. It has a moderate price range and a customer rating of 3 out of 5 and is not kid friendly.
"name[The Punter], eatType[restaurant], food[Indian], priceRange[moderate], customer rating[3 out of 5], area[riverside], familyFriendly[yes], near[Express by Holiday Inn]"	"The Punter, located near Express by Holiday Inn in the riverside area is an Indian restaurant with a moderate price range and a customer rating of 3 out of 5 and is kid friendly."
"name[The Punter], eatType[restaurant], food[Indian], priceRange[more than £30], customer rating[high], area[city centre], familyFriendly[no], near[Express by Holiday Inn]"	"The Punter is an Indian restaurant near the Express by Holiday Inn in the city centre. It has a high customer rating, is not children friendly, and has a price range of more than £30."
"name[The Punter], eatType[restaurant], food[Indian], priceRange[more than £30], customer rating[high], area[city centre], familyFriendly[yes], near[Express by Holiday Inn]"	"In the city centre, near Express by Holiday Inn, there is a high priced Indian restaurant called The Punter. It has a high customer rating and is children friendly."
"name[The Punter], eatType[restaurant], food[Indian], priceRange[more than £30], customer rating[high], area[riverside], familyFriendly[no], near[Express by Holiday Inn]"	"The Punter is an Indian restaurant near Express by Holiday Inn in the riverside area. It has a high customer rating, is not children friendly, and has a price range of more than £30."
"name[The Punter], eatType[restaurant], food[Indian], priceRange[more than £30], customer rating[high], area[riverside], familyFriendly[yes], near[Express by Holiday Inn]"	"The Punter is an Indian restaurant near Express by Holiday Inn in the riverside area. It is child friendly, has a high customer rating, and has a price range of more than £30."
"name[The Punter], eatType[restaurant], food[Italian], priceRange[£20-25], customer rating[high], area[city centre], familyFriendly[no], near[Express by Holiday Inn]"	"The Punter is an Italian restaurant in the city centre near Express by Holiday Inn. It has a high customer rating, is not kid friendly, and has a price range of £20-25."
"name[The Punter], eatType[restaurant], food[Italian], priceRange[£20-25], customer rating[high], area[city centre], familyFriendly[yes], near[Express by Holiday Inn]"	The Punter is a family-friendly Italian restaurant in the city centre near Express by Holiday Inn with a high customer rating and a price range of £20-25.
"name[The Punter], eatType[restaurant], food[Italian], priceRange[£20-25], customer rating[high], area[riverside], familyFriendly[no], near[Express by Holiday Inn]"	"The Punter is an Italian restaurant near Express by Holiday Inn in the riverside area. It has a high customer rating, is not kid friendly, and has a price range of £20-25."
"name[The Punter], eatType[restaurant], food[Italian], priceRange[£20-25], customer rating[high], area[riverside], familyFriendly[yes], near[Express by Holiday Inn]"	The Punter is a family friendly Italian restaurant in the riverside area near Express by Holiday Inn. It has a high customer rating and a price range of £20-25.
"name[The Punter], eatType[restaurant], food[Italian], priceRange[cheap], customer rating[5 out of 5], area[city centre], familyFriendly[no], near[Express by Holiday Inn]"	"The Punter, located near Express by Holiday Inn in the city centre, is a cheap Italian restaurant with a 5 out of 5 customer rating."
"name[The Punter], eatType[restaurant], food[Italian], priceRange[cheap], customer rating[5 out of 5], area[city centre], familyFriendly[no], near[Rainbow Vegetarian Café]"	"Located in the city centre near Rainbow Vegetarian Café, The Punter is a cheap Italian restaurant with a 5 out of 5 customer rating. It is not family-friendly."
"name[The Punter], eatType[restaurant], food[Italian], priceRange[cheap], customer rating[5 out of 5], area[city centre], familyFriendly[yes], near[Rainbow Vegetarian Café]"	"Located in the city centre near Rainbow Vegetarian Café, The Punter is a family-friendly Italian restaurant with a customer rating of 5 out of 5 and a cheap price range."
"name[The Punter], eatType[restaurant], food[Italian], priceRange[cheap], customer rating[5 out of 5], area[riverside], familyFriendly[no], near[Rainbow Vegetarian Café]"	"Located near Rainbow Vegetarian Café in riverside, The Punter is a cheap Italian restaurant with a 5 out of 5 customer rating. It is not family friendly."
"name[The Punter], eatType[restaurant], food[Italian], priceRange[cheap], customer rating[5 out of 5], area[riverside], familyFriendly[yes], near[Rainbow Vegetarian Café]"	In the riverside area near the Rainbow Vegetarian Café is a cheap family friendly restaurant called The Punter which serves Italian food with a customer rating of 5 out of 5.
"name[The Punter], eatType[restaurant], food[Italian], priceRange[cheap], customer rating[average], area[city centre], familyFriendly[no], near[Rainbow Vegetarian Café]"	"Located in the city centre near Rainbow Vegetarian Café, The Punter is a cheap Italian restaurant with an average customer rating."
"name[The Punter], eatType[restaurant], food[Italian], priceRange[cheap], customer rating[average], area[city centre], familyFriendly[yes], near[Rainbow Vegetarian Café]"	"Located in the city centre near Rainbow Vegetarian Café, The Punter is a family-friendly Italian restaurant with an average customer rating, and a cheap price range."
"name[The Punter], eatType[restaurant], food[Italian], priceRange[cheap], customer rating[average], area[riverside], familyFriendly[no], near[Rainbow Vegetarian Café]"	"The Punter is an Italian restaurant near Rainbow Vegetarian Café in riverside. It has an average customer rating, is not family-friendly, and has a cheap price range."
"name[The Punter], eatType[restaurant], food[Italian], priceRange[cheap], customer rating[average], area[riverside], familyFriendly[yes], near[Rainbow Vegetarian Café]"	"Located near Rainbow Vegetarian Café in riverside, The Punter is a family friendly Italian restaurant with an average customer rating."
"name[The Punter], eatType[restaurant], food[Italian], priceRange[high], customer rating[1 out of 5], area[city centre], familyFriendly[no], near[Rainbow Vegetarian Café]"	"Located near Rainbow Vegetarian Café in the city centre, The Punter is a high priced Italian restaurant with a 1 out of 5 customer rating and is not child friendly."
"name[The Punter], eatType[restaurant], food[Italian], priceRange[high], customer rating[1 out of 5], area[city centre], familyFriendly[yes], near[Rainbow Vegetarian Café]"	"Located in the city centre near Rainbow Vegetarian Café, The Punter is a child friendly Italian restaurant with a high price range and a customer rating of 1 out of 5."
"name[The Punter], eatType[restaurant], food[Italian], priceRange[high], customer rating[1 out of 5], area[riverside], familyFriendly[no], near[Rainbow Vegetarian Café]"	"Located near Rainbow Vegetarian Café in the riverside area, The Punter is a high priced Italian restaurant with a 1 out of 5 customer rating. It is not child friendly."
"name[The Punter], eatType[restaurant], food[Italian], priceRange[high], customer rating[1 out of 5], area[riverside], familyFriendly[yes], near[Rainbow Vegetarian Café]"	"Located in the riverside area near the Rainbow Vegetarian Café, The Punter is a family friendly Italian restaurant with a high price range and a customer rating of 1 out of 5."
"name[The Vaults], eatType[pub], food[French], priceRange[high], area[riverside], familyFriendly[yes], near[Raja Indian Cuisine]"	"The Vaults is a high priced, child friendly, French pub near Raja Indian Cuisine in the riverside area."
"name[The Vaults], eatType[pub], food[French], priceRange[less than £20], area[city centre], familyFriendly[no], near[Raja Indian Cuisine]"	"Located near Raja Indian Cuisine in the city centre, The Vaults is a non family-friendly pub with a price range of less than £20."
"name[The Vaults], eatType[pub], food[French], priceRange[less than £20], area[city centre], familyFriendly[yes], near[Raja Indian Cuisine]"	"The Vaults, a family-friendly pub near Raja Indian Cuisine in the city centre, serves French food for less than £20."
"name[The Vaults], eatType[pub], food[French], priceRange[less than £20], area[riverside], familyFriendly[no], near[Raja Indian Cuisine]"	"In the riverside area, near Raja Indian Cuisine, is a cheap pub called The Vaults. It serves French food and is not family friendly."
"name[The Vaults], eatType[pub], food[French], priceRange[less than £20], area[riverside], familyFriendly[yes], near[Raja Indian Cuisine]"	The Vaults is a family friendly pub that serves French food for less than £20 near Raja Indian Cuisine in the riverside area.
"name[The Vaults], eatType[pub], food[French], priceRange[moderate], area[city centre], familyFriendly[no], near[Raja Indian Cuisine]"	"In the city centre, near Raja Indian Cuisine, there is a French pub called The Vaults. It is not kid friendly and has a moderate price range."
"name[The Vaults], eatType[pub], food[French], priceRange[moderate], area[city centre], familyFriendly[yes], near[Raja Indian Cuisine]"	"Located near Raja Indian Cuisine in the city centre, The Vaults is a kid friendly French pub with a moderate price range."
"name[The Vaults], eatType[pub], food[French], priceRange[moderate], area[riverside], familyFriendly[no], near[Raja Indian Cuisine]"	"The Vaults, located near Raja Indian Cuisine in the riverside area, is a moderately priced pub that serves French food. It is not kid friendly."
"name[The Vaults], eatType[pub], food[French], priceRange[moderate], area[riverside], familyFriendly[yes], near[Raja Indian Cuisine]"	"A kid friendly pub located near Raja Indian Cuisine in the riverside area, The Vaults serves French food and has a moderate price range."
"name[The Vaults], eatType[pub], food[French], priceRange[more than £30], area[city centre], familyFriendly[no], near[Raja Indian Cuisine]"	"Located near Raja Indian Cuisine in the city centre, The Vaults is a French pub that costs more than £30 and is not child friendly."
"name[The Vaults], eatType[pub], food[French], priceRange[more than £30], area[city centre], familyFriendly[yes], near[Raja Indian Cuisine]"	The Vaults is a French pub located near the Raja Indian Cuisine in the city centre. It is children friendly and has a price range of more than £30.
"name[The Vaults], eatType[pub], food[French], priceRange[more than £30], area[riverside], familyFriendly[no], near[Raja Indian Cuisine]"	"The Vaults, located near Raja Indian Cuisine in riverside, is a French pub with a price range of more than £30 and is not child friendly."
"name[The Vaults], eatType[pub], food[French], priceRange[more than £30], area[riverside], familyFriendly[yes], near[Raja Indian Cuisine]"	Located near Raja Indian Cuisine in the riverside area is a child friendly pub called The Vaults that serves French food and has a price range of more than £30.
"name[The Vaults], eatType[pub], food[Indian], priceRange[£20-25], area[riverside], familyFriendly[yes], near[Raja Indian Cuisine]"	The Vaults is a pub that serves Indian food in the riverside area near Raja Indian Cuisine. It is kid friendly and has a price range of £20-25.
"name[The Vaults], eatType[pub], food[Indian], priceRange[cheap], area[riverside], familyFriendly[yes], near[Raja Indian Cuisine]"	"The Vaults is a cheap, family friendly, Indian pub near Raja Indian Cuisine in the riverside area."
"name[The Vaults], eatType[pub], food[Indian], priceRange[high], area[city centre], familyFriendly[no], near[Raja Indian Cuisine]"	"Located near Raja Indian Cuisine in the city centre, The Vaults is an Indian pub with a high price range and is not child friendly."
"name[The Vaults], eatType[pub], food[Indian], priceRange[high], area[city centre], familyFriendly[yes], near[Raja Indian Cuisine]"	"Located near Raja Indian Cuisine in the city centre, The Vaults is a child friendly Indian pub with a high price range."
"name[The Vaults], eatType[pub], food[Italian], priceRange[high], customer rating[average], area[city centre], familyFriendly[no], near[Rainbow Vegetarian Café]"	"Located near Rainbow Vegetarian Café in the city centre, The Vaults is an Italian pub with a high price range and an average customer rating and is not child friendly."
"name[The Vaults], eatType[pub], food[Italian], priceRange[high], customer rating[average], area[city centre], familyFriendly[yes], near[Rainbow Vegetarian Café]"	"Located near Rainbow Vegetarian Café in the city centre, The Vaults is a child friendly Italian pub with a high price range and average customer rating."
"name[The Vaults], eatType[pub], food[Italian], priceRange[high], customer rating[average], area[riverside], familyFriendly[no], near[Rainbow Vegetarian Café]"	"Near Rainbow Vegetarian Café, in the riverside area, is an Italian pub called The Vaults. It is not child friendly, has a high price range and an average customer rating."
"name[The Vaults], eatType[pub], food[Italian], priceRange[high], customer rating[average], area[riverside], familyFriendly[yes], near[Rainbow Vegetarian Café]"	The Vaults is a high priced Italian pub located in the riverside area near the Rainbow Vegetarian Café. It is children friendly and has an average customer rating.
"name[The Vaults], eatType[pub], food[Italian], priceRange[less than £20], customer rating[low], area[city centre], familyFriendly[no], near[Rainbow Vegetarian Café]"	"Located in the city centre near Rainbow Vegetarian Café, The Vaults is an Italian pub with a low customer rating and a price range of less than £20. It is not family-friendly."
"name[The Vaults], eatType[pub], food[Italian], priceRange[less than £20], customer rating[low], area[city centre], familyFriendly[yes], near[Rainbow Vegetarian Café]"	The The Vaults is a family-friendly pub located near Rainbow Vegetarian Café in the city centre with a low customer rating and a price range of less than £20.
"name[The Vaults], eatType[pub], food[Italian], priceRange[less than £20], customer rating[low], area[riverside], familyFriendly[no], near[Rainbow Vegetarian Café]"	"Located near Rainbow Vegetarian Café in riverside, The Vaults is an Italian pub with a low customer rating and a price range of less than £20. It is not family friendly."
"name[The Vaults], eatType[pub], food[Italian], priceRange[less than £20], customer rating[low], area[riverside], familyFriendly[yes], near[Rainbow Vegetarian Café]"	"Located near Rainbow Vegetarian Café in the riverside area, the The Vaults is a family friendly pub with a low customer rating and a price range of less than £20."
"name[The Vaults], eatType[pub], food[Italian], priceRange[moderate], customer rating[1 out of 5], area[city centre], familyFriendly[no], near[Rainbow Vegetarian Café]"	"Located near Rainbow Vegetarian Café in the city centre, The Vaults is a moderately priced Italian food pub with a customer rating of 1 out of 5."
"name[The Vaults], eatType[pub], food[Italian], priceRange[moderate], customer rating[1 out of 5], area[city centre], familyFriendly[yes], near[Rainbow Vegetarian Café]"	"Located near Rainbow Vegetarian Café in the city centre, The Vaults is a kid friendly Italian food pub with a moderate price range and a customer rating of 1 out of 5."
"name[The Vaults], eatType[pub], food[Italian], priceRange[moderate], customer rating[1 out of 5], area[riverside], familyFriendly[no], near[Rainbow Vegetarian Café]"	"The Vaults is an Italian restaurant near Rainbow Vegetarian Café in the riverside area. It is not kid friendly, has a moderate price range and has a customer rating of 1 out of 5."
"name[The Vaults], eatType[pub], food[Italian], priceRange[moderate], customer rating[1 out of 5], area[riverside], familyFriendly[yes], near[Rainbow Vegetarian Café]"	"Located near Rainbow Vegetarian Café in the riverside area, The Vaults is a kid friendly pub with a moderate price range and a customer rating of 1 out of 5."
"name[The Vaults], eatType[pub], food[Italian], priceRange[moderate], customer rating[3 out of 5], area[city centre], familyFriendly[no], near[Rainbow Vegetarian Café]"	"Located in the city centre near Rainbow Vegetarian Café, The Vaults is a moderately priced Italian pub with a customer rating of 3 out of 5."
"name[The Vaults], eatType[pub], food[Italian], priceRange[moderate], customer rating[3 out of 5], area[city centre], familyFriendly[yes], near[Rainbow Vegetarian Café]"	"Located near Rainbow Vegetarian Café in the city centre, The Vaults is a kid friendly Italian restaurant with a moderate price range and a customer rating of 3 out of 5."
"name[The Vaults], eatType[pub], food[Italian], priceRange[moderate], customer rating[3 out of 5], area[riverside], familyFriendly[no], near[Rainbow Vegetarian Café]"	"Located near Rainbow Vegetarian Café in the riverside area, The Vaults is an Italian restaurant with a moderate price range and a customer rating of 3 out of 5."
"name[The Vaults], eatType[pub], food[Italian], priceRange[moderate], customer rating[3 out of 5], area[riverside], familyFriendly[yes], near[Rainbow Vegetarian Café]"	"Located near Rainbow Vegetarian Café in the riverside area, The Vaults is a kid friendly Italian restaurant with a moderate price range and a customer rating of 3 out of 5."
"name[The Vaults], eatType[pub], food[Italian], priceRange[more than £30], customer rating[high], area[city centre], familyFriendly[no], near[Rainbow Vegetarian Café]"	"The Vaults is an Italian restaurant with a high customer rating. It is located in the city centre, near Rainbow Vegetarian Café and is not children friendly."
"name[The Vaults], eatType[pub], food[Italian], priceRange[more than £30], customer rating[high], area[city centre], familyFriendly[yes], near[Rainbow Vegetarian Café]"	The Vaults is a children friendly Italian pub in the city centre near Rainbow Vegetarian Café with a high customer rating and a price range of more than £30.
"name[The Vaults], eatType[pub], food[Italian], priceRange[more than £30], customer rating[high], area[riverside], familyFriendly[no], near[Rainbow Vegetarian Café]"	"With a high customer rating and a price range of more than £30, the Italian pub The Vaults, is located in the riverside area near the Rainbow Vegetarian Café. It is not children friendly."
"name[The Vaults], eatType[pub], food[Italian], priceRange[more than £30], customer rating[high], area[riverside], familyFriendly[yes], near[Rainbow Vegetarian Café]"	"The Vaults is a family friendly, high priced, Italian restaurant near Rainbow Vegetarian Café in the riverside area."
"name[The Vaults], eatType[pub], food[Japanese], priceRange[£20-25], customer rating[3 out of 5], area[city centre], familyFriendly[no], near[Rainbow Vegetarian Café]"	"In the city centre near Rainbow Vegetarian Café, there is a Japanese restaurant called The Vaults. It is not kid friendly and has a price range of £20-25 and a customer rating of 3 out of 5."
"name[The Vaults], eatType[pub], food[Japanese], priceRange[£20-25], customer rating[3 out of 5], area[city centre], familyFriendly[yes], near[Rainbow Vegetarian Café]"	"Located near Rainbow Vegetarian Café in the city centre, The Vaults is a kid friendly Japanese restaurant with a price range of £20-25 and a customer rating of 3 out of 5."
"name[The Vaults], eatType[pub], food[Japanese], priceRange[£20-25], customer rating[3 out of 5], area[riverside], familyFriendly[no], near[Rainbow Vegetarian Café]"	"In the riverside area near Rainbow Vegetarian Café is a Japanese restaurant called The Vaults. It has a moderate price range and a customer rating of 3 out of 5, and is not kid friendly."
"name[The Vaults], eatType[pub], food[Japanese], priceRange[£20-25], customer rating[3 out of 5], area[riverside], familyFriendly[yes], near[Rainbow Vegetarian Café]"	In the riverside area near Rainbow Vegetarian Café is a kid friendly Japanese restaurant called The Vaults. It has a customer rating of 3 out of 5 and a price range of £20-25.
"name[The Vaults], eatType[pub], food[Japanese], priceRange[£20-25], customer rating[high], area[city centre], familyFriendly[no], near[Rainbow Vegetarian Café]"	"The Vaults is a Japanese restaurant near the Rainbow Vegetarian Café in the city centre. It is not kid friendly, has a high customer rating and is in the price range of £20-25."
"name[The Vaults], eatType[pub], food[Japanese], priceRange[£20-25], customer rating[high], area[city centre], familyFriendly[yes], near[Rainbow Vegetarian Café]"	"Located near Rainbow Vegetarian Café in the city centre, The Vaults is a child friendly Japanese restaurant with a price range of £20-25 and a high customer rating."
"name[The Vaults], eatType[pub], food[Japanese], priceRange[£20-25], customer rating[high], area[riverside], familyFriendly[no], near[Rainbow Vegetarian Café]"	Near the Rainbow Vegetarian Café in the riverside area is a Japanese restaurant called The Vaults. It is not kid friendly and has a high customer rating and a price range of £20-25.
"name[The Vaults], eatType[pub], food[Japanese], priceRange[£20-25], customer rating[high], area[riverside], familyFriendly[no], near[Raja Indian Cuisine]"	Near the Raja Indian Cuisine in the riverside area is a Japanese restaurant called The Vaults. It is not kid friendly and has a high customer rating and a price range of £20-25.
"name[The Vaults], eatType[pub], food[Japanese], priceRange[£20-25], customer rating[high], area[riverside], familyFriendly[yes], near[Raja Indian Cuisine]"	Near the Raja Indian Cuisine in the riverside area is a kid friendly pub called The Vaults that serves Japanese food and has a high customer rating and a price range of £20-25.
"name[The Vaults], eatType[pub], food[Japanese], priceRange[cheap], customer rating[5 out of 5], area[city centre], familyFriendly[no], near[Raja Indian Cuisine]"	"The Vaults is a Japanese restaurant in the city centre near Raja Indian Cuisine. It is not family-friendly, has a customer rating of 5 out of 5 and has a cheap price range."
"name[The Vaults], eatType[pub], food[Japanese], priceRange[cheap], customer rating[5 out of 5], area[city centre], familyFriendly[yes], near[Raja Indian Cuisine]"	"Located in the city centre near Raja Indian Cuisine, The Vaults is a family-friendly Japanese restaurant with a customer rating of 5 out of 5."
"name[The Vaults], eatType[pub], food[Japanese], priceRange[cheap], customer rating[5 out of 5], area[riverside], familyFriendly[no], near[Raja Indian Cuisine]"	A cheap Japanese restaurant in riverside near Raja Indian Cuisine is The Vaults. It has a customer rating of 5 out of 5 and is not family-friendly.
"name[The Vaults], eatType[pub], food[Japanese], priceRange[cheap], customer rating[5 out of 5], area[riverside], familyFriendly[yes], near[Raja Indian Cuisine]"	A cheap Japanese food place in the riverside area near the Raja Indian Cuisine is The Vaults. It has a customer rating of 5 out of 5 and is family friendly.
"name[The Vaults], eatType[pub], food[Japanese], priceRange[high], customer rating[3 out of 5], area[city centre], familyFriendly[no], near[Raja Indian Cuisine]"	"The Vaults, located near Raja Indian Cuisine in the city centre, is a Japanese pub with a high price range and a customer rating of 3 out of 5. it is not children friendly."
"name[The Vaults], eatType[pub], food[Japanese], priceRange[high], customer rating[3 out of 5], area[city centre], familyFriendly[yes], near[Raja Indian Cuisine]"	"Located near Raja Indian Cuisine in the city centre, The Vaults is a child friendly Japanese pub with a high price range and a customer rating of 3 out of 5."
"name[The Vaults], eatType[pub], food[Japanese], priceRange[high], customer rating[3 out of 5], area[riverside], familyFriendly[no], near[Raja Indian Cuisine]"	The Vaults is a Japanese restaurant in the riverside area near Raja Indian Cuisine. It has a high price range and a customer rating of 3 out of 5 and is not child friendly.
"name[The Vaults], eatType[pub], food[Japanese], priceRange[high], customer rating[3 out of 5], area[riverside], familyFriendly[yes], near[Raja Indian Cuisine]"	Near the Raja Indian Cuisine in the riverside area is a child friendly pub called The Vaults that serves Japanese food in the high price range and has a customer rating of 3 out of 5
"name[The Vaults], eatType[pub], food[Japanese], priceRange[less than £20], customer rating[average], area[city centre], familyFriendly[no], near[Raja Indian Cuisine]"	"Located in the city centre near Raja Indian Cuisine, The Vaults is a Japanese pub with a price range of less than £20 and has an average customer rating."
"name[The Vaults], eatType[pub], food[Japanese], priceRange[less than £20], customer rating[average], area[city centre], familyFriendly[yes], near[Raja Indian Cuisine]"	"Located near Raja Indian Cuisine in the city centre, The Vaults is a family-friendly Japanese pub with a price range of less than £20 and has an average customer rating."
"name[The Vaults], eatType[pub], food[Japanese], priceRange[less than £20], customer rating[average], area[riverside], familyFriendly[no], near[Raja Indian Cuisine]"	"Located near Raja Indian Cuisine in the riverside area, The Vaults is a Japanese pub with an average customer rating and a price range of less than £20, but is not family-friendly."
"name[The Vaults], eatType[pub], food[Japanese], priceRange[less than £20], customer rating[average], area[riverside], familyFriendly[yes], near[Raja Indian Cuisine]"	Near the Raja Indian Cuisine in the riverside area is a family friendly pub called the The Vaults which has a price range of less than £20 and an average customer rating.
"name[The Vaults], eatType[pub], food[Japanese], priceRange[less than £20], customer rating[low], area[city centre], familyFriendly[no], near[Raja Indian Cuisine]"	The The Vaults is a Japanese pub in the city centre near Raja Indian Cuisine with a low customer rating but a price range of less than £20.
"name[The Vaults], eatType[pub], food[Japanese], priceRange[less than £20], customer rating[low], area[city centre], familyFriendly[yes], near[Raja Indian Cuisine]"	"The Vaults is a Japanese pub located near the Raja Indian Cuisine in the city centre. It has a low customer rating and is family-friendly, but the price range is less than £20."
"name[The Vaults], eatType[pub], food[Japanese], priceRange[less than £20], customer rating[low], area[riverside], familyFriendly[no], near[Raja Indian Cuisine]"	In the riverside area near Raja Indian Cuisine is a Japanese pub called The Vaults. It is not family-friendly and has a low customer rating and a price range of less than £20.
"name[The Vaults], eatType[pub], food[Japanese], priceRange[less than £20], customer rating[low], area[riverside], familyFriendly[yes], near[Raja Indian Cuisine]"	"In the riverside area, near the Raja Indian Cuisine, is a low priced pub called The Vaults."
"name[The Vaults], eatType[pub], food[Japanese], priceRange[moderate], customer rating[1 out of 5], area[city centre], familyFriendly[no], near[Raja Indian Cuisine]"	"The Vaults, located near the Raja Indian Cuisine in the city centre, is a moderately priced Japanese pub with a customer rating of 1 out of 5. it is not kid friendly."
"name[The Vaults], eatType[pub], food[Japanese], priceRange[moderate], customer rating[1 out of 5], area[city centre], familyFriendly[yes], near[Raja Indian Cuisine]"	"Located near Raja Indian Cuisine in the city centre, The Vaults is a kid friendly Japanese pub with a moderate price range and a customer rating of 1 out of 5."
"name[The Vaults], eatType[restaurant], food[French], priceRange[high], area[riverside], familyFriendly[yes], near[Raja Indian Cuisine]"	"Located in riverside, near Raja Indian Cuisine, The Vaults is a child friendly French restaurant with a high price range."
"name[The Vaults], eatType[restaurant], food[French], priceRange[less than £20], area[city centre], familyFriendly[no], near[Raja Indian Cuisine]"	"The Vaults, located near Raja Indian Cuisine in the city centre, is a French restaurant with a price range of less than £20. It is not family-friendly."
"name[The Vaults], eatType[restaurant], food[French], priceRange[less than £20], area[city centre], familyFriendly[yes], near[Raja Indian Cuisine]"	The Vaults is a family-friendly French restaurant with a price range less than £20 near Raja Indian Cuisine in the city centre.
"name[The Vaults], eatType[restaurant], food[French], priceRange[less than £20], area[riverside], familyFriendly[no], near[Raja Indian Cuisine]"	"Located near Raja Indian Cuisine, in the riverside area, The Vaults is a non family-friendly French restaurant with a price range of less than £20."
"name[The Vaults], eatType[restaurant], food[French], priceRange[less than £20], area[riverside], familyFriendly[yes], near[Raja Indian Cuisine]"	"Located near Raja Indian Cuisine in riverside, The Vaults is a family friendly French restaurant with a price range less than £20."
"name[The Vaults], eatType[restaurant], food[French], priceRange[moderate], area[city centre], familyFriendly[no], near[Raja Indian Cuisine]"	"In the city centre, near Raja Indian Cuisine, there is a French restaurant called The Vaults. It is not kid friendly and has a moderate price range."
"name[The Vaults], eatType[restaurant], food[French], priceRange[moderate], area[city centre], familyFriendly[yes], near[Raja Indian Cuisine]"	"Located near Raja Indian Cuisine in the city centre, The Vaults is a kid friendly French restaurant with a moderate price range."
"name[The Vaults], eatType[restaurant], food[French], priceRange[moderate], area[riverside], familyFriendly[no], near[Raja Indian Cuisine]"	"Near Raja Indian Cuisine, in the riverside area is a French restaurant called The Vaults. It has a moderate price range and is not kid friendly."
"name[The Vaults], eatType[restaurant], food[French], priceRange[moderate], area[riverside], familyFriendly[yes], near[Raja Indian Cuisine]"	"The Vaults, located near Raja Indian Cuisine in riverside, is a family friendly French restaurant with a moderate price range."
"name[The Vaults], eatType[restaurant], food[French], priceRange[more than £30], area[city centre], familyFriendly[no], near[Raja Indian Cuisine]"	"Located near Raja Indian Cuisine in the city centre, The Vaults is a French restaurant that costs more than £30 and is not child friendly."
"name[The Vaults], eatType[restaurant], food[French], priceRange[more than £30], area[city centre], familyFriendly[yes], near[Raja Indian Cuisine]"	"Located near Raja Indian Cuisine in the city centre, The Vaults is a child friendly French restaurant with prices ranging more than £30."
"name[The Vaults], eatType[restaurant], food[French], priceRange[more than £30], area[riverside], familyFriendly[no], near[Raja Indian Cuisine]"	"Located near Raja Indian Cuisine in riverside, The Vaults is a French restaurant with a price range of more than £30. It is not child friendly."
"name[The Vaults], eatType[restaurant], food[French], priceRange[more than £30], area[riverside], familyFriendly[yes], near[Raja Indian Cuisine]"	"The Vaults, located near Raja Indian Cuisine in the riverside area, is a child friendly French restaurant with a price range of more than £30."
"name[The Vaults], eatType[restaurant], food[Indian], priceRange[£20-25], area[riverside], familyFriendly[yes], near[Raja Indian Cuisine]"	Near Raja Indian Cuisine in the riverside area is a kid friendly restaurant called The Vaults that serves Indian food and has a price range of £20-25.
"name[The Vaults], eatType[restaurant], food[Indian], priceRange[cheap], area[riverside], familyFriendly[yes], near[Raja Indian Cuisine]"	Near Raja Indian Cuisine in the riverside area is a cheap family friendly Indian restaurant called The Vaults
"name[The Vaults], eatType[restaurant], food[Indian], priceRange[high], area[city centre], familyFriendly[no], near[Raja Indian Cuisine]"	"Near Raja Indian Cuisine, in the city centre, is an Indian restaurant called The Vaults. It has a high price range and is not child friendly."
"name[The Vaults], eatType[restaurant], food[Indian], priceRange[high], area[city centre], familyFriendly[yes], near[Raja Indian Cuisine]"	"Located near Raja Indian Cuisine in the city centre, The Vaults is a child friendly Indian restaurant with a high price range."
"name[The Waterman], eatType[pub], food[Indian], priceRange[high], area[city centre], familyFriendly[yes], near[Raja Indian Cuisine]"	"Located near Raja Indian Cuisine in the city centre, The Waterman is a child friendly Indian pub with a high price range."
"name[The Waterman], eatType[pub], food[Indian], priceRange[high], area[riverside], familyFriendly[no], near[Raja Indian Cuisine]"	The Waterman is a pub that serves Indian food in the high price range. It is located in the riverside area near Raja Indian Cuisine and is not children friendly.
"name[The Waterman], eatType[pub], food[Indian], priceRange[high], area[riverside], familyFriendly[yes], near[Raja Indian Cuisine]"	"Located near Raja Indian Cuisine in riverside, The Waterman is a child friendly pub with a high price range."
"name[The Waterman], eatType[pub], food[Indian], priceRange[less than £20], area[city centre], familyFriendly[no], near[Raja Indian Cuisine]"	"Located near Raja Indian Cuisine in the city centre, The Waterman is a non family-friendly pub with a price range of less than £20."
"name[The Waterman], eatType[pub], food[Indian], priceRange[less than £20], area[city centre], familyFriendly[yes], near[Raja Indian Cuisine]"	"Located in the city centre near Raja Indian Cuisine, The Waterman is a family-friendly pub serving Indian food at a price range of less than £20."
"name[The Waterman], eatType[pub], food[Indian], priceRange[less than £20], area[riverside], familyFriendly[no], near[Raja Indian Cuisine]"	"Located near Raja Indian Cuisine in the riverside area, The Waterman is an Indian pub with a price range of less than £20 and is not family friendly."
"name[The Waterman], eatType[pub], food[Indian], priceRange[less than £20], area[riverside], familyFriendly[yes], near[Raja Indian Cuisine]"	Near Raja Indian Cuisine in the riverside area is a pub called The Waterman that serves Indian food for less than £20 and is family friendly
"name[The Waterman], eatType[pub], food[Indian], priceRange[moderate], area[city centre], familyFriendly[no], near[Raja Indian Cuisine]"	"Located near Raja Indian Cuisine in the city centre, The Waterman is an Indian pub that is not kid friendly with a moderate price range."
"name[The Waterman], eatType[pub], food[Indian], priceRange[moderate], area[city centre], familyFriendly[yes], near[Raja Indian Cuisine]"	"Located near Raja Indian Cuisine in the city centre, The Waterman is a kid friendly Indian pub with a moderate price range."
"name[The Waterman], eatType[pub], food[Indian], priceRange[moderate], area[riverside], familyFriendly[no], near[Raja Indian Cuisine]"	The Waterman is a moderately priced Indian pub located in riverside near Raja Indian Cuisine.
"name[The Waterman], eatType[pub], food[Indian], priceRange[moderate], area[riverside], familyFriendly[yes], near[Raja Indian Cuisine]"	"Located near Raja Indian Cuisine, The Waterman is a kid friendly pub that serves Indian food at a moderate price. It is located in the riverside area."
"name[The Waterman], eatType[pub], food[Indian], priceRange[more than £30], area[riverside], familyFriendly[yes], near[Raja Indian Cuisine]"	The Waterman is a child friendly Indian pub in riverside near Raja Indian Cuisine
"name[The Waterman], eatType[pub], food[Italian], priceRange[£20-25], area[riverside], familyFriendly[yes], near[Raja Indian Cuisine]"	The Waterman is a pub that serves Italian food in the riverside area near Raja Indian Cuisine. It is kid friendly and has a price range of £20-25.
"name[The Waterman], eatType[pub], food[Italian], priceRange[cheap], area[riverside], familyFriendly[yes], near[Raja Indian Cuisine]"	"The Waterman is a cheap, family friendly, Italian pub near Raja Indian Cuisine in the riverside area."
"name[The Waterman], eatType[pub], food[Italian], priceRange[high], area[city centre], familyFriendly[no], near[Raja Indian Cuisine]"	"Located near Raja Indian Cuisine in the city centre, The Waterman is an Italian pub with a high price range and is not child friendly."
"name[The Waterman], eatType[pub], food[Italian], priceRange[high], area[city centre], familyFriendly[yes], near[Raja Indian Cuisine]"	"Located near Raja Indian Cuisine in the city centre, The Waterman is a child friendly Italian pub with a high price range."
"name[The Waterman], eatType[pub], food[Italian], priceRange[high], area[riverside], familyFriendly[no], near[Raja Indian Cuisine]"	The Waterman is a pub that serves Italian food in the high price range. It is located in the riverside area near Raja Indian Cuisine and is not children friendly.
"name[The Waterman], eatType[pub], food[Italian], priceRange[high], area[riverside], familyFriendly[yes], near[Raja Indian Cuisine]"	"Located near Raja Indian Cuisine in riverside, The Waterman is a child friendly pub with a high price range."
"name[The Waterman], eatType[pub], food[Italian], priceRange[less than £20], area[city centre], familyFriendly[no], near[Raja Indian Cuisine]"	"Located near Raja Indian Cuisine in the city centre, The Waterman is a non family-friendly pub with a price range of less than £20."
"name[The Waterman], eatType[pub], food[Italian], priceRange[less than £20], area[city centre], familyFriendly[yes], near[Raja Indian Cuisine]"	"Located in the city centre near Raja Indian Cuisine, The Waterman is a family-friendly pub serving Italian food at a price range of less than £20."
"name[The Waterman], eatType[pub], food[Italian], priceRange[less than £20], area[riverside], familyFriendly[no], near[Raja Indian Cuisine]"	"Located near Raja Indian Cuisine in the riverside area, The Waterman is an Italian pub with a price range of less than £20 and is not family friendly."
"name[The Waterman], eatType[restaurant], food[Indian], priceRange[high], area[city centre], familyFriendly[yes], near[Raja Indian Cuisine]"	"Located near Raja Indian Cuisine in the city centre, The Waterman is a child friendly Indian restaurant with a high price range."
"name[The Waterman], eatType[restaurant], food[Indian], priceRange[high], area[riverside], familyFriendly[no], near[Raja Indian Cuisine]"	"Located near Raja Indian Cuisine, The Waterman is an Indian restaurant with a high price range. It is not child friendly and is in the riverside area."
"name[The Waterman], eatType[restaurant], food[Indian], priceRange[high], area[riverside], familyFriendly[yes], near[Raja Indian Cuisine]"	"Located in the riverside area near Raja Indian Cuisine, The Waterman is a child friendly Indian restaurant with a high price range."
"name[The Waterman], eatType[restaurant], food[Indian], priceRange[less than £20], area[city centre], familyFriendly[no], near[Raja Indian Cuisine]"	"The Waterman is an Indian restaurant located near Raja Indian Cuisine in the city centre. It is not family-friendly, but has a price range of less than £20."
"name[The Waterman], eatType[restaurant], food[Indian], priceRange[less than £20], area[city centre], familyFriendly[yes], near[Raja Indian Cuisine]"	"In the city centre near Raja Indian Cuisine, there is a family friendly restaurant called The Waterman that serves Indian food at less than £20."
"name[The Waterman], eatType[restaurant], food[Indian], priceRange[less than £20], area[riverside], familyFriendly[no], near[Raja Indian Cuisine]"	"The Waterman is an Indian restaurant near Raja Indian Cuisine in riverside. It is not family-friendly, but has a price range of less than £20."
"name[The Waterman], eatType[restaurant], food[Indian], priceRange[less than £20], area[riverside], familyFriendly[yes], near[Raja Indian Cuisine]"	"Located near Raja Indian Cuisine in riverside, The Waterman is a family friendly Indian restaurant with a price range of less than £20."
"name[The Waterman], eatType[restaurant], food[Indian], priceRange[moderate], area[city centre], familyFriendly[no], near[Raja Indian Cuisine]"	"Located near Raja Indian Cuisine in the city centre, The Waterman is an Indian restaurant that is not kid friendly with a moderate price range."
"name[The Waterman], eatType[restaurant], food[Indian], priceRange[moderate], area[city centre], familyFriendly[yes], near[Raja Indian Cuisine]"	"The Waterman is a moderately priced, kid friendly, Indian restaurant near Raja Indian Cuisine in the city centre."
"name[The Waterman], eatType[restaurant], food[Indian], priceRange[moderate], area[riverside], familyFriendly[no], near[Raja Indian Cuisine]"	"The Waterman is a moderately priced Indian restaurant, not kid friendly, located near Raja Indian Cuisine in the riverside area."
"name[The Waterman], eatType[restaurant], food[Indian], priceRange[moderate], area[riverside], familyFriendly[yes], near[Raja Indian Cuisine]"	"Located in the riverside area near Raja Indian Cuisine, The Waterman is a kid friendly Indian restaurant with a moderate price range."
"name[The Waterman], eatType[restaurant], food[Indian], priceRange[more than £30], area[riverside], familyFriendly[yes], near[Raja Indian Cuisine]"	"Located near Raja Indian Cuisine in riverside, The Waterman is a child friendly Indian restaurant with a price range of more than £30."
"name[The Waterman], eatType[restaurant], food[Italian], priceRange[£20-25], area[riverside], familyFriendly[yes], near[Raja Indian Cuisine]"	Near Raja Indian Cuisine in the riverside area is a kid friendly restaurant called The Waterman that serves Italian food and has a price range of £20-25.
"name[The Waterman], eatType[restaurant], food[Italian], priceRange[cheap], area[riverside], familyFriendly[yes], near[Raja Indian Cuisine]"	Near Raja Indian Cuisine in the riverside area is a cheap family friendly Italian restaurant called The Waterman
"name[The Waterman], eatType[restaurant], food[Italian], priceRange[high], area[city centre], familyFriendly[no], near[Raja Indian Cuisine]"	"Near Raja Indian Cuisine, in the city centre, is an Italian restaurant called The Waterman. It has a high price range and is not child friendly."
"name[The Waterman], eatType[restaurant], food[Italian], priceRange[high], area[city centre], familyFriendly[yes], near[Raja Indian Cuisine]"	"Located near Raja Indian Cuisine in the city centre, The Waterman is a child friendly Italian restaurant with a high price range."
"name[The Waterman], eatType[restaurant], food[Italian], priceRange[high], area[riverside], familyFriendly[no], near[Raja Indian Cuisine]"	"Located near Raja Indian Cuisine, The Waterman is an Italian restaurant with a high price range. It is not child friendly and is in the riverside area."
"name[The Waterman], eatType[restaurant], food[Italian], priceRange[high], area[riverside], familyFriendly[yes], near[Raja Indian Cuisine]"	"Located in the riverside area near Raja Indian Cuisine, The Waterman is a child friendly Italian restaurant with a high price range."
"name[The Waterman], eatType[restaurant], food[Italian], priceRange[less than £20], area[city centre], familyFriendly[no], near[Raja Indian Cuisine]"	"The Waterman is an Italian restaurant located near Raja Indian Cuisine in the city centre. It is not family-friendly, but has a price range of less than £20."
"name[The Waterman], eatType[restaurant], food[Italian], priceRange[less than £20], area[city centre], familyFriendly[yes], near[Raja Indian Cuisine]"	"In the city centre near Raja Indian Cuisine, there is a family friendly restaurant called The Waterman that serves Italian food at less than £20."
"name[The Waterman], eatType[restaurant], food[Italian], priceRange[less than £20], area[riverside], familyFriendly[no], near[Raja Indian Cuisine]"	"The Waterman is an Italian restaurant near Raja Indian Cuisine in riverside. It is not family-friendly, but has a price range of less than £20."
"name[The Wrestlers], eatType[pub], food[Italian], priceRange[less than £20], area[riverside], familyFriendly[no], near[Raja Indian Cuisine]"	"Located near Raja Indian Cuisine in the riverside area, The Wrestlers is an Italian pub with a price range of less than £20 and is not family friendly."
"name[The Wrestlers], eatType[pub], food[Italian], priceRange[less than £20], area[riverside], familyFriendly[yes], near[Raja Indian Cuisine]"	Near Raja Indian Cuisine in the riverside area is a pub called The Wrestlers that serves Italian food for less than £20 and is family friendly
"name[The Wrestlers], eatType[pub], food[Italian], priceRange[moderate], area[city centre], familyFriendly[no], near[Raja Indian Cuisine]"	"Located near Raja Indian Cuisine in the city centre, The Wrestlers is an Italian pub that is not kid friendly with a moderate price range."
"name[The Wrestlers], eatType[pub], food[Italian], priceRange[moderate], area[city centre], familyFriendly[yes], near[Raja Indian Cuisine]"	"Located near Raja Indian Cuisine in the city centre, The Wrestlers is a kid friendly Italian pub with a moderate price range."
"name[The Wrestlers], eatType[pub], food[Italian], priceRange[moderate], area[riverside], familyFriendly[no], near[Raja Indian Cuisine]"	The Wrestlers is a moderately priced Italian pub located in riverside near Raja Indian Cuisine.
"name[The Wrestlers], eatType[pub], food[Italian], priceRange[moderate], area[riverside], familyFriendly[yes], near[Raja Indian Cuisine]"	"Located near Raja Indian Cuisine, The Wrestlers is a kid friendly pub that serves Italian food at a moderate price. It is located in the riverside area."
"name[The Wrestlers], eatType[pub], food[Italian], priceRange[more than £30], area[riverside], familyFriendly[yes], near[Raja Indian Cuisine]"	The Wrestlers is a child friendly Italian pub in riverside near Raja Indian Cuisine
"name[The Wrestlers], eatType[pub], food[Japanese], priceRange[£20-25], area[riverside], familyFriendly[yes], near[Raja Indian Cuisine]"	In the riverside area near Raja Indian Cuisine is a Japanese pub called The Wrestlers that is kid friendly and has a price range of £20-25
"name[The Wrestlers], eatType[pub], food[Japanese], priceRange[cheap], area[riverside], familyFriendly[yes], near[Raja Indian Cuisine]"	"The Wrestlers is a cheap, family friendly, Japanese pub near Raja Indian Cuisine in the riverside area."
"name[The Wrestlers], eatType[pub], food[Japanese], priceRange[high], area[riverside], familyFriendly[yes], near[Raja Indian Cuisine]"	"The Wrestlers is a high priced, child friendly, Japanese pub near Raja Indian Cuisine in the riverside area."
"name[The Wrestlers], eatType[pub], food[Japanese], priceRange[less than £20], area[city centre], familyFriendly[no], near[Raja Indian Cuisine]"	"Located near Raja Indian Cuisine in the city centre, The Wrestlers is a non family-friendly pub with a price range of less than £20."
"name[The Wrestlers], eatType[pub], food[Japanese], priceRange[less than £20], area[city centre], familyFriendly[yes], near[Raja Indian Cuisine]"	"The Wrestlers, a family-friendly pub near Raja Indian Cuisine in the city centre, serves Japanese food for less than £20."
"name[The Wrestlers], eatType[pub], food[Japanese], priceRange[less than £20], area[riverside], familyFriendly[no], near[Raja Indian Cuisine]"	"In the riverside area, near Raja Indian Cuisine, is a cheap pub called The Wrestlers. It serves Japanese food and is not family friendly."
"name[The Wrestlers], eatType[pub], food[Japanese], priceRange[less than £20], area[riverside], familyFriendly[yes], near[Raja Indian Cuisine]"	The Wrestlers is a family friendly pub that serves Japanese food for less than £20 near Raja Indian Cuisine in the riverside area.
"name[The Wrestlers], eatType[pub], food[Japanese], priceRange[moderate], area[city centre], familyFriendly[no], near[Raja Indian Cuisine]"	"In the city centre, near Raja Indian Cuisine, there is a Japanese pub called The Wrestlers. It is not kid friendly and has a moderate price range."
"name[The Wrestlers], eatType[pub], food[Japanese], priceRange[moderate], area[city centre], familyFriendly[yes], near[Raja Indian Cuisine]"	"Located near Raja Indian Cuisine in the city centre, The Wrestlers is a kid friendly Japanese pub with a moderate price range."
"name[The Wrestlers], eatType[pub], food[Japanese], priceRange[moderate], area[riverside], familyFriendly[no], near[Raja Indian Cuisine]"	"The Wrestlers, located near Raja Indian Cuisine in the riverside area, is a moderately priced pub that serves Japanese food. It is not kid friendly."
"name[The Wrestlers], eatType[pub], food[Japanese], priceRange[moderate], area[riverside], familyFriendly[yes], near[Raja Indian Cuisine]"	"A kid friendly pub located near Raja Indian Cuisine in the riverside area, The Wrestlers serves Japanese food and has a moderate price range."
"name[The Wrestlers], eatType[pub], food[Japanese], priceRange[moderate], customer rating[1 out of 5], area[city centre], familyFriendly[yes], near[Raja Indian Cuisine]"	"Located near Raja Indian Cuisine in the city centre, The Wrestlers is a kid friendly Japanese pub with a moderate price range and a customer rating of 1 out of 5."
"name[The Wrestlers], eatType[pub], food[Japanese], priceRange[moderate], customer rating[1 out of 5], area[riverside], familyFriendly[no], near[Raja Indian Cuisine]"	"The Wrestlers is a Japanese pub near Raja Indian Cuisine in the riverside area. It is not kid friendly, has a moderate price range and has a customer rating of 1 out of 5."
"name[The Wrestlers], eatType[pub], food[Japanese], priceRange[moderate], customer rating[1 out of 5], area[riverside], familyFriendly[yes], near[Raja Indian Cuisine]"	"The Wrestlers is a Japanese pub near Raja Indian Cuisine in the riverside area. It is kid friendly, has a moderate price range and a customer rating of 1 out of 5."
"name[The Wrestlers], eatType[pub], food[Japanese], priceRange[more than £30], area[city centre], familyFriendly[no], near[Raja Indian Cuisine]"	"Located near Raja Indian Cuisine in the city centre, The Wrestlers is a Japanese pub that costs more than £30 and is not child friendly."
"name[The Wrestlers], eatType[pub], food[Japanese], priceRange[more than £30], area[city centre], familyFriendly[yes], near[Raja Indian Cuisine]"	The Wrestlers is a Japanese pub located near the Raja Indian Cuisine in the city centre. It is children friendly and has a price range of more than £30.
"name[The Wrestlers], eatType[pub], food[Japanese], priceRange[more than £30], area[riverside], familyFriendly[no], near[Raja Indian Cuisine]"	"The Wrestlers, located near Raja Indian Cuisine in riverside, is a Japanese pub with a price range of more than £30 and is not child friendly."
"name[The Wrestlers], eatType[pub], food[Japanese], priceRange[more than £30], area[riverside], familyFriendly[yes], near[Raja Indian Cuisine]"	Located near Raja Indian Cuisine in the riverside area is a child friendly pub called The Wrestlers that serves Japanese food and has a price range of more than £30.
"name[The Wrestlers], eatType[pub], food[Japanese], priceRange[more than £30], customer rating[5 out of 5], area[city centre], familyFriendly[no], near[Raja Indian Cuisine]"	"The Wrestlers is a Japanese pub near the Raja Indian Cuisine in the city centre. It is not child friendly, has a customer rating of 5 out of 5 and has a price range of more than £30."
"name[The Wrestlers], eatType[pub], food[Japanese], priceRange[more than £30], customer rating[5 out of 5], area[city centre], familyFriendly[yes], near[Raja Indian Cuisine]"	"The Wrestlers is a Japanese pub near the Raja Indian Cuisine in the city centre. It is children friendly, has a customer rating of 5 out of 5 and has a price range of more than £30."
"name[The Wrestlers], eatType[pub], food[Japanese], priceRange[more than £30], customer rating[5 out of 5], area[riverside], familyFriendly[no], near[Raja Indian Cuisine]"	"Located in the riverside area, near Raja Indian Cuisine, The Wrestlers is a highly priced Japanese restaurant. It has a customer rating of 5 out of 5 and is not child friendly."
"name[The Wrestlers], eatType[pub], food[Japanese], priceRange[more than £30], customer rating[5 out of 5], area[riverside], familyFriendly[yes], near[Raja Indian Cuisine]"	"Located in riverside near Raja Indian Cuisine, The Wrestlers is a highly priced Japanese pub with a customer rating of 5 out of 5."
"name[The Wrestlers], eatType[pub], food[Japanese], priceRange[more than £30], customer rating[low], area[city centre], familyFriendly[no], near[Raja Indian Cuisine]"	"Located near Raja Indian Cuisine in the city centre, The Wrestlers is a Japanese pub with a low customer rating and a price range of more than £30. It is not child friendly."
"name[The Wrestlers], eatType[pub], food[Japanese], priceRange[more than £30], customer rating[low], area[city centre], familyFriendly[yes], near[Raja Indian Cuisine]"	"The Wrestlers is a Japanese pub near the Raja Indian Cuisine in the city centre. It is children friendly, has a low customer rating and a price range of more than £30."
"name[The Wrestlers], eatType[pub], food[Japanese], priceRange[more than £30], customer rating[low], area[riverside], familyFriendly[no], near[Raja Indian Cuisine]"	"Near the Raja Indian Cuisine is a Japanese pub called the The Wrestlers. It is in the riverside area, has a low customer rating and is in the price range of more than £30. It is not children friendly."
"name[The Wrestlers], eatType[pub], food[Japanese], priceRange[more than £30], customer rating[low], area[riverside], familyFriendly[yes], near[Raja Indian Cuisine]"	"In the riverside area, near the Raja Indian Cuisine is a Japanese pub called The Wrestlers. It is child friendly and has a low customer rating."
"name[The Wrestlers], eatType[restaurant], food[Italian], priceRange[less than £20], area[riverside], familyFriendly[no], near[Raja Indian Cuisine]"	"The Wrestlers is an Italian restaurant near Raja Indian Cuisine in riverside. It is not family-friendly, but has a price range of less than £20."
"name[The Wrestlers], eatType[restaurant], food[Italian], priceRange[less than £20], area[riverside], familyFriendly[yes], near[Raja Indian Cuisine]"	"Located near Raja Indian Cuisine in riverside, The Wrestlers is a family friendly Italian restaurant with a price range of less than £20."
"name[The Wrestlers], eatType[restaurant], food[Italian], priceRange[moderate], area[city centre], familyFriendly[no], near[Raja Indian Cuisine]"	"Located near Raja Indian Cuisine in the city centre, The Wrestlers is an Italian restaurant that is not kid friendly with a moderate price range."
"name[The Wrestlers], eatType[restaurant], food[Italian], priceRange[moderate], area[city centre], familyFriendly[yes], near[Raja Indian Cuisine]"	"The Wrestlers is a moderately priced, kid friendly, Italian restaurant near Raja Indian Cuisine in the city centre."
"name[The Wrestlers], eatType[restaurant], food[Italian], priceRange[moderate], area[riverside], familyFriendly[no], near[Raja Indian Cuisine]"	"The Wrestlers is a moderately priced Italian restaurant, not kid friendly, located near Raja Indian Cuisine in the riverside area."
"name[The Wrestlers], eatType[restaurant], food[Italian], priceRange[moderate], area[riverside], familyFriendly[yes], near[Raja Indian Cuisine]"	"Located in the riverside area near Raja Indian Cuisine, The Wrestlers is a kid friendly Italian restaurant with a moderate price range."
"name[The Wrestlers], eatType[restaurant], food[Italian], priceRange[more than £30], area[riverside], familyFriendly[yes], near[Raja Indian Cuisine]"	"Located near Raja Indian Cuisine in riverside, The Wrestlers is a child friendly Italian restaurant with a price range of more than £30."
"name[The Wrestlers], eatType[restaurant], food[Japanese], priceRange[£20-25], area[riverside], familyFriendly[yes], near[Raja Indian Cuisine]"	"Located near Raja Indian Cuisine in riverside, The Wrestlers is a kid friendly Japanese restaurant with a price range of £20-25."
"name[The Wrestlers], eatType[restaurant], food[Japanese], priceRange[cheap], area[riverside], familyFriendly[yes], near[Raja Indian Cuisine]"	"The Wrestlers is a cheap, family friendly, Japanese restaurant near Raja Indian Cuisine in the riverside area."
"name[The Wrestlers], eatType[restaurant], food[Japanese], priceRange[high], area[riverside], familyFriendly[yes], near[Raja Indian Cuisine]"	"Located in riverside, near Raja Indian Cuisine, The Wrestlers is a child friendly Japanese restaurant with a high price range."
"name[The Wrestlers], eatType[restaurant], food[Japanese], priceRange[less than £20], area[city centre], familyFriendly[no], near[Raja Indian Cuisine]"	"The Wrestlers, located near Raja Indian Cuisine in the city centre, is a Japanese restaurant with a price range of less than £20. It is not family-friendly."
"name[The Wrestlers], eatType[restaurant], food[Japanese], priceRange[less than £20], area[city centre], familyFriendly[yes], near[Raja Indian Cuisine]"	The Wrestlers is a family-friendly Japanese restaurant with a price range less than £20 near Raja Indian Cuisine in the city centre.
"name[The Wrestlers], eatType[restaurant], food[Japanese], priceRange[less than £20], area[riverside], familyFriendly[no], near[Raja Indian Cuisine]"	"Located near Raja Indian Cuisine, in the riverside area, The Wrestlers is a non family-friendly Japanese restaurant with a price range of less than £20."
"name[The Wrestlers], eatType[restaurant], food[Japanese], priceRange[less than £20], area[riverside], familyFriendly[yes], near[Raja Indian Cuisine]"	"Located near Raja Indian Cuisine in riverside, The Wrestlers is a family friendly Japanese restaurant with a price range less than £20."
"name[The Wrestlers], eatType[restaurant], food[Japanese], priceRange[moderate], area[city centre], familyFriendly[no], near[Raja Indian Cuisine]"	"In the city centre, near Raja Indian Cuisine, there is a Japanese restaurant called The Wrestlers. It is not kid friendly and has a moderate price range."
"name[The Wrestlers], eatType[restaurant], food[Japanese], priceRange[moderate], area[city centre], familyFriendly[yes], near[Raja Indian Cuisine]"	"Located near Raja Indian Cuisine in the city centre, The Wrestlers is a kid friendly Japanese restaurant with a moderate price range."
"name[The Wrestlers], eatType[restaurant], food[Japanese], priceRange[moderate], area[riverside], familyFriendly[no], near[Raja Indian Cuisine]"	"Near Raja Indian Cuisine, in the riverside area is a Japanese restaurant called The Wrestlers. It has a moderate price range and is not kid friendly."
"name[The Wrestlers], eatType[restaurant], food[Japanese], priceRange[moderate], area[riverside], familyFriendly[yes], near[Raja Indian Cuisine]"	"The Wrestlers, located near Raja Indian Cuisine in riverside, is a family friendly Japanese restaurant with a moderate price range."
"name[The Wrestlers], eatType[restaurant], food[Japanese], priceRange[more than £30], area[city centre], familyFriendly[no], near[Raja Indian Cuisine]"	"Located near Raja Indian Cuisine in the city centre, The Wrestlers is a Japanese restaurant that costs more than £30 and is not child friendly."
"name[The Wrestlers], eatType[restaurant], food[Japanese], priceRange[more than £30], area[city centre], familyFriendly[yes], near[Raja Indian Cuisine]"	"Located near Raja Indian Cuisine in the city centre, The Wrestlers is a child friendly Japanese restaurant with prices ranging more than £30."
"name[The Wrestlers], eatType[restaurant], food[Japanese], priceRange[more than £30], area[riverside], familyFriendly[no], near[Raja Indian Cuisine]"	"Located near Raja Indian Cuisine in riverside, The Wrestlers is a Japanese restaurant with a price range of more than £30. It is not child friendly."
"name[The Wrestlers], eatType[restaurant], food[Japanese], priceRange[more than £30], area[riverside], familyFriendly[yes], near[Raja Indian Cuisine]"	"The Wrestlers, located near Raja Indian Cuisine in the riverside area, is a child friendly Japanese restaurant with a price range of more than £30."
"name[Wildwood], eatType[coffee shop], area[riverside]"	"By the riverside, there is a coffee shop called Wildwood."
"name[Wildwood], eatType[pub], area[riverside]"	"By the riverside, there is a pub called Wildwood."
"name[Wildwood], eatType[pub], food[French], area[riverside], familyFriendly[yes], near[Raja Indian Cuisine]"	"Wildwood is a pub that serves French food, is kid friendly, and is near Raja Indian Cuisine in the riverside area."
"name[Wildwood], eatType[pub], food[Indian], area[city centre], familyFriendly[no], near[Raja Indian Cuisine]"	"Located in the city centre near the Raja Indian Cuisine, Wildwood is an Indian pub that is not family-friendly."
"name[Wildwood], eatType[pub], food[Indian], area[city centre], familyFriendly[yes], near[Raja Indian Cuisine]"	Wildwood is a family-friendly pub serving Indian food in the city centre near Raja Indian Cuisine
"name[Wildwood], eatType[pub], food[Indian], area[riverside], familyFriendly[no], near[Raja Indian Cuisine]"	Wildwood is a pub that serves Indian food and is located in the riverside area near Raja Indian Cuisine and is not family friendly.
"name[Wildwood], eatType[pub], food[Indian], area[riverside], familyFriendly[yes], near[Raja Indian Cuisine]"	Wildwood is a family friendly pub located in riverside near Raja Indian Cuisine
"name[Wildwood], eatType[pub], food[Italian], area[city centre], familyFriendly[no], near[Raja Indian Cuisine]"	"Located in the city centre near the Raja Indian Cuisine, Wildwood is an Italian pub that is not family-friendly."
"name[Wildwood], eatType[pub], food[Italian], area[city centre], familyFriendly[yes], near[Raja Indian Cuisine]"	Wildwood is a family-friendly pub serving Italian food in the city centre near Raja Indian Cuisine
"name[Wildwood], eatType[pub], food[Italian], area[riverside], familyFriendly[no], near[Raja Indian Cuisine]"	Wildwood is a pub that serves Italian food and is located in the riverside area near Raja Indian Cuisine and is not family friendly.
"name[Wildwood], eatType[pub], food[Italian], area[riverside], familyFriendly[yes], near[Raja Indian Cuisine]"	Wildwood is a family friendly pub located in riverside near Raja Indian Cuisine
"name[Wildwood], eatType[restaurant], food[French], area[riverside], familyFriendly[yes], near[Raja Indian Cuisine]"	A family friendly French restaurant in the riverside area near the Raja Indian Cuisine is Wildwood.
"name[Wildwood], eatType[restaurant], food[Indian], area[city centre], familyFriendly[no], near[Raja Indian Cuisine]"	"Located in the city centre near Raja Indian Cuisine, Wildwood is an Indian restaurant that is not family-friendly."
"name[Wildwood], eatType[restaurant], food[Indian], area[city centre], familyFriendly[yes], near[Raja Indian Cuisine]"	"Located in the city centre near Raja Indian Cuisine, Wildwood is a family-friendly family friendly Indian restaurant."
"name[Wildwood], eatType[restaurant], food[Indian], area[riverside], familyFriendly[no], near[Raja Indian Cuisine]"	"In the riverside area, near Raja Indian Cuisine, Wildwood is an Indian restaurant that is not family friendly."
"name[Wildwood], eatType[restaurant], food[Indian], area[riverside], familyFriendly[yes], near[Raja Indian Cuisine]"	"Wildwood, located near Raja Indian Cuisine in the riverside area, is a family friendly pub that serves Indian food."
"name[Wildwood], eatType[restaurant], food[Italian], area[city centre], familyFriendly[no], near[Raja Indian Cuisine]"	"Located in the city centre near Raja Indian Cuisine, Wildwood is an Italian restaurant that is not family-friendly."
"name[Wildwood], eatType[restaurant], food[Italian], area[city centre], familyFriendly[yes], near[Raja Indian Cuisine]"	"Located in the city centre near Raja Indian Cuisine, Wildwood is a family-friendly family friendly Italian restaurant."
"name[Wildwood], eatType[restaurant], food[Italian], area[riverside], familyFriendly[no], near[Raja Indian Cuisine]"	"In the riverside area, near Raja Indian Cuisine, Wildwood is an Italian restaurant that is not family friendly."
"name[Wildwood], eatType[restaurant], food[Italian], area[riverside], familyFriendly[yes], near[Raja Indian Cuisine]"	"Wildwood, located near Raja Indian Cuisine in the riverside area, is a family friendly pub that serves Italian food."
"name[Zizzi], eatType[coffee shop], area[riverside]"	"By the riverside, there is a coffee shop called Zizzi."
"name[Zizzi], eatType[coffee shop], customer rating[average], near[Burger King]"	"Located near Burger King, Zizzi is a coffee shop with an average customer rating."
"name[Zizzi], eatType[coffee shop], customer rating[high], near[Burger King]"	"Near Burger King is Zizzi, a highly rated coffee shop"
"name[Zizzi], eatType[coffee shop], near[The Sorrento]"	Zizzi is a coffee shop and is located near The Sorrento
"name[Zizzi], eatType[pub], area[riverside]"	"By the riverside, there is a pub called Zizzi."
"name[Zizzi], eatType[pub], customer rating[average], near[Burger King]"	"Located near Burger King, Zizzi is a pub with an average customer rating."
"name[Zizzi], eatType[pub], customer rating[high], near[Burger King]"	"Located near Burger King, Zizzi is a pub with a high customer rating."
"name[Zizzi], eatType[pub], near[The Sorrento]"	"Near The Sorrento, there is a pub called Zizzi."
